"","Date","Season","home","visitor","FT","hgoal","vgoal","division","tier","totgoal","goaldif","result"
"1",1933-07-01,1932,"CA Paris (alt)","AS Cannes","5-1",5,1,"1",1,6,4,"H"
"2",1933-07-01,1932,"SC Fives Lille","FC Sete","4-2",4,2,"1",1,6,2,"H"
"3",1933-07-01,1932,"Olympique Marseille","OGC Nice","4-0",4,0,"1",1,4,4,"H"
"4",1933-07-01,1932,"SC Nimes","Olympique Lillois Lille","3-3",3,3,"1",1,6,0,"D"
"5",1933-07-01,1932,"FC Antibes","Stade Rennes","1-1",1,1,"1",1,2,0,"D"
"6",1933-07-01,1932,"Stade Olympique Montpellierain","Racing Club de France","1-0",1,0,"1",1,1,1,"H"
"7",1933-07-01,1932,"Excelsior Roubaix","FC Sochaux","2-1",2,1,"1",1,3,1,"H"
"8",1933-07-01,1932,"FC Sete","CA Paris (alt)","6-2",6,2,"1",1,8,4,"H"
"9",1933-07-01,1932,"OGC Nice","Excelsior Roubaix","3-3",3,3,"1",1,6,0,"D"
"10",1933-07-01,1932,"Racing Club de France","Olympique Lillois Lille","1-0",1,0,"1",1,1,1,"H"
"11",1933-07-01,1932,"AS Cannes","Olympique Marseille","1-1",1,1,"1",1,2,0,"D"
"12",1933-07-01,1932,"SC Fives Lille","SC Nimes","5-2",5,2,"1",1,7,3,"H"
"13",1933-07-01,1932,"Stade Rennes","Stade Olympique Montpellierain","2-6",2,6,"1",1,8,-4,"D"
"14",1933-07-01,1932,"FC Sochaux","FC Antibes","6-4",6,4,"1",1,10,2,"H"
"15",1933-07-01,1932,"FC Antibes","OGC Nice","3-2",3,2,"1",1,5,1,"H"
"16",1933-07-01,1932,"Stade Olympique Montpellierain","FC Sochaux","3-2",3,2,"1",1,5,1,"H"
"17",1933-07-01,1932,"Olympique Marseille","FC Sete","3-3",3,3,"1",1,6,0,"D"
"18",1933-07-01,1932,"Olympique Lillois Lille","Stade Rennes","5-4",5,4,"1",1,9,1,"H"
"19",1933-07-01,1932,"Excelsior Roubaix","AS Cannes","3-1",3,1,"1",1,4,2,"H"
"20",1933-07-01,1932,"SC Nimes","Racing Club de France","3-1",3,1,"1",1,4,2,"H"
"21",1933-07-01,1932,"CA Paris (alt)","SC Fives Lille","0-1",0,1,"1",1,1,-1,"D"
"22",1933-07-01,1932,"FC Sete","Excelsior Roubaix","4-2",4,2,"1",1,6,2,"H"
"23",1933-07-01,1932,"AS Cannes","FC Antibes","1-0",1,0,"1",1,1,1,"H"
"24",1933-07-01,1932,"Stade Rennes","Racing Club de France","2-1",2,1,"1",1,3,1,"H"
"25",1933-07-01,1932,"CA Paris (alt)","SC Nimes","7-0",7,0,"1",1,7,7,"H"
"26",1933-07-01,1932,"SC Fives Lille","Olympique Marseille","2-3",2,3,"1",1,5,-1,"D"
"27",1933-07-01,1932,"FC Sochaux","Olympique Lillois Lille","3-5",3,5,"1",1,8,-2,"D"
"28",1933-07-01,1932,"OGC Nice","Stade Olympique Montpellierain","1-1",1,1,"1",1,2,0,"D"
"29",1933-07-01,1932,"OGC Nice","CA Paris (alt)","5-2",5,2,"1",1,7,3,"H"
"30",1933-07-01,1932,"Stade Rennes","Excelsior Roubaix","5-2",5,2,"1",1,7,3,"H"
"31",1933-07-01,1932,"Racing Club de France","FC Antibes","5-2",5,2,"1",1,7,3,"H"
"32",1933-07-01,1932,"FC Sochaux","Olympique Marseille","4-1",4,1,"1",1,5,3,"H"
"33",1933-07-01,1932,"AS Cannes","SC Fives Lille","0-0",0,0,"1",1,0,0,"D"
"34",1933-07-01,1932,"FC Sete","SC Nimes","8-2",8,2,"1",1,10,6,"H"
"35",1933-07-01,1932,"Olympique Lillois Lille","Stade Olympique Montpellierain","6-2",6,2,"1",1,8,4,"H"
"36",1933-07-01,1932,"FC Sete","AS Cannes","4-0",4,0,"1",1,4,4,"H"
"37",1933-07-01,1932,"CA Paris (alt)","FC Sochaux","4-6",4,6,"1",1,10,-2,"D"
"38",1933-07-01,1932,"FC Antibes","Olympique Lillois Lille","3-1",3,1,"1",1,4,2,"H"
"39",1933-07-01,1932,"Excelsior Roubaix","Racing Club de France","3-6",3,6,"1",1,9,-3,"D"
"40",1933-07-01,1932,"Olympique Marseille","Stade Rennes","7-1",7,1,"1",1,8,6,"H"
"41",1933-07-01,1932,"SC Nimes","Stade Olympique Montpellierain","2-0",2,0,"1",1,2,2,"H"
"42",1933-07-01,1932,"SC Fives Lille","OGC Nice","5-2",5,2,"1",1,7,3,"H"
"43",1933-07-01,1932,"OGC Nice","FC Sete","1-4",1,4,"1",1,5,-3,"D"
"44",1933-07-01,1932,"Stade Rennes","CA Paris (alt)","8-2",8,2,"1",1,10,6,"H"
"45",1933-07-01,1932,"Olympique Lillois Lille","Excelsior Roubaix","4-2",4,2,"1",1,6,2,"H"
"46",1933-07-01,1932,"Stade Olympique Montpellierain","FC Antibes","3-2",3,2,"1",1,5,1,"H"
"47",1933-07-01,1932,"AS Cannes","SC Nimes","1-1",1,1,"1",1,2,0,"D"
"48",1933-07-01,1932,"Racing Club de France","Olympique Marseille","0-1",0,1,"1",1,1,-1,"D"
"49",1933-07-01,1932,"FC Sochaux","SC Fives Lille","1-3",1,3,"1",1,4,-2,"D"
"50",1933-07-01,1932,"FC Sete","FC Sochaux","3-1",3,1,"1",1,4,2,"H"
"51",1933-07-01,1932,"SC Nimes","FC Antibes","5-0",5,0,"1",1,5,5,"H"
"52",1933-07-01,1932,"AS Cannes","OGC Nice","2-2",2,2,"1",1,4,0,"D"
"53",1933-07-01,1932,"CA Paris (alt)","Racing Club de France","1-4",1,4,"1",1,5,-3,"D"
"54",1933-07-01,1932,"Excelsior Roubaix","Stade Olympique Montpellierain","3-2",3,2,"1",1,5,1,"H"
"55",1933-07-01,1932,"Olympique Marseille","Olympique Lillois Lille","1-3",1,3,"1",1,4,-2,"D"
"56",1933-07-01,1932,"SC Fives Lille","Stade Rennes","5-0",5,0,"1",1,5,5,"H"
"57",1933-07-01,1932,"OGC Nice","SC Nimes","1-2",1,2,"1",1,3,-1,"D"
"58",1933-07-01,1932,"FC Sochaux","AS Cannes","3-3",3,3,"1",1,6,0,"D"
"59",1933-07-01,1932,"Olympique Lillois Lille","CA Paris (alt)","4-1",4,1,"1",1,5,3,"H"
"60",1933-07-01,1932,"Stade Rennes","FC Sete","4-4",4,4,"1",1,8,0,"D"
"61",1933-07-01,1932,"Racing Club de France","SC Fives Lille","1-0",1,0,"1",1,1,1,"H"
"62",1933-07-01,1932,"Stade Olympique Montpellierain","Olympique Marseille","3-3",3,3,"1",1,6,0,"D"
"63",1933-07-01,1932,"FC Antibes","Excelsior Roubaix","2-1",2,1,"1",1,3,1,"H"
"64",1933-07-01,1932,"SC Nimes","Excelsior Roubaix","3-0",3,0,"1",1,3,3,"H"
"65",1933-07-01,1932,"Olympique Marseille","FC Antibes","3-2",3,2,"1",1,5,1,"H"
"66",1933-07-01,1932,"SC Fives Lille","Olympique Lillois Lille","3-0",3,0,"1",1,3,3,"H"
"67",1933-07-01,1932,"AS Cannes","Stade Rennes","0-2",0,2,"1",1,2,-2,"D"
"68",1933-07-01,1932,"FC Sete","Racing Club de France","2-1",2,1,"1",1,3,1,"H"
"69",1933-07-01,1932,"OGC Nice","FC Sochaux","2-1",2,1,"1",1,3,1,"H"
"70",1933-07-01,1932,"CA Paris (alt)","Stade Olympique Montpellierain","1-4",1,4,"1",1,5,-3,"D"
"71",1933-07-01,1932,"Racing Club de France","AS Cannes","5-1",5,1,"1",1,6,4,"H"
"72",1933-07-01,1932,"Olympique Lillois Lille","FC Sete","6-0",6,0,"1",1,6,6,"H"
"73",1933-07-01,1932,"Stade Olympique Montpellierain","SC Fives Lille","4-1",4,1,"1",1,5,3,"H"
"74",1933-07-01,1932,"FC Sochaux","SC Nimes","6-3",6,3,"1",1,9,3,"H"
"75",1933-07-01,1932,"Excelsior Roubaix","Olympique Marseille","4-3",4,3,"1",1,7,1,"H"
"76",1933-07-01,1932,"Stade Rennes","OGC Nice","2-1",2,1,"1",1,3,1,"H"
"77",1933-07-01,1932,"FC Antibes","CA Paris (alt)","3-1",3,1,"1",1,4,2,"H"
"78",1933-07-01,1932,"CA Paris (alt)","Excelsior Roubaix","3-6",3,6,"1",1,9,-3,"D"
"79",1933-07-01,1932,"AS Cannes","Olympique Lillois Lille","2-0",2,0,"1",1,2,2,"H"
"80",1933-07-01,1932,"SC Nimes","Olympique Marseille","0-2",0,2,"1",1,2,-2,"D"
"81",1933-07-01,1932,"OGC Nice","Racing Club de France","2-0",2,0,"1",1,2,2,"H"
"82",1933-07-01,1932,"FC Sochaux","Stade Rennes","6-2",6,2,"1",1,8,4,"H"
"83",1933-07-01,1932,"SC Fives Lille","FC Antibes","0-0",0,0,"1",1,0,0,"D"
"84",1933-07-01,1932,"FC Sete","Stade Olympique Montpellierain","1-1",1,1,"1",1,2,0,"D"
"85",1933-07-01,1932,"Stade Olympique Montpellierain","AS Cannes","0-0",0,0,"1",1,0,0,"D"
"86",1933-07-01,1932,"FC Antibes","FC Sete","3-0",3,0,"1",1,3,3,"H"
"87",1933-07-01,1932,"Olympique Marseille","CA Paris (alt)","3-1",3,1,"1",1,4,2,"H"
"88",1933-07-01,1932,"Stade Rennes","SC Nimes","6-2",6,2,"1",1,8,4,"H"
"89",1933-07-01,1932,"Olympique Lillois Lille","OGC Nice","3-0",3,0,"1",1,3,3,"H"
"90",1933-07-01,1932,"Racing Club de France","FC Sochaux","0-2",0,2,"1",1,2,-2,"D"
"91",1933-07-01,1932,"Excelsior Roubaix","SC Fives Lille","1-1",1,1,"1",1,2,0,"D"
"92",1933-07-01,1932,"AS Cannes","CA Paris (alt)","3-1",3,1,"1",1,4,2,"H"
"93",1933-07-01,1932,"Stade Rennes","FC Antibes","2-2",2,2,"1",1,4,0,"D"
"94",1933-07-01,1932,"OGC Nice","Olympique Marseille","0-3",0,3,"1",1,3,-3,"D"
"95",1933-07-01,1932,"FC Sete","SC Fives Lille","2-2",2,2,"1",1,4,0,"D"
"96",1933-07-01,1932,"Olympique Lillois Lille","SC Nimes","3-1",3,1,"1",1,4,2,"H"
"97",1933-07-01,1932,"Racing Club de France","Stade Olympique Montpellierain","3-0",3,0,"1",1,3,3,"H"
"98",1933-07-01,1932,"FC Sochaux","Excelsior Roubaix","1-2",1,2,"1",1,3,-1,"D"
"99",1933-07-01,1932,"FC Antibes","FC Sochaux","3-1",3,1,"1",1,4,2,"H"
"100",1933-07-01,1932,"CA Paris (alt)","FC Sete","2-3",2,3,"1",1,5,-1,"D"
"101",1933-07-01,1932,"Olympique Lillois Lille","Racing Club de France","0-0",0,0,"1",1,0,0,"D"
"102",1933-07-01,1932,"Stade Olympique Montpellierain","Stade Rennes","1-2",1,2,"1",1,3,-1,"D"
"103",1933-07-01,1932,"Olympique Marseille","AS Cannes","4-0",4,0,"1",1,4,4,"H"
"104",1933-07-01,1932,"SC Nimes","SC Fives Lille","3-4",3,4,"1",1,7,-1,"D"
"105",1933-07-01,1932,"Excelsior Roubaix","OGC Nice","3-1",3,1,"1",1,4,2,"H"
"106",1933-07-01,1932,"AS Cannes","Excelsior Roubaix","1-0",1,0,"1",1,1,1,"H"
"107",1933-07-01,1932,"SC Fives Lille","CA Paris (alt)","2-0",2,0,"1",1,2,2,"H"
"108",1933-07-01,1932,"Stade Rennes","Olympique Lillois Lille","1-5",1,5,"1",1,6,-4,"D"
"109",1933-07-01,1932,"FC Sochaux","Stade Olympique Montpellierain","0-0",0,0,"1",1,0,0,"D"
"110",1933-07-01,1932,"OGC Nice","FC Antibes","1-1",1,1,"1",1,2,0,"D"
"111",1933-07-01,1932,"FC Sete","Olympique Marseille","1-0",1,0,"1",1,1,1,"H"
"112",1933-07-01,1932,"Racing Club de France","SC Nimes","1-1",1,1,"1",1,2,0,"D"
"113",1933-07-01,1932,"SC Nimes","CA Paris (alt)","5-1",5,1,"1",1,6,4,"H"
"114",1933-07-01,1932,"Olympique Lillois Lille","FC Sochaux","2-2",2,2,"1",1,4,0,"D"
"115",1933-07-01,1932,"Racing Club de France","Stade Rennes","2-3",2,3,"1",1,5,-1,"D"
"116",1933-07-01,1932,"Stade Olympique Montpellierain","OGC Nice","3-1",3,1,"1",1,4,2,"H"
"117",1933-07-01,1932,"Olympique Marseille","SC Fives Lille","2-1",2,1,"1",1,3,1,"H"
"118",1933-07-01,1932,"FC Antibes","AS Cannes","4-1",4,1,"1",1,5,3,"H"
"119",1933-07-01,1932,"Excelsior Roubaix","FC Sete","3-3",3,3,"1",1,6,0,"D"
"120",1933-07-01,1932,"SC Fives Lille","AS Cannes","1-2",1,2,"1",1,3,-1,"D"
"121",1933-07-01,1932,"SC Nimes","FC Sete","0-2",0,2,"1",1,2,-2,"D"
"122",1933-07-01,1932,"FC Antibes","Racing Club de France","1-0",1,0,"1",1,1,1,"H"
"123",1933-07-01,1932,"Stade Olympique Montpellierain","Olympique Lillois Lille","2-1",2,1,"1",1,3,1,"H"
"124",1933-07-01,1932,"Excelsior Roubaix","Stade Rennes","4-2",4,2,"1",1,6,2,"H"
"125",1933-07-01,1932,"CA Paris (alt)","OGC Nice","6-1",6,1,"1",1,7,5,"H"
"126",1933-07-01,1932,"Olympique Marseille","FC Sochaux","4-0",4,0,"1",1,4,4,"H"
"127",1933-07-01,1932,"FC Sochaux","CA Paris (alt)","2-3",2,3,"1",1,5,-1,"D"
"128",1933-07-01,1932,"AS Cannes","FC Sete","4-1",4,1,"1",1,5,3,"H"
"129",1933-07-01,1932,"Stade Olympique Montpellierain","SC Nimes","2-4",2,4,"1",1,6,-2,"D"
"130",1933-07-01,1932,"Racing Club de France","Excelsior Roubaix","3-3",3,3,"1",1,6,0,"D"
"131",1933-07-01,1932,"Olympique Lillois Lille","FC Antibes","4-0",4,0,"1",1,4,4,"H"
"132",1933-07-01,1932,"Stade Rennes","Olympique Marseille","1-0",1,0,"1",1,1,1,"H"
"133",1933-07-01,1932,"OGC Nice","SC Fives Lille","0-0",0,0,"1",1,0,0,"D"
"134",1933-07-01,1932,"SC Nimes","AS Cannes","4-1",4,1,"1",1,5,3,"H"
"135",1933-07-01,1932,"SC Fives Lille","FC Sochaux","3-0",3,0,"1",1,3,3,"H"
"136",1933-07-01,1932,"Excelsior Roubaix","Olympique Lillois Lille","2-0",2,0,"1",1,2,2,"H"
"137",1933-07-01,1932,"Olympique Marseille","Racing Club de France","4-1",4,1,"1",1,5,3,"H"
"138",1933-07-01,1932,"FC Sete","OGC Nice","4-0",4,0,"1",1,4,4,"H"
"139",1933-07-01,1932,"FC Antibes","Stade Olympique Montpellierain","3-3",3,3,"1",1,6,0,"D"
"140",1933-07-01,1932,"CA Paris (alt)","Stade Rennes","3-6",3,6,"1",1,9,-3,"D"
"141",1933-07-01,1932,"OGC Nice","AS Cannes","3-1",3,1,"1",1,4,2,"H"
"142",1933-07-01,1932,"FC Sochaux","FC Sete","3-2",3,2,"1",1,5,1,"H"
"143",1933-07-01,1932,"FC Antibes","SC Nimes","4-2",4,2,"1",1,6,2,"H"
"144",1933-07-01,1932,"Olympique Lillois Lille","Olympique Marseille","6-1",6,1,"1",1,7,5,"H"
"145",1933-07-01,1932,"Racing Club de France","CA Paris (alt)","4-1",4,1,"1",1,5,3,"H"
"146",1933-07-01,1932,"Stade Olympique Montpellierain","Excelsior Roubaix","2-6",2,6,"1",1,8,-4,"D"
"147",1933-07-01,1932,"Stade Rennes","SC Fives Lille","1-0",1,0,"1",1,1,1,"H"
"148",1933-07-01,1932,"Excelsior Roubaix","FC Antibes","2-3",2,3,"1",1,5,-1,"D"
"149",1933-07-01,1932,"AS Cannes","FC Sochaux","4-0",4,0,"1",1,4,4,"H"
"150",1933-07-01,1932,"CA Paris (alt)","Olympique Lillois Lille","0-3",0,3,"1",1,3,-3,"D"
"151",1933-07-01,1932,"FC Sete","Stade Rennes","3-1",3,1,"1",1,4,2,"H"
"152",1933-07-01,1932,"Olympique Marseille","Stade Olympique Montpellierain","3-1",3,1,"1",1,4,2,"H"
"153",1933-07-01,1932,"SC Nimes","OGC Nice","5-2",5,2,"1",1,7,3,"H"
"154",1933-07-01,1932,"SC Fives Lille","Racing Club de France","3-3",3,3,"1",1,6,0,"D"
"155",1933-07-01,1932,"Stade Rennes","AS Cannes","2-2",2,2,"1",1,4,0,"D"
"156",1933-07-01,1932,"FC Antibes","Olympique Marseille","1-3",1,3,"1",1,4,-2,"D"
"157",1933-07-01,1932,"Stade Olympique Montpellierain","CA Paris (alt)","3-2",3,2,"1",1,5,1,"H"
"158",1933-07-01,1932,"FC Sochaux","OGC Nice","3-1",3,1,"1",1,4,2,"H"
"159",1933-07-01,1932,"Racing Club de France","FC Sete","1-1",1,1,"1",1,2,0,"D"
"160",1933-07-01,1932,"Olympique Lillois Lille","SC Fives Lille","1-1",1,1,"1",1,2,0,"D"
"161",1933-07-01,1932,"Excelsior Roubaix","SC Nimes","1-0",1,0,"1",1,1,1,"H"
"162",1933-07-01,1932,"CA Paris (alt)","FC Antibes","1-3",1,3,"1",1,4,-2,"D"
"163",1933-07-01,1932,"FC Sete","Olympique Lillois Lille","1-0",1,0,"1",1,1,1,"H"
"164",1933-07-01,1932,"AS Cannes","Racing Club de France","6-2",6,2,"1",1,8,4,"H"
"165",1933-07-01,1932,"Olympique Marseille","Excelsior Roubaix","2-4",2,4,"1",1,6,-2,"D"
"166",1933-07-01,1932,"SC Nimes","FC Sochaux","7-1",7,1,"1",1,8,6,"H"
"167",1933-07-01,1932,"OGC Nice","Stade Rennes","4-2",4,2,"1",1,6,2,"H"
"168",1933-07-01,1932,"SC Fives Lille","Stade Olympique Montpellierain","2-1",2,1,"1",1,3,1,"H"
"169",1933-07-01,1932,"Excelsior Roubaix","CA Paris (alt)","3-2",3,2,"1",1,5,1,"H"
"170",1933-07-01,1932,"Olympique Lillois Lille","AS Cannes","3-1",3,1,"1",1,4,2,"H"
"171",1933-07-01,1932,"Stade Rennes","FC Sochaux","2-2",2,2,"1",1,4,0,"D"
"172",1933-07-01,1932,"Stade Olympique Montpellierain","FC Sete","4-1",4,1,"1",1,5,3,"H"
"173",1933-07-01,1932,"Racing Club de France","OGC Nice","4-3",4,3,"1",1,7,1,"H"
"174",1933-07-01,1932,"Olympique Marseille","SC Nimes","7-3",7,3,"1",1,10,4,"H"
"175",1933-07-01,1932,"FC Antibes","SC Fives Lille","0-7",0,7,"1",1,7,-7,"D"
"176",1933-07-01,1932,"SC Fives Lille","Excelsior Roubaix","1-0",1,0,"1",1,1,1,"H"
"177",1933-07-01,1932,"CA Paris (alt)","Olympique Marseille","3-1",3,1,"1",1,4,2,"H"
"178",1933-07-01,1932,"OGC Nice","Olympique Lillois Lille","3-2",3,2,"1",1,5,1,"H"
"179",1933-07-01,1932,"FC Sochaux","Racing Club de France","3-2",3,2,"1",1,5,1,"H"
"180",1933-07-01,1932,"SC Nimes","Stade Rennes","5-3",5,3,"1",1,8,2,"H"
"181",1933-07-01,1932,"AS Cannes","Stade Olympique Montpellierain","3-1",3,1,"1",1,4,2,"H"
"182",1933-07-01,1932,"FC Sete","FC Antibes","4-2",4,2,"1",1,6,2,"H"
"183",1934-07-01,1933,"FC Sochaux","Excelsior Roubaix","0-2",0,2,"1",1,2,-2,"D"
"184",1934-07-01,1933,"Olympique Lillois Lille","AS Cannes","0-0",0,0,"1",1,0,0,"D"
"185",1934-07-01,1933,"FC Mulhouse","SC Nimes","6-0",6,0,"1",1,6,6,"H"
"186",1934-07-01,1933,"FC Antibes","SC Fives Lille","2-3",2,3,"1",1,5,-1,"D"
"187",1934-07-01,1933,"Olympique Ales","Olympique Marseille","1-0",1,0,"1",1,1,1,"H"
"188",1934-07-01,1933,"Red Star Olympique","Stade Rennes","2-1",2,1,"1",1,3,1,"H"
"189",1934-07-01,1933,"RC Strasbourg","FC Sete","5-2",5,2,"1",1,7,3,"H"
"190",1934-07-01,1933,"Stade Olympique Montpellierain","Racing Club de France","3-3",3,3,"1",1,6,0,"D"
"191",1934-07-01,1933,"FC Sochaux","Stade Rennes","2-1",2,1,"1",1,3,1,"H"
"192",1934-07-01,1933,"FC Mulhouse","Olympique Marseille","3-4",3,4,"1",1,7,-1,"D"
"193",1934-07-01,1933,"Olympique Lillois Lille","FC Sete","2-0",2,0,"1",1,2,2,"H"
"194",1934-07-01,1933,"FC Antibes","Red Star Olympique","1-1",1,1,"1",1,2,0,"D"
"195",1934-07-01,1933,"Racing Club de France","Excelsior Roubaix","3-1",3,1,"1",1,4,2,"H"
"196",1934-07-01,1933,"Olympique Ales","SC Nimes","2-4",2,4,"1",1,6,-2,"D"
"197",1934-07-01,1933,"RC Strasbourg","AS Cannes","1-1",1,1,"1",1,2,0,"D"
"198",1934-07-01,1933,"Stade Olympique Montpellierain","SC Fives Lille","2-0",2,0,"1",1,2,2,"H"
"199",1934-07-01,1933,"Excelsior Roubaix","RC Strasbourg","1-2",1,2,"1",1,3,-1,"D"
"200",1934-07-01,1933,"Racing Club de France","Olympique Ales","6-3",6,3,"1",1,9,3,"H"
"201",1934-07-01,1933,"FC Sete","Red Star Olympique","2-2",2,2,"1",1,4,0,"D"
"202",1934-07-01,1933,"SC Nimes","Stade Olympique Montpellierain","4-5",4,5,"1",1,9,-1,"D"
"203",1934-07-01,1933,"AS Cannes","FC Sochaux","0-2",0,2,"1",1,2,-2,"D"
"204",1934-07-01,1933,"SC Fives Lille","FC Mulhouse","0-2",0,2,"1",1,2,-2,"D"
"205",1934-07-01,1933,"Stade Rennes","Olympique Lillois Lille","4-0",4,0,"1",1,4,4,"H"
"206",1934-07-01,1933,"Olympique Marseille","FC Antibes","7-2",7,2,"1",1,9,5,"H"
"207",1934-07-01,1933,"SC Nimes","FC Antibes","3-1",3,1,"1",1,4,2,"H"
"208",1934-07-01,1933,"Olympique Marseille","Stade Olympique Montpellierain","4-1",4,1,"1",1,5,3,"H"
"209",1934-07-01,1933,"Stade Rennes","RC Strasbourg","0-2",0,2,"1",1,2,-2,"D"
"210",1934-07-01,1933,"SC Fives Lille","Olympique Ales","1-0",1,0,"1",1,1,1,"H"
"211",1934-07-01,1933,"AS Cannes","Red Star Olympique","6-2",6,2,"1",1,8,4,"H"
"212",1934-07-01,1933,"Excelsior Roubaix","Olympique Lillois Lille","2-1",2,1,"1",1,3,1,"H"
"213",1934-07-01,1933,"Racing Club de France","FC Mulhouse","2-3",2,3,"1",1,5,-1,"D"
"214",1934-07-01,1933,"FC Sete","FC Sochaux","1-1",1,1,"1",1,2,0,"D"
"215",1934-07-01,1933,"FC Sochaux","SC Fives Lille","2-1",2,1,"1",1,3,1,"H"
"216",1934-07-01,1933,"FC Mulhouse","Stade Rennes","2-2",2,2,"1",1,4,0,"D"
"217",1934-07-01,1933,"Olympique Lillois Lille","Olympique Marseille","5-0",5,0,"1",1,5,5,"H"
"218",1934-07-01,1933,"FC Antibes","FC Sete","1-0",1,0,"1",1,1,1,"H"
"219",1934-07-01,1933,"Red Star Olympique","Racing Club de France","1-2",1,2,"1",1,3,-1,"D"
"220",1934-07-01,1933,"Olympique Ales","Excelsior Roubaix","0-3",0,3,"1",1,3,-3,"D"
"221",1934-07-01,1933,"RC Strasbourg","SC Nimes","3-0",3,0,"1",1,3,3,"H"
"222",1934-07-01,1933,"Stade Olympique Montpellierain","AS Cannes","2-3",2,3,"1",1,5,-1,"D"
"223",1934-07-01,1933,"FC Sochaux","SC Nimes","1-0",1,0,"1",1,1,1,"H"
"224",1934-07-01,1933,"Olympique Ales","FC Sete","3-0",3,0,"1",1,3,3,"H"
"225",1934-07-01,1933,"Racing Club de France","RC Strasbourg","2-2",2,2,"1",1,4,0,"D"
"226",1934-07-01,1933,"Stade Olympique Montpellierain","Excelsior Roubaix","0-2",0,2,"1",1,2,-2,"D"
"227",1934-07-01,1933,"AS Cannes","FC Mulhouse","5-0",5,0,"1",1,5,5,"H"
"228",1934-07-01,1933,"SC Fives Lille","Olympique Lillois Lille","2-1",2,1,"1",1,3,1,"H"
"229",1934-07-01,1933,"Stade Rennes","FC Antibes","4-1",4,1,"1",1,5,3,"H"
"230",1934-07-01,1933,"Olympique Marseille","Red Star Olympique","4-3",4,3,"1",1,7,1,"H"
"231",1934-07-01,1933,"FC Sochaux","Red Star Olympique","4-3",4,3,"1",1,7,1,"H"
"232",1934-07-01,1933,"FC Mulhouse","Olympique Ales","2-0",2,0,"1",1,2,2,"H"
"233",1934-07-01,1933,"Olympique Lillois Lille","RC Strasbourg","2-1",2,1,"1",1,3,1,"H"
"234",1934-07-01,1933,"FC Antibes","Stade Olympique Montpellierain","4-0",4,0,"1",1,4,4,"H"
"235",1934-07-01,1933,"Stade Rennes","Excelsior Roubaix","0-1",0,1,"1",1,1,-1,"D"
"236",1934-07-01,1933,"SC Nimes","Olympique Marseille","1-1",1,1,"1",1,2,0,"D"
"237",1934-07-01,1933,"FC Sete","AS Cannes","1-1",1,1,"1",1,2,0,"D"
"238",1934-07-01,1933,"Racing Club de France","SC Fives Lille","7-0",7,0,"1",1,7,7,"H"
"239",1934-07-01,1933,"Stade Olympique Montpellierain","FC Sochaux","0-4",0,4,"1",1,4,-4,"D"
"240",1934-07-01,1933,"Red Star Olympique","FC Mulhouse","3-1",3,1,"1",1,4,2,"H"
"241",1934-07-01,1933,"Olympique Ales","Olympique Lillois Lille","3-1",3,1,"1",1,4,2,"H"
"242",1934-07-01,1933,"RC Strasbourg","FC Antibes","6-1",6,1,"1",1,7,5,"H"
"243",1934-07-01,1933,"SC Fives Lille","Stade Rennes","4-1",4,1,"1",1,5,3,"H"
"244",1934-07-01,1933,"Excelsior Roubaix","Olympique Marseille","0-3",0,3,"1",1,3,-3,"D"
"245",1934-07-01,1933,"SC Nimes","FC Sete","1-3",1,3,"1",1,4,-2,"D"
"246",1934-07-01,1933,"AS Cannes","Racing Club de France","0-2",0,2,"1",1,2,-2,"D"
"247",1934-07-01,1933,"FC Sochaux","Racing Club de France","3-1",3,1,"1",1,4,2,"H"
"248",1934-07-01,1933,"Excelsior Roubaix","FC Mulhouse","1-2",1,2,"1",1,3,-1,"D"
"249",1934-07-01,1933,"Olympique Lillois Lille","SC Nimes","3-1",3,1,"1",1,4,2,"H"
"250",1934-07-01,1933,"AS Cannes","FC Antibes","3-1",3,1,"1",1,4,2,"H"
"251",1934-07-01,1933,"Red Star Olympique","SC Fives Lille","5-2",5,2,"1",1,7,3,"H"
"252",1934-07-01,1933,"Stade Rennes","Olympique Ales","6-0",6,0,"1",1,6,6,"H"
"253",1934-07-01,1933,"Olympique Marseille","RC Strasbourg","1-1",1,1,"1",1,2,0,"D"
"254",1934-07-01,1933,"Stade Olympique Montpellierain","FC Sete","0-2",0,2,"1",1,2,-2,"D"
"255",1934-07-01,1933,"FC Sochaux","RC Strasbourg","2-3",2,3,"1",1,5,-1,"D"
"256",1934-07-01,1933,"Olympique Lillois Lille","Red Star Olympique","0-4",0,4,"1",1,4,-4,"D"
"257",1934-07-01,1933,"Stade Rennes","AS Cannes","3-0",3,0,"1",1,3,3,"H"
"258",1934-07-01,1933,"FC Sete","Excelsior Roubaix","2-2",2,2,"1",1,4,0,"D"
"259",1934-07-01,1933,"FC Mulhouse","Stade Olympique Montpellierain","4-1",4,1,"1",1,5,3,"H"
"260",1934-07-01,1933,"FC Antibes","Olympique Ales","1-0",1,0,"1",1,1,1,"H"
"261",1934-07-01,1933,"Olympique Marseille","SC Fives Lille","5-1",5,1,"1",1,6,4,"H"
"262",1934-07-01,1933,"Racing Club de France","SC Nimes","2-0",2,0,"1",1,2,2,"H"
"263",1934-07-01,1933,"RC Strasbourg","FC Mulhouse","4-2",4,2,"1",1,6,2,"H"
"264",1934-07-01,1933,"Olympique Ales","FC Sochaux","0-5",0,5,"1",1,5,-5,"D"
"265",1934-07-01,1933,"Stade Olympique Montpellierain","Olympique Lillois Lille","1-3",1,3,"1",1,4,-2,"D"
"266",1934-07-01,1933,"Racing Club de France","FC Antibes","5-1",5,1,"1",1,6,4,"H"
"267",1934-07-01,1933,"SC Nimes","Stade Rennes","1-2",1,2,"1",1,3,-1,"D"
"268",1934-07-01,1933,"AS Cannes","Olympique Marseille","3-0",3,0,"1",1,3,3,"H"
"269",1934-07-01,1933,"SC Fives Lille","FC Sete","1-2",1,2,"1",1,3,-1,"D"
"270",1934-07-01,1933,"Excelsior Roubaix","Red Star Olympique","2-0",2,0,"1",1,2,2,"H"
"271",1934-07-01,1933,"FC Sochaux","FC Mulhouse","8-0",8,0,"1",1,8,8,"H"
"272",1934-07-01,1933,"Olympique Lillois Lille","FC Antibes","10-0",10,0,"1",1,10,10,"H"
"273",1934-07-01,1933,"Red Star Olympique","Olympique Ales","3-1",3,1,"1",1,4,2,"H"
"274",1934-07-01,1933,"RC Strasbourg","Stade Olympique Montpellierain","2-1",2,1,"1",1,3,1,"H"
"275",1934-07-01,1933,"AS Cannes","SC Fives Lille","2-0",2,0,"1",1,2,2,"H"
"276",1934-07-01,1933,"SC Nimes","Excelsior Roubaix","1-1",1,1,"1",1,2,0,"D"
"277",1934-07-01,1933,"Stade Rennes","Olympique Marseille","1-1",1,1,"1",1,2,0,"D"
"278",1934-07-01,1933,"FC Sete","Racing Club de France","2-2",2,2,"1",1,4,0,"D"
"279",1934-07-01,1933,"FC Antibes","FC Sochaux","1-1",1,1,"1",1,2,0,"D"
"280",1934-07-01,1933,"FC Mulhouse","Olympique Lillois Lille","1-0",1,0,"1",1,1,1,"H"
"281",1934-07-01,1933,"Stade Olympique Montpellierain","Red Star Olympique","0-3",0,3,"1",1,3,-3,"D"
"282",1934-07-01,1933,"Olympique Ales","RC Strasbourg","1-5",1,5,"1",1,6,-4,"D"
"283",1934-07-01,1933,"SC Fives Lille","Excelsior Roubaix","0-0",0,0,"1",1,0,0,"D"
"284",1934-07-01,1933,"SC Nimes","AS Cannes","1-2",1,2,"1",1,3,-1,"D"
"285",1934-07-01,1933,"Racing Club de France","Stade Rennes","2-1",2,1,"1",1,3,1,"H"
"286",1934-07-01,1933,"Olympique Marseille","FC Sete","1-1",1,1,"1",1,2,0,"D"
"287",1934-07-01,1933,"FC Sochaux","Olympique Lillois Lille","5-2",5,2,"1",1,7,3,"H"
"288",1934-07-01,1933,"FC Antibes","FC Mulhouse","1-1",1,1,"1",1,2,0,"D"
"289",1934-07-01,1933,"RC Strasbourg","Red Star Olympique","5-2",5,2,"1",1,7,3,"H"
"290",1934-07-01,1933,"Excelsior Roubaix","AS Cannes","2-0",2,0,"1",1,2,2,"H"
"291",1934-07-01,1933,"FC Sete","Stade Rennes","2-0",2,0,"1",1,2,2,"H"
"292",1934-07-01,1933,"Racing Club de France","Olympique Marseille","5-1",5,1,"1",1,6,4,"H"
"293",1934-07-01,1933,"SC Fives Lille","SC Nimes","3-1",3,1,"1",1,4,2,"H"
"294",1934-07-01,1933,"Olympique Ales","Stade Olympique Montpellierain","1-1",1,1,"1",1,2,0,"D"
"295",1934-07-01,1933,"Olympique Ales","AS Cannes","5-1",5,1,"1",1,6,4,"H"
"296",1934-07-01,1933,"Red Star Olympique","SC Nimes","2-2",2,2,"1",1,4,0,"D"
"297",1934-07-01,1933,"Stade Olympique Montpellierain","Stade Rennes","4-1",4,1,"1",1,5,3,"H"
"298",1934-07-01,1933,"RC Strasbourg","SC Fives Lille","2-1",2,1,"1",1,3,1,"H"
"299",1934-07-01,1933,"FC Antibes","Excelsior Roubaix","4-2",4,2,"1",1,6,2,"H"
"300",1934-07-01,1933,"Olympique Lillois Lille","Racing Club de France","0-0",0,0,"1",1,0,0,"D"
"301",1934-07-01,1933,"FC Mulhouse","FC Sete","1-1",1,1,"1",1,2,0,"D"
"302",1934-07-01,1933,"Olympique Marseille","FC Sochaux","1-3",1,3,"1",1,4,-2,"D"
"303",1934-07-01,1933,"Excelsior Roubaix","FC Sochaux","0-1",0,1,"1",1,1,-1,"D"
"304",1934-07-01,1933,"AS Cannes","Olympique Lillois Lille","1-2",1,2,"1",1,3,-1,"D"
"305",1934-07-01,1933,"SC Nimes","FC Mulhouse","3-2",3,2,"1",1,5,1,"H"
"306",1934-07-01,1933,"SC Fives Lille","FC Antibes","2-1",2,1,"1",1,3,1,"H"
"307",1934-07-01,1933,"Olympique Marseille","Olympique Ales","3-2",3,2,"1",1,5,1,"H"
"308",1934-07-01,1933,"Stade Rennes","Red Star Olympique","3-1",3,1,"1",1,4,2,"H"
"309",1934-07-01,1933,"FC Sete","RC Strasbourg","1-0",1,0,"1",1,1,1,"H"
"310",1934-07-01,1933,"Racing Club de France","Stade Olympique Montpellierain","1-0",1,0,"1",1,1,1,"H"
"311",1934-07-01,1933,"Stade Rennes","FC Sochaux","3-3",3,3,"1",1,6,0,"D"
"312",1934-07-01,1933,"Olympique Marseille","FC Mulhouse","8-3",8,3,"1",1,11,5,"H"
"313",1934-07-01,1933,"FC Sete","Olympique Lillois Lille","3-1",3,1,"1",1,4,2,"H"
"314",1934-07-01,1933,"Red Star Olympique","FC Antibes","2-2",2,2,"1",1,4,0,"D"
"315",1934-07-01,1933,"Excelsior Roubaix","Racing Club de France","5-3",5,3,"1",1,8,2,"H"
"316",1934-07-01,1933,"SC Nimes","Olympique Ales","1-1",1,1,"1",1,2,0,"D"
"317",1934-07-01,1933,"AS Cannes","RC Strasbourg","0-1",0,1,"1",1,1,-1,"D"
"318",1934-07-01,1933,"SC Fives Lille","Stade Olympique Montpellierain","1-0",1,0,"1",1,1,1,"H"
"319",1934-07-01,1933,"RC Strasbourg","Excelsior Roubaix","1-1",1,1,"1",1,2,0,"D"
"320",1934-07-01,1933,"Olympique Ales","Racing Club de France","7-2",7,2,"1",1,9,5,"H"
"321",1934-07-01,1933,"Red Star Olympique","FC Sete","3-4",3,4,"1",1,7,-1,"D"
"322",1934-07-01,1933,"Stade Olympique Montpellierain","SC Nimes","0-3",0,3,"1",1,3,-3,"D"
"323",1934-07-01,1933,"FC Sochaux","AS Cannes","4-2",4,2,"1",1,6,2,"H"
"324",1934-07-01,1933,"FC Mulhouse","SC Fives Lille","1-0",1,0,"1",1,1,1,"H"
"325",1934-07-01,1933,"Olympique Lillois Lille","Stade Rennes","3-1",3,1,"1",1,4,2,"H"
"326",1934-07-01,1933,"FC Antibes","Olympique Marseille","1-7",1,7,"1",1,8,-6,"D"
"327",1934-07-01,1933,"FC Antibes","SC Nimes","4-1",4,1,"1",1,5,3,"H"
"328",1934-07-01,1933,"Stade Olympique Montpellierain","Olympique Marseille","3-2",3,2,"1",1,5,1,"H"
"329",1934-07-01,1933,"RC Strasbourg","Stade Rennes","2-1",2,1,"1",1,3,1,"H"
"330",1934-07-01,1933,"Olympique Ales","SC Fives Lille","2-1",2,1,"1",1,3,1,"H"
"331",1934-07-01,1933,"Red Star Olympique","AS Cannes","2-1",2,1,"1",1,3,1,"H"
"332",1934-07-01,1933,"FC Mulhouse","Racing Club de France","3-1",3,1,"1",1,4,2,"H"
"333",1934-07-01,1933,"FC Sochaux","FC Sete","0-0",0,0,"1",1,0,0,"D"
"334",1934-07-01,1933,"Olympique Lillois Lille","Excelsior Roubaix","4-0",4,0,"1",1,4,4,"H"
"335",1934-07-01,1933,"SC Fives Lille","FC Sochaux","0-3",0,3,"1",1,3,-3,"D"
"336",1934-07-01,1933,"Stade Rennes","FC Mulhouse","6-2",6,2,"1",1,8,4,"H"
"337",1934-07-01,1933,"Olympique Marseille","Olympique Lillois Lille","3-1",3,1,"1",1,4,2,"H"
"338",1934-07-01,1933,"FC Sete","FC Antibes","1-1",1,1,"1",1,2,0,"D"
"339",1934-07-01,1933,"Racing Club de France","Red Star Olympique","2-2",2,2,"1",1,4,0,"D"
"340",1934-07-01,1933,"Excelsior Roubaix","Olympique Ales","2-0",2,0,"1",1,2,2,"H"
"341",1934-07-01,1933,"SC Nimes","RC Strasbourg","0-1",0,1,"1",1,1,-1,"D"
"342",1934-07-01,1933,"AS Cannes","Stade Olympique Montpellierain","7-2",7,2,"1",1,9,5,"H"
"343",1934-07-01,1933,"SC Nimes","FC Sochaux","0-2",0,2,"1",1,2,-2,"D"
"344",1934-07-01,1933,"FC Sete","Olympique Ales","1-0",1,0,"1",1,1,1,"H"
"345",1934-07-01,1933,"RC Strasbourg","Racing Club de France","6-0",6,0,"1",1,6,6,"H"
"346",1934-07-01,1933,"Excelsior Roubaix","Stade Olympique Montpellierain","6-1",6,1,"1",1,7,5,"H"
"347",1934-07-01,1933,"FC Mulhouse","AS Cannes","4-0",4,0,"1",1,4,4,"H"
"348",1934-07-01,1933,"Olympique Lillois Lille","SC Fives Lille","3-0",3,0,"1",1,3,3,"H"
"349",1934-07-01,1933,"FC Antibes","Stade Rennes","0-0",0,0,"1",1,0,0,"D"
"350",1934-07-01,1933,"Red Star Olympique","Olympique Marseille","4-1",4,1,"1",1,5,3,"H"
"351",1934-07-01,1933,"Red Star Olympique","FC Sochaux","2-7",2,7,"1",1,9,-5,"D"
"352",1934-07-01,1933,"Olympique Ales","FC Mulhouse","2-2",2,2,"1",1,4,0,"D"
"353",1934-07-01,1933,"RC Strasbourg","Olympique Lillois Lille","4-1",4,1,"1",1,5,3,"H"
"354",1934-07-01,1933,"Stade Olympique Montpellierain","FC Antibes","2-0",2,0,"1",1,2,2,"H"
"355",1934-07-01,1933,"Excelsior Roubaix","Stade Rennes","0-0",0,0,"1",1,0,0,"D"
"356",1934-07-01,1933,"Olympique Marseille","SC Nimes","2-1",2,1,"1",1,3,1,"H"
"357",1934-07-01,1933,"AS Cannes","FC Sete","2-0",2,0,"1",1,2,2,"H"
"358",1934-07-01,1933,"SC Fives Lille","Racing Club de France","2-1",2,1,"1",1,3,1,"H"
"359",1934-07-01,1933,"FC Sochaux","Stade Olympique Montpellierain","9-0",9,0,"1",1,9,9,"H"
"360",1934-07-01,1933,"FC Mulhouse","Red Star Olympique","0-0",0,0,"1",1,0,0,"D"
"361",1934-07-01,1933,"Olympique Lillois Lille","Olympique Ales","2-1",2,1,"1",1,3,1,"H"
"362",1934-07-01,1933,"FC Antibes","RC Strasbourg","1-3",1,3,"1",1,4,-2,"D"
"363",1934-07-01,1933,"Stade Rennes","SC Fives Lille","3-1",3,1,"1",1,4,2,"H"
"364",1934-07-01,1933,"Olympique Marseille","Excelsior Roubaix","2-4",2,4,"1",1,6,-2,"D"
"365",1934-07-01,1933,"FC Sete","SC Nimes","2-2",2,2,"1",1,4,0,"D"
"366",1934-07-01,1933,"Racing Club de France","AS Cannes","3-2",3,2,"1",1,5,1,"H"
"367",1934-07-01,1933,"Racing Club de France","FC Sochaux","1-2",1,2,"1",1,3,-1,"D"
"368",1934-07-01,1933,"FC Mulhouse","Excelsior Roubaix","6-1",6,1,"1",1,7,5,"H"
"369",1934-07-01,1933,"SC Nimes","Olympique Lillois Lille","1-2",1,2,"1",1,3,-1,"D"
"370",1934-07-01,1933,"FC Antibes","AS Cannes","1-1",1,1,"1",1,2,0,"D"
"371",1934-07-01,1933,"SC Fives Lille","Red Star Olympique","6-0",6,0,"1",1,6,6,"H"
"372",1934-07-01,1933,"Olympique Ales","Stade Rennes","3-2",3,2,"1",1,5,1,"H"
"373",1934-07-01,1933,"RC Strasbourg","Olympique Marseille","1-0",1,0,"1",1,1,1,"H"
"374",1934-07-01,1933,"FC Sete","Stade Olympique Montpellierain","3-0",3,0,"1",1,3,3,"H"
"375",1934-07-01,1933,"RC Strasbourg","FC Sochaux","0-1",0,1,"1",1,1,-1,"D"
"376",1934-07-01,1933,"Red Star Olympique","Olympique Lillois Lille","1-1",1,1,"1",1,2,0,"D"
"377",1934-07-01,1933,"AS Cannes","Stade Rennes","3-0",3,0,"1",1,3,3,"H"
"378",1934-07-01,1933,"Excelsior Roubaix","FC Sete","0-1",0,1,"1",1,1,-1,"D"
"379",1934-07-01,1933,"Stade Olympique Montpellierain","FC Mulhouse","5-3",5,3,"1",1,8,2,"H"
"380",1934-07-01,1933,"Olympique Ales","FC Antibes","2-1",2,1,"1",1,3,1,"H"
"381",1934-07-01,1933,"SC Fives Lille","Olympique Marseille","6-3",6,3,"1",1,9,3,"H"
"382",1934-07-01,1933,"SC Nimes","Racing Club de France","0-2",0,2,"1",1,2,-2,"D"
"383",1934-07-01,1933,"FC Mulhouse","RC Strasbourg","4-1",4,1,"1",1,5,3,"H"
"384",1934-07-01,1933,"FC Sochaux","Olympique Ales","6-2",6,2,"1",1,8,4,"H"
"385",1934-07-01,1933,"Olympique Lillois Lille","Stade Olympique Montpellierain","4-1",4,1,"1",1,5,3,"H"
"386",1934-07-01,1933,"FC Antibes","Racing Club de France","2-5",2,5,"1",1,7,-3,"D"
"387",1934-07-01,1933,"Stade Rennes","SC Nimes","2-0",2,0,"1",1,2,2,"H"
"388",1934-07-01,1933,"Olympique Marseille","AS Cannes","2-2",2,2,"1",1,4,0,"D"
"389",1934-07-01,1933,"FC Sete","SC Fives Lille","4-0",4,0,"1",1,4,4,"H"
"390",1934-07-01,1933,"Red Star Olympique","Excelsior Roubaix","1-3",1,3,"1",1,4,-2,"D"
"391",1934-07-01,1933,"FC Mulhouse","FC Sochaux","1-5",1,5,"1",1,6,-4,"D"
"392",1934-07-01,1933,"FC Antibes","Olympique Lillois Lille","1-0",1,0,"1",1,1,1,"H"
"393",1934-07-01,1933,"Olympique Ales","Red Star Olympique","3-2",3,2,"1",1,5,1,"H"
"394",1934-07-01,1933,"Stade Olympique Montpellierain","RC Strasbourg","0-0",0,0,"1",1,0,0,"D"
"395",1934-07-01,1933,"SC Fives Lille","AS Cannes","1-2",1,2,"1",1,3,-1,"D"
"396",1934-07-01,1933,"Excelsior Roubaix","SC Nimes","4-0",4,0,"1",1,4,4,"H"
"397",1934-07-01,1933,"Olympique Marseille","Stade Rennes","4-1",4,1,"1",1,5,3,"H"
"398",1934-07-01,1933,"Racing Club de France","FC Sete","6-2",6,2,"1",1,8,4,"H"
"399",1934-07-01,1933,"FC Sochaux","FC Antibes","3-7",3,7,"1",1,10,-4,"D"
"400",1934-07-01,1933,"Olympique Lillois Lille","FC Mulhouse","0-1",0,1,"1",1,1,-1,"D"
"401",1934-07-01,1933,"Red Star Olympique","Stade Olympique Montpellierain","0-1",0,1,"1",1,1,-1,"D"
"402",1934-07-01,1933,"RC Strasbourg","Olympique Ales","3-2",3,2,"1",1,5,1,"H"
"403",1934-07-01,1933,"Excelsior Roubaix","SC Fives Lille","0-1",0,1,"1",1,1,-1,"D"
"404",1934-07-01,1933,"AS Cannes","SC Nimes","1-0",1,0,"1",1,1,1,"H"
"405",1934-07-01,1933,"Stade Rennes","Racing Club de France","0-1",0,1,"1",1,1,-1,"D"
"406",1934-07-01,1933,"FC Sete","Olympique Marseille","6-3",6,3,"1",1,9,3,"H"
"407",1934-07-01,1933,"Olympique Lillois Lille","FC Sochaux","2-1",2,1,"1",1,3,1,"H"
"408",1934-07-01,1933,"FC Mulhouse","FC Antibes","4-1",4,1,"1",1,5,3,"H"
"409",1934-07-01,1933,"Red Star Olympique","RC Strasbourg","1-3",1,3,"1",1,4,-2,"D"
"410",1934-07-01,1933,"AS Cannes","Excelsior Roubaix","5-2",5,2,"1",1,7,3,"H"
"411",1934-07-01,1933,"Stade Rennes","FC Sete","4-1",4,1,"1",1,5,3,"H"
"412",1934-07-01,1933,"Olympique Marseille","Racing Club de France","3-2",3,2,"1",1,5,1,"H"
"413",1934-07-01,1933,"SC Nimes","SC Fives Lille","1-4",1,4,"1",1,5,-3,"D"
"414",1934-07-01,1933,"Stade Olympique Montpellierain","Olympique Ales","0-3",0,3,"1",1,3,-3,"D"
"415",1934-07-01,1933,"AS Cannes","Olympique Ales","6-2",6,2,"1",1,8,4,"H"
"416",1934-07-01,1933,"SC Nimes","Red Star Olympique","2-1",2,1,"1",1,3,1,"H"
"417",1934-07-01,1933,"Stade Rennes","Stade Olympique Montpellierain","4-1",4,1,"1",1,5,3,"H"
"418",1934-07-01,1933,"SC Fives Lille","RC Strasbourg","1-3",1,3,"1",1,4,-2,"D"
"419",1934-07-01,1933,"Excelsior Roubaix","FC Antibes","1-4",1,4,"1",1,5,-3,"D"
"420",1934-07-01,1933,"Racing Club de France","Olympique Lillois Lille","3-0",3,0,"1",1,3,3,"H"
"421",1934-07-01,1933,"FC Sete","FC Mulhouse","2-0",2,0,"1",1,2,2,"H"
"422",1934-07-01,1933,"FC Sochaux","Olympique Marseille","4-0",4,0,"1",1,4,4,"H"
"423",1935-07-01,1934,"AS Cannes","Olympique Ales","3-1",3,1,"1",1,4,2,"H"
"424",1935-07-01,1934,"Olympique Lillois Lille","Stade Rennes","0-0",0,0,"1",1,0,0,"D"
"425",1935-07-01,1934,"Olympique Marseille","Excelsior Roubaix","2-5",2,5,"1",1,7,-3,"D"
"426",1935-07-01,1934,"FC Mulhouse","Red Star Olympique","3-2",3,2,"1",1,5,1,"H"
"427",1935-07-01,1934,"Racing Club de France","FC Metz","3-5",3,5,"1",1,8,-2,"D"
"428",1935-07-01,1934,"FC Sete","FC Antibes","4-0",4,0,"1",1,4,4,"H"
"429",1935-07-01,1934,"FC Sochaux","US Valenciennes-Anzin","12-1",12,1,"1",1,13,11,"H"
"430",1935-07-01,1934,"RC Strasbourg","SC Fives Lille","2-1",2,1,"1",1,3,1,"H"
"431",1935-07-01,1934,"Olympique Ales","FC Sete","1-2",1,2,"1",1,3,-1,"D"
"432",1935-07-01,1934,"FC Antibes","RC Strasbourg","1-1",1,1,"1",1,2,0,"D"
"433",1935-07-01,1934,"Excelsior Roubaix","FC Mulhouse","4-0",4,0,"1",1,4,4,"H"
"434",1935-07-01,1934,"SC Fives Lille","Racing Club de France","2-0",2,0,"1",1,2,2,"H"
"435",1935-07-01,1934,"FC Metz","FC Sochaux","3-2",3,2,"1",1,5,1,"H"
"436",1935-07-01,1934,"Red Star Olympique","Olympique Lillois Lille","0-2",0,2,"1",1,2,-2,"D"
"437",1935-07-01,1934,"Stade Rennes","AS Cannes","1-3",1,3,"1",1,4,-2,"D"
"438",1935-07-01,1934,"US Valenciennes-Anzin","Olympique Marseille","2-2",2,2,"1",1,4,0,"D"
"439",1935-07-01,1934,"AS Cannes","Red Star Olympique","2-1",2,1,"1",1,3,1,"H"
"440",1935-07-01,1934,"Olympique Lillois Lille","Excelsior Roubaix","3-2",3,2,"1",1,5,1,"H"
"441",1935-07-01,1934,"Olympique Marseille","FC Metz","3-0",3,0,"1",1,3,3,"H"
"442",1935-07-01,1934,"FC Mulhouse","US Valenciennes-Anzin","3-2",3,2,"1",1,5,1,"H"
"443",1935-07-01,1934,"Racing Club de France","FC Antibes","3-2",3,2,"1",1,5,1,"H"
"444",1935-07-01,1934,"FC Sete","Stade Rennes","4-2",4,2,"1",1,6,2,"H"
"445",1935-07-01,1934,"FC Sochaux","SC Fives Lille","0-0",0,0,"1",1,0,0,"D"
"446",1935-07-01,1934,"RC Strasbourg","Olympique Ales","6-1",6,1,"1",1,7,5,"H"
"447",1935-07-01,1934,"Olympique Ales","Racing Club de France","0-2",0,2,"1",1,2,-2,"D"
"448",1935-07-01,1934,"FC Antibes","FC Sochaux","1-3",1,3,"1",1,4,-2,"D"
"449",1935-07-01,1934,"Excelsior Roubaix","AS Cannes","2-0",2,0,"1",1,2,2,"H"
"450",1935-07-01,1934,"SC Fives Lille","Olympique Marseille","1-2",1,2,"1",1,3,-1,"D"
"451",1935-07-01,1934,"FC Metz","FC Mulhouse","2-1",2,1,"1",1,3,1,"H"
"452",1935-07-01,1934,"Red Star Olympique","FC Sete","1-1",1,1,"1",1,2,0,"D"
"453",1935-07-01,1934,"Stade Rennes","RC Strasbourg","2-0",2,0,"1",1,2,2,"H"
"454",1935-07-01,1934,"US Valenciennes-Anzin","Olympique Lillois Lille","1-5",1,5,"1",1,6,-4,"D"
"455",1935-07-01,1934,"AS Cannes","US Valenciennes-Anzin","5-1",5,1,"1",1,6,4,"H"
"456",1935-07-01,1934,"Olympique Lillois Lille","FC Metz","3-0",3,0,"1",1,3,3,"H"
"457",1935-07-01,1934,"Olympique Marseille","FC Antibes","4-1",4,1,"1",1,5,3,"H"
"458",1935-07-01,1934,"FC Mulhouse","SC Fives Lille","3-1",3,1,"1",1,4,2,"H"
"459",1935-07-01,1934,"Racing Club de France","Stade Rennes","4-0",4,0,"1",1,4,4,"H"
"460",1935-07-01,1934,"FC Sete","Excelsior Roubaix","1-3",1,3,"1",1,4,-2,"D"
"461",1935-07-01,1934,"FC Sochaux","Olympique Ales","7-0",7,0,"1",1,7,7,"H"
"462",1935-07-01,1934,"RC Strasbourg","Red Star Olympique","6-0",6,0,"1",1,6,6,"H"
"463",1935-07-01,1934,"Olympique Ales","Olympique Marseille","3-3",3,3,"1",1,6,0,"D"
"464",1935-07-01,1934,"FC Antibes","FC Mulhouse","3-2",3,2,"1",1,5,1,"H"
"465",1935-07-01,1934,"Excelsior Roubaix","RC Strasbourg","2-1",2,1,"1",1,3,1,"H"
"466",1935-07-01,1934,"FC Metz","AS Cannes","2-1",2,1,"1",1,3,1,"H"
"467",1935-07-01,1934,"Red Star Olympique","Racing Club de France","1-4",1,4,"1",1,5,-3,"D"
"468",1935-07-01,1934,"Stade Rennes","FC Sochaux","1-1",1,1,"1",1,2,0,"D"
"469",1935-07-01,1934,"US Valenciennes-Anzin","FC Sete","5-3",5,3,"1",1,8,2,"H"
"470",1935-07-01,1934,"Olympique Lillois Lille","SC Fives Lille","1-0",1,0,"1",1,1,1,"H"
"471",1935-07-01,1934,"AS Cannes","SC Fives Lille","1-0",1,0,"1",1,1,1,"H"
"472",1935-07-01,1934,"Olympique Lillois Lille","FC Antibes","6-3",6,3,"1",1,9,3,"H"
"473",1935-07-01,1934,"Olympique Marseille","Stade Rennes","7-1",7,1,"1",1,8,6,"H"
"474",1935-07-01,1934,"FC Mulhouse","Olympique Ales","3-3",3,3,"1",1,6,0,"D"
"475",1935-07-01,1934,"Racing Club de France","Excelsior Roubaix","3-2",3,2,"1",1,5,1,"H"
"476",1935-07-01,1934,"FC Sete","FC Metz","2-1",2,1,"1",1,3,1,"H"
"477",1935-07-01,1934,"FC Sochaux","Red Star Olympique","0-1",0,1,"1",1,1,-1,"D"
"478",1935-07-01,1934,"RC Strasbourg","US Valenciennes-Anzin","4-0",4,0,"1",1,4,4,"H"
"479",1935-07-01,1934,"Olympique Ales","Olympique Lillois Lille","1-1",1,1,"1",1,2,0,"D"
"480",1935-07-01,1934,"FC Antibes","AS Cannes","0-1",0,1,"1",1,1,-1,"D"
"481",1935-07-01,1934,"Excelsior Roubaix","FC Sochaux","2-2",2,2,"1",1,4,0,"D"
"482",1935-07-01,1934,"SC Fives Lille","FC Sete","3-0",3,0,"1",1,3,3,"H"
"483",1935-07-01,1934,"FC Metz","RC Strasbourg","5-1",5,1,"1",1,6,4,"H"
"484",1935-07-01,1934,"Red Star Olympique","Olympique Marseille","0-2",0,2,"1",1,2,-2,"D"
"485",1935-07-01,1934,"Stade Rennes","FC Mulhouse","5-1",5,1,"1",1,6,4,"H"
"486",1935-07-01,1934,"US Valenciennes-Anzin","Racing Club de France","5-3",5,3,"1",1,8,2,"H"
"487",1935-07-01,1934,"FC Antibes","Olympique Ales","3-2",3,2,"1",1,5,1,"H"
"488",1935-07-01,1934,"SC Fives Lille","Stade Rennes","1-3",1,3,"1",1,4,-2,"D"
"489",1935-07-01,1934,"FC Metz","Red Star Olympique","5-1",5,1,"1",1,6,4,"H"
"490",1935-07-01,1934,"Racing Club de France","FC Mulhouse","3-1",3,1,"1",1,4,2,"H"
"491",1935-07-01,1934,"FC Sete","AS Cannes","2-0",2,0,"1",1,2,2,"H"
"492",1935-07-01,1934,"FC Sochaux","Olympique Marseille","4-0",4,0,"1",1,4,4,"H"
"493",1935-07-01,1934,"RC Strasbourg","Olympique Lillois Lille","3-2",3,2,"1",1,5,1,"H"
"494",1935-07-01,1934,"US Valenciennes-Anzin","Excelsior Roubaix","4-0",4,0,"1",1,4,4,"H"
"495",1935-07-01,1934,"Olympique Ales","US Valenciennes-Anzin","3-5",3,5,"1",1,8,-2,"D"
"496",1935-07-01,1934,"AS Cannes","RC Strasbourg","0-2",0,2,"1",1,2,-2,"D"
"497",1935-07-01,1934,"Excelsior Roubaix","FC Metz","2-3",2,3,"1",1,5,-1,"D"
"498",1935-07-01,1934,"Olympique Lillois Lille","Racing Club de France","4-0",4,0,"1",1,4,4,"H"
"499",1935-07-01,1934,"Olympique Marseille","FC Sete","1-0",1,0,"1",1,1,1,"H"
"500",1935-07-01,1934,"FC Mulhouse","FC Sochaux","3-6",3,6,"1",1,9,-3,"D"
"501",1935-07-01,1934,"Red Star Olympique","SC Fives Lille","1-4",1,4,"1",1,5,-3,"D"
"502",1935-07-01,1934,"Stade Rennes","FC Antibes","2-1",2,1,"1",1,3,1,"H"
"503",1935-07-01,1934,"FC Antibes","Red Star Olympique","2-0",2,0,"1",1,2,2,"H"
"504",1935-07-01,1934,"SC Fives Lille","Excelsior Roubaix","1-0",1,0,"1",1,1,1,"H"
"505",1935-07-01,1934,"FC Metz","Olympique Ales","1-1",1,1,"1",1,2,0,"D"
"506",1935-07-01,1934,"FC Mulhouse","FC Sete","2-1",2,1,"1",1,3,1,"H"
"507",1935-07-01,1934,"Racing Club de France","AS Cannes","5-0",5,0,"1",1,5,5,"H"
"508",1935-07-01,1934,"FC Sochaux","Olympique Lillois Lille","1-1",1,1,"1",1,2,0,"D"
"509",1935-07-01,1934,"RC Strasbourg","Olympique Marseille","4-1",4,1,"1",1,5,3,"H"
"510",1935-07-01,1934,"US Valenciennes-Anzin","Stade Rennes","3-1",3,1,"1",1,4,2,"H"
"511",1935-07-01,1934,"AS Cannes","FC Sochaux","1-0",1,0,"1",1,1,1,"H"
"512",1935-07-01,1934,"Excelsior Roubaix","FC Antibes","2-0",2,0,"1",1,2,2,"H"
"513",1935-07-01,1934,"SC Fives Lille","Olympique Ales","1-2",1,2,"1",1,3,-1,"D"
"514",1935-07-01,1934,"Olympique Marseille","Racing Club de France","2-5",2,5,"1",1,7,-3,"D"
"515",1935-07-01,1934,"FC Metz","Stade Rennes","2-0",2,0,"1",1,2,2,"H"
"516",1935-07-01,1934,"Red Star Olympique","US Valenciennes-Anzin","2-0",2,0,"1",1,2,2,"H"
"517",1935-07-01,1934,"FC Sete","Olympique Lillois Lille","2-1",2,1,"1",1,3,1,"H"
"518",1935-07-01,1934,"RC Strasbourg","FC Mulhouse","3-0",3,0,"1",1,3,3,"H"
"519",1935-07-01,1934,"Olympique Ales","Red Star Olympique","0-0",0,0,"1",1,0,0,"D"
"520",1935-07-01,1934,"FC Antibes","FC Metz","0-0",0,0,"1",1,0,0,"D"
"521",1935-07-01,1934,"Olympique Lillois Lille","FC Mulhouse","4-0",4,0,"1",1,4,4,"H"
"522",1935-07-01,1934,"Olympique Marseille","AS Cannes","3-0",3,0,"1",1,3,3,"H"
"523",1935-07-01,1934,"Racing Club de France","RC Strasbourg","4-1",4,1,"1",1,5,3,"H"
"524",1935-07-01,1934,"Stade Rennes","Excelsior Roubaix","2-2",2,2,"1",1,4,0,"D"
"525",1935-07-01,1934,"FC Sochaux","FC Sete","2-2",2,2,"1",1,4,0,"D"
"526",1935-07-01,1934,"US Valenciennes-Anzin","SC Fives Lille","1-2",1,2,"1",1,3,-1,"D"
"527",1935-07-01,1934,"Olympique Ales","Excelsior Roubaix","3-2",3,2,"1",1,5,1,"H"
"528",1935-07-01,1934,"FC Antibes","US Valenciennes-Anzin","3-1",3,1,"1",1,4,2,"H"
"529",1935-07-01,1934,"Olympique Lillois Lille","Olympique Marseille","1-0",1,0,"1",1,1,1,"H"
"530",1935-07-01,1934,"FC Metz","SC Fives Lille","0-2",0,2,"1",1,2,-2,"D"
"531",1935-07-01,1934,"FC Mulhouse","AS Cannes","2-2",2,2,"1",1,4,0,"D"
"532",1935-07-01,1934,"Red Star Olympique","Stade Rennes","0-1",0,1,"1",1,1,-1,"D"
"533",1935-07-01,1934,"FC Sete","Racing Club de France","1-1",1,1,"1",1,2,0,"D"
"534",1935-07-01,1934,"FC Sochaux","RC Strasbourg","1-1",1,1,"1",1,2,0,"D"
"535",1935-07-01,1934,"AS Cannes","Olympique Lillois Lille","0-0",0,0,"1",1,0,0,"D"
"536",1935-07-01,1934,"Excelsior Roubaix","Red Star Olympique","6-4",6,4,"1",1,10,2,"H"
"537",1935-07-01,1934,"SC Fives Lille","FC Antibes","1-1",1,1,"1",1,2,0,"D"
"538",1935-07-01,1934,"Olympique Marseille","FC Mulhouse","6-2",6,2,"1",1,8,4,"H"
"539",1935-07-01,1934,"Racing Club de France","FC Sochaux","1-1",1,1,"1",1,2,0,"D"
"540",1935-07-01,1934,"Stade Rennes","Olympique Ales","2-0",2,0,"1",1,2,2,"H"
"541",1935-07-01,1934,"RC Strasbourg","FC Sete","4-0",4,0,"1",1,4,4,"H"
"542",1935-07-01,1934,"US Valenciennes-Anzin","FC Metz","3-1",3,1,"1",1,4,2,"H"
"543",1935-07-01,1934,"Olympique Ales","AS Cannes","3-1",3,1,"1",1,4,2,"H"
"544",1935-07-01,1934,"Stade Rennes","Olympique Lillois Lille","1-1",1,1,"1",1,2,0,"D"
"545",1935-07-01,1934,"Excelsior Roubaix","Olympique Marseille","1-1",1,1,"1",1,2,0,"D"
"546",1935-07-01,1934,"Red Star Olympique","FC Mulhouse","7-1",7,1,"1",1,8,6,"H"
"547",1935-07-01,1934,"FC Metz","Racing Club de France","1-2",1,2,"1",1,3,-1,"D"
"548",1935-07-01,1934,"FC Antibes","FC Sete","1-4",1,4,"1",1,5,-3,"D"
"549",1935-07-01,1934,"US Valenciennes-Anzin","FC Sochaux","0-5",0,5,"1",1,5,-5,"D"
"550",1935-07-01,1934,"SC Fives Lille","RC Strasbourg","0-1",0,1,"1",1,1,-1,"D"
"551",1935-07-01,1934,"FC Sete","Olympique Ales","1-0",1,0,"1",1,1,1,"H"
"552",1935-07-01,1934,"RC Strasbourg","FC Antibes","2-1",2,1,"1",1,3,1,"H"
"553",1935-07-01,1934,"FC Mulhouse","Excelsior Roubaix","0-4",0,4,"1",1,4,-4,"D"
"554",1935-07-01,1934,"Racing Club de France","SC Fives Lille","4-0",4,0,"1",1,4,4,"H"
"555",1935-07-01,1934,"FC Sochaux","FC Metz","6-0",6,0,"1",1,6,6,"H"
"556",1935-07-01,1934,"Olympique Lillois Lille","Red Star Olympique","2-1",2,1,"1",1,3,1,"H"
"557",1935-07-01,1934,"AS Cannes","Stade Rennes","6-0",6,0,"1",1,6,6,"H"
"558",1935-07-01,1934,"Olympique Marseille","US Valenciennes-Anzin","1-0",1,0,"1",1,1,1,"H"
"559",1935-07-01,1934,"Red Star Olympique","AS Cannes","0-3",0,3,"1",1,3,-3,"D"
"560",1935-07-01,1934,"Excelsior Roubaix","Olympique Lillois Lille","1-2",1,2,"1",1,3,-1,"D"
"561",1935-07-01,1934,"FC Metz","Olympique Marseille","5-2",5,2,"1",1,7,3,"H"
"562",1935-07-01,1934,"US Valenciennes-Anzin","FC Mulhouse","8-2",8,2,"1",1,10,6,"H"
"563",1935-07-01,1934,"FC Antibes","Racing Club de France","3-9",3,9,"1",1,12,-6,"D"
"564",1935-07-01,1934,"Stade Rennes","FC Sete","1-0",1,0,"1",1,1,1,"H"
"565",1935-07-01,1934,"SC Fives Lille","FC Sochaux","2-1",2,1,"1",1,3,1,"H"
"566",1935-07-01,1934,"Olympique Ales","RC Strasbourg","0-2",0,2,"1",1,2,-2,"D"
"567",1935-07-01,1934,"Racing Club de France","Olympique Ales","3-1",3,1,"1",1,4,2,"H"
"568",1935-07-01,1934,"FC Sochaux","FC Antibes","5-1",5,1,"1",1,6,4,"H"
"569",1935-07-01,1934,"AS Cannes","Excelsior Roubaix","2-3",2,3,"1",1,5,-1,"D"
"570",1935-07-01,1934,"Olympique Marseille","SC Fives Lille","3-2",3,2,"1",1,5,1,"H"
"571",1935-07-01,1934,"FC Mulhouse","FC Metz","3-0",3,0,"1",1,3,3,"H"
"572",1935-07-01,1934,"FC Sete","Red Star Olympique","3-2",3,2,"1",1,5,1,"H"
"573",1935-07-01,1934,"RC Strasbourg","Stade Rennes","8-0",8,0,"1",1,8,8,"H"
"574",1935-07-01,1934,"Olympique Lillois Lille","US Valenciennes-Anzin","3-0",3,0,"1",1,3,3,"H"
"575",1935-07-01,1934,"US Valenciennes-Anzin","AS Cannes","2-5",2,5,"1",1,7,-3,"D"
"576",1935-07-01,1934,"FC Metz","Olympique Lillois Lille","1-2",1,2,"1",1,3,-1,"D"
"577",1935-07-01,1934,"FC Antibes","Olympique Marseille","3-2",3,2,"1",1,5,1,"H"
"578",1935-07-01,1934,"SC Fives Lille","FC Mulhouse","3-0",3,0,"1",1,3,3,"H"
"579",1935-07-01,1934,"Stade Rennes","Racing Club de France","0-3",0,3,"1",1,3,-3,"D"
"580",1935-07-01,1934,"Excelsior Roubaix","FC Sete","2-0",2,0,"1",1,2,2,"H"
"581",1935-07-01,1934,"Olympique Ales","FC Sochaux","0-0",0,0,"1",1,0,0,"D"
"582",1935-07-01,1934,"Red Star Olympique","RC Strasbourg","1-2",1,2,"1",1,3,-1,"D"
"583",1935-07-01,1934,"Olympique Marseille","Olympique Ales","2-0",2,0,"1",1,2,2,"H"
"584",1935-07-01,1934,"FC Mulhouse","FC Antibes","2-2",2,2,"1",1,4,0,"D"
"585",1935-07-01,1934,"RC Strasbourg","Excelsior Roubaix","1-0",1,0,"1",1,1,1,"H"
"586",1935-07-01,1934,"AS Cannes","FC Metz","2-1",2,1,"1",1,3,1,"H"
"587",1935-07-01,1934,"Racing Club de France","Red Star Olympique","4-1",4,1,"1",1,5,3,"H"
"588",1935-07-01,1934,"FC Sochaux","Stade Rennes","2-0",2,0,"1",1,2,2,"H"
"589",1935-07-01,1934,"FC Sete","US Valenciennes-Anzin","1-1",1,1,"1",1,2,0,"D"
"590",1935-07-01,1934,"SC Fives Lille","Olympique Lillois Lille","1-1",1,1,"1",1,2,0,"D"
"591",1935-07-01,1934,"SC Fives Lille","AS Cannes","5-1",5,1,"1",1,6,4,"H"
"592",1935-07-01,1934,"FC Antibes","Olympique Lillois Lille","3-1",3,1,"1",1,4,2,"H"
"593",1935-07-01,1934,"Stade Rennes","Olympique Marseille","1-1",1,1,"1",1,2,0,"D"
"594",1935-07-01,1934,"Olympique Ales","FC Mulhouse","3-3",3,3,"1",1,6,0,"D"
"595",1935-07-01,1934,"Excelsior Roubaix","Racing Club de France","0-2",0,2,"1",1,2,-2,"D"
"596",1935-07-01,1934,"FC Metz","FC Sete","3-1",3,1,"1",1,4,2,"H"
"597",1935-07-01,1934,"Red Star Olympique","FC Sochaux","2-2",2,2,"1",1,4,0,"D"
"598",1935-07-01,1934,"US Valenciennes-Anzin","RC Strasbourg","1-1",1,1,"1",1,2,0,"D"
"599",1935-07-01,1934,"Olympique Lillois Lille","Olympique Ales","3-0",3,0,"1",1,3,3,"H"
"600",1935-07-01,1934,"AS Cannes","FC Antibes","2-1",2,1,"1",1,3,1,"H"
"601",1935-07-01,1934,"FC Sochaux","Excelsior Roubaix","6-2",6,2,"1",1,8,4,"H"
"602",1935-07-01,1934,"FC Sete","SC Fives Lille","1-0",1,0,"1",1,1,1,"H"
"603",1935-07-01,1934,"RC Strasbourg","FC Metz","4-0",4,0,"1",1,4,4,"H"
"604",1935-07-01,1934,"Olympique Marseille","Red Star Olympique","1-4",1,4,"1",1,5,-3,"D"
"605",1935-07-01,1934,"FC Mulhouse","Stade Rennes","2-2",2,2,"1",1,4,0,"D"
"606",1935-07-01,1934,"Racing Club de France","US Valenciennes-Anzin","2-1",2,1,"1",1,3,1,"H"
"607",1935-07-01,1934,"Olympique Ales","FC Antibes","1-2",1,2,"1",1,3,-1,"D"
"608",1935-07-01,1934,"Stade Rennes","SC Fives Lille","2-3",2,3,"1",1,5,-1,"D"
"609",1935-07-01,1934,"Red Star Olympique","FC Metz","6-2",6,2,"1",1,8,4,"H"
"610",1935-07-01,1934,"FC Mulhouse","Racing Club de France","3-0",3,0,"1",1,3,3,"H"
"611",1935-07-01,1934,"AS Cannes","FC Sete","3-2",3,2,"1",1,5,1,"H"
"612",1935-07-01,1934,"Olympique Marseille","FC Sochaux","4-1",4,1,"1",1,5,3,"H"
"613",1935-07-01,1934,"Olympique Lillois Lille","RC Strasbourg","4-0",4,0,"1",1,4,4,"H"
"614",1935-07-01,1934,"Excelsior Roubaix","US Valenciennes-Anzin","3-1",3,1,"1",1,4,2,"H"
"615",1935-07-01,1934,"US Valenciennes-Anzin","Olympique Ales","2-4",2,4,"1",1,6,-2,"D"
"616",1935-07-01,1934,"RC Strasbourg","AS Cannes","0-2",0,2,"1",1,2,-2,"D"
"617",1935-07-01,1934,"FC Metz","Excelsior Roubaix","3-5",3,5,"1",1,8,-2,"D"
"618",1935-07-01,1934,"Racing Club de France","Olympique Lillois Lille","2-3",2,3,"1",1,5,-1,"D"
"619",1935-07-01,1934,"FC Sete","Olympique Marseille","1-0",1,0,"1",1,1,1,"H"
"620",1935-07-01,1934,"FC Sochaux","FC Mulhouse","0-1",0,1,"1",1,1,-1,"D"
"621",1935-07-01,1934,"SC Fives Lille","Red Star Olympique","2-1",2,1,"1",1,3,1,"H"
"622",1935-07-01,1934,"FC Antibes","Stade Rennes","3-1",3,1,"1",1,4,2,"H"
"623",1935-07-01,1934,"Red Star Olympique","FC Antibes","4-1",4,1,"1",1,5,3,"H"
"624",1935-07-01,1934,"Excelsior Roubaix","SC Fives Lille","4-3",4,3,"1",1,7,1,"H"
"625",1935-07-01,1934,"Olympique Ales","FC Metz","1-1",1,1,"1",1,2,0,"D"
"626",1935-07-01,1934,"FC Sete","FC Mulhouse","3-1",3,1,"1",1,4,2,"H"
"627",1935-07-01,1934,"AS Cannes","Racing Club de France","0-2",0,2,"1",1,2,-2,"D"
"628",1935-07-01,1934,"Olympique Lillois Lille","FC Sochaux","2-3",2,3,"1",1,5,-1,"D"
"629",1935-07-01,1934,"Olympique Marseille","RC Strasbourg","1-0",1,0,"1",1,1,1,"H"
"630",1935-07-01,1934,"Stade Rennes","US Valenciennes-Anzin","1-1",1,1,"1",1,2,0,"D"
"631",1935-07-01,1934,"FC Sochaux","AS Cannes","1-1",1,1,"1",1,2,0,"D"
"632",1935-07-01,1934,"FC Antibes","Excelsior Roubaix","1-0",1,0,"1",1,1,1,"H"
"633",1935-07-01,1934,"Olympique Ales","SC Fives Lille","0-3",0,3,"1",1,3,-3,"D"
"634",1935-07-01,1934,"Racing Club de France","Olympique Marseille","2-2",2,2,"1",1,4,0,"D"
"635",1935-07-01,1934,"Stade Rennes","FC Metz","2-0",2,0,"1",1,2,2,"H"
"636",1935-07-01,1934,"US Valenciennes-Anzin","Red Star Olympique","0-2",0,2,"1",1,2,-2,"D"
"637",1935-07-01,1934,"Olympique Lillois Lille","FC Sete","0-2",0,2,"1",1,2,-2,"D"
"638",1935-07-01,1934,"FC Mulhouse","RC Strasbourg","2-4",2,4,"1",1,6,-2,"D"
"639",1935-07-01,1934,"Red Star Olympique","Olympique Ales","1-2",1,2,"1",1,3,-1,"D"
"640",1935-07-01,1934,"FC Metz","FC Antibes","2-1",2,1,"1",1,3,1,"H"
"641",1935-07-01,1934,"FC Mulhouse","Olympique Lillois Lille","2-3",2,3,"1",1,5,-1,"D"
"642",1935-07-01,1934,"AS Cannes","Olympique Marseille","3-1",3,1,"1",1,4,2,"H"
"643",1935-07-01,1934,"RC Strasbourg","Racing Club de France","0-1",0,1,"1",1,1,-1,"D"
"644",1935-07-01,1934,"Excelsior Roubaix","Stade Rennes","1-1",1,1,"1",1,2,0,"D"
"645",1935-07-01,1934,"FC Sete","FC Sochaux","1-4",1,4,"1",1,5,-3,"D"
"646",1935-07-01,1934,"SC Fives Lille","US Valenciennes-Anzin","3-2",3,2,"1",1,5,1,"H"
"647",1935-07-01,1934,"Excelsior Roubaix","Olympique Ales","1-1",1,1,"1",1,2,0,"D"
"648",1935-07-01,1934,"US Valenciennes-Anzin","FC Antibes","0-0",0,0,"1",1,0,0,"D"
"649",1935-07-01,1934,"Olympique Marseille","Olympique Lillois Lille","1-0",1,0,"1",1,1,1,"H"
"650",1935-07-01,1934,"SC Fives Lille","FC Metz","3-0",3,0,"1",1,3,3,"H"
"651",1935-07-01,1934,"AS Cannes","FC Mulhouse","2-2",2,2,"1",1,4,0,"D"
"652",1935-07-01,1934,"Stade Rennes","Red Star Olympique","3-0",3,0,"1",1,3,3,"H"
"653",1935-07-01,1934,"Racing Club de France","FC Sete","2-1",2,1,"1",1,3,1,"H"
"654",1935-07-01,1934,"RC Strasbourg","FC Sochaux","2-1",2,1,"1",1,3,1,"H"
"655",1935-07-01,1934,"Olympique Lillois Lille","AS Cannes","1-1",1,1,"1",1,2,0,"D"
"656",1935-07-01,1934,"Red Star Olympique","Excelsior Roubaix","3-2",3,2,"1",1,5,1,"H"
"657",1935-07-01,1934,"FC Antibes","SC Fives Lille","3-1",3,1,"1",1,4,2,"H"
"658",1935-07-01,1934,"FC Mulhouse","Olympique Marseille","3-1",3,1,"1",1,4,2,"H"
"659",1935-07-01,1934,"FC Sochaux","Racing Club de France","2-2",2,2,"1",1,4,0,"D"
"660",1935-07-01,1934,"Olympique Ales","Stade Rennes","2-6",2,6,"1",1,8,-4,"D"
"661",1935-07-01,1934,"FC Sete","RC Strasbourg","3-1",3,1,"1",1,4,2,"H"
"662",1935-07-01,1934,"FC Metz","US Valenciennes-Anzin","5-4",5,4,"1",1,9,1,"H"
"663",1936-07-01,1935,"FC Sete","Red Star Olympique","2-1",2,1,"1",1,3,1,"H"
"664",1936-07-01,1935,"RC Roubaix","FC Mulhouse","4-1",4,1,"1",1,5,3,"H"
"665",1936-07-01,1935,"Olympique Lillois Lille","FC Antibes","3-2",3,2,"1",1,5,1,"H"
"666",1936-07-01,1935,"FC Rouen","SC Fives Lille","2-1",2,1,"1",1,3,1,"H"
"667",1936-07-01,1935,"AS Cannes","RC Strasbourg","0-0",0,0,"1",1,0,0,"D"
"668",1936-07-01,1935,"FC Sochaux","Excelsior Roubaix","2-1",2,1,"1",1,3,1,"H"
"669",1936-07-01,1935,"FC Metz","Olympique Marseille","3-1",3,1,"1",1,4,2,"H"
"670",1936-07-01,1935,"Racing Club de France","Stade Rennes","3-1",3,1,"1",1,4,2,"H"
"671",1936-07-01,1935,"Olympique Marseille","Racing Club de France","4-1",4,1,"1",1,5,3,"H"
"672",1936-07-01,1935,"Excelsior Roubaix","FC Metz","2-2",2,2,"1",1,4,0,"D"
"673",1936-07-01,1935,"RC Strasbourg","FC Sochaux","3-2",3,2,"1",1,5,1,"H"
"674",1936-07-01,1935,"SC Fives Lille","AS Cannes","1-2",1,2,"1",1,3,-1,"D"
"675",1936-07-01,1935,"FC Antibes","FC Rouen","1-1",1,1,"1",1,2,0,"D"
"676",1936-07-01,1935,"FC Mulhouse","Olympique Lillois Lille","1-3",1,3,"1",1,4,-2,"D"
"677",1936-07-01,1935,"Red Star Olympique","RC Roubaix","2-2",2,2,"1",1,4,0,"D"
"678",1936-07-01,1935,"Stade Rennes","FC Sete","3-1",3,1,"1",1,4,2,"H"
"679",1936-07-01,1935,"Olympique Marseille","FC Rouen","3-0",3,0,"1",1,3,3,"H"
"680",1936-07-01,1935,"Excelsior Roubaix","Olympique Lillois Lille","0-1",0,1,"1",1,1,-1,"D"
"681",1936-07-01,1935,"RC Strasbourg","RC Roubaix","5-1",5,1,"1",1,6,4,"H"
"682",1936-07-01,1935,"SC Fives Lille","FC Sete","3-2",3,2,"1",1,5,1,"H"
"683",1936-07-01,1935,"FC Antibes","Racing Club de France","1-3",1,3,"1",1,4,-2,"D"
"684",1936-07-01,1935,"FC Mulhouse","FC Metz","2-4",2,4,"1",1,6,-2,"D"
"685",1936-07-01,1935,"Red Star Olympique","FC Sochaux","2-2",2,2,"1",1,4,0,"D"
"686",1936-07-01,1935,"Stade Rennes","AS Cannes","0-2",0,2,"1",1,2,-2,"D"
"687",1936-07-01,1935,"FC Sete","Excelsior Roubaix","2-0",2,0,"1",1,2,2,"H"
"688",1936-07-01,1935,"RC Roubaix","Olympique Marseille","2-2",2,2,"1",1,4,0,"D"
"689",1936-07-01,1935,"Olympique Lillois Lille","Stade Rennes","3-1",3,1,"1",1,4,2,"H"
"690",1936-07-01,1935,"FC Rouen","Red Star Olympique","7-1",7,1,"1",1,8,6,"H"
"691",1936-07-01,1935,"AS Cannes","FC Mulhouse","6-4",6,4,"1",1,10,2,"H"
"692",1936-07-01,1935,"FC Sochaux","FC Antibes","2-0",2,0,"1",1,2,2,"H"
"693",1936-07-01,1935,"FC Metz","SC Fives Lille","1-3",1,3,"1",1,4,-2,"D"
"694",1936-07-01,1935,"Racing Club de France","RC Strasbourg","2-2",2,2,"1",1,4,0,"D"
"695",1936-07-01,1935,"AS Cannes","Olympique Lillois Lille","0-2",0,2,"1",1,2,-2,"D"
"696",1936-07-01,1935,"FC Sochaux","RC Roubaix","2-0",2,0,"1",1,2,2,"H"
"697",1936-07-01,1935,"FC Metz","FC Sete","4-0",4,0,"1",1,4,4,"H"
"698",1936-07-01,1935,"Racing Club de France","FC Rouen","2-4",2,4,"1",1,6,-2,"D"
"699",1936-07-01,1935,"Olympique Marseille","Red Star Olympique","3-2",3,2,"1",1,5,1,"H"
"700",1936-07-01,1935,"Excelsior Roubaix","FC Mulhouse","5-1",5,1,"1",1,6,4,"H"
"701",1936-07-01,1935,"RC Strasbourg","FC Antibes","2-1",2,1,"1",1,3,1,"H"
"702",1936-07-01,1935,"SC Fives Lille","Stade Rennes","5-1",5,1,"1",1,6,4,"H"
"703",1936-07-01,1935,"FC Sete","Racing Club de France","3-0",3,0,"1",1,3,3,"H"
"704",1936-07-01,1935,"RC Roubaix","FC Metz","1-2",1,2,"1",1,3,-1,"D"
"705",1936-07-01,1935,"Olympique Lillois Lille","FC Sochaux","2-1",2,1,"1",1,3,1,"H"
"706",1936-07-01,1935,"FC Rouen","AS Cannes","2-2",2,2,"1",1,4,0,"D"
"707",1936-07-01,1935,"FC Antibes","SC Fives Lille","5-2",5,2,"1",1,7,3,"H"
"708",1936-07-01,1935,"FC Mulhouse","RC Strasbourg","1-9",1,9,"1",1,10,-8,"D"
"709",1936-07-01,1935,"Red Star Olympique","Excelsior Roubaix","3-2",3,2,"1",1,5,1,"H"
"710",1936-07-01,1935,"Stade Rennes","Olympique Marseille","3-1",3,1,"1",1,4,2,"H"
"711",1936-07-01,1935,"Olympique Lillois Lille","FC Metz","5-0",5,0,"1",1,5,5,"H"
"712",1936-07-01,1935,"AS Cannes","FC Sete","2-2",2,2,"1",1,4,0,"D"
"713",1936-07-01,1935,"FC Sochaux","FC Rouen","2-0",2,0,"1",1,2,2,"H"
"714",1936-07-01,1935,"Racing Club de France","RC Roubaix","2-0",2,0,"1",1,2,2,"H"
"715",1936-07-01,1935,"Olympique Marseille","FC Antibes","2-0",2,0,"1",1,2,2,"H"
"716",1936-07-01,1935,"Excelsior Roubaix","Stade Rennes","3-1",3,1,"1",1,4,2,"H"
"717",1936-07-01,1935,"RC Strasbourg","Red Star Olympique","3-0",3,0,"1",1,3,3,"H"
"718",1936-07-01,1935,"FC Mulhouse","SC Fives Lille","1-0",1,0,"1",1,1,1,"H"
"719",1936-07-01,1935,"FC Sete","FC Rouen","2-0",2,0,"1",1,2,2,"H"
"720",1936-07-01,1935,"RC Roubaix","Olympique Lillois Lille","0-1",0,1,"1",1,1,-1,"D"
"721",1936-07-01,1935,"AS Cannes","Racing Club de France","1-2",1,2,"1",1,3,-1,"D"
"722",1936-07-01,1935,"FC Metz","FC Sochaux","2-2",2,2,"1",1,4,0,"D"
"723",1936-07-01,1935,"RC Strasbourg","Olympique Marseille","1-0",1,0,"1",1,1,1,"H"
"724",1936-07-01,1935,"SC Fives Lille","Excelsior Roubaix","6-2",6,2,"1",1,8,4,"H"
"725",1936-07-01,1935,"Red Star Olympique","FC Antibes","3-1",3,1,"1",1,4,2,"H"
"726",1936-07-01,1935,"Stade Rennes","FC Mulhouse","1-2",1,2,"1",1,3,-1,"D"
"727",1936-07-01,1935,"FC Sete","Olympique Lillois Lille","3-0",3,0,"1",1,3,3,"H"
"728",1936-07-01,1935,"FC Rouen","RC Roubaix","4-0",4,0,"1",1,4,4,"H"
"729",1936-07-01,1935,"FC Sochaux","Racing Club de France","2-1",2,1,"1",1,3,1,"H"
"730",1936-07-01,1935,"FC Metz","AS Cannes","3-1",3,1,"1",1,4,2,"H"
"731",1936-07-01,1935,"Excelsior Roubaix","RC Strasbourg","3-3",3,3,"1",1,6,0,"D"
"732",1936-07-01,1935,"SC Fives Lille","Olympique Marseille","4-3",4,3,"1",1,7,1,"H"
"733",1936-07-01,1935,"FC Antibes","Stade Rennes","1-0",1,0,"1",1,1,1,"H"
"734",1936-07-01,1935,"Red Star Olympique","FC Mulhouse","3-2",3,2,"1",1,5,1,"H"
"735",1936-07-01,1935,"RC Roubaix","FC Sete","1-1",1,1,"1",1,2,0,"D"
"736",1936-07-01,1935,"Olympique Lillois Lille","FC Rouen","3-3",3,3,"1",1,6,0,"D"
"737",1936-07-01,1935,"AS Cannes","FC Sochaux","2-1",2,1,"1",1,3,1,"H"
"738",1936-07-01,1935,"Racing Club de France","FC Metz","2-0",2,0,"1",1,2,2,"H"
"739",1936-07-01,1935,"Olympique Marseille","Excelsior Roubaix","4-4",4,4,"1",1,8,0,"D"
"740",1936-07-01,1935,"RC Strasbourg","SC Fives Lille","1-1",1,1,"1",1,2,0,"D"
"741",1936-07-01,1935,"FC Mulhouse","FC Antibes","2-3",2,3,"1",1,5,-1,"D"
"742",1936-07-01,1935,"Stade Rennes","Red Star Olympique","1-3",1,3,"1",1,4,-2,"D"
"743",1936-07-01,1935,"FC Sete","Olympique Marseille","2-2",2,2,"1",1,4,0,"D"
"744",1936-07-01,1935,"FC Rouen","FC Mulhouse","4-2",4,2,"1",1,6,2,"H"
"745",1936-07-01,1935,"AS Cannes","FC Antibes","2-3",2,3,"1",1,5,-1,"D"
"746",1936-07-01,1935,"FC Metz","RC Strasbourg","0-0",0,0,"1",1,0,0,"D"
"747",1936-07-01,1935,"Excelsior Roubaix","Racing Club de France","4-2",4,2,"1",1,6,2,"H"
"748",1936-07-01,1935,"SC Fives Lille","FC Sochaux","0-1",0,1,"1",1,1,-1,"D"
"749",1936-07-01,1935,"Red Star Olympique","Olympique Lillois Lille","2-1",2,1,"1",1,3,1,"H"
"750",1936-07-01,1935,"Stade Rennes","RC Roubaix","1-1",1,1,"1",1,2,0,"D"
"751",1936-07-01,1935,"FC Sochaux","Stade Rennes","1-0",1,0,"1",1,1,1,"H"
"752",1936-07-01,1935,"FC Metz","Red Star Olympique","4-0",4,0,"1",1,4,4,"H"
"753",1936-07-01,1935,"Racing Club de France","FC Mulhouse","4-1",4,1,"1",1,5,3,"H"
"754",1936-07-01,1935,"Olympique Marseille","AS Cannes","2-0",2,0,"1",1,2,2,"H"
"755",1936-07-01,1935,"Excelsior Roubaix","FC Rouen","0-0",0,0,"1",1,0,0,"D"
"756",1936-07-01,1935,"RC Strasbourg","Olympique Lillois Lille","2-1",2,1,"1",1,3,1,"H"
"757",1936-07-01,1935,"SC Fives Lille","RC Roubaix","3-2",3,2,"1",1,5,1,"H"
"758",1936-07-01,1935,"FC Antibes","FC Sete","2-1",2,1,"1",1,3,1,"H"
"759",1936-07-01,1935,"FC Sete","FC Sochaux","1-1",1,1,"1",1,2,0,"D"
"760",1936-07-01,1935,"RC Roubaix","AS Cannes","2-1",2,1,"1",1,3,1,"H"
"761",1936-07-01,1935,"Olympique Lillois Lille","Racing Club de France","1-0",1,0,"1",1,1,1,"H"
"762",1936-07-01,1935,"FC Rouen","FC Metz","3-2",3,2,"1",1,5,1,"H"
"763",1936-07-01,1935,"FC Antibes","Excelsior Roubaix","3-0",3,0,"1",1,3,3,"H"
"764",1936-07-01,1935,"FC Mulhouse","Olympique Marseille","1-3",1,3,"1",1,4,-2,"D"
"765",1936-07-01,1935,"Red Star Olympique","SC Fives Lille","0-0",0,0,"1",1,0,0,"D"
"766",1936-07-01,1935,"Stade Rennes","RC Strasbourg","2-1",2,1,"1",1,3,1,"H"
"767",1936-07-01,1935,"FC Sete","FC Mulhouse","4-1",4,1,"1",1,5,3,"H"
"768",1936-07-01,1935,"RC Roubaix","FC Antibes","5-3",5,3,"1",1,8,2,"H"
"769",1936-07-01,1935,"Olympique Lillois Lille","SC Fives Lille","1-3",1,3,"1",1,4,-2,"D"
"770",1936-07-01,1935,"FC Rouen","RC Strasbourg","2-1",2,1,"1",1,3,1,"H"
"771",1936-07-01,1935,"AS Cannes","Excelsior Roubaix","1-4",1,4,"1",1,5,-3,"D"
"772",1936-07-01,1935,"FC Sochaux","Olympique Marseille","3-1",3,1,"1",1,4,2,"H"
"773",1936-07-01,1935,"FC Metz","Stade Rennes","2-1",2,1,"1",1,3,1,"H"
"774",1936-07-01,1935,"Racing Club de France","Red Star Olympique","4-2",4,2,"1",1,6,2,"H"
"775",1936-07-01,1935,"Olympique Marseille","Olympique Lillois Lille","2-1",2,1,"1",1,3,1,"H"
"776",1936-07-01,1935,"Excelsior Roubaix","RC Roubaix","3-2",3,2,"1",1,5,1,"H"
"777",1936-07-01,1935,"RC Strasbourg","FC Sete","1-1",1,1,"1",1,2,0,"D"
"778",1936-07-01,1935,"SC Fives Lille","Racing Club de France","1-3",1,3,"1",1,4,-2,"D"
"779",1936-07-01,1935,"FC Antibes","FC Metz","2-2",2,2,"1",1,4,0,"D"
"780",1936-07-01,1935,"FC Mulhouse","FC Sochaux","4-1",4,1,"1",1,5,3,"H"
"781",1936-07-01,1935,"Red Star Olympique","AS Cannes","3-3",3,3,"1",1,6,0,"D"
"782",1936-07-01,1935,"Stade Rennes","FC Rouen","0-1",0,1,"1",1,1,-1,"D"
"783",1936-07-01,1935,"Red Star Olympique","FC Sete","1-0",1,0,"1",1,1,1,"H"
"784",1936-07-01,1935,"FC Mulhouse","RC Roubaix","2-1",2,1,"1",1,3,1,"H"
"785",1936-07-01,1935,"FC Antibes","Olympique Lillois Lille","2-2",2,2,"1",1,4,0,"D"
"786",1936-07-01,1935,"SC Fives Lille","FC Rouen","2-1",2,1,"1",1,3,1,"H"
"787",1936-07-01,1935,"RC Strasbourg","AS Cannes","1-3",1,3,"1",1,4,-2,"D"
"788",1936-07-01,1935,"Excelsior Roubaix","FC Sochaux","1-0",1,0,"1",1,1,1,"H"
"789",1936-07-01,1935,"Olympique Marseille","FC Metz","4-0",4,0,"1",1,4,4,"H"
"790",1936-07-01,1935,"Stade Rennes","Racing Club de France","1-3",1,3,"1",1,4,-2,"D"
"791",1936-07-01,1935,"Racing Club de France","Olympique Marseille","1-1",1,1,"1",1,2,0,"D"
"792",1936-07-01,1935,"FC Metz","Excelsior Roubaix","2-1",2,1,"1",1,3,1,"H"
"793",1936-07-01,1935,"FC Sochaux","RC Strasbourg","3-2",3,2,"1",1,5,1,"H"
"794",1936-07-01,1935,"AS Cannes","SC Fives Lille","0-0",0,0,"1",1,0,0,"D"
"795",1936-07-01,1935,"FC Rouen","FC Antibes","5-1",5,1,"1",1,6,4,"H"
"796",1936-07-01,1935,"Olympique Lillois Lille","FC Mulhouse","1-1",1,1,"1",1,2,0,"D"
"797",1936-07-01,1935,"RC Roubaix","Red Star Olympique","2-3",2,3,"1",1,5,-1,"D"
"798",1936-07-01,1935,"FC Sete","Stade Rennes","1-1",1,1,"1",1,2,0,"D"
"799",1936-07-01,1935,"FC Rouen","Olympique Marseille","1-0",1,0,"1",1,1,1,"H"
"800",1936-07-01,1935,"Olympique Lillois Lille","Excelsior Roubaix","5-4",5,4,"1",1,9,1,"H"
"801",1936-07-01,1935,"RC Roubaix","RC Strasbourg","2-1",2,1,"1",1,3,1,"H"
"802",1936-07-01,1935,"FC Sete","SC Fives Lille","2-1",2,1,"1",1,3,1,"H"
"803",1936-07-01,1935,"Racing Club de France","FC Antibes","2-1",2,1,"1",1,3,1,"H"
"804",1936-07-01,1935,"FC Metz","FC Mulhouse","8-1",8,1,"1",1,9,7,"H"
"805",1936-07-01,1935,"FC Sochaux","Red Star Olympique","4-2",4,2,"1",1,6,2,"H"
"806",1936-07-01,1935,"AS Cannes","Stade Rennes","1-2",1,2,"1",1,3,-1,"D"
"807",1936-07-01,1935,"Excelsior Roubaix","FC Sete","3-1",3,1,"1",1,4,2,"H"
"808",1936-07-01,1935,"Olympique Marseille","RC Roubaix","4-1",4,1,"1",1,5,3,"H"
"809",1936-07-01,1935,"Stade Rennes","Olympique Lillois Lille","0-0",0,0,"1",1,0,0,"D"
"810",1936-07-01,1935,"Red Star Olympique","FC Rouen","0-1",0,1,"1",1,1,-1,"D"
"811",1936-07-01,1935,"FC Mulhouse","AS Cannes","1-1",1,1,"1",1,2,0,"D"
"812",1936-07-01,1935,"FC Antibes","FC Sochaux","1-3",1,3,"1",1,4,-2,"D"
"813",1936-07-01,1935,"SC Fives Lille","FC Metz","6-0",6,0,"1",1,6,6,"H"
"814",1936-07-01,1935,"RC Strasbourg","Racing Club de France","0-0",0,0,"1",1,0,0,"D"
"815",1936-07-01,1935,"Olympique Lillois Lille","AS Cannes","4-3",4,3,"1",1,7,1,"H"
"816",1936-07-01,1935,"RC Roubaix","FC Sochaux","3-2",3,2,"1",1,5,1,"H"
"817",1936-07-01,1935,"FC Sete","FC Metz","3-0",3,0,"1",1,3,3,"H"
"818",1936-07-01,1935,"FC Rouen","Racing Club de France","0-1",0,1,"1",1,1,-1,"D"
"819",1936-07-01,1935,"Red Star Olympique","Olympique Marseille","0-5",0,5,"1",1,5,-5,"D"
"820",1936-07-01,1935,"FC Mulhouse","Excelsior Roubaix","1-4",1,4,"1",1,5,-3,"D"
"821",1936-07-01,1935,"FC Antibes","RC Strasbourg","1-6",1,6,"1",1,7,-5,"D"
"822",1936-07-01,1935,"Stade Rennes","SC Fives Lille","1-0",1,0,"1",1,1,1,"H"
"823",1936-07-01,1935,"Racing Club de France","FC Sete","4-1",4,1,"1",1,5,3,"H"
"824",1936-07-01,1935,"FC Metz","RC Roubaix","4-0",4,0,"1",1,4,4,"H"
"825",1936-07-01,1935,"FC Sochaux","Olympique Lillois Lille","1-1",1,1,"1",1,2,0,"D"
"826",1936-07-01,1935,"AS Cannes","FC Rouen","4-1",4,1,"1",1,5,3,"H"
"827",1936-07-01,1935,"SC Fives Lille","FC Antibes","1-1",1,1,"1",1,2,0,"D"
"828",1936-07-01,1935,"RC Strasbourg","FC Mulhouse","7-2",7,2,"1",1,9,5,"H"
"829",1936-07-01,1935,"Excelsior Roubaix","Red Star Olympique","2-2",2,2,"1",1,4,0,"D"
"830",1936-07-01,1935,"Olympique Marseille","Stade Rennes","3-0",3,0,"1",1,3,3,"H"
"831",1936-07-01,1935,"FC Metz","Olympique Lillois Lille","2-1",2,1,"1",1,3,1,"H"
"832",1936-07-01,1935,"FC Sete","AS Cannes","0-0",0,0,"1",1,0,0,"D"
"833",1936-07-01,1935,"FC Rouen","FC Sochaux","6-1",6,1,"1",1,7,5,"H"
"834",1936-07-01,1935,"RC Roubaix","Racing Club de France","2-0",2,0,"1",1,2,2,"H"
"835",1936-07-01,1935,"FC Antibes","Olympique Marseille","1-3",1,3,"1",1,4,-2,"D"
"836",1936-07-01,1935,"Stade Rennes","Excelsior Roubaix","5-4",5,4,"1",1,9,1,"H"
"837",1936-07-01,1935,"Red Star Olympique","RC Strasbourg","1-1",1,1,"1",1,2,0,"D"
"838",1936-07-01,1935,"SC Fives Lille","FC Mulhouse","3-0",3,0,"1",1,3,3,"H"
"839",1936-07-01,1935,"FC Rouen","FC Sete","5-0",5,0,"1",1,5,5,"H"
"840",1936-07-01,1935,"Olympique Lillois Lille","RC Roubaix","2-3",2,3,"1",1,5,-1,"D"
"841",1936-07-01,1935,"Racing Club de France","AS Cannes","2-1",2,1,"1",1,3,1,"H"
"842",1936-07-01,1935,"FC Sochaux","FC Metz","2-1",2,1,"1",1,3,1,"H"
"843",1936-07-01,1935,"Olympique Marseille","RC Strasbourg","4-0",4,0,"1",1,4,4,"H"
"844",1936-07-01,1935,"Excelsior Roubaix","SC Fives Lille","4-1",4,1,"1",1,5,3,"H"
"845",1936-07-01,1935,"FC Antibes","Red Star Olympique","2-0",2,0,"1",1,2,2,"H"
"846",1936-07-01,1935,"FC Mulhouse","Stade Rennes","5-2",5,2,"1",1,7,3,"H"
"847",1936-07-01,1935,"Olympique Lillois Lille","FC Sete","2-0",2,0,"1",1,2,2,"H"
"848",1936-07-01,1935,"RC Roubaix","FC Rouen","3-0",3,0,"1",1,3,3,"H"
"849",1936-07-01,1935,"Racing Club de France","FC Sochaux","1-0",1,0,"1",1,1,1,"H"
"850",1936-07-01,1935,"AS Cannes","FC Metz","5-1",5,1,"1",1,6,4,"H"
"851",1936-07-01,1935,"RC Strasbourg","Excelsior Roubaix","0-1",0,1,"1",1,1,-1,"D"
"852",1936-07-01,1935,"Olympique Marseille","SC Fives Lille","1-0",1,0,"1",1,1,1,"H"
"853",1936-07-01,1935,"Stade Rennes","FC Antibes","0-1",0,1,"1",1,1,-1,"D"
"854",1936-07-01,1935,"FC Mulhouse","Red Star Olympique","1-3",1,3,"1",1,4,-2,"D"
"855",1936-07-01,1935,"FC Sete","RC Roubaix","2-1",2,1,"1",1,3,1,"H"
"856",1936-07-01,1935,"FC Rouen","Olympique Lillois Lille","0-2",0,2,"1",1,2,-2,"D"
"857",1936-07-01,1935,"FC Sochaux","AS Cannes","1-1",1,1,"1",1,2,0,"D"
"858",1936-07-01,1935,"FC Metz","Racing Club de France","3-1",3,1,"1",1,4,2,"H"
"859",1936-07-01,1935,"Excelsior Roubaix","Olympique Marseille","0-3",0,3,"1",1,3,-3,"D"
"860",1936-07-01,1935,"SC Fives Lille","RC Strasbourg","2-0",2,0,"1",1,2,2,"H"
"861",1936-07-01,1935,"FC Antibes","FC Mulhouse","3-2",3,2,"1",1,5,1,"H"
"862",1936-07-01,1935,"Red Star Olympique","Stade Rennes","0-1",0,1,"1",1,1,-1,"D"
"863",1936-07-01,1935,"Olympique Marseille","FC Sete","2-1",2,1,"1",1,3,1,"H"
"864",1936-07-01,1935,"FC Mulhouse","FC Rouen","3-2",3,2,"1",1,5,1,"H"
"865",1936-07-01,1935,"FC Antibes","AS Cannes","4-1",4,1,"1",1,5,3,"H"
"866",1936-07-01,1935,"RC Strasbourg","FC Metz","1-1",1,1,"1",1,2,0,"D"
"867",1936-07-01,1935,"Racing Club de France","Excelsior Roubaix","3-6",3,6,"1",1,9,-3,"D"
"868",1936-07-01,1935,"FC Sochaux","SC Fives Lille","1-0",1,0,"1",1,1,1,"H"
"869",1936-07-01,1935,"Olympique Lillois Lille","Red Star Olympique","0-0",0,0,"1",1,0,0,"D"
"870",1936-07-01,1935,"RC Roubaix","Stade Rennes","4-3",4,3,"1",1,7,1,"H"
"871",1936-07-01,1935,"Stade Rennes","FC Sochaux","1-1",1,1,"1",1,2,0,"D"
"872",1936-07-01,1935,"Red Star Olympique","FC Metz","2-1",2,1,"1",1,3,1,"H"
"873",1936-07-01,1935,"FC Mulhouse","Racing Club de France","0-2",0,2,"1",1,2,-2,"D"
"874",1936-07-01,1935,"AS Cannes","Olympique Marseille","3-0",3,0,"1",1,3,3,"H"
"875",1936-07-01,1935,"FC Rouen","Excelsior Roubaix","2-1",2,1,"1",1,3,1,"H"
"876",1936-07-01,1935,"Olympique Lillois Lille","RC Strasbourg","1-2",1,2,"1",1,3,-1,"D"
"877",1936-07-01,1935,"RC Roubaix","SC Fives Lille","2-1",2,1,"1",1,3,1,"H"
"878",1936-07-01,1935,"FC Sete","FC Antibes","4-0",4,0,"1",1,4,4,"H"
"879",1936-07-01,1935,"FC Sochaux","FC Sete","6-2",6,2,"1",1,8,4,"H"
"880",1936-07-01,1935,"AS Cannes","RC Roubaix","0-0",0,0,"1",1,0,0,"D"
"881",1936-07-01,1935,"Racing Club de France","Olympique Lillois Lille","3-0",3,0,"1",1,3,3,"H"
"882",1936-07-01,1935,"FC Metz","FC Rouen","4-4",4,4,"1",1,8,0,"D"
"883",1936-07-01,1935,"Excelsior Roubaix","FC Antibes","1-2",1,2,"1",1,3,-1,"D"
"884",1936-07-01,1935,"Olympique Marseille","FC Mulhouse","5-1",5,1,"1",1,6,4,"H"
"885",1936-07-01,1935,"SC Fives Lille","Red Star Olympique","1-2",1,2,"1",1,3,-1,"D"
"886",1936-07-01,1935,"RC Strasbourg","Stade Rennes","3-0",3,0,"1",1,3,3,"H"
"887",1936-07-01,1935,"FC Mulhouse","FC Sete","1-1",1,1,"1",1,2,0,"D"
"888",1936-07-01,1935,"FC Antibes","RC Roubaix","2-3",2,3,"1",1,5,-1,"D"
"889",1936-07-01,1935,"SC Fives Lille","Olympique Lillois Lille","1-0",1,0,"1",1,1,1,"H"
"890",1936-07-01,1935,"RC Strasbourg","FC Rouen","4-0",4,0,"1",1,4,4,"H"
"891",1936-07-01,1935,"Excelsior Roubaix","AS Cannes","5-0",5,0,"1",1,5,5,"H"
"892",1936-07-01,1935,"Olympique Marseille","FC Sochaux","0-1",0,1,"1",1,1,-1,"D"
"893",1936-07-01,1935,"Stade Rennes","FC Metz","5-1",5,1,"1",1,6,4,"H"
"894",1936-07-01,1935,"Red Star Olympique","Racing Club de France","2-0",2,0,"1",1,2,2,"H"
"895",1936-07-01,1935,"Olympique Lillois Lille","Olympique Marseille","2-1",2,1,"1",1,3,1,"H"
"896",1936-07-01,1935,"RC Roubaix","Excelsior Roubaix","0-2",0,2,"1",1,2,-2,"D"
"897",1936-07-01,1935,"FC Sete","RC Strasbourg","1-0",1,0,"1",1,1,1,"H"
"898",1936-07-01,1935,"Racing Club de France","SC Fives Lille","3-2",3,2,"1",1,5,1,"H"
"899",1936-07-01,1935,"FC Metz","FC Antibes","1-0",1,0,"1",1,1,1,"H"
"900",1936-07-01,1935,"FC Sochaux","FC Mulhouse","5-1",5,1,"1",1,6,4,"H"
"901",1936-07-01,1935,"AS Cannes","Red Star Olympique","0-2",0,2,"1",1,2,-2,"D"
"902",1936-07-01,1935,"FC Rouen","Stade Rennes","1-0",1,0,"1",1,1,1,"H"
"903",1937-07-01,1936,"RC Lens","Olympique Marseille","4-3",4,3,"1",1,7,1,"H"
"904",1937-07-01,1936,"FC Sete","Racing Club de France","2-2",2,2,"1",1,4,0,"D"
"905",1937-07-01,1936,"AS Cannes","RC Strasbourg","2-3",2,3,"1",1,5,-1,"D"
"906",1937-07-01,1936,"US Valenciennes-Anzin","FC Sochaux","0-0",0,0,"1",1,0,0,"D"
"907",1937-07-01,1936,"SC Fives Lille","FC Antibes","3-1",3,1,"1",1,4,2,"H"
"908",1937-07-01,1936,"Red Star Olympique","Excelsior Roubaix","2-2",2,2,"1",1,4,0,"D"
"909",1937-07-01,1936,"FC Metz","Olympique Lillois Lille","1-0",1,0,"1",1,1,1,"H"
"910",1937-07-01,1936,"RC Roubaix","FC Rouen","0-3",0,3,"1",1,3,-3,"D"
"911",1937-07-01,1936,"Olympique Marseille","AS Cannes","2-2",2,2,"1",1,4,0,"D"
"912",1937-07-01,1936,"FC Rouen","Red Star Olympique","4-0",4,0,"1",1,4,4,"H"
"913",1937-07-01,1936,"FC Metz","RC Strasbourg","4-0",4,0,"1",1,4,4,"H"
"914",1937-07-01,1936,"Excelsior Roubaix","RC Lens","1-1",1,1,"1",1,2,0,"D"
"915",1937-07-01,1936,"FC Sochaux","SC Fives Lille","6-2",6,2,"1",1,8,4,"H"
"916",1937-07-01,1936,"Racing Club de France","RC Roubaix","2-1",2,1,"1",1,3,1,"H"
"917",1937-07-01,1936,"Olympique Lillois Lille","US Valenciennes-Anzin","0-1",0,1,"1",1,1,-1,"D"
"918",1937-07-01,1936,"FC Antibes","FC Sete","1-1",1,1,"1",1,2,0,"D"
"919",1937-07-01,1936,"RC Lens","AS Cannes","2-2",2,2,"1",1,4,0,"D"
"920",1937-07-01,1936,"RC Strasbourg","Olympique Marseille","2-2",2,2,"1",1,4,0,"D"
"921",1937-07-01,1936,"Red Star Olympique","FC Metz","2-2",2,2,"1",1,4,0,"D"
"922",1937-07-01,1936,"FC Sochaux","FC Rouen","5-0",5,0,"1",1,5,5,"H"
"923",1937-07-01,1936,"FC Sete","SC Fives Lille","1-0",1,0,"1",1,1,1,"H"
"924",1937-07-01,1936,"FC Antibes","Racing Club de France","2-2",2,2,"1",1,4,0,"D"
"925",1937-07-01,1936,"RC Roubaix","US Valenciennes-Anzin","3-2",3,2,"1",1,5,1,"H"
"926",1937-07-01,1936,"Olympique Lillois Lille","Excelsior Roubaix","1-1",1,1,"1",1,2,0,"D"
"927",1937-07-01,1936,"AS Cannes","Red Star Olympique","5-5",5,5,"1",1,10,0,"D"
"928",1937-07-01,1936,"US Valenciennes-Anzin","FC Sete","0-0",0,0,"1",1,0,0,"D"
"929",1937-07-01,1936,"Racing Club de France","RC Strasbourg","0-3",0,3,"1",1,3,-3,"D"
"930",1937-07-01,1936,"FC Rouen","FC Antibes","2-0",2,0,"1",1,2,2,"H"
"931",1937-07-01,1936,"Olympique Marseille","Olympique Lillois Lille","4-0",4,0,"1",1,4,4,"H"
"932",1937-07-01,1936,"FC Metz","RC Roubaix","1-1",1,1,"1",1,2,0,"D"
"933",1937-07-01,1936,"SC Fives Lille","RC Lens","2-1",2,1,"1",1,3,1,"H"
"934",1937-07-01,1936,"Excelsior Roubaix","FC Sochaux","1-2",1,2,"1",1,3,-1,"D"
"935",1937-07-01,1936,"FC Sete","FC Metz","4-1",4,1,"1",1,5,3,"H"
"936",1937-07-01,1936,"RC Strasbourg","FC Rouen","3-3",3,3,"1",1,6,0,"D"
"937",1937-07-01,1936,"RC Lens","US Valenciennes-Anzin","2-1",2,1,"1",1,3,1,"H"
"938",1937-07-01,1936,"FC Sochaux","Olympique Marseille","1-2",1,2,"1",1,3,-1,"D"
"939",1937-07-01,1936,"FC Antibes","Excelsior Roubaix","4-2",4,2,"1",1,6,2,"H"
"940",1937-07-01,1936,"Red Star Olympique","SC Fives Lille","3-2",3,2,"1",1,5,1,"H"
"941",1937-07-01,1936,"Olympique Lillois Lille","Racing Club de France","0-1",0,1,"1",1,1,-1,"D"
"942",1937-07-01,1936,"RC Roubaix","AS Cannes","4-1",4,1,"1",1,5,3,"H"
"943",1937-07-01,1936,"Red Star Olympique","US Valenciennes-Anzin","2-0",2,0,"1",1,2,2,"H"
"944",1937-07-01,1936,"FC Metz","RC Lens","1-1",1,1,"1",1,2,0,"D"
"945",1937-07-01,1936,"FC Sochaux","Racing Club de France","4-0",4,0,"1",1,4,4,"H"
"946",1937-07-01,1936,"AS Cannes","FC Sete","3-4",3,4,"1",1,7,-1,"D"
"947",1937-07-01,1936,"Olympique Marseille","FC Antibes","1-0",1,0,"1",1,1,1,"H"
"948",1937-07-01,1936,"FC Rouen","Olympique Lillois Lille","0-0",0,0,"1",1,0,0,"D"
"949",1937-07-01,1936,"SC Fives Lille","RC Roubaix","3-0",3,0,"1",1,3,3,"H"
"950",1937-07-01,1936,"Excelsior Roubaix","RC Strasbourg","3-2",3,2,"1",1,5,1,"H"
"951",1937-07-01,1936,"US Valenciennes-Anzin","FC Metz","5-2",5,2,"1",1,7,3,"H"
"952",1937-07-01,1936,"RC Strasbourg","FC Sochaux","1-6",1,6,"1",1,7,-5,"D"
"953",1937-07-01,1936,"RC Lens","FC Sete","0-2",0,2,"1",1,2,-2,"D"
"954",1937-07-01,1936,"FC Rouen","Olympique Marseille","2-2",2,2,"1",1,4,0,"D"
"955",1937-07-01,1936,"SC Fives Lille","AS Cannes","1-1",1,1,"1",1,2,0,"D"
"956",1937-07-01,1936,"Racing Club de France","Excelsior Roubaix","5-1",5,1,"1",1,6,4,"H"
"957",1937-07-01,1936,"FC Antibes","Olympique Lillois Lille","0-0",0,0,"1",1,0,0,"D"
"958",1937-07-01,1936,"RC Roubaix","Red Star Olympique","0-0",0,0,"1",1,0,0,"D"
"959",1937-07-01,1936,"US Valenciennes-Anzin","AS Cannes","0-1",0,1,"1",1,1,-1,"D"
"960",1937-07-01,1936,"Racing Club de France","Olympique Marseille","3-3",3,3,"1",1,6,0,"D"
"961",1937-07-01,1936,"FC Sete","Red Star Olympique","3-1",3,1,"1",1,4,2,"H"
"962",1937-07-01,1936,"FC Metz","SC Fives Lille","0-0",0,0,"1",1,0,0,"D"
"963",1937-07-01,1936,"Olympique Lillois Lille","FC Sochaux","0-0",0,0,"1",1,0,0,"D"
"964",1937-07-01,1936,"FC Antibes","RC Strasbourg","1-2",1,2,"1",1,3,-1,"D"
"965",1937-07-01,1936,"Excelsior Roubaix","FC Rouen","2-0",2,0,"1",1,2,2,"H"
"966",1937-07-01,1936,"RC Lens","RC Roubaix","2-1",2,1,"1",1,3,1,"H"
"967",1937-07-01,1936,"AS Cannes","FC Metz","4-0",4,0,"1",1,4,4,"H"
"968",1937-07-01,1936,"Red Star Olympique","RC Lens","0-1",0,1,"1",1,1,-1,"D"
"969",1937-07-01,1936,"FC Rouen","Racing Club de France","3-1",3,1,"1",1,4,2,"H"
"970",1937-07-01,1936,"Olympique Marseille","Excelsior Roubaix","1-1",1,1,"1",1,2,0,"D"
"971",1937-07-01,1936,"FC Sochaux","FC Antibes","1-0",1,0,"1",1,1,1,"H"
"972",1937-07-01,1936,"RC Strasbourg","Olympique Lillois Lille","0-0",0,0,"1",1,0,0,"D"
"973",1937-07-01,1936,"SC Fives Lille","US Valenciennes-Anzin","2-2",2,2,"1",1,4,0,"D"
"974",1937-07-01,1936,"RC Roubaix","FC Sete","1-1",1,1,"1",1,2,0,"D"
"975",1937-07-01,1936,"FC Sete","RC Strasbourg","3-0",3,0,"1",1,3,3,"H"
"976",1937-07-01,1936,"Red Star Olympique","FC Sochaux","0-1",0,1,"1",1,1,-1,"D"
"977",1937-07-01,1936,"AS Cannes","Racing Club de France","2-2",2,2,"1",1,4,0,"D"
"978",1937-07-01,1936,"FC Metz","FC Rouen","1-1",1,1,"1",1,2,0,"D"
"979",1937-07-01,1936,"RC Lens","FC Antibes","2-4",2,4,"1",1,6,-2,"D"
"980",1937-07-01,1936,"US Valenciennes-Anzin","Excelsior Roubaix","1-1",1,1,"1",1,2,0,"D"
"981",1937-07-01,1936,"RC Roubaix","Olympique Lillois Lille","3-0",3,0,"1",1,3,3,"H"
"982",1937-07-01,1936,"SC Fives Lille","Olympique Marseille","2-1",2,1,"1",1,3,1,"H"
"983",1937-07-01,1936,"Olympique Marseille","Red Star Olympique","1-0",1,0,"1",1,1,1,"H"
"984",1937-07-01,1936,"FC Rouen","FC Sete","3-1",3,1,"1",1,4,2,"H"
"985",1937-07-01,1936,"FC Sochaux","FC Metz","3-2",3,2,"1",1,5,1,"H"
"986",1937-07-01,1936,"RC Strasbourg","RC Lens","2-2",2,2,"1",1,4,0,"D"
"987",1937-07-01,1936,"Olympique Lillois Lille","AS Cannes","0-0",0,0,"1",1,0,0,"D"
"988",1937-07-01,1936,"Racing Club de France","SC Fives Lille","1-1",1,1,"1",1,2,0,"D"
"989",1937-07-01,1936,"FC Antibes","US Valenciennes-Anzin","0-0",0,0,"1",1,0,0,"D"
"990",1937-07-01,1936,"Excelsior Roubaix","RC Roubaix","0-1",0,1,"1",1,1,-1,"D"
"991",1937-07-01,1936,"Olympique Marseille","US Valenciennes-Anzin","1-1",1,1,"1",1,2,0,"D"
"992",1937-07-01,1936,"FC Rouen","AS Cannes","1-0",1,0,"1",1,1,1,"H"
"993",1937-07-01,1936,"Racing Club de France","RC Lens","1-3",1,3,"1",1,4,-2,"D"
"994",1937-07-01,1936,"RC Strasbourg","SC Fives Lille","2-0",2,0,"1",1,2,2,"H"
"995",1937-07-01,1936,"Excelsior Roubaix","FC Metz","2-4",2,4,"1",1,6,-2,"D"
"996",1937-07-01,1936,"Olympique Lillois Lille","FC Sete","2-1",2,1,"1",1,3,1,"H"
"997",1937-07-01,1936,"FC Sochaux","RC Roubaix","3-0",3,0,"1",1,3,3,"H"
"998",1937-07-01,1936,"FC Antibes","Red Star Olympique","4-1",4,1,"1",1,5,3,"H"
"999",1937-07-01,1936,"RC Lens","FC Rouen","1-1",1,1,"1",1,2,0,"D"
"1000",1937-07-01,1936,"US Valenciennes-Anzin","RC Strasbourg","1-2",1,2,"1",1,3,-1,"D"
"1001",1937-07-01,1936,"Red Star Olympique","Racing Club de France","2-2",2,2,"1",1,4,0,"D"
"1002",1937-07-01,1936,"FC Metz","Olympique Marseille","1-2",1,2,"1",1,3,-1,"D"
"1003",1937-07-01,1936,"FC Sete","FC Sochaux","0-1",0,1,"1",1,1,-1,"D"
"1004",1937-07-01,1936,"RC Roubaix","FC Antibes","2-1",2,1,"1",1,3,1,"H"
"1005",1937-07-01,1936,"SC Fives Lille","Olympique Lillois Lille","0-1",0,1,"1",1,1,-1,"D"
"1006",1937-07-01,1936,"AS Cannes","Excelsior Roubaix","2-1",2,1,"1",1,3,1,"H"
"1007",1937-07-01,1936,"FC Sochaux","RC Lens","4-0",4,0,"1",1,4,4,"H"
"1008",1937-07-01,1936,"FC Rouen","US Valenciennes-Anzin","4-1",4,1,"1",1,5,3,"H"
"1009",1937-07-01,1936,"Racing Club de France","FC Metz","2-2",2,2,"1",1,4,0,"D"
"1010",1937-07-01,1936,"FC Antibes","AS Cannes","2-0",2,0,"1",1,2,2,"H"
"1011",1937-07-01,1936,"Excelsior Roubaix","SC Fives Lille","3-2",3,2,"1",1,5,1,"H"
"1012",1937-07-01,1936,"RC Strasbourg","RC Roubaix","4-0",4,0,"1",1,4,4,"H"
"1013",1937-07-01,1936,"Olympique Lillois Lille","Red Star Olympique","4-1",4,1,"1",1,5,3,"H"
"1014",1937-07-01,1936,"Olympique Marseille","FC Sete","3-0",3,0,"1",1,3,3,"H"
"1015",1937-07-01,1936,"AS Cannes","FC Sochaux","0-1",0,1,"1",1,1,-1,"D"
"1016",1937-07-01,1936,"Red Star Olympique","RC Strasbourg","2-2",2,2,"1",1,4,0,"D"
"1017",1937-07-01,1936,"US Valenciennes-Anzin","Racing Club de France","1-3",1,3,"1",1,4,-2,"D"
"1018",1937-07-01,1936,"FC Metz","FC Antibes","1-1",1,1,"1",1,2,0,"D"
"1019",1937-07-01,1936,"RC Lens","Olympique Lillois Lille","2-1",2,1,"1",1,3,1,"H"
"1020",1937-07-01,1936,"FC Sete","Excelsior Roubaix","3-0",3,0,"1",1,3,3,"H"
"1021",1937-07-01,1936,"RC Roubaix","Olympique Marseille","1-3",1,3,"1",1,4,-2,"D"
"1022",1937-07-01,1936,"SC Fives Lille","FC Rouen","0-1",0,1,"1",1,1,-1,"D"
"1023",1937-07-01,1936,"RC Strasbourg","AS Cannes","1-0",1,0,"1",1,1,1,"H"
"1024",1937-07-01,1936,"Racing Club de France","FC Sete","0-2",0,2,"1",1,2,-2,"D"
"1025",1937-07-01,1936,"FC Sochaux","US Valenciennes-Anzin","6-1",6,1,"1",1,7,5,"H"
"1026",1937-07-01,1936,"Olympique Marseille","RC Lens","2-2",2,2,"1",1,4,0,"D"
"1027",1937-07-01,1936,"FC Antibes","SC Fives Lille","1-1",1,1,"1",1,2,0,"D"
"1028",1937-07-01,1936,"Excelsior Roubaix","Red Star Olympique","3-1",3,1,"1",1,4,2,"H"
"1029",1937-07-01,1936,"Olympique Lillois Lille","FC Metz","3-1",3,1,"1",1,4,2,"H"
"1030",1937-07-01,1936,"FC Rouen","RC Roubaix","2-0",2,0,"1",1,2,2,"H"
"1031",1937-07-01,1936,"AS Cannes","Olympique Marseille","1-1",1,1,"1",1,2,0,"D"
"1032",1937-07-01,1936,"RC Strasbourg","FC Metz","1-1",1,1,"1",1,2,0,"D"
"1033",1937-07-01,1936,"Red Star Olympique","FC Rouen","2-2",2,2,"1",1,4,0,"D"
"1034",1937-07-01,1936,"RC Lens","Excelsior Roubaix","2-2",2,2,"1",1,4,0,"D"
"1035",1937-07-01,1936,"US Valenciennes-Anzin","Olympique Lillois Lille","0-4",0,4,"1",1,4,-4,"D"
"1036",1937-07-01,1936,"SC Fives Lille","FC Sochaux","1-1",1,1,"1",1,2,0,"D"
"1037",1937-07-01,1936,"FC Sete","FC Antibes","0-0",0,0,"1",1,0,0,"D"
"1038",1937-07-01,1936,"RC Roubaix","Racing Club de France","2-1",2,1,"1",1,3,1,"H"
"1039",1937-07-01,1936,"AS Cannes","RC Lens","5-0",5,0,"1",1,5,5,"H"
"1040",1937-07-01,1936,"Olympique Marseille","RC Strasbourg","2-1",2,1,"1",1,3,1,"H"
"1041",1937-07-01,1936,"FC Rouen","FC Sochaux","1-3",1,3,"1",1,4,-2,"D"
"1042",1937-07-01,1936,"FC Metz","Red Star Olympique","3-0",3,0,"1",1,3,3,"H"
"1043",1937-07-01,1936,"US Valenciennes-Anzin","RC Roubaix","2-4",2,4,"1",1,6,-2,"D"
"1044",1937-07-01,1936,"Excelsior Roubaix","Olympique Lillois Lille","2-2",2,2,"1",1,4,0,"D"
"1045",1937-07-01,1936,"SC Fives Lille","FC Sete","1-2",1,2,"1",1,3,-1,"D"
"1046",1937-07-01,1936,"Racing Club de France","FC Antibes","1-2",1,2,"1",1,3,-1,"D"
"1047",1937-07-01,1936,"Red Star Olympique","AS Cannes","2-1",2,1,"1",1,3,1,"H"
"1048",1937-07-01,1936,"FC Sete","US Valenciennes-Anzin","3-0",3,0,"1",1,3,3,"H"
"1049",1937-07-01,1936,"RC Strasbourg","Racing Club de France","1-3",1,3,"1",1,4,-2,"D"
"1050",1937-07-01,1936,"FC Antibes","FC Rouen","0-1",0,1,"1",1,1,-1,"D"
"1051",1937-07-01,1936,"Olympique Lillois Lille","Olympique Marseille","1-1",1,1,"1",1,2,0,"D"
"1052",1937-07-01,1936,"RC Roubaix","FC Metz","2-3",2,3,"1",1,5,-1,"D"
"1053",1937-07-01,1936,"FC Sochaux","Excelsior Roubaix","1-1",1,1,"1",1,2,0,"D"
"1054",1937-07-01,1936,"RC Lens","SC Fives Lille","3-2",3,2,"1",1,5,1,"H"
"1055",1937-07-01,1936,"US Valenciennes-Anzin","RC Lens","1-3",1,3,"1",1,4,-2,"D"
"1056",1937-07-01,1936,"FC Rouen","RC Strasbourg","3-0",3,0,"1",1,3,3,"H"
"1057",1937-07-01,1936,"FC Metz","FC Sete","1-1",1,1,"1",1,2,0,"D"
"1058",1937-07-01,1936,"Olympique Marseille","FC Sochaux","2-0",2,0,"1",1,2,2,"H"
"1059",1937-07-01,1936,"Excelsior Roubaix","FC Antibes","2-1",2,1,"1",1,3,1,"H"
"1060",1937-07-01,1936,"SC Fives Lille","Red Star Olympique","3-0",3,0,"1",1,3,3,"H"
"1061",1937-07-01,1936,"Racing Club de France","Olympique Lillois Lille","1-0",1,0,"1",1,1,1,"H"
"1062",1937-07-01,1936,"AS Cannes","RC Roubaix","2-3",2,3,"1",1,5,-1,"D"
"1063",1937-07-01,1936,"FC Sete","AS Cannes","1-1",1,1,"1",1,2,0,"D"
"1064",1937-07-01,1936,"RC Lens","FC Metz","2-3",2,3,"1",1,5,-1,"D"
"1065",1937-07-01,1936,"Racing Club de France","FC Sochaux","0-4",0,4,"1",1,4,-4,"D"
"1066",1937-07-01,1936,"US Valenciennes-Anzin","Red Star Olympique","3-2",3,2,"1",1,5,1,"H"
"1067",1937-07-01,1936,"Olympique Lillois Lille","FC Rouen","4-0",4,0,"1",1,4,4,"H"
"1068",1937-07-01,1936,"FC Antibes","Olympique Marseille","0-3",0,3,"1",1,3,-3,"D"
"1069",1937-07-01,1936,"RC Strasbourg","Excelsior Roubaix","3-3",3,3,"1",1,6,0,"D"
"1070",1937-07-01,1936,"RC Roubaix","SC Fives Lille","0-0",0,0,"1",1,0,0,"D"
"1071",1937-07-01,1936,"FC Sete","RC Lens","3-1",3,1,"1",1,4,2,"H"
"1072",1937-07-01,1936,"Olympique Marseille","FC Rouen","1-1",1,1,"1",1,2,0,"D"
"1073",1937-07-01,1936,"FC Sochaux","RC Strasbourg","3-3",3,3,"1",1,6,0,"D"
"1074",1937-07-01,1936,"FC Metz","US Valenciennes-Anzin","1-0",1,0,"1",1,1,1,"H"
"1075",1937-07-01,1936,"Olympique Lillois Lille","FC Antibes","4-0",4,0,"1",1,4,4,"H"
"1076",1937-07-01,1936,"Excelsior Roubaix","Racing Club de France","3-2",3,2,"1",1,5,1,"H"
"1077",1937-07-01,1936,"AS Cannes","SC Fives Lille","1-1",1,1,"1",1,2,0,"D"
"1078",1937-07-01,1936,"Red Star Olympique","RC Roubaix","7-0",7,0,"1",1,7,7,"H"
"1079",1937-07-01,1936,"AS Cannes","US Valenciennes-Anzin","5-0",5,0,"1",1,5,5,"H"
"1080",1937-07-01,1936,"Red Star Olympique","FC Sete","1-4",1,4,"1",1,5,-3,"D"
"1081",1937-07-01,1936,"Olympique Marseille","Racing Club de France","2-1",2,1,"1",1,3,1,"H"
"1082",1937-07-01,1936,"FC Rouen","Excelsior Roubaix","1-3",1,3,"1",1,4,-2,"D"
"1083",1937-07-01,1936,"SC Fives Lille","FC Metz","3-0",3,0,"1",1,3,3,"H"
"1084",1937-07-01,1936,"FC Sochaux","Olympique Lillois Lille","2-0",2,0,"1",1,2,2,"H"
"1085",1937-07-01,1936,"RC Strasbourg","FC Antibes","3-0",3,0,"1",1,3,3,"H"
"1086",1937-07-01,1936,"RC Roubaix","RC Lens","3-1",3,1,"1",1,4,2,"H"
"1087",1937-07-01,1936,"FC Metz","AS Cannes","1-0",1,0,"1",1,1,1,"H"
"1088",1937-07-01,1936,"Racing Club de France","FC Rouen","2-1",2,1,"1",1,3,1,"H"
"1089",1937-07-01,1936,"RC Lens","Red Star Olympique","1-3",1,3,"1",1,4,-2,"D"
"1090",1937-07-01,1936,"Excelsior Roubaix","Olympique Marseille","4-2",4,2,"1",1,6,2,"H"
"1091",1937-07-01,1936,"Olympique Lillois Lille","RC Strasbourg","2-0",2,0,"1",1,2,2,"H"
"1092",1937-07-01,1936,"FC Sete","RC Roubaix","0-1",0,1,"1",1,1,-1,"D"
"1093",1937-07-01,1936,"FC Antibes","FC Sochaux","2-1",2,1,"1",1,3,1,"H"
"1094",1937-07-01,1936,"US Valenciennes-Anzin","SC Fives Lille","1-0",1,0,"1",1,1,1,"H"
"1095",1937-07-01,1936,"Racing Club de France","AS Cannes","3-1",3,1,"1",1,4,2,"H"
"1096",1937-07-01,1936,"RC Strasbourg","FC Sete","0-2",0,2,"1",1,2,-2,"D"
"1097",1937-07-01,1936,"FC Rouen","FC Metz","2-1",2,1,"1",1,3,1,"H"
"1098",1937-07-01,1936,"FC Sochaux","Red Star Olympique","3-1",3,1,"1",1,4,2,"H"
"1099",1937-07-01,1936,"Olympique Marseille","SC Fives Lille","1-1",1,1,"1",1,2,0,"D"
"1100",1937-07-01,1936,"FC Antibes","RC Lens","1-1",1,1,"1",1,2,0,"D"
"1101",1937-07-01,1936,"Olympique Lillois Lille","RC Roubaix","1-1",1,1,"1",1,2,0,"D"
"1102",1937-07-01,1936,"Excelsior Roubaix","US Valenciennes-Anzin","4-0",4,0,"1",1,4,4,"H"
"1103",1937-07-01,1936,"Red Star Olympique","Olympique Marseille","0-1",0,1,"1",1,1,-1,"D"
"1104",1937-07-01,1936,"RC Lens","RC Strasbourg","2-3",2,3,"1",1,5,-1,"D"
"1105",1937-07-01,1936,"FC Metz","FC Sochaux","2-2",2,2,"1",1,4,0,"D"
"1106",1937-07-01,1936,"FC Sete","FC Rouen","1-0",1,0,"1",1,1,1,"H"
"1107",1937-07-01,1936,"RC Roubaix","Excelsior Roubaix","2-1",2,1,"1",1,3,1,"H"
"1108",1937-07-01,1936,"SC Fives Lille","Racing Club de France","1-0",1,0,"1",1,1,1,"H"
"1109",1937-07-01,1936,"US Valenciennes-Anzin","FC Antibes","1-1",1,1,"1",1,2,0,"D"
"1110",1937-07-01,1936,"AS Cannes","Olympique Lillois Lille","3-1",3,1,"1",1,4,2,"H"
"1111",1937-07-01,1936,"AS Cannes","FC Rouen","6-1",6,1,"1",1,7,5,"H"
"1112",1937-07-01,1936,"US Valenciennes-Anzin","Olympique Marseille","1-2",1,2,"1",1,3,-1,"D"
"1113",1937-07-01,1936,"RC Lens","Racing Club de France","2-1",2,1,"1",1,3,1,"H"
"1114",1937-07-01,1936,"FC Metz","Excelsior Roubaix","1-2",1,2,"1",1,3,-1,"D"
"1115",1937-07-01,1936,"SC Fives Lille","RC Strasbourg","1-1",1,1,"1",1,2,0,"D"
"1116",1937-07-01,1936,"RC Roubaix","FC Sochaux","2-2",2,2,"1",1,4,0,"D"
"1117",1937-07-01,1936,"FC Sete","Olympique Lillois Lille","3-1",3,1,"1",1,4,2,"H"
"1118",1937-07-01,1936,"Red Star Olympique","FC Antibes","0-1",0,1,"1",1,1,-1,"D"
"1119",1937-07-01,1936,"Olympique Marseille","FC Metz","4-0",4,0,"1",1,4,4,"H"
"1120",1937-07-01,1936,"RC Strasbourg","US Valenciennes-Anzin","10-0",10,0,"1",1,10,10,"H"
"1121",1937-07-01,1936,"FC Rouen","RC Lens","3-1",3,1,"1",1,4,2,"H"
"1122",1937-07-01,1936,"Racing Club de France","Red Star Olympique","2-1",2,1,"1",1,3,1,"H"
"1123",1937-07-01,1936,"FC Sochaux","FC Sete","0-1",0,1,"1",1,1,-1,"D"
"1124",1937-07-01,1936,"Excelsior Roubaix","AS Cannes","2-2",2,2,"1",1,4,0,"D"
"1125",1937-07-01,1936,"FC Antibes","RC Roubaix","5-0",5,0,"1",1,5,5,"H"
"1126",1937-07-01,1936,"Olympique Lillois Lille","SC Fives Lille","2-1",2,1,"1",1,3,1,"H"
"1127",1937-07-01,1936,"FC Metz","Racing Club de France","4-4",4,4,"1",1,8,0,"D"
"1128",1937-07-01,1936,"RC Lens","FC Sochaux","0-2",0,2,"1",1,2,-2,"D"
"1129",1937-07-01,1936,"FC Sete","Olympique Marseille","1-1",1,1,"1",1,2,0,"D"
"1130",1937-07-01,1936,"US Valenciennes-Anzin","FC Rouen","1-9",1,9,"1",1,10,-8,"D"
"1131",1937-07-01,1936,"SC Fives Lille","Excelsior Roubaix","4-4",4,4,"1",1,8,0,"D"
"1132",1937-07-01,1936,"RC Roubaix","RC Strasbourg","0-2",0,2,"1",1,2,-2,"D"
"1133",1937-07-01,1936,"AS Cannes","FC Antibes","2-1",2,1,"1",1,3,1,"H"
"1134",1937-07-01,1936,"Red Star Olympique","Olympique Lillois Lille","3-2",3,2,"1",1,5,1,"H"
"1135",1937-07-01,1936,"FC Sochaux","AS Cannes","1-1",1,1,"1",1,2,0,"D"
"1136",1937-07-01,1936,"Racing Club de France","US Valenciennes-Anzin","0-3",0,3,"1",1,3,-3,"D"
"1137",1937-07-01,1936,"RC Strasbourg","Red Star Olympique","9-3",9,3,"1",1,12,6,"H"
"1138",1937-07-01,1936,"Olympique Lillois Lille","RC Lens","3-0",3,0,"1",1,3,3,"H"
"1139",1937-07-01,1936,"FC Antibes","FC Metz","2-0",2,0,"1",1,2,2,"H"
"1140",1937-07-01,1936,"Excelsior Roubaix","FC Sete","2-2",2,2,"1",1,4,0,"D"
"1141",1937-07-01,1936,"FC Rouen","SC Fives Lille","2-2",2,2,"1",1,4,0,"D"
"1142",1937-07-01,1936,"Olympique Marseille","RC Roubaix","5-1",5,1,"1",1,6,4,"H"
"1143",1938-09-04,1938,"FC Antibes","Olympique Lillois Lille","0-3",0,3,"1",1,3,-3,"D"
"1144",1938-09-04,1938,"Excelsior Roubaix","Le Havre AC","3-3",3,3,"1",1,6,0,"D"
"1145",1938-09-04,1938,"RC Strasbourg","FC Sete","1-3",1,3,"1",1,4,-2,"D"
"1146",1938-09-04,1938,"RC Lens","FC Metz","2-1",2,1,"1",1,3,1,"H"
"1147",1938-09-04,1938,"FC Sochaux","RC Roubaix","3-1",3,1,"1",1,4,2,"H"
"1148",1938-09-04,1938,"Olympique Marseille","Racing Club de France","5-2",5,2,"1",1,7,3,"H"
"1149",1938-09-04,1938,"FC Rouen","AS Cannes","2-1",2,1,"1",1,3,1,"H"
"1150",1938-09-04,1938,"SC Fives Lille","AS Saint-Etienne","3-2",3,2,"1",1,5,1,"H"
"1151",1938-09-11,1938,"AS Cannes","FC Sochaux","0-0",0,0,"1",1,0,0,"D"
"1152",1938-09-11,1938,"RC Roubaix","Olympique Marseille","1-0",1,0,"1",1,1,1,"H"
"1153",1938-09-11,1938,"Racing Club de France","SC Fives Lille","2-2",2,2,"1",1,4,0,"D"
"1154",1938-09-11,1938,"FC Metz","RC Strasbourg","2-1",2,1,"1",1,3,1,"H"
"1155",1938-09-11,1938,"FC Sete","Excelsior Roubaix","4-2",4,2,"1",1,6,2,"H"
"1156",1938-09-11,1938,"Le Havre AC","FC Antibes","2-0",2,0,"1",1,2,2,"H"
"1157",1938-09-11,1938,"Olympique Lillois Lille","RC Lens","2-0",2,0,"1",1,2,2,"H"
"1158",1938-09-11,1938,"AS Saint-Etienne","FC Rouen","2-1",2,1,"1",1,3,1,"H"
"1159",1938-09-18,1938,"FC Antibes","SC Fives Lille","0-3",0,3,"1",1,3,-3,"D"
"1160",1938-09-18,1938,"Excelsior Roubaix","FC Rouen","1-1",1,1,"1",1,2,0,"D"
"1161",1938-09-18,1938,"RC Strasbourg","FC Sochaux","2-0",2,0,"1",1,2,2,"H"
"1162",1938-09-18,1938,"RC Lens","Olympique Marseille","2-3",2,3,"1",1,5,-1,"D"
"1163",1938-09-18,1938,"FC Sete","FC Metz","6-3",6,3,"1",1,9,3,"H"
"1164",1938-09-18,1938,"Le Havre AC","Racing Club de France","2-1",2,1,"1",1,3,1,"H"
"1165",1938-09-18,1938,"Olympique Lillois Lille","RC Roubaix","2-1",2,1,"1",1,3,1,"H"
"1166",1938-09-18,1938,"AS Saint-Etienne","AS Cannes","2-0",2,0,"1",1,2,2,"H"
"1167",1938-09-25,1938,"Olympique Marseille","Excelsior Roubaix","4-2",4,2,"1",1,6,2,"H"
"1168",1938-09-25,1938,"FC Sochaux","FC Antibes","2-0",2,0,"1",1,2,2,"H"
"1169",1938-09-25,1938,"FC Rouen","RC Lens","3-0",3,0,"1",1,3,3,"H"
"1170",1938-09-25,1938,"SC Fives Lille","RC Strasbourg","2-0",2,0,"1",1,2,2,"H"
"1171",1938-09-25,1938,"AS Cannes","Le Havre AC","3-2",3,2,"1",1,5,1,"H"
"1172",1938-09-25,1938,"RC Roubaix","FC Sete","1-0",1,0,"1",1,1,1,"H"
"1173",1938-09-25,1938,"Racing Club de France","AS Saint-Etienne","1-1",1,1,"1",1,2,0,"D"
"1174",1938-09-25,1938,"FC Metz","Olympique Lillois Lille","0-1",0,1,"1",1,1,-1,"D"
"1175",1938-10-02,1938,"FC Antibes","FC Rouen","0-0",0,0,"1",1,0,0,"D"
"1176",1938-10-02,1938,"Excelsior Roubaix","FC Sochaux","3-2",3,2,"1",1,5,1,"H"
"1177",1938-10-02,1938,"RC Strasbourg","Olympique Marseille","1-0",1,0,"1",1,1,1,"H"
"1178",1938-10-02,1938,"RC Lens","SC Fives Lille","1-0",1,0,"1",1,1,1,"H"
"1179",1938-10-02,1938,"FC Sete","Racing Club de France","5-0",5,0,"1",1,5,5,"H"
"1180",1938-10-02,1938,"Le Havre AC","RC Roubaix","5-2",5,2,"1",1,7,3,"H"
"1181",1938-10-02,1938,"Olympique Lillois Lille","AS Cannes","0-0",0,0,"1",1,0,0,"D"
"1182",1938-10-02,1938,"AS Saint-Etienne","FC Metz","0-1",0,1,"1",1,1,-1,"D"
"1183",1938-10-09,1938,"RC Strasbourg","FC Rouen","5-1",5,1,"1",1,6,4,"H"
"1184",1938-10-09,1938,"Olympique Marseille","FC Antibes","5-2",5,2,"1",1,7,3,"H"
"1185",1938-10-09,1938,"FC Sochaux","RC Lens","0-2",0,2,"1",1,2,-2,"D"
"1186",1938-10-09,1938,"SC Fives Lille","Excelsior Roubaix","4-2",4,2,"1",1,6,2,"H"
"1187",1938-10-09,1938,"AS Cannes","FC Sete","3-2",3,2,"1",1,5,1,"H"
"1188",1938-10-09,1938,"RC Roubaix","AS Saint-Etienne","2-2",2,2,"1",1,4,0,"D"
"1189",1938-10-09,1938,"Racing Club de France","Olympique Lillois Lille","2-2",2,2,"1",1,4,0,"D"
"1190",1938-10-09,1938,"Le Havre AC","FC Metz","0-3",0,3,"1",1,3,-3,"D"
"1191",1938-10-16,1938,"Excelsior Roubaix","RC Strasbourg","6-1",6,1,"1",1,7,5,"H"
"1192",1938-10-16,1938,"RC Lens","FC Antibes","1-1",1,1,"1",1,2,0,"D"
"1193",1938-10-16,1938,"FC Rouen","FC Sochaux","1-0",1,0,"1",1,1,1,"H"
"1194",1938-10-16,1938,"SC Fives Lille","Olympique Marseille","0-0",0,0,"1",1,0,0,"D"
"1195",1938-10-16,1938,"AS Cannes","Racing Club de France","1-2",1,2,"1",1,3,-1,"D"
"1196",1938-10-16,1938,"FC Metz","RC Roubaix","1-0",1,0,"1",1,1,1,"H"
"1197",1938-10-16,1938,"FC Sete","Olympique Lillois Lille","2-2",2,2,"1",1,4,0,"D"
"1198",1938-10-16,1938,"AS Saint-Etienne","Le Havre AC","0-0",0,0,"1",1,0,0,"D"
"1199",1938-10-23,1938,"FC Antibes","RC Strasbourg","1-1",1,1,"1",1,2,0,"D"
"1200",1938-10-23,1938,"RC Lens","Excelsior Roubaix","2-2",2,2,"1",1,4,0,"D"
"1201",1938-10-23,1938,"FC Sochaux","SC Fives Lille","5-2",5,2,"1",1,7,3,"H"
"1202",1938-10-23,1938,"FC Rouen","Olympique Marseille","1-2",1,2,"1",1,3,-1,"D"
"1203",1938-10-23,1938,"RC Roubaix","Racing Club de France","0-3",0,3,"1",1,3,-3,"D"
"1204",1938-10-23,1938,"FC Metz","AS Cannes","2-1",2,1,"1",1,3,1,"H"
"1205",1938-10-23,1938,"FC Sete","AS Saint-Etienne","2-1",2,1,"1",1,3,1,"H"
"1206",1938-10-23,1938,"Olympique Lillois Lille","Le Havre AC","1-0",1,0,"1",1,1,1,"H"
"1207",1938-10-30,1938,"Excelsior Roubaix","FC Antibes","0-2",0,2,"1",1,2,-2,"D"
"1208",1938-10-30,1938,"RC Strasbourg","RC Lens","3-2",3,2,"1",1,5,1,"H"
"1209",1938-10-30,1938,"Olympique Marseille","FC Sochaux","1-0",1,0,"1",1,1,1,"H"
"1210",1938-10-30,1938,"SC Fives Lille","FC Rouen","1-0",1,0,"1",1,1,1,"H"
"1211",1938-10-30,1938,"AS Cannes","RC Roubaix","4-1",4,1,"1",1,5,3,"H"
"1212",1938-10-30,1938,"Racing Club de France","FC Metz","3-2",3,2,"1",1,5,1,"H"
"1213",1938-10-30,1938,"Le Havre AC","FC Sete","2-1",2,1,"1",1,3,1,"H"
"1214",1938-10-30,1938,"AS Saint-Etienne","Olympique Lillois Lille","2-0",2,0,"1",1,2,2,"H"
"1215",1938-11-06,1938,"AS Cannes","RC Lens","2-1",2,1,"1",1,3,1,"H"
"1216",1938-11-06,1938,"RC Roubaix","RC Strasbourg","2-0",2,0,"1",1,2,2,"H"
"1217",1938-11-06,1938,"Racing Club de France","Excelsior Roubaix","3-1",3,1,"1",1,4,2,"H"
"1218",1938-11-06,1938,"FC Metz","FC Antibes","6-0",6,0,"1",1,6,6,"H"
"1219",1938-11-06,1938,"FC Sete","SC Fives Lille","2-0",2,0,"1",1,2,2,"H"
"1220",1938-11-06,1938,"Le Havre AC","FC Rouen","1-1",1,1,"1",1,2,0,"D"
"1221",1938-11-06,1938,"AS Saint-Etienne","Olympique Marseille","1-0",1,0,"1",1,1,1,"H"
"1222",1938-11-06,1938,"Olympique Lillois Lille","FC Sochaux","2-0",2,0,"1",1,2,2,"H"
"1223",1938-11-11,1938,"FC Antibes","AS Cannes","0-0",0,0,"1",1,0,0,"D"
"1224",1938-11-11,1938,"Excelsior Roubaix","AS Saint-Etienne","1-0",1,0,"1",1,1,1,"H"
"1225",1938-11-11,1938,"RC Strasbourg","Olympique Lillois Lille","1-2",1,2,"1",1,3,-1,"D"
"1226",1938-11-11,1938,"RC Lens","Le Havre AC","4-2",4,2,"1",1,6,2,"H"
"1227",1938-11-11,1938,"Olympique Marseille","FC Sete","1-1",1,1,"1",1,2,0,"D"
"1228",1938-11-11,1938,"FC Sochaux","FC Metz","0-1",0,1,"1",1,1,-1,"D"
"1229",1938-11-11,1938,"FC Rouen","Racing Club de France","3-1",3,1,"1",1,4,2,"H"
"1230",1938-11-11,1938,"SC Fives Lille","RC Roubaix","1-3",1,3,"1",1,4,-2,"D"
"1231",1938-11-13,1938,"FC Antibes","FC Sete","0-2",0,2,"1",1,2,-2,"D"
"1232",1938-11-13,1938,"Excelsior Roubaix","FC Metz","3-1",3,1,"1",1,4,2,"H"
"1233",1938-11-13,1938,"RC Strasbourg","Racing Club de France","1-1",1,1,"1",1,2,0,"D"
"1234",1938-11-13,1938,"RC Lens","RC Roubaix","3-1",3,1,"1",1,4,2,"H"
"1235",1938-11-13,1938,"Olympique Marseille","AS Cannes","0-1",0,1,"1",1,1,-1,"D"
"1236",1938-11-13,1938,"FC Sochaux","AS Saint-Etienne","1-2",1,2,"1",1,3,-1,"D"
"1237",1938-11-13,1938,"FC Rouen","Olympique Lillois Lille","0-0",0,0,"1",1,0,0,"D"
"1238",1938-11-13,1938,"SC Fives Lille","Le Havre AC","7-3",7,3,"1",1,10,4,"H"
"1239",1938-11-20,1938,"AS Cannes","SC Fives Lille","1-5",1,5,"1",1,6,-4,"D"
"1240",1938-11-20,1938,"RC Roubaix","FC Rouen","1-2",1,2,"1",1,3,-1,"D"
"1241",1938-11-20,1938,"Racing Club de France","FC Sochaux","6-1",6,1,"1",1,7,5,"H"
"1242",1938-11-20,1938,"FC Metz","Olympique Marseille","5-1",5,1,"1",1,6,4,"H"
"1243",1938-11-20,1938,"FC Sete","RC Lens","2-2",2,2,"1",1,4,0,"D"
"1244",1938-11-20,1938,"Le Havre AC","RC Strasbourg","2-1",2,1,"1",1,3,1,"H"
"1245",1938-11-20,1938,"Olympique Lillois Lille","Excelsior Roubaix","4-3",4,3,"1",1,7,1,"H"
"1246",1938-11-20,1938,"AS Saint-Etienne","FC Antibes","1-0",1,0,"1",1,1,1,"H"
"1247",1938-12-11,1938,"FC Antibes","RC Roubaix","1-0",1,0,"1",1,1,1,"H"
"1248",1938-12-11,1938,"Excelsior Roubaix","AS Cannes","3-5",3,5,"1",1,8,-2,"D"
"1249",1938-12-11,1938,"RC Strasbourg","AS Saint-Etienne","1-1",1,1,"1",1,2,0,"D"
"1250",1938-12-11,1938,"RC Lens","Racing Club de France","1-1",1,1,"1",1,2,0,"D"
"1251",1938-12-11,1938,"Olympique Marseille","Le Havre AC","0-2",0,2,"1",1,2,-2,"D"
"1252",1938-12-11,1938,"FC Sochaux","FC Sete","1-1",1,1,"1",1,2,0,"D"
"1253",1938-12-11,1938,"FC Rouen","FC Metz","2-2",2,2,"1",1,4,0,"D"
"1254",1938-12-11,1938,"SC Fives Lille","Olympique Lillois Lille","3-1",3,1,"1",1,4,2,"H"
"1255",1938-12-25,1938,"AS Cannes","RC Strasbourg","1-1",1,1,"1",1,2,0,"D"
"1256",1938-12-25,1938,"RC Roubaix","Excelsior Roubaix","1-1",1,1,"1",1,2,0,"D"
"1257",1938-12-25,1938,"Racing Club de France","FC Antibes","3-0",3,0,"1",1,3,3,"H"
"1258",1938-12-25,1938,"FC Metz","SC Fives Lille","1-3",1,3,"1",1,4,-2,"D"
"1259",1938-12-25,1938,"FC Sete","FC Rouen","2-0",2,0,"1",1,2,2,"H"
"1260",1938-12-25,1938,"Le Havre AC","FC Sochaux","2-1",2,1,"1",1,3,1,"H"
"1261",1938-12-25,1938,"Olympique Lillois Lille","Olympique Marseille","0-1",0,1,"1",1,1,-1,"D"
"1262",1938-12-25,1938,"AS Saint-Etienne","RC Lens","1-1",1,1,"1",1,2,0,"D"
"1263",1939-01-01,1938,"Olympique Lillois Lille","FC Antibes","2-0",2,0,"1",1,2,2,"H"
"1264",1939-01-01,1938,"Le Havre AC","Excelsior Roubaix","1-3",1,3,"1",1,4,-2,"D"
"1265",1939-01-01,1938,"FC Sete","RC Strasbourg","2-0",2,0,"1",1,2,2,"H"
"1266",1939-01-01,1938,"FC Metz","RC Lens","1-1",1,1,"1",1,2,0,"D"
"1267",1939-01-01,1938,"Racing Club de France","Olympique Marseille","1-1",1,1,"1",1,2,0,"D"
"1268",1939-01-01,1938,"RC Roubaix","FC Sochaux","1-4",1,4,"1",1,5,-3,"D"
"1269",1939-01-01,1938,"AS Cannes","FC Rouen","2-0",2,0,"1",1,2,2,"H"
"1270",1939-01-01,1938,"AS Saint-Etienne","SC Fives Lille","2-0",2,0,"1",1,2,2,"H"
"1271",1939-01-15,1938,"FC Sochaux","AS Cannes","7-3",7,3,"1",1,10,4,"H"
"1272",1939-01-15,1938,"Olympique Marseille","RC Roubaix","6-0",6,0,"1",1,6,6,"H"
"1273",1939-01-15,1938,"SC Fives Lille","Racing Club de France","0-1",0,1,"1",1,1,-1,"D"
"1274",1939-01-15,1938,"RC Strasbourg","FC Metz","0-0",0,0,"1",1,0,0,"D"
"1275",1939-01-15,1938,"Excelsior Roubaix","FC Sete","2-3",2,3,"1",1,5,-1,"D"
"1276",1939-01-15,1938,"FC Antibes","Le Havre AC","1-0",1,0,"1",1,1,1,"H"
"1277",1939-01-15,1938,"RC Lens","Olympique Lillois Lille","3-1",3,1,"1",1,4,2,"H"
"1278",1939-01-15,1938,"FC Rouen","AS Saint-Etienne","0-2",0,2,"1",1,2,-2,"D"
"1279",1939-01-29,1938,"SC Fives Lille","FC Antibes","4-1",4,1,"1",1,5,3,"H"
"1280",1939-01-29,1938,"FC Rouen","Excelsior Roubaix","2-2",2,2,"1",1,4,0,"D"
"1281",1939-01-29,1938,"FC Sochaux","RC Strasbourg","2-0",2,0,"1",1,2,2,"H"
"1282",1939-01-29,1938,"Olympique Marseille","RC Lens","2-0",2,0,"1",1,2,2,"H"
"1283",1939-01-29,1938,"FC Metz","FC Sete","0-2",0,2,"1",1,2,-2,"D"
"1284",1939-01-29,1938,"Racing Club de France","Le Havre AC","3-0",3,0,"1",1,3,3,"H"
"1285",1939-01-29,1938,"RC Roubaix","Olympique Lillois Lille","0-0",0,0,"1",1,0,0,"D"
"1286",1939-01-29,1938,"AS Cannes","AS Saint-Etienne","1-2",1,2,"1",1,3,-1,"D"
"1287",1939-02-12,1938,"Excelsior Roubaix","Olympique Marseille","1-2",1,2,"1",1,3,-1,"D"
"1288",1939-02-12,1938,"FC Antibes","FC Sochaux","0-0",0,0,"1",1,0,0,"D"
"1289",1939-02-12,1938,"RC Lens","FC Rouen","0-2",0,2,"1",1,2,-2,"D"
"1290",1939-02-12,1938,"RC Strasbourg","SC Fives Lille","3-1",3,1,"1",1,4,2,"H"
"1291",1939-02-12,1938,"Le Havre AC","AS Cannes","3-0",3,0,"1",1,3,3,"H"
"1292",1939-02-12,1938,"FC Sete","RC Roubaix","3-1",3,1,"1",1,4,2,"H"
"1293",1939-02-12,1938,"AS Saint-Etienne","Racing Club de France","0-1",0,1,"1",1,1,-1,"D"
"1294",1939-02-12,1938,"Olympique Lillois Lille","FC Metz","3-2",3,2,"1",1,5,1,"H"
"1295",1939-02-26,1938,"FC Rouen","FC Antibes","0-1",0,1,"1",1,1,-1,"D"
"1296",1939-02-26,1938,"FC Sochaux","Excelsior Roubaix","8-0",8,0,"1",1,8,8,"H"
"1297",1939-02-26,1938,"Olympique Marseille","RC Strasbourg","1-0",1,0,"1",1,1,1,"H"
"1298",1939-02-26,1938,"SC Fives Lille","RC Lens","0-4",0,4,"1",1,4,-4,"D"
"1299",1939-02-26,1938,"Racing Club de France","FC Sete","3-0",3,0,"1",1,3,3,"H"
"1300",1939-02-26,1938,"RC Roubaix","Le Havre AC","1-1",1,1,"1",1,2,0,"D"
"1301",1939-02-26,1938,"AS Cannes","Olympique Lillois Lille","1-2",1,2,"1",1,3,-1,"D"
"1302",1939-02-26,1938,"FC Metz","AS Saint-Etienne","1-0",1,0,"1",1,1,1,"H"
"1303",1939-03-05,1938,"FC Rouen","RC Strasbourg","1-1",1,1,"1",1,2,0,"D"
"1304",1939-03-05,1938,"FC Antibes","Olympique Marseille","2-2",2,2,"1",1,4,0,"D"
"1305",1939-03-05,1938,"RC Lens","FC Sochaux","2-2",2,2,"1",1,4,0,"D"
"1306",1939-03-05,1938,"Excelsior Roubaix","SC Fives Lille","3-1",3,1,"1",1,4,2,"H"
"1307",1939-03-05,1938,"FC Sete","AS Cannes","3-0",3,0,"1",1,3,3,"H"
"1308",1939-03-05,1938,"Olympique Lillois Lille","Racing Club de France","0-2",0,2,"1",1,2,-2,"D"
"1309",1939-03-05,1938,"FC Metz","Le Havre AC","2-1",2,1,"1",1,3,1,"H"
"1310",1939-03-05,1938,"AS Saint-Etienne","RC Roubaix","5-0",5,0,"1",1,5,5,"H"
"1311",1939-03-12,1938,"RC Strasbourg","Excelsior Roubaix","3-1",3,1,"1",1,4,2,"H"
"1312",1939-03-12,1938,"FC Antibes","RC Lens","1-0",1,0,"1",1,1,1,"H"
"1313",1939-03-12,1938,"FC Sochaux","FC Rouen","2-0",2,0,"1",1,2,2,"H"
"1314",1939-03-12,1938,"Olympique Marseille","SC Fives Lille","2-0",2,0,"1",1,2,2,"H"
"1315",1939-03-12,1938,"Racing Club de France","AS Cannes","5-1",5,1,"1",1,6,4,"H"
"1316",1939-03-12,1938,"RC Roubaix","FC Metz","1-2",1,2,"1",1,3,-1,"D"
"1317",1939-03-12,1938,"Olympique Lillois Lille","FC Sete","1-0",1,0,"1",1,1,1,"H"
"1318",1939-03-12,1938,"Le Havre AC","AS Saint-Etienne","2-4",2,4,"1",1,6,-2,"D"
"1319",1939-03-19,1938,"RC Strasbourg","FC Antibes","2-1",2,1,"1",1,3,1,"H"
"1320",1939-03-19,1938,"Excelsior Roubaix","RC Lens","0-1",0,1,"1",1,1,-1,"D"
"1321",1939-03-19,1938,"SC Fives Lille","FC Sochaux","2-4",2,4,"1",1,6,-2,"D"
"1322",1939-03-19,1938,"Olympique Marseille","FC Rouen","1-0",1,0,"1",1,1,1,"H"
"1323",1939-03-19,1938,"Racing Club de France","RC Roubaix","1-1",1,1,"1",1,2,0,"D"
"1324",1939-03-19,1938,"AS Cannes","FC Metz","2-1",2,1,"1",1,3,1,"H"
"1325",1939-03-19,1938,"AS Saint-Etienne","FC Sete","3-1",3,1,"1",1,4,2,"H"
"1326",1939-03-19,1938,"Le Havre AC","Olympique Lillois Lille","1-0",1,0,"1",1,1,1,"H"
"1327",1939-03-26,1938,"FC Antibes","Excelsior Roubaix","3-0",3,0,"1",1,3,3,"H"
"1328",1939-03-26,1938,"RC Lens","RC Strasbourg","1-1",1,1,"1",1,2,0,"D"
"1329",1939-03-26,1938,"FC Sochaux","Olympique Marseille","2-0",2,0,"1",1,2,2,"H"
"1330",1939-03-26,1938,"FC Rouen","SC Fives Lille","2-3",2,3,"1",1,5,-1,"D"
"1331",1939-03-26,1938,"RC Roubaix","AS Cannes","1-1",1,1,"1",1,2,0,"D"
"1332",1939-03-26,1938,"FC Metz","Racing Club de France","3-0",3,0,"1",1,3,3,"H"
"1333",1939-03-26,1938,"FC Sete","Le Havre AC","3-2",3,2,"1",1,5,1,"H"
"1334",1939-03-26,1938,"Olympique Lillois Lille","AS Saint-Etienne","3-1",3,1,"1",1,4,2,"H"
"1335",1939-04-02,1938,"RC Lens","AS Cannes","6-2",6,2,"1",1,8,4,"H"
"1336",1939-04-02,1938,"RC Strasbourg","RC Roubaix","2-0",2,0,"1",1,2,2,"H"
"1337",1939-04-02,1938,"Excelsior Roubaix","Racing Club de France","6-2",6,2,"1",1,8,4,"H"
"1338",1939-04-02,1938,"FC Antibes","FC Metz","1-1",1,1,"1",1,2,0,"D"
"1339",1939-04-02,1938,"SC Fives Lille","FC Sete","1-3",1,3,"1",1,4,-2,"D"
"1340",1939-04-02,1938,"FC Rouen","Le Havre AC","1-4",1,4,"1",1,5,-3,"D"
"1341",1939-04-02,1938,"FC Sochaux","Olympique Lillois Lille","4-1",4,1,"1",1,5,3,"H"
"1342",1939-04-02,1938,"Olympique Marseille","AS Saint-Etienne","3-1",3,1,"1",1,4,2,"H"
"1343",1939-04-08,1938,"AS Cannes","FC Antibes","3-0",3,0,"1",1,3,3,"H"
"1344",1939-04-08,1938,"AS Saint-Etienne","Excelsior Roubaix","2-2",2,2,"1",1,4,0,"D"
"1345",1939-04-08,1938,"Olympique Lillois Lille","RC Strasbourg","0-1",0,1,"1",1,1,-1,"D"
"1346",1939-04-08,1938,"Le Havre AC","RC Lens","2-2",2,2,"1",1,4,0,"D"
"1347",1939-04-08,1938,"FC Sete","Olympique Marseille","1-2",1,2,"1",1,3,-1,"D"
"1348",1939-04-08,1938,"FC Metz","FC Sochaux","0-3",0,3,"1",1,3,-3,"D"
"1349",1939-04-08,1938,"Racing Club de France","FC Rouen","3-0",3,0,"1",1,3,3,"H"
"1350",1939-04-08,1938,"RC Roubaix","SC Fives Lille","3-3",3,3,"1",1,6,0,"D"
"1351",1939-04-10,1938,"FC Sete","FC Antibes","4-0",4,0,"1",1,4,4,"H"
"1352",1939-04-10,1938,"FC Metz","Excelsior Roubaix","1-1",1,1,"1",1,2,0,"D"
"1353",1939-04-10,1938,"Racing Club de France","RC Strasbourg","3-2",3,2,"1",1,5,1,"H"
"1354",1939-04-10,1938,"RC Roubaix","RC Lens","1-5",1,5,"1",1,6,-4,"D"
"1355",1939-04-10,1938,"AS Cannes","Olympique Marseille","2-4",2,4,"1",1,6,-2,"D"
"1356",1939-04-10,1938,"AS Saint-Etienne","FC Sochaux","2-1",2,1,"1",1,3,1,"H"
"1357",1939-04-10,1938,"Olympique Lillois Lille","FC Rouen","5-3",5,3,"1",1,8,2,"H"
"1358",1939-04-10,1938,"Le Havre AC","SC Fives Lille","0-0",0,0,"1",1,0,0,"D"
"1359",1939-04-16,1938,"SC Fives Lille","AS Cannes","3-1",3,1,"1",1,4,2,"H"
"1360",1939-04-16,1938,"FC Rouen","RC Roubaix","0-0",0,0,"1",1,0,0,"D"
"1361",1939-04-16,1938,"FC Sochaux","Racing Club de France","1-0",1,0,"1",1,1,1,"H"
"1362",1939-04-16,1938,"Olympique Marseille","FC Metz","5-1",5,1,"1",1,6,4,"H"
"1363",1939-04-16,1938,"RC Lens","FC Sete","1-2",1,2,"1",1,3,-1,"D"
"1364",1939-04-16,1938,"RC Strasbourg","Le Havre AC","3-1",3,1,"1",1,4,2,"H"
"1365",1939-04-16,1938,"Excelsior Roubaix","Olympique Lillois Lille","1-1",1,1,"1",1,2,0,"D"
"1366",1939-04-16,1938,"FC Antibes","AS Saint-Etienne","0-4",0,4,"1",1,4,-4,"D"
"1367",1939-04-30,1938,"RC Roubaix","FC Antibes","2-2",2,2,"1",1,4,0,"D"
"1368",1939-04-30,1938,"AS Cannes","Excelsior Roubaix","2-1",2,1,"1",1,3,1,"H"
"1369",1939-04-30,1938,"AS Saint-Etienne","RC Strasbourg","0-0",0,0,"1",1,0,0,"D"
"1370",1939-04-30,1938,"Racing Club de France","RC Lens","1-0",1,0,"1",1,1,1,"H"
"1371",1939-04-30,1938,"Le Havre AC","Olympique Marseille","2-0",2,0,"1",1,2,2,"H"
"1372",1939-04-30,1938,"FC Sete","FC Sochaux","2-1",2,1,"1",1,3,1,"H"
"1373",1939-04-30,1938,"FC Metz","FC Rouen","2-2",2,2,"1",1,4,0,"D"
"1374",1939-04-30,1938,"Olympique Lillois Lille","SC Fives Lille","1-2",1,2,"1",1,3,-1,"D"
"1375",1939-05-07,1938,"RC Strasbourg","AS Cannes","1-3",1,3,"1",1,4,-2,"D"
"1376",1939-05-07,1938,"Excelsior Roubaix","RC Roubaix","4-2",4,2,"1",1,6,2,"H"
"1377",1939-05-07,1938,"FC Antibes","Racing Club de France","1-1",1,1,"1",1,2,0,"D"
"1378",1939-05-07,1938,"SC Fives Lille","FC Metz","1-1",1,1,"1",1,2,0,"D"
"1379",1939-05-07,1938,"FC Rouen","FC Sete","0-1",0,1,"1",1,1,-1,"D"
"1380",1939-05-07,1938,"FC Sochaux","Le Havre AC","8-0",8,0,"1",1,8,8,"H"
"1381",1939-05-07,1938,"Olympique Marseille","Olympique Lillois Lille","2-0",2,0,"1",1,2,2,"H"
"1382",1939-05-07,1938,"RC Lens","AS Saint-Etienne","1-0",1,0,"1",1,1,1,"H"
"1383",1945-08-26,1945,"RC Lens","FC Sete","5-1",5,1,"1",1,6,4,"H"
"1384",1945-08-26,1945,"AS Saint-Etienne","RC Roubaix","1-3",1,3,"1",1,4,-2,"D"
"1385",1945-08-26,1945,"Lille OSC","AS Cannes","5-1",5,1,"1",1,6,4,"H"
"1386",1945-08-26,1945,"Stade Rennes","FC Rouen","2-0",2,0,"1",1,2,2,"H"
"1387",1945-08-26,1945,"Racing Club de France","Olympique Marseille","2-6",2,6,"1",1,8,-4,"D"
"1388",1945-08-26,1945,"Red Star Olympique","FC Metz","2-3",2,3,"1",1,5,-1,"D"
"1389",1945-08-26,1945,"Le Havre AC","Stade Reims","2-3",2,3,"1",1,5,-1,"D"
"1390",1945-08-26,1945,"FC Sochaux","Olympique Lyon","1-3",1,3,"1",1,4,-2,"D"
"1391",1945-08-26,1945,"Girondins Bordeaux","RC Strasbourg","4-3",4,3,"1",1,7,1,"H"
"1392",1945-09-02,1945,"RC Roubaix","FC Sochaux","2-2",2,2,"1",1,4,0,"D"
"1393",1945-09-02,1945,"FC Rouen","Racing Club de France","2-0",2,0,"1",1,2,2,"H"
"1394",1945-09-02,1945,"RC Strasbourg","Stade Rennes","1-1",1,1,"1",1,2,0,"D"
"1395",1945-09-02,1945,"Girondins Bordeaux","FC Sete","0-3",0,3,"1",1,3,-3,"D"
"1396",1945-09-02,1945,"Stade Reims","RC Lens","1-2",1,2,"1",1,3,-1,"D"
"1397",1945-09-02,1945,"Red Star Olympique","Le Havre AC","3-0",3,0,"1",1,3,3,"H"
"1398",1945-09-02,1945,"AS Saint-Etienne","Olympique Marseille","2-4",2,4,"1",1,6,-2,"D"
"1399",1945-09-02,1945,"AS Cannes","FC Metz","0-1",0,1,"1",1,1,-1,"D"
"1400",1945-09-02,1945,"Olympique Lyon","Lille OSC","1-2",1,2,"1",1,3,-1,"D"
"1401",1945-09-09,1945,"FC Sochaux","Olympique Marseille","1-0",1,0,"1",1,1,1,"H"
"1402",1945-09-09,1945,"RC Roubaix","Olympique Lyon","5-0",5,0,"1",1,5,5,"H"
"1403",1945-09-09,1945,"FC Metz","Lille OSC","0-3",0,3,"1",1,3,-3,"D"
"1404",1945-09-09,1945,"Le Havre AC","AS Cannes","1-2",1,2,"1",1,3,-1,"D"
"1405",1945-09-09,1945,"RC Lens","Red Star Olympique","1-1",1,1,"1",1,2,0,"D"
"1406",1945-09-09,1945,"Girondins Bordeaux","Stade Reims","5-1",5,1,"1",1,6,4,"H"
"1407",1945-09-09,1945,"Stade Rennes","FC Sete","3-3",3,3,"1",1,6,0,"D"
"1408",1945-09-09,1945,"Racing Club de France","RC Strasbourg","2-1",2,1,"1",1,3,1,"H"
"1409",1945-09-09,1945,"AS Saint-Etienne","FC Rouen","3-1",3,1,"1",1,4,2,"H"
"1410",1945-09-16,1945,"Lille OSC","Le Havre AC","1-0",1,0,"1",1,1,1,"H"
"1411",1945-09-16,1945,"Olympique Marseille","RC Roubaix","0-2",0,2,"1",1,2,-2,"D"
"1412",1945-09-16,1945,"FC Rouen","FC Sochaux","1-1",1,1,"1",1,2,0,"D"
"1413",1945-09-16,1945,"RC Strasbourg","AS Saint-Etienne","3-2",3,2,"1",1,5,1,"H"
"1414",1945-09-16,1945,"FC Sete","Racing Club de France","3-2",3,2,"1",1,5,1,"H"
"1415",1945-09-16,1945,"Stade Reims","Stade Rennes","5-0",5,0,"1",1,5,5,"H"
"1416",1945-09-16,1945,"Red Star Olympique","Girondins Bordeaux","4-2",4,2,"1",1,6,2,"H"
"1417",1945-09-16,1945,"AS Cannes","RC Lens","1-0",1,0,"1",1,1,1,"H"
"1418",1945-09-16,1945,"Olympique Lyon","FC Metz","2-0",2,0,"1",1,2,2,"H"
"1419",1945-09-23,1945,"FC Sochaux","RC Strasbourg","4-2",4,2,"1",1,6,2,"H"
"1420",1945-09-23,1945,"RC Roubaix","FC Rouen","0-0",0,0,"1",1,0,0,"D"
"1421",1945-09-23,1945,"Olympique Marseille","Olympique Lyon","1-1",1,1,"1",1,2,0,"D"
"1422",1945-09-23,1945,"Le Havre AC","FC Metz","3-0",3,0,"1",1,3,3,"H"
"1423",1945-09-23,1945,"RC Lens","Lille OSC","3-1",3,1,"1",1,4,2,"H"
"1424",1945-09-23,1945,"Girondins Bordeaux","AS Cannes","4-1",4,1,"1",1,5,3,"H"
"1425",1945-09-23,1945,"Stade Rennes","Red Star Olympique","1-0",1,0,"1",1,1,1,"H"
"1426",1945-09-23,1945,"Racing Club de France","Stade Reims","2-1",2,1,"1",1,3,1,"H"
"1427",1945-09-23,1945,"AS Saint-Etienne","FC Sete","6-2",6,2,"1",1,8,4,"H"
"1428",1945-09-30,1945,"Lille OSC","Girondins Bordeaux","5-0",5,0,"1",1,5,5,"H"
"1429",1945-09-30,1945,"FC Metz","RC Lens","2-3",2,3,"1",1,5,-1,"D"
"1430",1945-09-30,1945,"FC Rouen","Olympique Marseille","6-0",6,0,"1",1,6,6,"H"
"1431",1945-09-30,1945,"RC Strasbourg","RC Roubaix","2-1",2,1,"1",1,3,1,"H"
"1432",1945-09-30,1945,"FC Sete","FC Sochaux","4-0",4,0,"1",1,4,4,"H"
"1433",1945-09-30,1945,"Stade Reims","AS Saint-Etienne","1-3",1,3,"1",1,4,-2,"D"
"1434",1945-09-30,1945,"Red Star Olympique","Racing Club de France","0-1",0,1,"1",1,1,-1,"D"
"1435",1945-09-30,1945,"AS Cannes","Stade Rennes","2-2",2,2,"1",1,4,0,"D"
"1436",1945-09-30,1945,"Olympique Lyon","Le Havre AC","1-0",1,0,"1",1,1,1,"H"
"1437",1945-10-07,1945,"FC Sochaux","Stade Reims","1-1",1,1,"1",1,2,0,"D"
"1438",1945-10-07,1945,"RC Roubaix","FC Sete","3-1",3,1,"1",1,4,2,"H"
"1439",1945-10-07,1945,"Olympique Marseille","RC Strasbourg","5-0",5,0,"1",1,5,5,"H"
"1440",1945-10-07,1945,"FC Rouen","Olympique Lyon","2-1",2,1,"1",1,3,1,"H"
"1441",1945-10-07,1945,"RC Lens","Le Havre AC","7-1",7,1,"1",1,8,6,"H"
"1442",1945-10-07,1945,"Girondins Bordeaux","FC Metz","8-0",8,0,"1",1,8,8,"H"
"1443",1945-10-07,1945,"Stade Rennes","Lille OSC","1-4",1,4,"1",1,5,-3,"D"
"1444",1945-10-07,1945,"Racing Club de France","AS Cannes","0-3",0,3,"1",1,3,-3,"D"
"1445",1945-10-07,1945,"AS Saint-Etienne","Red Star Olympique","3-2",3,2,"1",1,5,1,"H"
"1446",1945-10-14,1945,"Lille OSC","Racing Club de France","0-1",0,1,"1",1,1,-1,"D"
"1447",1945-10-14,1945,"FC Metz","Stade Rennes","0-1",0,1,"1",1,1,-1,"D"
"1448",1945-10-14,1945,"Le Havre AC","Girondins Bordeaux","3-2",3,2,"1",1,5,1,"H"
"1449",1945-10-14,1945,"RC Strasbourg","FC Rouen","0-1",0,1,"1",1,1,-1,"D"
"1450",1945-10-14,1945,"FC Sete","Olympique Marseille","2-3",2,3,"1",1,5,-1,"D"
"1451",1945-10-14,1945,"Stade Reims","RC Roubaix","1-1",1,1,"1",1,2,0,"D"
"1452",1945-10-14,1945,"Red Star Olympique","FC Sochaux","4-1",4,1,"1",1,5,3,"H"
"1453",1945-10-14,1945,"AS Cannes","AS Saint-Etienne","1-4",1,4,"1",1,5,-3,"D"
"1454",1945-10-14,1945,"Olympique Lyon","RC Lens","2-0",2,0,"1",1,2,2,"H"
"1455",1945-10-21,1945,"FC Sochaux","AS Cannes","2-2",2,2,"1",1,4,0,"D"
"1456",1945-10-21,1945,"RC Roubaix","Red Star Olympique","3-5",3,5,"1",1,8,-2,"D"
"1457",1945-10-21,1945,"Olympique Marseille","Stade Reims","3-5",3,5,"1",1,8,-2,"D"
"1458",1945-10-21,1945,"FC Rouen","FC Sete","0-3",0,3,"1",1,3,-3,"D"
"1459",1945-10-21,1945,"RC Strasbourg","Olympique Lyon","3-2",3,2,"1",1,5,1,"H"
"1460",1945-10-21,1945,"Girondins Bordeaux","RC Lens","2-2",2,2,"1",1,4,0,"D"
"1461",1945-10-21,1945,"Stade Rennes","Le Havre AC","0-1",0,1,"1",1,1,-1,"D"
"1462",1945-10-21,1945,"Racing Club de France","FC Metz","2-0",2,0,"1",1,2,2,"H"
"1463",1945-10-21,1945,"AS Saint-Etienne","Lille OSC","3-1",3,1,"1",1,4,2,"H"
"1464",1945-10-28,1945,"Lille OSC","FC Sochaux","3-1",3,1,"1",1,4,2,"H"
"1465",1945-10-28,1945,"FC Metz","AS Saint-Etienne","0-3",0,3,"1",1,3,-3,"D"
"1466",1945-10-28,1945,"Le Havre AC","Racing Club de France","3-5",3,5,"1",1,8,-2,"D"
"1467",1945-10-28,1945,"RC Lens","Stade Rennes","2-2",2,2,"1",1,4,0,"D"
"1468",1945-10-28,1945,"FC Sete","RC Strasbourg","0-1",0,1,"1",1,1,-1,"D"
"1469",1945-10-28,1945,"Stade Reims","FC Rouen","4-1",4,1,"1",1,5,3,"H"
"1470",1945-10-28,1945,"Red Star Olympique","Olympique Marseille","2-2",2,2,"1",1,4,0,"D"
"1471",1945-10-28,1945,"AS Cannes","RC Roubaix","1-1",1,1,"1",1,2,0,"D"
"1472",1945-10-28,1945,"Olympique Lyon","Girondins Bordeaux","0-0",0,0,"1",1,0,0,"D"
"1473",1945-11-04,1945,"FC Sochaux","FC Metz","0-0",0,0,"1",1,0,0,"D"
"1474",1945-11-04,1945,"RC Roubaix","Lille OSC","1-1",1,1,"1",1,2,0,"D"
"1475",1945-11-04,1945,"Olympique Marseille","AS Cannes","6-1",6,1,"1",1,7,5,"H"
"1476",1945-11-04,1945,"FC Rouen","Red Star Olympique","1-1",1,1,"1",1,2,0,"D"
"1477",1945-11-04,1945,"RC Strasbourg","Stade Reims","3-1",3,1,"1",1,4,2,"H"
"1478",1945-11-04,1945,"FC Sete","Olympique Lyon","6-2",6,2,"1",1,8,4,"H"
"1479",1945-11-04,1945,"Stade Rennes","Girondins Bordeaux","4-2",4,2,"1",1,6,2,"H"
"1480",1945-11-04,1945,"Racing Club de France","RC Lens","2-0",2,0,"1",1,2,2,"H"
"1481",1945-11-04,1945,"AS Saint-Etienne","Le Havre AC","5-1",5,1,"1",1,6,4,"H"
"1482",1945-11-11,1945,"Girondins Bordeaux","Racing Club de France","3-1",3,1,"1",1,4,2,"H"
"1483",1945-11-11,1945,"AS Cannes","FC Rouen","3-1",3,1,"1",1,4,2,"H"
"1484",1945-11-11,1945,"Le Havre AC","FC Sochaux","1-0",1,0,"1",1,1,1,"H"
"1485",1945-11-11,1945,"RC Lens","AS Saint-Etienne","6-1",6,1,"1",1,7,5,"H"
"1486",1945-11-11,1945,"Lille OSC","Olympique Marseille","4-4",4,4,"1",1,8,0,"D"
"1487",1945-11-11,1945,"Olympique Lyon","Stade Rennes","3-5",3,5,"1",1,8,-2,"D"
"1488",1945-11-11,1945,"FC Metz","RC Roubaix","4-2",4,2,"1",1,6,2,"H"
"1489",1945-11-11,1945,"Red Star Olympique","RC Strasbourg","4-2",4,2,"1",1,6,2,"H"
"1490",1945-11-11,1945,"Stade Reims","FC Sete","2-1",2,1,"1",1,3,1,"H"
"1491",1945-11-18,1945,"Olympique Marseille","FC Metz","2-1",2,1,"1",1,3,1,"H"
"1492",1945-11-18,1945,"Racing Club de France","Stade Rennes","3-0",3,0,"1",1,3,3,"H"
"1493",1945-11-18,1945,"Stade Reims","Olympique Lyon","6-0",6,0,"1",1,6,6,"H"
"1494",1945-11-18,1945,"RC Roubaix","Le Havre AC","1-1",1,1,"1",1,2,0,"D"
"1495",1945-11-18,1945,"FC Rouen","Lille OSC","2-1",2,1,"1",1,3,1,"H"
"1496",1945-11-18,1945,"FC Sete","Red Star Olympique","4-0",4,0,"1",1,4,4,"H"
"1497",1945-11-18,1945,"FC Sochaux","RC Lens","0-3",0,3,"1",1,3,-3,"D"
"1498",1945-11-18,1945,"AS Saint-Etienne","Girondins Bordeaux","3-1",3,1,"1",1,4,2,"H"
"1499",1945-11-18,1945,"RC Strasbourg","AS Cannes","3-2",3,2,"1",1,5,1,"H"
"1500",1945-12-02,1945,"Lille OSC","RC Strasbourg","4-1",4,1,"1",1,5,3,"H"
"1501",1945-12-02,1945,"FC Metz","FC Rouen","0-0",0,0,"1",1,0,0,"D"
"1502",1945-12-02,1945,"Le Havre AC","Olympique Marseille","4-3",4,3,"1",1,7,1,"H"
"1503",1945-12-02,1945,"RC Lens","RC Roubaix","2-1",2,1,"1",1,3,1,"H"
"1504",1945-12-02,1945,"Girondins Bordeaux","FC Sochaux","3-2",3,2,"1",1,5,1,"H"
"1505",1945-12-02,1945,"Stade Rennes","AS Saint-Etienne","2-3",2,3,"1",1,5,-1,"D"
"1506",1945-12-02,1945,"Red Star Olympique","Stade Reims","0-3",0,3,"1",1,3,-3,"D"
"1507",1945-12-02,1945,"AS Cannes","FC Sete","2-1",2,1,"1",1,3,1,"H"
"1508",1945-12-02,1945,"Olympique Lyon","Racing Club de France","1-0",1,0,"1",1,1,1,"H"
"1509",1945-12-09,1945,"Olympique Marseille","RC Lens","4-1",4,1,"1",1,5,3,"H"
"1510",1945-12-09,1945,"Red Star Olympique","Olympique Lyon","2-2",2,2,"1",1,4,0,"D"
"1511",1945-12-09,1945,"Stade Reims","AS Cannes","2-4",2,4,"1",1,6,-2,"D"
"1512",1945-12-09,1945,"RC Roubaix","Girondins Bordeaux","3-1",3,1,"1",1,4,2,"H"
"1513",1945-12-09,1945,"FC Rouen","Le Havre AC","6-0",6,0,"1",1,6,6,"H"
"1514",1945-12-09,1945,"FC Sete","Lille OSC","1-2",1,2,"1",1,3,-1,"D"
"1515",1945-12-09,1945,"FC Sochaux","Stade Rennes","0-2",0,2,"1",1,2,-2,"D"
"1516",1945-12-09,1945,"AS Saint-Etienne","Racing Club de France","3-2",3,2,"1",1,5,1,"H"
"1517",1945-12-09,1945,"RC Strasbourg","FC Metz","0-2",0,2,"1",1,2,-2,"D"
"1518",1945-12-23,1945,"Girondins Bordeaux","Olympique Marseille","1-1",1,1,"1",1,2,0,"D"
"1519",1945-12-23,1945,"AS Cannes","Red Star Olympique","3-1",3,1,"1",1,4,2,"H"
"1520",1945-12-23,1945,"Le Havre AC","RC Strasbourg","3-0",3,0,"1",1,3,3,"H"
"1521",1945-12-23,1945,"RC Lens","FC Rouen","1-0",1,0,"1",1,1,1,"H"
"1522",1945-12-23,1945,"Lille OSC","Stade Reims","3-0",3,0,"1",1,3,3,"H"
"1523",1945-12-23,1945,"FC Metz","FC Sete","2-1",2,1,"1",1,3,1,"H"
"1524",1945-12-23,1945,"Racing Club de France","FC Sochaux","3-0",3,0,"1",1,3,3,"H"
"1525",1945-12-23,1945,"Stade Rennes","RC Roubaix","1-1",1,1,"1",1,2,0,"D"
"1526",1945-12-23,1945,"AS Saint-Etienne","Olympique Lyon","4-0",4,0,"1",1,4,4,"H"
"1527",1945-12-30,1945,"Olympique Lyon","AS Cannes","2-2",2,2,"1",1,4,0,"D"
"1528",1945-12-30,1945,"Olympique Marseille","Stade Rennes","2-2",2,2,"1",1,4,0,"D"
"1529",1945-12-30,1945,"Red Star Olympique","Lille OSC","2-2",2,2,"1",1,4,0,"D"
"1530",1945-12-30,1945,"Stade Reims","FC Metz","1-1",1,1,"1",1,2,0,"D"
"1531",1945-12-30,1945,"RC Roubaix","Racing Club de France","1-0",1,0,"1",1,1,1,"H"
"1532",1945-12-30,1945,"FC Rouen","Girondins Bordeaux","1-1",1,1,"1",1,2,0,"D"
"1533",1945-12-30,1945,"FC Sete","Le Havre AC","3-0",3,0,"1",1,3,3,"H"
"1534",1945-12-30,1945,"FC Sochaux","AS Saint-Etienne","4-4",4,4,"1",1,8,0,"D"
"1535",1945-12-30,1945,"RC Strasbourg","RC Lens","3-3",3,3,"1",1,6,0,"D"
"1536",1946-01-13,1945,"FC Sete","RC Lens","0-0",0,0,"1",1,0,0,"D"
"1537",1946-01-13,1945,"RC Roubaix","AS Saint-Etienne","3-2",3,2,"1",1,5,1,"H"
"1538",1946-01-13,1945,"AS Cannes","Lille OSC","2-1",2,1,"1",1,3,1,"H"
"1539",1946-01-13,1945,"FC Rouen","Stade Rennes","1-1",1,1,"1",1,2,0,"D"
"1540",1946-01-13,1945,"Olympique Marseille","Racing Club de France","0-0",0,0,"1",1,0,0,"D"
"1541",1946-01-13,1945,"FC Metz","Red Star Olympique Audonien","2-4",2,4,"1",1,6,-2,"D"
"1542",1946-01-13,1945,"Stade Reims","Le Havre AC","4-0",4,0,"1",1,4,4,"H"
"1543",1946-01-13,1945,"Olympique Lyon","FC Sochaux","3-4",3,4,"1",1,7,-1,"D"
"1544",1946-01-13,1945,"RC Strasbourg","Girondins Bordeaux","1-1",1,1,"1",1,2,0,"D"
"1545",1946-01-20,1945,"FC Sochaux","RC Roubaix","0-1",0,1,"1",1,1,-1,"D"
"1546",1946-01-20,1945,"Racing Club de France","FC Rouen","0-1",0,1,"1",1,1,-1,"D"
"1547",1946-01-20,1945,"Stade Rennes","RC Strasbourg","0-1",0,1,"1",1,1,-1,"D"
"1548",1946-01-20,1945,"FC Sete","Girondins Bordeaux","2-4",2,4,"1",1,6,-2,"D"
"1549",1946-01-20,1945,"RC Lens","Stade Reims","2-2",2,2,"1",1,4,0,"D"
"1550",1946-01-20,1945,"Le Havre AC","Red Star Olympique Audonien","0-1",0,1,"1",1,1,-1,"D"
"1551",1946-01-20,1945,"Olympique Marseille","AS Saint-Etienne","1-4",1,4,"1",1,5,-3,"D"
"1552",1946-01-20,1945,"FC Metz","AS Cannes","1-0",1,0,"1",1,1,1,"H"
"1553",1946-01-20,1945,"Lille OSC","Olympique Lyon","4-0",4,0,"1",1,4,4,"H"
"1554",1946-01-27,1945,"Olympique Marseille","FC Sochaux","3-1",3,1,"1",1,4,2,"H"
"1555",1946-01-27,1945,"Olympique Lyon","RC Roubaix","0-5",0,5,"1",1,5,-5,"D"
"1556",1946-01-27,1945,"Lille OSC","FC Metz","7-0",7,0,"1",1,7,7,"H"
"1557",1946-01-27,1945,"AS Cannes","Le Havre AC","3-2",3,2,"1",1,5,1,"H"
"1558",1946-01-27,1945,"Red Star Olympique Audonien","RC Lens","1-1",1,1,"1",1,2,0,"D"
"1559",1946-01-27,1945,"Stade Reims","Girondins Bordeaux","2-2",2,2,"1",1,4,0,"D"
"1560",1946-01-27,1945,"FC Sete","Stade Rennes","2-0",2,0,"1",1,2,2,"H"
"1561",1946-01-27,1945,"RC Strasbourg","Racing Club de France","4-1",4,1,"1",1,5,3,"H"
"1562",1946-01-27,1945,"FC Rouen","AS Saint-Etienne","2-1",2,1,"1",1,3,1,"H"
"1563",1946-02-10,1945,"Le Havre AC","Lille OSC","1-2",1,2,"1",1,3,-1,"D"
"1564",1946-02-10,1945,"RC Roubaix","Olympique Marseille","1-1",1,1,"1",1,2,0,"D"
"1565",1946-02-10,1945,"FC Sochaux","FC Rouen","2-0",2,0,"1",1,2,2,"H"
"1566",1946-02-10,1945,"AS Saint-Etienne","RC Strasbourg","0-0",0,0,"1",1,0,0,"D"
"1567",1946-02-10,1945,"Racing Club de France","FC Sete","4-1",4,1,"1",1,5,3,"H"
"1568",1946-02-10,1945,"Stade Rennes","Stade Reims","1-1",1,1,"1",1,2,0,"D"
"1569",1946-02-10,1945,"Girondins Bordeaux","Red Star Olympique Audonien","2-1",2,1,"1",1,3,1,"H"
"1570",1946-02-10,1945,"RC Lens","AS Cannes","2-1",2,1,"1",1,3,1,"H"
"1571",1946-02-10,1945,"FC Metz","Olympique Lyon","1-4",1,4,"1",1,5,-3,"D"
"1572",1946-02-17,1945,"RC Strasbourg","FC Sochaux","2-1",2,1,"1",1,3,1,"H"
"1573",1946-02-17,1945,"FC Rouen","RC Roubaix","2-1",2,1,"1",1,3,1,"H"
"1574",1946-02-17,1945,"Olympique Lyon","Olympique Marseille","1-1",1,1,"1",1,2,0,"D"
"1575",1946-02-17,1945,"FC Metz","Le Havre AC","2-2",2,2,"1",1,4,0,"D"
"1576",1946-02-17,1945,"Lille OSC","RC Lens","3-1",3,1,"1",1,4,2,"H"
"1577",1946-02-17,1945,"AS Cannes","Girondins Bordeaux","0-0",0,0,"1",1,0,0,"D"
"1578",1946-02-17,1945,"Red Star Olympique Audonien","Stade Rennes","0-4",0,4,"1",1,4,-4,"D"
"1579",1946-02-17,1945,"Stade Reims","Racing Club de France","1-0",1,0,"1",1,1,1,"H"
"1580",1946-02-17,1945,"FC Sete","AS Saint-Etienne","1-1",1,1,"1",1,2,0,"D"
"1581",1946-02-24,1945,"Girondins Bordeaux","Lille OSC","1-5",1,5,"1",1,6,-4,"D"
"1582",1946-02-24,1945,"RC Lens","FC Metz","5-3",5,3,"1",1,8,2,"H"
"1583",1946-02-24,1945,"Olympique Marseille","FC Rouen","2-3",2,3,"1",1,5,-1,"D"
"1584",1946-02-24,1945,"RC Roubaix","RC Strasbourg","1-1",1,1,"1",1,2,0,"D"
"1585",1946-02-24,1945,"FC Sochaux","FC Sete","1-3",1,3,"1",1,4,-2,"D"
"1586",1946-02-24,1945,"AS Saint-Etienne","Stade Reims","2-3",2,3,"1",1,5,-1,"D"
"1587",1946-02-24,1945,"Racing Club de France","Red Star Olympique Audonien","1-0",1,0,"1",1,1,1,"H"
"1588",1946-02-24,1945,"Stade Rennes","AS Cannes","0-2",0,2,"1",1,2,-2,"D"
"1589",1946-02-24,1945,"Le Havre AC","Olympique Lyon","0-0",0,0,"1",1,0,0,"D"
"1590",1946-03-10,1945,"Stade Reims","FC Sochaux","1-0",1,0,"1",1,1,1,"H"
"1591",1946-03-10,1945,"FC Sete","RC Roubaix","0-0",0,0,"1",1,0,0,"D"
"1592",1946-03-10,1945,"RC Strasbourg","Olympique Marseille","3-0",3,0,"1",1,3,3,"H"
"1593",1946-03-10,1945,"Olympique Lyon","FC Rouen","2-1",2,1,"1",1,3,1,"H"
"1594",1946-03-10,1945,"Le Havre AC","RC Lens","1-0",1,0,"1",1,1,1,"H"
"1595",1946-03-10,1945,"FC Metz","Girondins Bordeaux","2-0",2,0,"1",1,2,2,"H"
"1596",1946-03-10,1945,"Lille OSC","Stade Rennes","2-5",2,5,"1",1,7,-3,"D"
"1597",1946-03-10,1945,"AS Cannes","Racing Club de France","1-1",1,1,"1",1,2,0,"D"
"1598",1946-03-10,1945,"Red Star Olympique Audonien","AS Saint-Etienne","3-2",3,2,"1",1,5,1,"H"
"1599",1946-03-10,1946,"FC Sete","FC Metz","2-2",2,2,"1",1,4,0,"D"
"1600",1946-03-10,1946,"Lille OSC","FC Rouen","0-0",0,0,"1",1,0,0,"D"
"1601",1946-03-10,1946,"RC Strasbourg","Red Star Olympique Audonien","4-1",4,1,"1",1,5,3,"H"
"1602",1946-03-10,1946,"Toulouse FC","Stade Reims","0-2",0,2,"1",1,2,-2,"D"
"1603",1946-03-10,1946,"RC Lens","Le Havre AC","8-0",8,0,"1",1,8,8,"H"
"1604",1946-03-10,1946,"Stade Francais","Racing Club de France","2-2",2,2,"1",1,4,0,"D"
"1605",1946-03-10,1946,"Stade Rennes","Stade Olympique Montpellierain","2-1",2,1,"1",1,3,1,"H"
"1606",1946-03-10,1946,"AS Cannes","AS Nancy","2-1",2,1,"1",1,3,1,"H"
"1607",1946-03-10,1946,"Girondins Bordeaux","AS Saint-Etienne","3-1",3,1,"1",1,4,2,"H"
"1608",1946-03-10,1946,"Olympique Marseille","RC Roubaix","1-1",1,1,"1",1,2,0,"D"
"1609",1946-03-24,1945,"Racing Club de France","Lille OSC","2-1",2,1,"1",1,3,1,"H"
"1610",1946-03-24,1945,"Stade Rennes","FC Metz","1-0",1,0,"1",1,1,1,"H"
"1611",1946-03-24,1945,"Girondins Bordeaux","Le Havre AC","1-2",1,2,"1",1,3,-1,"D"
"1612",1946-03-24,1945,"FC Rouen","RC Strasbourg","5-0",5,0,"1",1,5,5,"H"
"1613",1946-03-24,1945,"Olympique Marseille","FC Sete","1-2",1,2,"1",1,3,-1,"D"
"1614",1946-03-24,1945,"RC Roubaix","Stade Reims","0-1",0,1,"1",1,1,-1,"D"
"1615",1946-03-24,1945,"FC Sochaux","Red Star Olympique Audonien","0-2",0,2,"1",1,2,-2,"D"
"1616",1946-03-24,1945,"AS Saint-Etienne","AS Cannes","2-1",2,1,"1",1,3,1,"H"
"1617",1946-03-24,1945,"RC Lens","Olympique Lyon","9-2",9,2,"1",1,11,7,"H"
"1618",1946-04-07,1945,"AS Cannes","FC Sochaux","4-1",4,1,"1",1,5,3,"H"
"1619",1946-04-07,1945,"Red Star Olympique Audonien","RC Roubaix","3-0",3,0,"1",1,3,3,"H"
"1620",1946-04-07,1945,"Stade Reims","Olympique Marseille","4-1",4,1,"1",1,5,3,"H"
"1621",1946-04-07,1945,"FC Sete","FC Rouen","4-1",4,1,"1",1,5,3,"H"
"1622",1946-04-07,1945,"Olympique Lyon","RC Strasbourg","3-2",3,2,"1",1,5,1,"H"
"1623",1946-04-07,1945,"RC Lens","Girondins Bordeaux","1-1",1,1,"1",1,2,0,"D"
"1624",1946-04-07,1945,"Le Havre AC","Stade Rennes","0-0",0,0,"1",1,0,0,"D"
"1625",1946-04-07,1945,"FC Metz","Racing Club de France","2-1",2,1,"1",1,3,1,"H"
"1626",1946-04-07,1945,"Lille OSC","AS Saint-Etienne","8-0",8,0,"1",1,8,8,"H"
"1627",1946-04-14,1945,"FC Sochaux","Lille OSC","0-0",0,0,"1",1,0,0,"D"
"1628",1946-04-14,1945,"AS Saint-Etienne","FC Metz","3-1",3,1,"1",1,4,2,"H"
"1629",1946-04-14,1945,"Racing Club de France","Le Havre AC","4-1",4,1,"1",1,5,3,"H"
"1630",1946-04-14,1945,"Stade Rennes","RC Lens","3-0",3,0,"1",1,3,3,"H"
"1631",1946-04-14,1945,"RC Strasbourg","FC Sete","1-1",1,1,"1",1,2,0,"D"
"1632",1946-04-14,1945,"FC Rouen","Stade Reims","1-0",1,0,"1",1,1,1,"H"
"1633",1946-04-14,1945,"Olympique Marseille","Red Star Olympique Audonien","2-1",2,1,"1",1,3,1,"H"
"1634",1946-04-14,1945,"RC Roubaix","AS Cannes","2-0",2,0,"1",1,2,2,"H"
"1635",1946-04-14,1945,"Girondins Bordeaux","Olympique Lyon","0-1",0,1,"1",1,1,-1,"D"
"1636",1946-04-21,1945,"FC Metz","FC Sochaux","2-0",2,0,"1",1,2,2,"H"
"1637",1946-04-21,1945,"Lille OSC","RC Roubaix","0-2",0,2,"1",1,2,-2,"D"
"1638",1946-04-21,1945,"AS Cannes","Olympique Marseille","0-2",0,2,"1",1,2,-2,"D"
"1639",1946-04-21,1945,"Red Star Olympique Audonien","FC Rouen","3-1",3,1,"1",1,4,2,"H"
"1640",1946-04-21,1945,"Stade Reims","RC Strasbourg","0-1",0,1,"1",1,1,-1,"D"
"1641",1946-04-21,1945,"Olympique Lyon","FC Sete","2-0",2,0,"1",1,2,2,"H"
"1642",1946-04-21,1945,"Girondins Bordeaux","Stade Rennes","4-1",4,1,"1",1,5,3,"H"
"1643",1946-04-21,1945,"RC Lens","Racing Club de France","2-3",2,3,"1",1,5,-1,"D"
"1644",1946-04-21,1945,"Le Havre AC","AS Saint-Etienne","0-2",0,2,"1",1,2,-2,"D"
"1645",1946-04-28,1945,"Racing Club de France","Girondins Bordeaux","2-2",2,2,"1",1,4,0,"D"
"1646",1946-04-28,1945,"FC Rouen","AS Cannes","1-1",1,1,"1",1,2,0,"D"
"1647",1946-04-28,1945,"FC Sochaux","Le Havre AC","2-4",2,4,"1",1,6,-2,"D"
"1648",1946-04-28,1945,"AS Saint-Etienne","RC Lens","2-1",2,1,"1",1,3,1,"H"
"1649",1946-04-28,1945,"Olympique Marseille","Lille OSC","2-2",2,2,"1",1,4,0,"D"
"1650",1946-04-28,1945,"Stade Rennes","Olympique Lyon","3-1",3,1,"1",1,4,2,"H"
"1651",1946-04-28,1945,"RC Roubaix","FC Metz","4-0",4,0,"1",1,4,4,"H"
"1652",1946-04-28,1945,"RC Strasbourg","Red Star Olympique Audonien","1-1",1,1,"1",1,2,0,"D"
"1653",1946-04-28,1945,"FC Sete","Stade Reims","1-1",1,1,"1",1,2,0,"D"
"1654",1946-05-05,1945,"FC Metz","Olympique Marseille","3-1",3,1,"1",1,4,2,"H"
"1655",1946-05-05,1945,"Stade Rennes","Racing Club de France","1-0",1,0,"1",1,1,1,"H"
"1656",1946-05-05,1945,"Olympique Lyon","Stade Reims","1-2",1,2,"1",1,3,-1,"D"
"1657",1946-05-05,1945,"Le Havre AC","RC Roubaix","4-1",4,1,"1",1,5,3,"H"
"1658",1946-05-05,1945,"Lille OSC","FC Rouen","2-2",2,2,"1",1,4,0,"D"
"1659",1946-05-05,1945,"Red Star Olympique Audonien","FC Sete","6-0",6,0,"1",1,6,6,"H"
"1660",1946-05-05,1945,"RC Lens","FC Sochaux","3-0",3,0,"1",1,3,3,"H"
"1661",1946-05-05,1945,"Girondins Bordeaux","AS Saint-Etienne","1-3",1,3,"1",1,4,-2,"D"
"1662",1946-05-05,1945,"AS Cannes","RC Strasbourg","3-1",3,1,"1",1,4,2,"H"
"1663",1946-05-12,1945,"RC Strasbourg","Lille OSC","0-1",0,1,"1",1,1,-1,"D"
"1664",1946-05-12,1945,"FC Rouen","FC Metz","4-1",4,1,"1",1,5,3,"H"
"1665",1946-05-12,1945,"Olympique Marseille","Le Havre AC","3-0",3,0,"1",1,3,3,"H"
"1666",1946-05-12,1945,"RC Roubaix","RC Lens","3-0",3,0,"1",1,3,3,"H"
"1667",1946-05-12,1945,"FC Sochaux","Girondins Bordeaux","0-3",0,3,"1",1,3,-3,"D"
"1668",1946-05-12,1945,"AS Saint-Etienne","Stade Rennes","4-2",4,2,"1",1,6,2,"H"
"1669",1946-05-12,1945,"Stade Reims","Red Star Olympique Audonien","4-0",4,0,"1",1,4,4,"H"
"1670",1946-05-12,1945,"FC Sete","AS Cannes","1-0",1,0,"1",1,1,1,"H"
"1671",1946-05-12,1945,"Racing Club de France","Olympique Lyon","1-3",1,3,"1",1,4,-2,"D"
"1672",1946-05-19,1945,"RC Lens","Olympique Marseille","3-1",3,1,"1",1,4,2,"H"
"1673",1946-05-19,1945,"Olympique Lyon","Red Star Olympique Audonien","2-2",2,2,"1",1,4,0,"D"
"1674",1946-05-19,1945,"AS Cannes","Stade Reims","1-1",1,1,"1",1,2,0,"D"
"1675",1946-05-19,1945,"Girondins Bordeaux","RC Roubaix","0-2",0,2,"1",1,2,-2,"D"
"1676",1946-05-19,1945,"Le Havre AC","FC Rouen","1-0",1,0,"1",1,1,1,"H"
"1677",1946-05-19,1945,"Lille OSC","FC Sete","5-2",5,2,"1",1,7,3,"H"
"1678",1946-05-19,1945,"Stade Rennes","FC Sochaux","5-1",5,1,"1",1,6,4,"H"
"1679",1946-05-19,1945,"Racing Club de France","AS Saint-Etienne","4-1",4,1,"1",1,5,3,"H"
"1680",1946-05-19,1945,"FC Metz","RC Strasbourg","1-3",1,3,"1",1,4,-2,"D"
"1681",1946-05-26,1945,"Olympique Marseille","Girondins Bordeaux","3-0",3,0,"1",1,3,3,"H"
"1682",1946-05-26,1945,"Red Star Olympique Audonien","AS Cannes","1-1",1,1,"1",1,2,0,"D"
"1683",1946-05-26,1945,"RC Strasbourg","Le Havre AC","0-2",0,2,"1",1,2,-2,"D"
"1684",1946-05-26,1945,"FC Rouen","RC Lens","2-1",2,1,"1",1,3,1,"H"
"1685",1946-05-26,1945,"Stade Reims","Lille OSC","1-1",1,1,"1",1,2,0,"D"
"1686",1946-05-26,1945,"FC Sete","FC Metz","3-1",3,1,"1",1,4,2,"H"
"1687",1946-05-26,1945,"FC Sochaux","Racing Club de France","2-4",2,4,"1",1,6,-2,"D"
"1688",1946-05-26,1945,"RC Roubaix","Stade Rennes","1-1",1,1,"1",1,2,0,"D"
"1689",1946-05-26,1945,"Olympique Lyon","AS Saint-Etienne","3-3",3,3,"1",1,6,0,"D"
"1690",1946-06-02,1945,"AS Cannes","Olympique Lyon","1-1",1,1,"1",1,2,0,"D"
"1691",1946-06-02,1945,"Stade Rennes","Olympique Marseille","0-0",0,0,"1",1,0,0,"D"
"1692",1946-06-02,1945,"Lille OSC","Red Star Olympique Audonien","3-1",3,1,"1",1,4,2,"H"
"1693",1946-06-02,1945,"FC Metz","Stade Reims","2-2",2,2,"1",1,4,0,"D"
"1694",1946-06-02,1945,"Racing Club de France","RC Roubaix","0-2",0,2,"1",1,2,-2,"D"
"1695",1946-06-02,1945,"Girondins Bordeaux","FC Rouen","4-1",4,1,"1",1,5,3,"H"
"1696",1946-06-02,1945,"Le Havre AC","FC Sete","4-1",4,1,"1",1,5,3,"H"
"1697",1946-06-02,1945,"AS Saint-Etienne","FC Sochaux","1-0",1,0,"1",1,1,1,"H"
"1698",1946-06-02,1945,"RC Lens","RC Strasbourg","0-4",0,4,"1",1,4,-4,"D"
"1699",1946-08-18,1946,"FC Metz","Red Star Olympique Audonien","8-0",8,0,"1",1,8,8,"H"
"1700",1946-08-18,1946,"Toulouse FC","Le Havre AC","5-0",5,0,"1",1,5,5,"H"
"1701",1946-08-18,1946,"RC Lens","Lille OSC","3-3",3,3,"1",1,6,0,"D"
"1702",1946-08-18,1946,"FC Rouen","FC Sete","6-1",6,1,"1",1,7,5,"H"
"1703",1946-08-18,1946,"Stade Francais","Olympique Marseille","4-1",4,1,"1",1,5,3,"H"
"1704",1946-08-18,1946,"RC Roubaix","AS Cannes-Grasse","1-0",1,0,"1",1,1,1,"H"
"1705",1946-08-18,1946,"AS Nancy","Stade Rennes","7-0",7,0,"1",1,7,7,"H"
"1706",1946-08-18,1946,"Stade Olympique Montpellierain","AS Saint-Etienne","3-1",3,1,"1",1,4,2,"H"
"1707",1946-08-18,1946,"Girondins Bordeaux","Racing Club de France","0-6",0,6,"1",1,6,-6,"D"
"1708",1946-08-18,1946,"RC Strasbourg","Stade Reims","3-0",3,0,"1",1,3,3,"H"
"1709",1946-08-25,1946,"FC Metz","FC Rouen","0-0",0,0,"1",1,0,0,"D"
"1710",1946-08-25,1946,"FC Sete","RC Lens","2-1",2,1,"1",1,3,1,"H"
"1711",1946-08-25,1946,"Lille OSC","Toulouse FC","1-1",1,1,"1",1,2,0,"D"
"1712",1946-08-25,1946,"Le Havre AC","RC Strasbourg","1-2",1,2,"1",1,3,-1,"D"
"1713",1946-08-25,1946,"Stade Reims","Red Star Olympique Audonien","1-0",1,0,"1",1,1,1,"H"
"1714",1946-08-25,1946,"Racing Club de France","Stade Olympique Montpellierain","2-3",2,3,"1",1,5,-1,"D"
"1715",1946-08-25,1946,"AS Saint-Etienne","AS Nancy","2-2",2,2,"1",1,4,0,"D"
"1716",1946-08-25,1946,"Stade Rennes","RC Roubaix","2-3",2,3,"1",1,5,-1,"D"
"1717",1946-08-25,1946,"AS Cannes-Grasse","Olympique Marseille","2-1",2,1,"1",1,3,1,"H"
"1718",1946-08-25,1946,"Girondins Bordeaux","Stade Francais","1-4",1,4,"1",1,5,-3,"D"
"1719",1946-09-01,1946,"Lille OSC","Stade Reims","5-0",5,0,"1",1,5,5,"H"
"1720",1946-09-01,1946,"RC Strasbourg","FC Sete","2-1",2,1,"1",1,3,1,"H"
"1721",1946-09-01,1946,"Toulouse FC","FC Metz","3-3",3,3,"1",1,6,0,"D"
"1722",1946-09-01,1946,"FC Rouen","RC Lens","3-1",3,1,"1",1,4,2,"H"
"1723",1946-09-01,1946,"Red Star Olympique Audonien","Le Havre AC","1-0",1,0,"1",1,1,1,"H"
"1724",1946-09-01,1946,"Racing Club de France","RC Roubaix","2-1",2,1,"1",1,3,1,"H"
"1725",1946-09-01,1946,"AS Saint-Etienne","AS Cannes-Grasse","4-3",4,3,"1",1,7,1,"H"
"1726",1946-09-01,1946,"Stade Rennes","Olympique Marseille","2-0",2,0,"1",1,2,2,"H"
"1727",1946-09-01,1946,"AS Nancy","Stade Francais","0-0",0,0,"1",1,0,0,"D"
"1728",1946-09-01,1946,"Stade Olympique Montpellierain","Girondins Bordeaux","0-0",0,0,"1",1,0,0,"D"
"1729",1946-09-08,1946,"FC Metz","Girondins Bordeaux","1-1",1,1,"1",1,2,0,"D"
"1730",1946-09-08,1946,"FC Sete","Stade Olympique Montpellierain","1-0",1,0,"1",1,1,1,"H"
"1731",1946-09-08,1946,"Lille OSC","AS Nancy","4-1",4,1,"1",1,5,3,"H"
"1732",1946-09-08,1946,"Le Havre AC","RC Roubaix","0-3",0,3,"1",1,3,-3,"D"
"1733",1946-09-08,1946,"Stade Reims","AS Cannes-Grasse","5-1",5,1,"1",1,6,4,"H"
"1734",1946-09-08,1946,"RC Strasbourg","Stade Rennes","3-2",3,2,"1",1,5,1,"H"
"1735",1946-09-08,1946,"Toulouse FC","AS Saint-Etienne","4-3",4,3,"1",1,7,1,"H"
"1736",1946-09-08,1946,"RC Lens","Racing Club de France","5-2",5,2,"1",1,7,3,"H"
"1737",1946-09-08,1946,"Red Star Olympique Audonien","Olympique Marseille","2-2",2,2,"1",1,4,0,"D"
"1738",1946-09-08,1946,"Stade Francais","FC Rouen","0-1",0,1,"1",1,1,-1,"D"
"1739",1946-09-12,1946,"Stade Francais","RC Lens","3-1",3,1,"1",1,4,2,"H"
"1740",1946-09-12,1946,"Racing Club de France","FC Sete","0-2",0,2,"1",1,2,-2,"D"
"1741",1946-09-12,1946,"AS Saint-Etienne","FC Metz","6-2",6,2,"1",1,8,4,"H"
"1742",1946-09-12,1946,"Stade Rennes","Stade Reims","2-3",2,3,"1",1,5,-1,"D"
"1743",1946-09-12,1946,"AS Cannes-Grasse","Le Havre AC","2-1",2,1,"1",1,3,1,"H"
"1744",1946-09-12,1946,"RC Roubaix","Lille OSC","1-0",1,0,"1",1,1,1,"H"
"1745",1946-09-12,1946,"AS Nancy","Toulouse FC","3-1",3,1,"1",1,4,2,"H"
"1746",1946-09-12,1946,"Stade Olympique Montpellierain","RC Strasbourg","0-1",0,1,"1",1,1,-1,"D"
"1747",1946-09-12,1946,"Girondins Bordeaux","Red Star Olympique Audonien","3-2",3,2,"1",1,5,1,"H"
"1748",1946-09-12,1946,"Olympique Marseille","FC Rouen","4-0",4,0,"1",1,4,4,"H"
"1749",1946-09-15,1946,"Stade Francais","Lille OSC","0-2",0,2,"1",1,2,-2,"D"
"1750",1946-09-15,1946,"Racing Club de France","Toulouse FC","8-2",8,2,"1",1,10,6,"H"
"1751",1946-09-15,1946,"AS Saint-Etienne","RC Strasbourg","1-1",1,1,"1",1,2,0,"D"
"1752",1946-09-15,1946,"Stade Rennes","Red Star Olympique Audonien","2-2",2,2,"1",1,4,0,"D"
"1753",1946-09-15,1946,"AS Cannes-Grasse","FC Rouen","3-1",3,1,"1",1,4,2,"H"
"1754",1946-09-15,1946,"RC Roubaix","RC Lens","5-2",5,2,"1",1,7,3,"H"
"1755",1946-09-15,1946,"AS Nancy","FC Sete","3-1",3,1,"1",1,4,2,"H"
"1756",1946-09-15,1946,"Stade Olympique Montpellierain","FC Metz","3-0",3,0,"1",1,3,3,"H"
"1757",1946-09-15,1946,"Girondins Bordeaux","Stade Reims","1-3",1,3,"1",1,4,-2,"D"
"1758",1946-09-15,1946,"Olympique Marseille","Le Havre AC","5-3",5,3,"1",1,8,2,"H"
"1759",1946-09-22,1946,"FC Metz","Stade Francais","1-1",1,1,"1",1,2,0,"D"
"1760",1946-09-22,1946,"FC Sete","Olympique Marseille","1-1",1,1,"1",1,2,0,"D"
"1761",1946-09-22,1946,"Lille OSC","Girondins Bordeaux","4-1",4,1,"1",1,5,3,"H"
"1762",1946-09-22,1946,"Le Havre AC","Stade Olympique Montpellierain","2-0",2,0,"1",1,2,2,"H"
"1763",1946-09-22,1946,"Stade Reims","AS Nancy","1-0",1,0,"1",1,1,1,"H"
"1764",1946-09-22,1946,"RC Strasbourg","RC Roubaix","1-1",1,1,"1",1,2,0,"D"
"1765",1946-09-22,1946,"RC Lens","Stade Rennes","5-1",5,1,"1",1,6,4,"H"
"1766",1946-09-22,1946,"FC Rouen","AS Saint-Etienne","3-0",3,0,"1",1,3,3,"H"
"1767",1946-09-22,1946,"Racing Club de France","Red Star Olympique Audonien","1-2",1,2,"1",1,3,-1,"D"
"1768",1946-09-22,1946,"AS Cannes-Grasse","Toulouse FC","3-2",3,2,"1",1,5,1,"H"
"1769",1946-09-26,1946,"FC Metz","AS Nancy","6-0",6,0,"1",1,6,6,"H"
"1770",1946-09-26,1946,"FC Sete","RC Roubaix","2-5",2,5,"1",1,7,-3,"D"
"1771",1946-09-26,1946,"Lille OSC","AS Cannes-Grasse","8-2",8,2,"1",1,10,6,"H"
"1772",1946-09-26,1946,"Le Havre AC","Stade Rennes","2-2",2,2,"1",1,4,0,"D"
"1773",1946-09-26,1946,"Stade Reims","AS Saint-Etienne","5-0",5,0,"1",1,5,5,"H"
"1774",1946-09-26,1946,"RC Strasbourg","Racing Club de France","8-1",8,1,"1",1,9,7,"H"
"1775",1946-09-26,1946,"Toulouse FC","Stade Francais","1-2",1,2,"1",1,3,-1,"D"
"1776",1946-09-26,1946,"RC Lens","Olympique Marseille","0-0",0,0,"1",1,0,0,"D"
"1777",1946-09-26,1946,"FC Rouen","Girondins Bordeaux","2-2",2,2,"1",1,4,0,"D"
"1778",1946-09-26,1946,"Red Star Olympique Audonien","Stade Olympique Montpellierain","1-1",1,1,"1",1,2,0,"D"
"1779",1946-09-29,1946,"FC Metz","Racing Club de France","5-0",5,0,"1",1,5,5,"H"
"1780",1946-09-29,1946,"FC Sete","Stade Francais","3-1",3,1,"1",1,4,2,"H"
"1781",1946-09-29,1946,"Lille OSC","Olympique Marseille","5-1",5,1,"1",1,6,4,"H"
"1782",1946-09-29,1946,"Le Havre AC","Girondins Bordeaux","1-0",1,0,"1",1,1,1,"H"
"1783",1946-09-29,1946,"Stade Reims","Stade Olympique Montpellierain","4-0",4,0,"1",1,4,4,"H"
"1784",1946-09-29,1946,"RC Strasbourg","AS Nancy","0-1",0,1,"1",1,1,-1,"D"
"1785",1946-09-29,1946,"Toulouse FC","RC Roubaix","1-2",1,2,"1",1,3,-1,"D"
"1786",1946-09-29,1946,"RC Lens","AS Cannes-Grasse","2-1",2,1,"1",1,3,1,"H"
"1787",1946-09-29,1946,"FC Rouen","Stade Rennes","1-1",1,1,"1",1,2,0,"D"
"1788",1946-09-29,1946,"Red Star Olympique Audonien","AS Saint-Etienne","0-0",0,0,"1",1,0,0,"D"
"1789",1946-10-06,1946,"Stade Francais","RC Strasbourg","2-4",2,4,"1",1,6,-2,"D"
"1790",1946-10-06,1946,"Racing Club de France","Stade Reims","0-3",0,3,"1",1,3,-3,"D"
"1791",1946-10-06,1946,"AS Saint-Etienne","Le Havre AC","2-0",2,0,"1",1,2,2,"H"
"1792",1946-10-06,1946,"Stade Rennes","Lille OSC","0-0",0,0,"1",1,0,0,"D"
"1793",1946-10-06,1946,"AS Cannes-Grasse","FC Sete","5-2",5,2,"1",1,7,3,"H"
"1794",1946-10-06,1946,"RC Roubaix","FC Metz","2-1",2,1,"1",1,3,1,"H"
"1795",1946-10-06,1946,"AS Nancy","Red Star Olympique Audonien","0-1",0,1,"1",1,1,-1,"D"
"1796",1946-10-06,1946,"Stade Olympique Montpellierain","FC Rouen","3-0",3,0,"1",1,3,3,"H"
"1797",1946-10-06,1946,"Girondins Bordeaux","RC Lens","3-2",3,2,"1",1,5,1,"H"
"1798",1946-10-06,1946,"Olympique Marseille","Toulouse FC","3-0",3,0,"1",1,3,3,"H"
"1799",1946-10-13,1946,"FC Metz","Stade Rennes","6-0",6,0,"1",1,6,6,"H"
"1800",1946-10-13,1946,"FC Sete","AS Saint-Etienne","2-1",2,1,"1",1,3,1,"H"
"1801",1946-10-13,1946,"Lille OSC","Racing Club de France","3-1",3,1,"1",1,4,2,"H"
"1802",1946-10-13,1946,"Le Havre AC","Stade Francais","2-3",2,3,"1",1,5,-1,"D"
"1803",1946-10-13,1946,"Stade Reims","Olympique Marseille","1-0",1,0,"1",1,1,1,"H"
"1804",1946-10-13,1946,"RC Strasbourg","Girondins Bordeaux","1-1",1,1,"1",1,2,0,"D"
"1805",1946-10-13,1946,"Toulouse FC","Stade Olympique Montpellierain","2-1",2,1,"1",1,3,1,"H"
"1806",1946-10-13,1946,"RC Lens","AS Nancy","2-3",2,3,"1",1,5,-1,"D"
"1807",1946-10-13,1946,"FC Rouen","RC Roubaix","0-1",0,1,"1",1,1,-1,"D"
"1808",1946-10-13,1946,"Red Star Olympique Audonien","AS Cannes-Grasse","2-0",2,0,"1",1,2,2,"H"
"1809",1946-10-17,1946,"Red Star Olympique Audonien","Stade Francais","2-0",2,0,"1",1,2,2,"H"
"1810",1946-10-17,1946,"Racing Club de France","FC Rouen","0-0",0,0,"1",1,0,0,"D"
"1811",1946-10-17,1946,"AS Saint-Etienne","RC Lens","4-1",4,1,"1",1,5,3,"H"
"1812",1946-10-17,1946,"Stade Rennes","Toulouse FC","3-0",3,0,"1",1,3,3,"H"
"1813",1946-10-17,1946,"AS Cannes-Grasse","RC Strasbourg","2-2",2,2,"1",1,4,0,"D"
"1814",1946-10-17,1946,"RC Roubaix","Stade Reims","1-1",1,1,"1",1,2,0,"D"
"1815",1946-10-17,1946,"AS Nancy","Le Havre AC","7-0",7,0,"1",1,7,7,"H"
"1816",1946-10-17,1946,"Stade Olympique Montpellierain","Lille OSC","0-1",0,1,"1",1,1,-1,"D"
"1817",1946-10-17,1946,"Girondins Bordeaux","FC Sete","4-3",4,3,"1",1,7,1,"H"
"1818",1946-10-17,1946,"Olympique Marseille","FC Metz","3-3",3,3,"1",1,6,0,"D"
"1819",1946-10-20,1946,"Stade Francais","Stade Reims","2-2",2,2,"1",1,4,0,"D"
"1820",1946-10-20,1946,"Racing Club de France","Le Havre AC","3-1",3,1,"1",1,4,2,"H"
"1821",1946-10-20,1946,"AS Saint-Etienne","Lille OSC","2-1",2,1,"1",1,3,1,"H"
"1822",1946-10-20,1946,"Stade Rennes","FC Sete","5-2",5,2,"1",1,7,3,"H"
"1823",1946-10-20,1946,"AS Cannes-Grasse","FC Metz","1-0",1,0,"1",1,1,1,"H"
"1824",1946-10-20,1946,"RC Roubaix","Red Star Olympique Audonien","2-0",2,0,"1",1,2,2,"H"
"1825",1946-10-20,1946,"AS Nancy","FC Rouen","0-0",0,0,"1",1,0,0,"D"
"1826",1946-10-20,1946,"Stade Olympique Montpellierain","RC Lens","2-1",2,1,"1",1,3,1,"H"
"1827",1946-10-20,1946,"Girondins Bordeaux","Toulouse FC","1-1",1,1,"1",1,2,0,"D"
"1828",1946-10-20,1946,"Olympique Marseille","RC Strasbourg","2-1",2,1,"1",1,3,1,"H"
"1829",1946-10-27,1946,"Lille OSC","RC Strasbourg","2-2",2,2,"1",1,4,0,"D"
"1830",1946-10-27,1946,"Le Havre AC","Stade Reims","1-0",1,0,"1",1,1,1,"H"
"1831",1946-10-27,1946,"Toulouse FC","FC Sete","5-1",5,1,"1",1,6,4,"H"
"1832",1946-10-27,1946,"RC Lens","FC Metz","5-1",5,1,"1",1,6,4,"H"
"1833",1946-10-27,1946,"FC Rouen","Red Star Olympique Audonien","3-0",3,0,"1",1,3,3,"H"
"1834",1946-10-27,1946,"Racing Club de France","AS Nancy","4-3",4,3,"1",1,7,1,"H"
"1835",1946-10-27,1946,"AS Saint-Etienne","RC Roubaix","2-0",2,0,"1",1,2,2,"H"
"1836",1946-10-27,1946,"Stade Rennes","AS Cannes-Grasse","2-1",2,1,"1",1,3,1,"H"
"1837",1946-10-27,1946,"Stade Olympique Montpellierain","Stade Francais","1-3",1,3,"1",1,4,-2,"D"
"1838",1946-10-27,1946,"Olympique Marseille","Girondins Bordeaux","0-0",0,0,"1",1,0,0,"D"
"1839",1946-11-03,1946,"FC Metz","Le Havre AC","2-3",2,3,"1",1,5,-1,"D"
"1840",1946-11-03,1946,"FC Sete","Lille OSC","2-1",2,1,"1",1,3,1,"H"
"1841",1946-11-03,1946,"Stade Reims","FC Rouen","3-0",3,0,"1",1,3,3,"H"
"1842",1946-11-03,1946,"RC Strasbourg","RC Lens","2-0",2,0,"1",1,2,2,"H"
"1843",1946-11-03,1946,"Red Star Olympique Audonien","Toulouse FC","2-1",2,1,"1",1,3,1,"H"
"1844",1946-11-03,1946,"Stade Francais","Stade Rennes","5-3",5,3,"1",1,8,2,"H"
"1845",1946-11-03,1946,"AS Saint-Etienne","Racing Club de France","0-3",0,3,"1",1,3,-3,"D"
"1846",1946-11-03,1946,"RC Roubaix","Stade Olympique Montpellierain","2-1",2,1,"1",1,3,1,"H"
"1847",1946-11-03,1946,"AS Nancy","Olympique Marseille","1-1",1,1,"1",1,2,0,"D"
"1848",1946-11-03,1946,"Girondins Bordeaux","AS Cannes-Grasse","1-4",1,4,"1",1,5,-3,"D"
"1849",1946-11-17,1946,"Le Havre AC","FC Sete","5-1",5,1,"1",1,6,4,"H"
"1850",1946-11-17,1946,"Stade Reims","FC Metz","0-1",0,1,"1",1,1,-1,"D"
"1851",1946-11-17,1946,"RC Lens","Toulouse FC","3-1",3,1,"1",1,4,2,"H"
"1852",1946-11-17,1946,"FC Rouen","RC Strasbourg","1-3",1,3,"1",1,4,-2,"D"
"1853",1946-11-17,1946,"Red Star Olympique Audonien","Lille OSC","5-1",5,1,"1",1,6,4,"H"
"1854",1946-11-17,1946,"Racing Club de France","Stade Rennes","2-3",2,3,"1",1,5,-1,"D"
"1855",1946-11-17,1946,"AS Saint-Etienne","Olympique Marseille","3-1",3,1,"1",1,4,2,"H"
"1856",1946-11-17,1946,"AS Cannes-Grasse","Stade Francais","1-0",1,0,"1",1,1,1,"H"
"1857",1946-11-17,1946,"RC Roubaix","Girondins Bordeaux","4-1",4,1,"1",1,5,3,"H"
"1858",1946-11-17,1946,"Stade Olympique Montpellierain","AS Nancy","4-1",4,1,"1",1,5,3,"H"
"1859",1946-11-24,1946,"FC Metz","Lille OSC","4-1",4,1,"1",1,5,3,"H"
"1860",1946-11-24,1946,"Le Havre AC","FC Rouen","4-1",4,1,"1",1,5,3,"H"
"1861",1946-11-24,1946,"Toulouse FC","RC Strasbourg","3-1",3,1,"1",1,4,2,"H"
"1862",1946-11-24,1946,"Red Star Olympique Audonien","FC Sete","1-1",1,1,"1",1,2,0,"D"
"1863",1946-11-24,1946,"Stade Reims","RC Lens","3-1",3,1,"1",1,4,2,"H"
"1864",1946-11-24,1946,"Stade Olympique Montpellierain","AS Cannes-Grasse","0-1",0,1,"1",1,1,-1,"D"
"1865",1946-11-24,1946,"Girondins Bordeaux","Stade Rennes","0-1",0,1,"1",1,1,-1,"D"
"1866",1946-11-24,1946,"Olympique Marseille","Racing Club de France","5-3",5,3,"1",1,8,2,"H"
"1867",1946-11-24,1946,"Stade Francais","AS Saint-Etienne","3-0",3,0,"1",1,3,3,"H"
"1868",1946-11-24,1946,"RC Roubaix","AS Nancy","1-1",1,1,"1",1,2,0,"D"
"1869",1946-12-01,1946,"FC Sete","Stade Reims","2-1",2,1,"1",1,3,1,"H"
"1870",1946-12-01,1946,"Lille OSC","Le Havre AC","3-0",3,0,"1",1,3,3,"H"
"1871",1946-12-01,1946,"RC Strasbourg","FC Metz","2-2",2,2,"1",1,4,0,"D"
"1872",1946-12-01,1946,"RC Lens","Red Star Olympique Audonien","2-0",2,0,"1",1,2,2,"H"
"1873",1946-12-01,1946,"FC Rouen","Toulouse FC","1-5",1,5,"1",1,6,-4,"D"
"1874",1946-12-01,1946,"Stade Francais","RC Roubaix","4-3",4,3,"1",1,7,1,"H"
"1875",1946-12-01,1946,"Stade Rennes","AS Saint-Etienne","2-1",2,1,"1",1,3,1,"H"
"1876",1946-12-01,1946,"AS Cannes-Grasse","Racing Club de France","1-0",1,0,"1",1,1,1,"H"
"1877",1946-12-01,1946,"AS Nancy","Girondins Bordeaux","2-4",2,4,"1",1,6,-2,"D"
"1878",1946-12-01,1946,"Olympique Marseille","Stade Olympique Montpellierain","2-1",2,1,"1",1,3,1,"H"
"1879",1946-12-08,1946,"FC Metz","FC Sete","1-1",1,1,"1",1,2,0,"D"
"1880",1946-12-08,1946,"Red Star Olympique Audonien","RC Strasbourg","0-2",0,2,"1",1,2,-2,"D"
"1881",1946-12-08,1946,"Stade Reims","Toulouse FC","3-1",3,1,"1",1,4,2,"H"
"1882",1946-12-08,1946,"Le Havre AC","RC Lens","0-2",0,2,"1",1,2,-2,"D"
"1883",1946-12-08,1946,"Racing Club de France","Stade Francais","4-2",4,2,"1",1,6,2,"H"
"1884",1946-12-08,1946,"Stade Olympique Montpellierain","Stade Rennes","1-0",1,0,"1",1,1,1,"H"
"1885",1946-12-08,1946,"AS Nancy","AS Cannes-Grasse","0-0",0,0,"1",1,0,0,"D"
"1886",1946-12-08,1946,"AS Saint-Etienne","Girondins Bordeaux","4-2",4,2,"1",1,6,2,"H"
"1887",1946-12-08,1946,"RC Roubaix","Olympique Marseille","2-0",2,0,"1",1,2,2,"H"
"1888",1946-12-08,1946,"FC Rouen","Lille OSC","0-3",0,3,"1",1,3,-3,"D"
"1889",1946-12-22,1946,"Le Havre AC","FC Metz","1-2",1,2,"1",1,3,-1,"D"
"1890",1946-12-22,1946,"Lille OSC","FC Sete","2-3",2,3,"1",1,5,-1,"D"
"1891",1946-12-22,1946,"FC Rouen","Stade Reims","1-0",1,0,"1",1,1,1,"H"
"1892",1946-12-22,1946,"RC Lens","RC Strasbourg","2-1",2,1,"1",1,3,1,"H"
"1893",1946-12-22,1946,"Toulouse FC","Red Star Olympique Audonien","0-4",0,4,"1",1,4,-4,"D"
"1894",1946-12-22,1946,"Stade Rennes","Stade Francais","0-1",0,1,"1",1,1,-1,"D"
"1895",1946-12-22,1946,"Racing Club de France","AS Saint-Etienne","3-4",3,4,"1",1,7,-1,"D"
"1896",1946-12-22,1946,"Stade Olympique Montpellierain","RC Roubaix","2-2",2,2,"1",1,4,0,"D"
"1897",1946-12-22,1946,"Olympique Marseille","AS Nancy","3-1",3,1,"1",1,4,2,"H"
"1898",1946-12-22,1946,"AS Cannes-Grasse","Girondins Bordeaux","2-0",2,0,"1",1,2,2,"H"
"1899",1946-12-29,1946,"RC Strasbourg","Lille OSC","1-2",1,2,"1",1,3,-1,"D"
"1900",1946-12-29,1946,"Stade Reims","Le Havre AC","3-1",3,1,"1",1,4,2,"H"
"1901",1946-12-29,1946,"FC Sete","Toulouse FC","1-0",1,0,"1",1,1,1,"H"
"1902",1946-12-29,1946,"FC Metz","RC Lens","2-1",2,1,"1",1,3,1,"H"
"1903",1946-12-29,1946,"Red Star Olympique Audonien","FC Rouen","4-1",4,1,"1",1,5,3,"H"
"1904",1946-12-29,1946,"AS Nancy","Racing Club de France","0-2",0,2,"1",1,2,-2,"D"
"1905",1946-12-29,1946,"RC Roubaix","AS Saint-Etienne","7-3",7,3,"1",1,10,4,"H"
"1906",1946-12-29,1946,"AS Cannes-Grasse","Stade Rennes","0-2",0,2,"1",1,2,-2,"D"
"1907",1946-12-29,1946,"Stade Francais","Stade Olympique Montpellierain","6-2",6,2,"1",1,8,4,"H"
"1908",1946-12-29,1946,"Girondins Bordeaux","Olympique Marseille","2-2",2,2,"1",1,4,0,"D"
"1909",1947-01-12,1946,"Red Star Olympique Audonien","FC Metz","3-1",3,1,"1",1,4,2,"H"
"1910",1947-01-12,1946,"Stade Reims","RC Strasbourg","3-0",3,0,"1",1,3,3,"H"
"1911",1947-01-12,1946,"Le Havre AC","Toulouse FC","0-2",0,2,"1",1,2,-2,"D"
"1912",1947-01-12,1946,"Lille OSC","RC Lens","1-1",1,1,"1",1,2,0,"D"
"1913",1947-01-12,1946,"FC Sete","FC Rouen","1-3",1,3,"1",1,4,-2,"D"
"1914",1947-01-12,1946,"Olympique Marseille","Stade Francais","0-1",0,1,"1",1,1,-1,"D"
"1915",1947-01-12,1946,"AS Cannes-Grasse","RC Roubaix","3-1",3,1,"1",1,4,2,"H"
"1916",1947-01-12,1946,"Stade Rennes","AS Nancy","3-1",3,1,"1",1,4,2,"H"
"1917",1947-01-12,1946,"AS Saint-Etienne","Stade Olympique Montpellierain","3-0",3,0,"1",1,3,3,"H"
"1918",1947-01-12,1946,"Racing Club de France","Girondins Bordeaux","0-1",0,1,"1",1,1,-1,"D"
"1919",1947-01-19,1946,"FC Sete","Le Havre AC","1-1",1,1,"1",1,2,0,"D"
"1920",1947-01-19,1946,"FC Metz","Stade Reims","2-2",2,2,"1",1,4,0,"D"
"1921",1947-01-19,1946,"Toulouse FC","RC Lens","2-0",2,0,"1",1,2,2,"H"
"1922",1947-01-19,1946,"RC Strasbourg","FC Rouen","2-1",2,1,"1",1,3,1,"H"
"1923",1947-01-19,1946,"Lille OSC","Red Star Olympique Audonien","3-0",3,0,"1",1,3,3,"H"
"1924",1947-01-19,1946,"Stade Rennes","Racing Club de France","2-2",2,2,"1",1,4,0,"D"
"1925",1947-01-19,1946,"Olympique Marseille","AS Saint-Etienne","2-0",2,0,"1",1,2,2,"H"
"1926",1947-01-19,1946,"Stade Francais","AS Cannes-Grasse","2-0",2,0,"1",1,2,2,"H"
"1927",1947-01-19,1946,"Girondins Bordeaux","RC Roubaix","1-3",1,3,"1",1,4,-2,"D"
"1928",1947-01-19,1946,"AS Nancy","Stade Olympique Montpellierain","3-1",3,1,"1",1,4,2,"H"
"1929",1947-01-26,1946,"FC Rouen","FC Metz","0-1",0,1,"1",1,1,-1,"D"
"1930",1947-01-26,1946,"RC Lens","FC Sete","1-1",1,1,"1",1,2,0,"D"
"1931",1947-01-26,1946,"Toulouse FC","Lille OSC","3-4",3,4,"1",1,7,-1,"D"
"1932",1947-01-26,1946,"RC Strasbourg","Le Havre AC","2-0",2,0,"1",1,2,2,"H"
"1933",1947-01-26,1946,"Red Star Olympique Audonien","Stade Reims","1-0",1,0,"1",1,1,1,"H"
"1934",1947-01-26,1946,"Stade Olympique Montpellierain","Racing Club de France","0-1",0,1,"1",1,1,-1,"D"
"1935",1947-01-26,1946,"AS Nancy","AS Saint-Etienne","1-1",1,1,"1",1,2,0,"D"
"1936",1947-01-26,1946,"RC Roubaix","Stade Rennes","2-3",2,3,"1",1,5,-1,"D"
"1937",1947-01-26,1946,"Olympique Marseille","AS Cannes-Grasse","4-1",4,1,"1",1,5,3,"H"
"1938",1947-01-26,1946,"Stade Francais","Girondins Bordeaux","0-1",0,1,"1",1,1,-1,"D"
"1939",1947-02-09,1946,"Stade Reims","FC Sete","3-0",3,0,"1",1,3,3,"H"
"1940",1947-02-09,1946,"Le Havre AC","Lille OSC","1-4",1,4,"1",1,5,-3,"D"
"1941",1947-02-09,1946,"FC Metz","RC Strasbourg","0-2",0,2,"1",1,2,-2,"D"
"1942",1947-02-09,1946,"Red Star Olympique Audonien","RC Lens","6-2",6,2,"1",1,8,4,"H"
"1943",1947-02-09,1946,"Toulouse FC","FC Rouen","3-2",3,2,"1",1,5,1,"H"
"1944",1947-02-09,1946,"RC Roubaix","Stade Francais","1-3",1,3,"1",1,4,-2,"D"
"1945",1947-02-09,1946,"AS Saint-Etienne","Stade Rennes","1-5",1,5,"1",1,6,-4,"D"
"1946",1947-02-09,1946,"Racing Club de France","AS Cannes-Grasse","4-0",4,0,"1",1,4,4,"H"
"1947",1947-02-09,1946,"Girondins Bordeaux","AS Nancy","1-1",1,1,"1",1,2,0,"D"
"1948",1947-02-09,1946,"Stade Olympique Montpellierain","Olympique Marseille","3-1",3,1,"1",1,4,2,"H"
"1949",1947-02-16,1946,"Stade Reims","Lille OSC","1-0",1,0,"1",1,1,1,"H"
"1950",1947-02-16,1946,"FC Sete","RC Strasbourg","1-2",1,2,"1",1,3,-1,"D"
"1951",1947-02-16,1946,"FC Metz","Toulouse FC","1-4",1,4,"1",1,5,-3,"D"
"1952",1947-02-16,1946,"RC Lens","FC Rouen","1-1",1,1,"1",1,2,0,"D"
"1953",1947-02-16,1946,"Le Havre AC","Red Star Olympique Audonien","0-0",0,0,"1",1,0,0,"D"
"1954",1947-02-16,1946,"RC Roubaix","Racing Club de France","2-1",2,1,"1",1,3,1,"H"
"1955",1947-02-16,1946,"AS Cannes-Grasse","AS Saint-Etienne","7-0",7,0,"1",1,7,7,"H"
"1956",1947-02-16,1946,"Olympique Marseille","Stade Rennes","1-0",1,0,"1",1,1,1,"H"
"1957",1947-02-16,1946,"Stade Francais","AS Nancy","1-0",1,0,"1",1,1,1,"H"
"1958",1947-02-16,1946,"Girondins Bordeaux","Stade Olympique Montpellierain","4-0",4,0,"1",1,4,4,"H"
"1959",1947-02-23,1946,"Lille OSC","FC Metz","5-3",5,3,"1",1,8,2,"H"
"1960",1947-02-23,1946,"FC Rouen","Le Havre AC","2-2",2,2,"1",1,4,0,"D"
"1961",1947-02-23,1946,"RC Strasbourg","Toulouse FC","1-3",1,3,"1",1,4,-2,"D"
"1962",1947-02-23,1946,"FC Sete","Red Star Olympique Audonien","1-1",1,1,"1",1,2,0,"D"
"1963",1947-02-23,1946,"RC Lens","Stade Reims","1-1",1,1,"1",1,2,0,"D"
"1964",1947-02-23,1946,"AS Cannes-Grasse","Stade Olympique Montpellierain","2-2",2,2,"1",1,4,0,"D"
"1965",1947-02-23,1946,"Stade Rennes","Girondins Bordeaux","3-2",3,2,"1",1,5,1,"H"
"1966",1947-02-23,1946,"Racing Club de France","Olympique Marseille","1-2",1,2,"1",1,3,-1,"D"
"1967",1947-02-23,1946,"AS Saint-Etienne","Stade Francais","1-1",1,1,"1",1,2,0,"D"
"1968",1947-02-23,1946,"AS Nancy","RC Roubaix","2-0",2,0,"1",1,2,2,"H"
"1969",1947-03-09,1946,"Stade Francais","FC Metz","0-0",0,0,"1",1,0,0,"D"
"1970",1947-03-09,1946,"Olympique Marseille","FC Sete","3-1",3,1,"1",1,4,2,"H"
"1971",1947-03-09,1946,"Girondins Bordeaux","Lille OSC","1-0",1,0,"1",1,1,1,"H"
"1972",1947-03-09,1946,"Stade Olympique Montpellierain","Le Havre AC","2-0",2,0,"1",1,2,2,"H"
"1973",1947-03-09,1946,"AS Nancy","Stade Reims","1-3",1,3,"1",1,4,-2,"D"
"1974",1947-03-09,1946,"RC Roubaix","RC Strasbourg","2-0",2,0,"1",1,2,2,"H"
"1975",1947-03-09,1946,"Stade Rennes","RC Lens","3-0",3,0,"1",1,3,3,"H"
"1976",1947-03-09,1946,"AS Saint-Etienne","FC Rouen","1-0",1,0,"1",1,1,1,"H"
"1977",1947-03-09,1946,"Red Star Olympique Audonien","Racing Club de France","1-3",1,3,"1",1,4,-2,"D"
"1978",1947-03-09,1946,"Toulouse FC","AS Cannes-Grasse","2-1",2,1,"1",1,3,1,"H"
"1979",1947-03-16,1946,"Lille OSC","Stade Francais","5-0",5,0,"1",1,5,5,"H"
"1980",1947-03-16,1946,"Toulouse FC","Racing Club de France","4-2",4,2,"1",1,6,2,"H"
"1981",1947-03-16,1946,"RC Strasbourg","AS Saint-Etienne","3-3",3,3,"1",1,6,0,"D"
"1982",1947-03-16,1946,"Red Star Olympique Audonien","Stade Rennes","1-1",1,1,"1",1,2,0,"D"
"1983",1947-03-16,1946,"FC Rouen","AS Cannes-Grasse","0-0",0,0,"1",1,0,0,"D"
"1984",1947-03-16,1946,"RC Lens","RC Roubaix","3-1",3,1,"1",1,4,2,"H"
"1985",1947-03-16,1946,"FC Sete","AS Nancy","2-2",2,2,"1",1,4,0,"D"
"1986",1947-03-16,1946,"FC Metz","Stade Olympique Montpellierain","7-2",7,2,"1",1,9,5,"H"
"1987",1947-03-16,1946,"Stade Reims","Girondins Bordeaux","3-1",3,1,"1",1,4,2,"H"
"1988",1947-03-16,1946,"Le Havre AC","Olympique Marseille","1-1",1,1,"1",1,2,0,"D"
"1989",1947-03-20,1946,"RC Lens","Stade Francais","0-1",0,1,"1",1,1,-1,"D"
"1990",1947-03-20,1946,"FC Sete","Racing Club de France","2-2",2,2,"1",1,4,0,"D"
"1991",1947-03-20,1946,"FC Metz","AS Saint-Etienne","4-4",4,4,"1",1,8,0,"D"
"1992",1947-03-20,1946,"Stade Reims","Stade Rennes","1-0",1,0,"1",1,1,1,"H"
"1993",1947-03-20,1946,"Le Havre AC","AS Cannes-Grasse","1-0",1,0,"1",1,1,1,"H"
"1994",1947-03-20,1946,"Lille OSC","RC Roubaix","0-1",0,1,"1",1,1,-1,"D"
"1995",1947-03-20,1946,"Toulouse FC","AS Nancy","2-1",2,1,"1",1,3,1,"H"
"1996",1947-03-20,1946,"RC Strasbourg","Stade Olympique Montpellierain","2-1",2,1,"1",1,3,1,"H"
"1997",1947-03-20,1946,"Red Star Olympique Audonien","Girondins Bordeaux","2-1",2,1,"1",1,3,1,"H"
"1998",1947-03-20,1946,"FC Rouen","Olympique Marseille","2-3",2,3,"1",1,5,-1,"D"
"1999",1947-04-03,1946,"AS Nancy","FC Metz","3-1",3,1,"1",1,4,2,"H"
"2000",1947-04-03,1946,"RC Roubaix","FC Sete","2-1",2,1,"1",1,3,1,"H"
"2001",1947-04-03,1946,"AS Cannes-Grasse","Lille OSC","0-2",0,2,"1",1,2,-2,"D"
"2002",1947-04-03,1946,"Stade Rennes","Le Havre AC","3-1",3,1,"1",1,4,2,"H"
"2003",1947-04-03,1946,"AS Saint-Etienne","Stade Reims","1-1",1,1,"1",1,2,0,"D"
"2004",1947-04-03,1946,"Racing Club de France","RC Strasbourg","2-3",2,3,"1",1,5,-1,"D"
"2005",1947-04-03,1946,"Stade Francais","Toulouse FC","5-1",5,1,"1",1,6,4,"H"
"2006",1947-04-03,1946,"Olympique Marseille","RC Lens","5-2",5,2,"1",1,7,3,"H"
"2007",1947-04-03,1946,"Girondins Bordeaux","FC Rouen","2-1",2,1,"1",1,3,1,"H"
"2008",1947-04-03,1946,"Stade Olympique Montpellierain","Red Star Olympique Audonien","4-4",4,4,"1",1,8,0,"D"
"2009",1947-04-06,1946,"Racing Club de France","FC Metz","3-3",3,3,"1",1,6,0,"D"
"2010",1947-04-06,1946,"Stade Francais","FC Sete","1-1",1,1,"1",1,2,0,"D"
"2011",1947-04-06,1946,"Olympique Marseille","Lille OSC","1-1",1,1,"1",1,2,0,"D"
"2012",1947-04-06,1946,"Girondins Bordeaux","Le Havre AC","1-2",1,2,"1",1,3,-1,"D"
"2013",1947-04-06,1946,"Stade Olympique Montpellierain","Stade Reims","2-0",2,0,"1",1,2,2,"H"
"2014",1947-04-06,1946,"AS Nancy","RC Strasbourg","1-0",1,0,"1",1,1,1,"H"
"2015",1947-04-06,1946,"RC Roubaix","Toulouse FC","1-0",1,0,"1",1,1,1,"H"
"2016",1947-04-06,1946,"AS Cannes-Grasse","RC Lens","2-0",2,0,"1",1,2,2,"H"
"2017",1947-04-06,1946,"Stade Rennes","FC Rouen","2-0",2,0,"1",1,2,2,"H"
"2018",1947-04-06,1946,"AS Saint-Etienne","Red Star Olympique Audonien","3-1",3,1,"1",1,4,2,"H"
"2019",1947-05-18,1946,"Girondins Bordeaux","FC Metz","4-3",4,3,"1",1,7,1,"H"
"2020",1947-05-18,1946,"Stade Olympique Montpellierain","FC Sete","3-2",3,2,"1",1,5,1,"H"
"2021",1947-05-18,1946,"AS Nancy","Lille OSC","3-1",3,1,"1",1,4,2,"H"
"2022",1947-05-18,1946,"RC Roubaix","Le Havre AC","1-0",1,0,"1",1,1,1,"H"
"2023",1947-05-18,1946,"AS Cannes-Grasse","Stade Reims","1-0",1,0,"1",1,1,1,"H"
"2024",1947-05-18,1946,"Stade Rennes","RC Strasbourg","1-6",1,6,"1",1,7,-5,"D"
"2025",1947-05-18,1946,"AS Saint-Etienne","Toulouse FC","4-2",4,2,"1",1,6,2,"H"
"2026",1947-05-18,1946,"Racing Club de France","RC Lens","1-3",1,3,"1",1,4,-2,"D"
"2027",1947-05-18,1946,"Olympique Marseille","Red Star Olympique Audonien","4-0",4,0,"1",1,4,4,"H"
"2028",1947-05-18,1946,"FC Rouen","Stade Francais","0-2",0,2,"1",1,2,-2,"D"
"2029",1947-08-24,1947,"Racing Club de France","Lille OSC","1-4",1,4,"1",1,5,-3,"D"
"2030",1947-08-24,1947,"FC Sete","Red Star Olympique Audonien","1-2",1,2,"1",1,3,-1,"D"
"2031",1947-08-24,1947,"RC Roubaix","AS Cannes-Grasse","3-1",3,1,"1",1,4,2,"H"
"2032",1947-08-24,1947,"Stade Francais","FC Sochaux","2-2",2,2,"1",1,4,0,"D"
"2033",1947-08-24,1947,"Olympique Ales","RC Strasbourg","0-2",0,2,"1",1,2,-2,"D"
"2034",1947-08-24,1947,"Olympique Marseille","Toulouse FC","3-2",3,2,"1",1,5,1,"H"
"2035",1947-08-24,1947,"Stade Reims","AS Nancy","5-0",5,0,"1",1,5,5,"H"
"2036",1947-08-24,1947,"Stade Rennes","AS Saint-Etienne","1-3",1,3,"1",1,4,-2,"D"
"2037",1947-08-24,1947,"FC Metz","Stade Olympique Montpellierain","1-0",1,0,"1",1,1,1,"H"
"2038",1947-08-31,1947,"Lille OSC","RC Roubaix","4-0",4,0,"1",1,4,4,"H"
"2039",1947-08-31,1947,"Stade Olympique Montpellierain","FC Sochaux","2-0",2,0,"1",1,2,2,"H"
"2040",1947-08-31,1947,"AS Cannes-Grasse","FC Metz","1-1",1,1,"1",1,2,0,"D"
"2041",1947-08-31,1947,"Red Star Olympique Audonien","Racing Club de France","1-3",1,3,"1",1,4,-2,"D"
"2042",1947-08-31,1947,"AS Saint-Etienne","Olympique Ales","3-3",3,3,"1",1,6,0,"D"
"2043",1947-08-31,1947,"Toulouse FC","Stade Francais","4-0",4,0,"1",1,4,4,"H"
"2044",1947-08-31,1947,"RC Strasbourg","FC Sete","3-1",3,1,"1",1,4,2,"H"
"2045",1947-08-31,1947,"Stade Reims","Stade Rennes","1-0",1,0,"1",1,1,1,"H"
"2046",1947-08-31,1947,"AS Nancy","Olympique Marseille","4-0",4,0,"1",1,4,4,"H"
"2047",1947-09-07,1947,"Racing Club de France","AS Saint-Etienne","2-2",2,2,"1",1,4,0,"D"
"2048",1947-09-07,1947,"FC Sete","Stade Rennes","2-0",2,0,"1",1,2,2,"H"
"2049",1947-09-07,1947,"RC Roubaix","RC Strasbourg","3-2",3,2,"1",1,5,1,"H"
"2050",1947-09-07,1947,"FC Sochaux","Lille OSC","1-2",1,2,"1",1,3,-1,"D"
"2051",1947-09-07,1947,"Toulouse FC","AS Cannes-Grasse","0-0",0,0,"1",1,0,0,"D"
"2052",1947-09-07,1947,"FC Metz","Red Star Olympique Audonien","2-0",2,0,"1",1,2,2,"H"
"2053",1947-09-07,1947,"Olympique Marseille","Stade Francais","5-1",5,1,"1",1,6,4,"H"
"2054",1947-09-07,1947,"AS Nancy","Stade Olympique Montpellierain","2-2",2,2,"1",1,4,0,"D"
"2055",1947-09-07,1947,"Olympique Ales","Stade Reims","0-1",0,1,"1",1,1,-1,"D"
"2056",1947-09-14,1947,"Stade Francais","AS Nancy","2-3",2,3,"1",1,5,-1,"D"
"2057",1947-09-14,1947,"Stade Reims","Olympique Marseille","3-0",3,0,"1",1,3,3,"H"
"2058",1947-09-14,1947,"RC Strasbourg","Racing Club de France","1-2",1,2,"1",1,3,-1,"D"
"2059",1947-09-14,1947,"AS Cannes-Grasse","FC Sochaux","3-0",3,0,"1",1,3,3,"H"
"2060",1947-09-14,1947,"AS Saint-Etienne","FC Sete","3-1",3,1,"1",1,4,2,"H"
"2061",1947-09-14,1947,"Red Star Olympique Audonien","RC Roubaix","1-1",1,1,"1",1,2,0,"D"
"2062",1947-09-14,1947,"Stade Rennes","Olympique Ales","4-1",4,1,"1",1,5,3,"H"
"2063",1947-09-14,1947,"Lille OSC","FC Metz","3-1",3,1,"1",1,4,2,"H"
"2064",1947-09-14,1947,"Stade Olympique Montpellierain","Toulouse FC","1-3",1,3,"1",1,4,-2,"D"
"2065",1947-09-18,1947,"RC Roubaix","AS Saint-Etienne","0-3",0,3,"1",1,3,-3,"D"
"2066",1947-09-18,1947,"Olympique Marseille","Stade Olympique Montpellierain","2-1",2,1,"1",1,3,1,"H"
"2067",1947-09-18,1947,"FC Metz","RC Strasbourg","4-1",4,1,"1",1,5,3,"H"
"2068",1947-09-18,1947,"Racing Club de France","Stade Rennes","2-4",2,4,"1",1,6,-2,"D"
"2069",1947-09-18,1947,"AS Nancy","AS Cannes-Grasse","1-1",1,1,"1",1,2,0,"D"
"2070",1947-09-18,1947,"FC Sete","Olympique Ales","2-3",2,3,"1",1,5,-1,"D"
"2071",1947-09-18,1947,"FC Sochaux","Red Star Olympique Audonien","0-1",0,1,"1",1,1,-1,"D"
"2072",1947-09-18,1947,"Toulouse FC","Lille OSC","1-4",1,4,"1",1,5,-3,"D"
"2073",1947-09-18,1947,"Stade Francais","Stade Reims","2-1",2,1,"1",1,3,1,"H"
"2074",1947-09-21,1947,"Olympique Ales","Racing Club de France","0-5",0,5,"1",1,5,-5,"D"
"2075",1947-09-21,1947,"AS Saint-Etienne","FC Metz","3-0",3,0,"1",1,3,3,"H"
"2076",1947-09-21,1947,"Stade Olympique Montpellierain","Stade Francais","6-2",6,2,"1",1,8,4,"H"
"2077",1947-09-21,1947,"Stade Reims","FC Sete","3-0",3,0,"1",1,3,3,"H"
"2078",1947-09-21,1947,"Red Star Olympique Audonien","Toulouse FC","1-2",1,2,"1",1,3,-1,"D"
"2079",1947-09-21,1947,"Stade Rennes","RC Roubaix","4-4",4,4,"1",1,8,0,"D"
"2080",1947-09-21,1947,"AS Cannes-Grasse","Olympique Marseille","0-2",0,2,"1",1,2,-2,"D"
"2081",1947-09-21,1947,"RC Strasbourg","FC Sochaux","2-2",2,2,"1",1,4,0,"D"
"2082",1947-09-21,1947,"Lille OSC","AS Nancy","4-1",4,1,"1",1,5,3,"H"
"2083",1947-09-28,1947,"Racing Club de France","FC Sete","7-1",7,1,"1",1,8,6,"H"
"2084",1947-09-28,1947,"FC Metz","Stade Rennes","6-1",6,1,"1",1,7,5,"H"
"2085",1947-09-28,1947,"Olympique Marseille","Lille OSC","4-1",4,1,"1",1,5,3,"H"
"2086",1947-09-28,1947,"FC Sochaux","AS Saint-Etienne","2-2",2,2,"1",1,4,0,"D"
"2087",1947-09-28,1947,"RC Roubaix","Olympique Ales","1-0",1,0,"1",1,1,1,"H"
"2088",1947-09-28,1947,"Stade Olympique Montpellierain","Stade Reims","2-3",2,3,"1",1,5,-1,"D"
"2089",1947-09-28,1947,"Toulouse FC","RC Strasbourg","0-3",0,3,"1",1,3,-3,"D"
"2090",1947-09-28,1947,"AS Nancy","Red Star Olympique Audonien","5-1",5,1,"1",1,6,4,"H"
"2091",1947-09-28,1947,"Stade Francais","AS Cannes-Grasse","1-4",1,4,"1",1,5,-3,"D"
"2092",1947-10-05,1947,"Red Star Olympique Audonien","Olympique Marseille","2-2",2,2,"1",1,4,0,"D"
"2093",1947-10-05,1947,"Lille OSC","Stade Francais","1-3",1,3,"1",1,4,-2,"D"
"2094",1947-10-05,1947,"Stade Rennes","FC Sochaux","0-3",0,3,"1",1,3,-3,"D"
"2095",1947-10-05,1947,"AS Saint-Etienne","Toulouse FC","4-2",4,2,"1",1,6,2,"H"
"2096",1947-10-05,1947,"FC Sete","RC Roubaix","1-5",1,5,"1",1,6,-4,"D"
"2097",1947-10-05,1947,"AS Cannes-Grasse","Stade Olympique Montpellierain","1-1",1,1,"1",1,2,0,"D"
"2098",1947-10-05,1947,"RC Strasbourg","AS Nancy","1-1",1,1,"1",1,2,0,"D"
"2099",1947-10-05,1947,"Racing Club de France","Stade Reims","2-1",2,1,"1",1,3,1,"H"
"2100",1947-10-05,1947,"Olympique Ales","FC Metz","3-0",3,0,"1",1,3,3,"H"
"2101",1947-10-12,1947,"RC Roubaix","Racing Club de France","5-2",5,2,"1",1,7,3,"H"
"2102",1947-10-12,1947,"Stade Olympique Montpellierain","Lille OSC","0-1",0,1,"1",1,1,-1,"D"
"2103",1947-10-12,1947,"FC Metz","FC Sete","4-2",4,2,"1",1,6,2,"H"
"2104",1947-10-12,1947,"FC Sochaux","Olympique Ales","2-0",2,0,"1",1,2,2,"H"
"2105",1947-10-12,1947,"Stade Reims","AS Cannes-Grasse","3-0",3,0,"1",1,3,3,"H"
"2106",1947-10-12,1947,"Toulouse FC","Stade Rennes","0-1",0,1,"1",1,1,-1,"D"
"2107",1947-10-12,1947,"Stade Francais","Red Star Olympique Audonien","4-0",4,0,"1",1,4,4,"H"
"2108",1947-10-12,1947,"Olympique Marseille","RC Strasbourg","1-0",1,0,"1",1,1,1,"H"
"2109",1947-10-12,1947,"AS Nancy","AS Saint-Etienne","4-0",4,0,"1",1,4,4,"H"
"2110",1947-10-26,1947,"Red Star Olympique Audonien","Stade Olympique Montpellierain","3-4",3,4,"1",1,7,-1,"D"
"2111",1947-10-26,1947,"AS Saint-Etienne","Olympique Marseille","3-2",3,2,"1",1,5,1,"H"
"2112",1947-10-26,1947,"Racing Club de France","FC Metz","4-2",4,2,"1",1,6,2,"H"
"2113",1947-10-26,1947,"Lille OSC","AS Cannes-Grasse","3-0",3,0,"1",1,3,3,"H"
"2114",1947-10-26,1947,"Stade Reims","RC Roubaix","1-1",1,1,"1",1,2,0,"D"
"2115",1947-10-26,1947,"FC Sete","FC Sochaux","1-5",1,5,"1",1,6,-4,"D"
"2116",1947-10-26,1947,"RC Strasbourg","Stade Francais","1-1",1,1,"1",1,2,0,"D"
"2117",1947-10-26,1947,"Stade Rennes","AS Nancy","0-0",0,0,"1",1,0,0,"D"
"2118",1947-10-26,1947,"Olympique Ales","Toulouse FC","3-2",3,2,"1",1,5,1,"H"
"2119",1947-11-02,1947,"Stade Francais","AS Saint-Etienne","2-1",2,1,"1",1,3,1,"H"
"2120",1947-11-02,1947,"Lille OSC","Stade Reims","0-0",0,0,"1",1,0,0,"D"
"2121",1947-11-02,1947,"Stade Olympique Montpellierain","RC Strasbourg","1-1",1,1,"1",1,2,0,"D"
"2122",1947-11-02,1947,"FC Metz","RC Roubaix","0-1",0,1,"1",1,1,-1,"D"
"2123",1947-11-02,1947,"FC Sochaux","Racing Club de France","3-2",3,2,"1",1,5,1,"H"
"2124",1947-11-02,1947,"Toulouse FC","FC Sete","2-1",2,1,"1",1,3,1,"H"
"2125",1947-11-02,1947,"AS Nancy","Olympique Ales","1-0",1,0,"1",1,1,1,"H"
"2126",1947-11-02,1947,"AS Cannes-Grasse","Red Star Olympique Audonien","1-0",1,0,"1",1,1,1,"H"
"2127",1947-11-02,1947,"Olympique Marseille","Stade Rennes","1-1",1,1,"1",1,2,0,"D"
"2128",1947-11-09,1947,"Racing Club de France","Toulouse FC","2-0",2,0,"1",1,2,2,"H"
"2129",1947-11-09,1947,"RC Roubaix","FC Sochaux","3-1",3,1,"1",1,4,2,"H"
"2130",1947-11-09,1947,"Stade Rennes","Stade Francais","0-3",0,3,"1",1,3,-3,"D"
"2131",1947-11-09,1947,"RC Strasbourg","AS Cannes-Grasse","8-2",8,2,"1",1,10,6,"H"
"2132",1947-11-09,1947,"FC Metz","Stade Reims","1-3",1,3,"1",1,4,-2,"D"
"2133",1947-11-09,1947,"FC Sete","AS Nancy","4-3",4,3,"1",1,7,1,"H"
"2134",1947-11-09,1947,"Olympique Ales","Olympique Marseille","2-3",2,3,"1",1,5,-1,"D"
"2135",1947-11-09,1947,"AS Saint-Etienne","Stade Olympique Montpellierain","2-2",2,2,"1",1,4,0,"D"
"2136",1947-11-09,1947,"Red Star Olympique Audonien","Lille OSC","1-2",1,2,"1",1,3,-1,"D"
"2137",1947-11-16,1947,"Stade Francais","Olympique Ales","3-1",3,1,"1",1,4,2,"H"
"2138",1947-11-16,1947,"Stade Reims","Red Star Olympique Audonien","1-0",1,0,"1",1,1,1,"H"
"2139",1947-11-16,1947,"Stade Olympique Montpellierain","Stade Rennes","2-2",2,2,"1",1,4,0,"D"
"2140",1947-11-16,1947,"Lille OSC","RC Strasbourg","1-1",1,1,"1",1,2,0,"D"
"2141",1947-11-16,1947,"Olympique Marseille","FC Sete","4-1",4,1,"1",1,5,3,"H"
"2142",1947-11-16,1947,"AS Nancy","Racing Club de France","1-3",1,3,"1",1,4,-2,"D"
"2143",1947-11-16,1947,"Toulouse FC","RC Roubaix","2-1",2,1,"1",1,3,1,"H"
"2144",1947-11-16,1947,"FC Sochaux","FC Metz","4-3",4,3,"1",1,7,1,"H"
"2145",1947-11-16,1947,"AS Cannes-Grasse","AS Saint-Etienne","0-3",0,3,"1",1,3,-3,"D"
"2146",1947-11-21,1947,"FC Metz","Olympique Marseille","0-1",0,1,"1",1,1,-1,"D"
"2147",1947-11-21,1947,"Racing Club de France","Stade Olympique Montpellierain","6-1",6,1,"1",1,7,5,"H"
"2148",1947-11-21,1947,"FC Sete","AS Cannes-Grasse","4-0",4,0,"1",1,4,4,"H"
"2149",1947-11-21,1947,"Stade Rennes","Red Star Olympique Audonien","1-0",1,0,"1",1,1,1,"H"
"2150",1947-11-21,1947,"FC Sochaux","AS Nancy","2-2",2,2,"1",1,4,0,"D"
"2151",1947-11-21,1947,"RC Roubaix","Stade Francais","1-0",1,0,"1",1,1,1,"H"
"2152",1947-11-21,1947,"Olympique Ales","Lille OSC","1-1",1,1,"1",1,2,0,"D"
"2153",1947-11-21,1947,"AS Saint-Etienne","RC Strasbourg","1-1",1,1,"1",1,2,0,"D"
"2154",1947-11-21,1947,"Toulouse FC","Stade Reims","1-3",1,3,"1",1,4,-2,"D"
"2155",1947-11-30,1947,"Stade Rennes","Lille OSC","4-2",4,2,"1",1,6,2,"H"
"2156",1947-11-30,1947,"RC Strasbourg","Stade Reims","2-2",2,2,"1",1,4,0,"D"
"2157",1947-11-30,1947,"Racing Club de France","Stade Francais","0-1",0,1,"1",1,1,-1,"D"
"2158",1947-11-30,1947,"FC Metz","AS Nancy","4-3",4,3,"1",1,7,1,"H"
"2159",1947-11-30,1947,"FC Sete","Stade Olympique Montpellierain","0-1",0,1,"1",1,1,-1,"D"
"2160",1947-11-30,1947,"Olympique Ales","AS Cannes-Grasse","2-1",2,1,"1",1,3,1,"H"
"2161",1947-11-30,1947,"AS Saint-Etienne","Red Star Olympique Audonien","4-1",4,1,"1",1,5,3,"H"
"2162",1947-11-30,1947,"FC Sochaux","Toulouse FC","4-0",4,0,"1",1,4,4,"H"
"2163",1947-11-30,1947,"RC Roubaix","Olympique Marseille","1-1",1,1,"1",1,2,0,"D"
"2164",1947-12-07,1947,"Red Star Olympique Audonien","RC Strasbourg","0-5",0,5,"1",1,5,-5,"D"
"2165",1947-12-07,1947,"AS Nancy","RC Roubaix","0-4",0,4,"1",1,4,-4,"D"
"2166",1947-12-07,1947,"Stade Olympique Montpellierain","Olympique Ales","1-3",1,3,"1",1,4,-2,"D"
"2167",1947-12-07,1947,"Lille OSC","AS Saint-Etienne","0-0",0,0,"1",1,0,0,"D"
"2168",1947-12-07,1947,"Stade Reims","FC Sochaux","4-0",4,0,"1",1,4,4,"H"
"2169",1947-12-07,1947,"Toulouse FC","FC Metz","4-3",4,3,"1",1,7,1,"H"
"2170",1947-12-07,1947,"Olympique Marseille","Racing Club de France","4-1",4,1,"1",1,5,3,"H"
"2171",1947-12-07,1947,"Stade Francais","FC Sete","4-1",4,1,"1",1,5,3,"H"
"2172",1947-12-07,1947,"AS Cannes-Grasse","Stade Rennes","5-2",5,2,"1",1,7,3,"H"
"2173",1947-12-25,1947,"Stade Reims","AS Saint-Etienne","6-0",6,0,"1",1,6,6,"H"
"2174",1947-12-25,1947,"Stade Olympique Montpellierain","RC Roubaix","1-1",1,1,"1",1,2,0,"D"
"2175",1947-12-25,1947,"RC Strasbourg","Stade Rennes","6-1",6,1,"1",1,7,5,"H"
"2176",1947-12-25,1947,"Olympique Marseille","FC Sochaux","3-1",3,1,"1",1,4,2,"H"
"2177",1947-12-25,1947,"Lille OSC","FC Sete","5-3",5,3,"1",1,8,2,"H"
"2178",1947-12-25,1947,"AS Nancy","Toulouse FC","0-0",0,0,"1",1,0,0,"D"
"2179",1947-12-25,1947,"Red Star Olympique Audonien","Olympique Ales","3-1",3,1,"1",1,4,2,"H"
"2180",1947-12-25,1947,"AS Cannes-Grasse","Racing Club de France","4-4",4,4,"1",1,8,0,"D"
"2181",1947-12-25,1947,"Stade Francais","FC Metz","7-1",7,1,"1",1,8,6,"H"
"2182",1947-12-28,1947,"Toulouse FC","Olympique Marseille","3-1",3,1,"1",1,4,2,"H"
"2183",1947-12-28,1947,"Lille OSC","Racing Club de France","2-1",2,1,"1",1,3,1,"H"
"2184",1947-12-28,1947,"FC Sochaux","Stade Francais","4-0",4,0,"1",1,4,4,"H"
"2185",1947-12-28,1947,"AS Nancy","Stade Reims","1-2",1,2,"1",1,3,-1,"D"
"2186",1947-12-28,1947,"Red Star Olympique Audonien","FC Sete","1-0",1,0,"1",1,1,1,"H"
"2187",1947-12-28,1947,"Stade Olympique Montpellierain","FC Metz","5-2",5,2,"1",1,7,3,"H"
"2188",1947-12-28,1947,"AS Saint-Etienne","Stade Rennes","1-0",1,0,"1",1,1,1,"H"
"2189",1947-12-28,1947,"AS Cannes-Grasse","RC Roubaix","1-1",1,1,"1",1,2,0,"D"
"2190",1947-12-28,1947,"RC Strasbourg","Olympique Ales","9-3",9,3,"1",1,12,6,"H"
"2191",1948-01-11,1947,"Stade Francais","Toulouse FC","2-1",2,1,"1",1,3,1,"H"
"2192",1948-01-11,1947,"Stade Rennes","Stade Reims","1-0",1,0,"1",1,1,1,"H"
"2193",1948-01-11,1947,"Olympique Marseille","AS Nancy","5-0",5,0,"1",1,5,5,"H"
"2194",1948-01-11,1947,"RC Roubaix","Lille OSC","1-5",1,5,"1",1,6,-4,"D"
"2195",1948-01-11,1947,"Olympique Ales","AS Saint-Etienne","2-2",2,2,"1",1,4,0,"D"
"2196",1948-01-11,1947,"Racing Club de France","Red Star Olympique Audonien","2-1",2,1,"1",1,3,1,"H"
"2197",1948-01-11,1947,"FC Sete","RC Strasbourg","3-2",3,2,"1",1,5,1,"H"
"2198",1948-01-11,1947,"FC Sochaux","Stade Olympique Montpellierain","1-0",1,0,"1",1,1,1,"H"
"2199",1948-01-11,1947,"FC Metz","AS Cannes-Grasse","1-1",1,1,"1",1,2,0,"D"
"2200",1948-01-18,1947,"Stade Francais","Olympique Marseille","1-1",1,1,"1",1,2,0,"D"
"2201",1948-01-18,1947,"AS Cannes-Grasse","Toulouse FC","1-0",1,0,"1",1,1,1,"H"
"2202",1948-01-18,1947,"Stade Reims","Olympique Ales","1-0",1,0,"1",1,1,1,"H"
"2203",1948-01-18,1947,"Lille OSC","FC Sochaux","6-1",6,1,"1",1,7,5,"H"
"2204",1948-01-18,1947,"AS Saint-Etienne","Racing Club de France","1-4",1,4,"1",1,5,-3,"D"
"2205",1948-01-18,1947,"RC Strasbourg","RC Roubaix","3-0",3,0,"1",1,3,3,"H"
"2206",1948-01-18,1947,"Stade Olympique Montpellierain","AS Nancy","3-1",3,1,"1",1,4,2,"H"
"2207",1948-01-18,1947,"Stade Rennes","FC Sete","3-0",3,0,"1",1,3,3,"H"
"2208",1948-01-18,1947,"Red Star Olympique Audonien","FC Metz","0-1",0,1,"1",1,1,-1,"D"
"2209",1948-01-25,1947,"AS Nancy","Stade Francais","0-0",0,0,"1",1,0,0,"D"
"2210",1948-01-25,1947,"Toulouse FC","Stade Olympique Montpellierain","4-2",4,2,"1",1,6,2,"H"
"2211",1948-01-25,1947,"FC Sochaux","AS Cannes-Grasse","5-1",5,1,"1",1,6,4,"H"
"2212",1948-01-25,1947,"FC Sete","AS Saint-Etienne","4-2",4,2,"1",1,6,2,"H"
"2213",1948-01-25,1947,"Olympique Ales","Stade Rennes","1-1",1,1,"1",1,2,0,"D"
"2214",1948-01-25,1947,"RC Roubaix","Red Star Olympique Audonien","1-0",1,0,"1",1,1,1,"H"
"2215",1948-01-25,1947,"FC Metz","Lille OSC","6-2",6,2,"1",1,8,4,"H"
"2216",1948-01-25,1947,"Olympique Marseille","Stade Reims","1-0",1,0,"1",1,1,1,"H"
"2217",1948-01-25,1947,"Racing Club de France","RC Strasbourg","4-2",4,2,"1",1,6,2,"H"
"2218",1948-02-08,1947,"AS Nancy","RC Strasbourg","3-0",3,0,"1",1,3,3,"H"
"2219",1948-02-08,1947,"Stade Reims","Racing Club de France","2-2",2,2,"1",1,4,0,"D"
"2220",1948-02-08,1947,"Stade Francais","Lille OSC","1-1",1,1,"1",1,2,0,"D"
"2221",1948-02-08,1947,"FC Metz","Olympique Ales","4-4",4,4,"1",1,8,0,"D"
"2222",1948-02-08,1947,"Toulouse FC","AS Saint-Etienne","0-2",0,2,"1",1,2,-2,"D"
"2223",1948-02-08,1947,"Olympique Marseille","Red Star Olympique Audonien","3-0",3,0,"1",1,3,3,"H"
"2224",1948-02-08,1947,"Stade Olympique Montpellierain","AS Cannes-Grasse","0-2",0,2,"1",1,2,-2,"D"
"2225",1948-02-08,1947,"FC Sochaux","Stade Rennes","2-0",2,0,"1",1,2,2,"H"
"2226",1948-02-08,1947,"RC Roubaix","FC Sete","2-4",2,4,"1",1,6,-2,"D"
"2227",1948-02-15,1947,"Stade Reims","Stade Olympique Montpellierain","1-0",1,0,"1",1,1,1,"H"
"2228",1948-02-15,1947,"Olympique Ales","RC Roubaix","1-1",1,1,"1",1,2,0,"D"
"2229",1948-02-15,1947,"Stade Rennes","FC Metz","0-2",0,2,"1",1,2,-2,"D"
"2230",1948-02-15,1947,"AS Saint-Etienne","FC Sochaux","2-1",2,1,"1",1,3,1,"H"
"2231",1948-02-15,1947,"RC Strasbourg","Toulouse FC","3-1",3,1,"1",1,4,2,"H"
"2232",1948-02-15,1947,"FC Sete","Racing Club de France","3-2",3,2,"1",1,5,1,"H"
"2233",1948-02-15,1947,"Red Star Olympique Audonien","AS Nancy","2-0",2,0,"1",1,2,2,"H"
"2234",1948-02-15,1947,"AS Cannes-Grasse","Stade Francais","2-0",2,0,"1",1,2,2,"H"
"2235",1948-02-15,1947,"Lille OSC","Olympique Marseille","3-0",3,0,"1",1,3,3,"H"
"2236",1948-02-22,1947,"Racing Club de France","Olympique Ales","0-0",0,0,"1",1,0,0,"D"
"2237",1948-02-22,1947,"RC Roubaix","Stade Rennes","1-2",1,2,"1",1,3,-1,"D"
"2238",1948-02-22,1947,"AS Nancy","Lille OSC","2-1",2,1,"1",1,3,1,"H"
"2239",1948-02-22,1947,"Toulouse FC","Red Star Olympique Audonien","2-1",2,1,"1",1,3,1,"H"
"2240",1948-02-22,1947,"FC Sochaux","RC Strasbourg","1-0",1,0,"1",1,1,1,"H"
"2241",1948-02-22,1947,"Olympique Marseille","AS Cannes-Grasse","2-1",2,1,"1",1,3,1,"H"
"2242",1948-03-04,1947,"Red Star Olympique Audonien","FC Sochaux","0-0",0,0,"1",1,0,0,"D"
"2243",1948-03-04,1947,"Stade Reims","Stade Francais","0-3",0,3,"1",1,3,-3,"D"
"2244",1948-03-04,1947,"AS Cannes-Grasse","AS Nancy","2-1",2,1,"1",1,3,1,"H"
"2245",1948-03-04,1947,"Olympique Ales","FC Sete","1-1",1,1,"1",1,2,0,"D"
"2246",1948-03-04,1947,"AS Saint-Etienne","RC Roubaix","1-2",1,2,"1",1,3,-1,"D"
"2247",1948-03-04,1947,"Lille OSC","Toulouse FC","3-0",3,0,"1",1,3,3,"H"
"2248",1948-03-04,1947,"Stade Rennes","Racing Club de France","2-0",2,0,"1",1,2,2,"H"
"2249",1948-03-04,1947,"RC Strasbourg","FC Metz","8-4",8,4,"1",1,12,4,"H"
"2250",1948-03-04,1947,"Stade Olympique Montpellierain","Olympique Marseille","1-0",1,0,"1",1,1,1,"H"
"2251",1948-03-07,1947,"AS Cannes-Grasse","Stade Reims","0-4",0,4,"1",1,4,-4,"D"
"2252",1948-03-07,1947,"RC Strasbourg","Olympique Marseille","1-1",1,1,"1",1,2,0,"D"
"2253",1948-03-07,1947,"Red Star Olympique Audonien","Stade Francais","0-7",0,7,"1",1,7,-7,"D"
"2254",1948-03-07,1947,"Olympique Ales","FC Sochaux","2-2",2,2,"1",1,4,0,"D"
"2255",1948-03-07,1947,"FC Sete","FC Metz","2-1",2,1,"1",1,3,1,"H"
"2256",1948-03-07,1947,"Lille OSC","Stade Olympique Montpellierain","4-1",4,1,"1",1,5,3,"H"
"2257",1948-03-07,1947,"Racing Club de France","RC Roubaix","2-1",2,1,"1",1,3,1,"H"
"2258",1948-03-07,1947,"Stade Rennes","Toulouse FC","2-0",2,0,"1",1,2,2,"H"
"2259",1948-03-07,1947,"AS Saint-Etienne","AS Nancy","2-0",2,0,"1",1,2,2,"H"
"2260",1948-03-11,1947,"FC Metz","AS Saint-Etienne","2-2",2,2,"1",1,4,0,"D"
"2261",1948-03-11,1947,"FC Sete","Stade Reims","4-2",4,2,"1",1,6,2,"H"
"2262",1948-03-11,1947,"Stade Francais","Stade Olympique Montpellierain","4-1",4,1,"1",1,5,3,"H"
"2263",1948-03-14,1947,"AS Cannes-Grasse","Lille OSC","0-2",0,2,"1",1,2,-2,"D"
"2264",1948-03-14,1947,"Olympique Marseille","AS Saint-Etienne","4-1",4,1,"1",1,5,3,"H"
"2265",1948-03-14,1947,"RC Roubaix","Stade Reims","2-1",2,1,"1",1,3,1,"H"
"2266",1948-03-14,1947,"FC Metz","Racing Club de France","2-1",2,1,"1",1,3,1,"H"
"2267",1948-03-14,1947,"FC Sochaux","FC Sete","2-2",2,2,"1",1,4,0,"D"
"2268",1948-03-14,1947,"Toulouse FC","Olympique Ales","2-0",2,0,"1",1,2,2,"H"
"2269",1948-03-14,1947,"Stade Francais","RC Strasbourg","2-2",2,2,"1",1,4,0,"D"
"2270",1948-03-14,1947,"AS Nancy","Stade Rennes","1-0",1,0,"1",1,1,1,"H"
"2271",1948-03-14,1947,"Stade Olympique Montpellierain","Red Star Olympique Audonien","0-0",0,0,"1",1,0,0,"D"
"2272",1948-03-26,1947,"Stade Rennes","Olympique Marseille","1-1",1,1,"1",1,2,0,"D"
"2273",1948-03-26,1947,"FC Sete","Toulouse FC","2-2",2,2,"1",1,4,0,"D"
"2274",1948-03-26,1947,"RC Roubaix","FC Metz","1-2",1,2,"1",1,3,-1,"D"
"2275",1948-03-26,1947,"AS Saint-Etienne","Stade Francais","1-1",1,1,"1",1,2,0,"D"
"2276",1948-03-26,1947,"Olympique Ales","AS Nancy","1-1",1,1,"1",1,2,0,"D"
"2277",1948-03-26,1947,"RC Strasbourg","Stade Olympique Montpellierain","0-1",0,1,"1",1,1,-1,"D"
"2278",1948-03-26,1947,"Red Star Olympique Audonien","AS Cannes-Grasse","3-2",3,2,"1",1,5,1,"H"
"2279",1948-03-26,1947,"Stade Reims","Lille OSC","2-2",2,2,"1",1,4,0,"D"
"2280",1948-03-26,1947,"Racing Club de France","FC Sochaux","2-1",2,1,"1",1,3,1,"H"
"2281",1948-03-28,1947,"Stade Reims","FC Metz","4-2",4,2,"1",1,6,2,"H"
"2282",1948-03-28,1947,"Stade Francais","Stade Rennes","3-1",3,1,"1",1,4,2,"H"
"2283",1948-03-28,1947,"Toulouse FC","Racing Club de France","1-0",1,0,"1",1,1,1,"H"
"2284",1948-03-28,1947,"Lille OSC","Red Star Olympique Audonien","2-0",2,0,"1",1,2,2,"H"
"2285",1948-03-28,1947,"Stade Olympique Montpellierain","AS Saint-Etienne","2-0",2,0,"1",1,2,2,"H"
"2286",1948-03-28,1947,"Olympique Marseille","Olympique Ales","8-0",8,0,"1",1,8,8,"H"
"2287",1948-03-28,1947,"FC Sochaux","RC Roubaix","5-1",5,1,"1",1,6,4,"H"
"2288",1948-03-28,1947,"AS Nancy","FC Sete","2-0",2,0,"1",1,2,2,"H"
"2289",1948-03-28,1947,"AS Cannes-Grasse","RC Strasbourg","2-2",2,2,"1",1,4,0,"D"
"2290",1948-04-11,1947,"Racing Club de France","AS Nancy","3-0",3,0,"1",1,3,3,"H"
"2291",1948-04-11,1947,"RC Roubaix","Toulouse FC","1-3",1,3,"1",1,4,-2,"D"
"2292",1948-04-11,1947,"AS Saint-Etienne","AS Cannes-Grasse","2-0",2,0,"1",1,2,2,"H"
"2293",1948-04-11,1947,"FC Sete","Olympique Marseille","1-3",1,3,"1",1,4,-2,"D"
"2294",1948-04-11,1947,"RC Strasbourg","Lille OSC","2-0",2,0,"1",1,2,2,"H"
"2295",1948-04-11,1947,"Stade Rennes","Stade Olympique Montpellierain","4-1",4,1,"1",1,5,3,"H"
"2296",1948-04-11,1947,"FC Metz","FC Sochaux","2-0",2,0,"1",1,2,2,"H"
"2297",1948-04-11,1947,"Red Star Olympique Audonien","Stade Reims","0-2",0,2,"1",1,2,-2,"D"
"2298",1948-04-11,1947,"Olympique Ales","Stade Francais","2-2",2,2,"1",1,4,0,"D"
"2299",1948-04-25,1947,"Stade Reims","RC Strasbourg","2-2",2,2,"1",1,4,0,"D"
"2300",1948-04-25,1947,"Toulouse FC","FC Sochaux","2-3",2,3,"1",1,5,-1,"D"
"2301",1948-04-25,1947,"Stade Francais","Racing Club de France","1-5",1,5,"1",1,6,-4,"D"
"2302",1948-04-25,1947,"Olympique Marseille","RC Roubaix","6-0",6,0,"1",1,6,6,"H"
"2303",1948-04-25,1947,"Stade Olympique Montpellierain","FC Sete","1-1",1,1,"1",1,2,0,"D"
"2304",1948-04-25,1947,"Lille OSC","Stade Rennes","1-1",1,1,"1",1,2,0,"D"
"2305",1948-04-25,1947,"AS Nancy","FC Metz","4-2",4,2,"1",1,6,2,"H"
"2306",1948-04-25,1947,"AS Cannes-Grasse","Olympique Ales","4-1",4,1,"1",1,5,3,"H"
"2307",1948-04-25,1947,"Red Star Olympique Audonien","AS Saint-Etienne","0-5",0,5,"1",1,5,-5,"D"
"2308",1948-05-02,1947,"FC Sochaux","Stade Reims","0-3",0,3,"1",1,3,-3,"D"
"2309",1948-05-02,1947,"FC Sete","Stade Francais","3-2",3,2,"1",1,5,1,"H"
"2310",1948-05-02,1947,"AS Saint-Etienne","Lille OSC","8-3",8,3,"1",1,11,5,"H"
"2311",1948-05-02,1947,"Racing Club de France","Olympique Marseille","1-1",1,1,"1",1,2,0,"D"
"2312",1948-05-02,1947,"Stade Rennes","AS Cannes-Grasse","0-0",0,0,"1",1,0,0,"D"
"2313",1948-05-02,1947,"FC Metz","Toulouse FC","1-0",1,0,"1",1,1,1,"H"
"2314",1948-05-02,1947,"Olympique Ales","Stade Olympique Montpellierain","3-0",3,0,"1",1,3,3,"H"
"2315",1948-05-02,1947,"RC Strasbourg","Red Star Olympique Audonien","3-1",3,1,"1",1,4,2,"H"
"2316",1948-05-02,1947,"RC Roubaix","AS Nancy","3-0",3,0,"1",1,3,3,"H"
"2317",1948-05-16,1947,"Stade Francais","RC Roubaix","0-2",0,2,"1",1,2,-2,"D"
"2318",1948-05-16,1947,"Lille OSC","Olympique Ales","5-2",5,2,"1",1,7,3,"H"
"2319",1948-05-16,1947,"Stade Reims","Toulouse FC","4-0",4,0,"1",1,4,4,"H"
"2320",1948-05-16,1947,"Olympique Marseille","FC Metz","6-3",6,3,"1",1,9,3,"H"
"2321",1948-05-16,1947,"RC Strasbourg","AS Saint-Etienne","2-0",2,0,"1",1,2,2,"H"
"2322",1948-05-16,1947,"Red Star Olympique Audonien","Stade Rennes","3-5",3,5,"1",1,8,-2,"D"
"2323",1948-05-16,1947,"AS Nancy","FC Sochaux","2-1",2,1,"1",1,3,1,"H"
"2324",1948-05-16,1947,"AS Cannes-Grasse","FC Sete","1-2",1,2,"1",1,3,-1,"D"
"2325",1948-05-16,1947,"Stade Olympique Montpellierain","Racing Club de France","6-0",6,0,"1",1,6,6,"H"
"2326",1948-05-30,1947,"FC Sochaux","Olympique Marseille","2-2",2,2,"1",1,4,0,"D"
"2327",1948-05-30,1947,"FC Sete","Lille OSC","1-2",1,2,"1",1,3,-1,"D"
"2328",1948-05-30,1947,"Racing Club de France","AS Cannes-Grasse","2-3",2,3,"1",1,5,-1,"D"
"2329",1948-05-30,1947,"AS Saint-Etienne","Stade Reims","3-2",3,2,"1",1,5,1,"H"
"2330",1948-05-30,1947,"Stade Rennes","RC Strasbourg","7-1",7,1,"1",1,8,6,"H"
"2331",1948-05-30,1947,"RC Roubaix","Stade Olympique Montpellierain","7-0",7,0,"1",1,7,7,"H"
"2332",1948-05-30,1947,"FC Metz","Stade Francais","0-1",0,1,"1",1,1,-1,"D"
"2333",1948-05-30,1947,"Olympique Ales","Red Star Olympique Audonien","3-1",3,1,"1",1,4,2,"H"
"2334",1948-05-30,1947,"Toulouse FC","AS Nancy","4-0",4,0,"1",1,4,4,"H"
"2335",1948-08-22,1948,"Olympique Marseille","SR Colmar","7-2",7,2,"1",1,9,5,"H"
"2336",1948-08-22,1948,"FC Metz","Stade Rennes","1-6",1,6,"1",1,7,-5,"D"
"2337",1948-08-22,1948,"FC Sochaux","Toulouse FC","3-0",3,0,"1",1,3,3,"H"
"2338",1948-08-22,1948,"RC Strasbourg","AS Nancy","4-2",4,2,"1",1,6,2,"H"
"2339",1948-08-22,1948,"AS Saint-Etienne","Stade Reims","2-3",2,3,"1",1,5,-1,"D"
"2340",1948-08-22,1948,"RC Roubaix","Stade Olympique Montpellierain","2-3",2,3,"1",1,5,-1,"D"
"2341",1948-08-22,1948,"AS Cannes-Grasse","Racing Club de France","2-1",2,1,"1",1,3,1,"H"
"2342",1948-08-22,1948,"FC Sete","Lille OSC","1-0",1,0,"1",1,1,1,"H"
"2343",1948-08-22,1948,"Stade Red Star","OGC Nice","1-1",1,1,"1",1,2,0,"D"
"2344",1948-08-29,1948,"Olympique Marseille","RC Roubaix","4-2",4,2,"1",1,6,2,"H"
"2345",1948-08-29,1948,"RC Strasbourg","FC Sochaux","0-3",0,3,"1",1,3,-3,"D"
"2346",1948-08-29,1948,"OGC Nice","FC Metz","5-2",5,2,"1",1,7,3,"H"
"2347",1948-08-29,1948,"SR Colmar","Stade Reims","3-3",3,3,"1",1,6,0,"D"
"2348",1948-08-29,1948,"Stade Red Star","FC Sete","2-2",2,2,"1",1,4,0,"D"
"2349",1948-08-29,1948,"Toulouse FC","Stade Rennes","2-1",2,1,"1",1,3,1,"H"
"2350",1948-08-29,1948,"Lille OSC","AS Saint-Etienne","5-0",5,0,"1",1,5,5,"H"
"2351",1948-08-29,1948,"Stade Olympique Montpellierain","Racing Club de France","0-4",0,4,"1",1,4,-4,"D"
"2352",1948-08-29,1948,"AS Nancy","AS Cannes-Grasse","1-0",1,0,"1",1,1,1,"H"
"2353",1948-09-04,1948,"Racing Club de France","Olympique Marseille","5-4",5,4,"1",1,9,1,"H"
"2354",1948-09-04,1948,"Stade Rennes","RC Strasbourg","1-1",1,1,"1",1,2,0,"D"
"2355",1948-09-04,1948,"AS Saint-Etienne","Stade Red Star","2-2",2,2,"1",1,4,0,"D"
"2356",1948-09-05,1948,"FC Sochaux","AS Cannes-Grasse","4-0",4,0,"1",1,4,4,"H"
"2357",1948-09-05,1948,"OGC Nice","Toulouse FC","2-1",2,1,"1",1,3,1,"H"
"2358",1948-09-05,1948,"Stade Reims","Lille OSC","2-4",2,4,"1",1,6,-2,"D"
"2359",1948-09-05,1948,"FC Sete","FC Metz","1-1",1,1,"1",1,2,0,"D"
"2360",1948-09-05,1948,"AS Nancy","Stade Olympique Montpellierain","1-0",1,0,"1",1,1,1,"H"
"2361",1948-09-05,1948,"RC Roubaix","SR Colmar","3-2",3,2,"1",1,5,1,"H"
"2362",1948-09-09,1948,"Stade Olympique Montpellierain","FC Sochaux","2-1",2,1,"1",1,3,1,"H"
"2363",1948-09-09,1948,"Olympique Marseille","AS Nancy","3-1",3,1,"1",1,4,2,"H"
"2364",1948-09-09,1948,"Toulouse FC","FC Sete","0-2",0,2,"1",1,2,-2,"D"
"2365",1948-09-09,1948,"SR Colmar","Lille OSC","2-2",2,2,"1",1,4,0,"D"
"2366",1948-09-09,1948,"RC Roubaix","Racing Club de France","2-2",2,2,"1",1,4,0,"D"
"2367",1948-09-09,1948,"RC Strasbourg","OGC Nice","3-1",3,1,"1",1,4,2,"H"
"2368",1948-09-09,1948,"Stade Red Star","Stade Reims","3-5",3,5,"1",1,8,-2,"D"
"2369",1948-09-09,1948,"AS Cannes-Grasse","Stade Rennes","1-1",1,1,"1",1,2,0,"D"
"2370",1948-09-09,1948,"FC Metz","AS Saint-Etienne","2-0",2,0,"1",1,2,2,"H"
"2371",1948-09-12,1948,"FC Sochaux","Olympique Marseille","1-1",1,1,"1",1,2,0,"D"
"2372",1948-09-12,1948,"Lille OSC","Stade Red Star","2-1",2,1,"1",1,3,1,"H"
"2373",1948-09-12,1948,"Stade Reims","FC Metz","6-1",6,1,"1",1,7,5,"H"
"2374",1948-09-12,1948,"OGC Nice","AS Cannes-Grasse","2-0",2,0,"1",1,2,2,"H"
"2375",1948-09-12,1948,"FC Sete","RC Strasbourg","0-1",0,1,"1",1,1,-1,"D"
"2376",1948-09-12,1948,"Stade Rennes","Stade Olympique Montpellierain","3-0",3,0,"1",1,3,3,"H"
"2377",1948-09-12,1948,"Racing Club de France","SR Colmar","3-3",3,3,"1",1,6,0,"D"
"2378",1948-09-12,1948,"AS Nancy","RC Roubaix","1-2",1,2,"1",1,3,-1,"D"
"2379",1948-09-12,1948,"AS Saint-Etienne","Toulouse FC","4-2",4,2,"1",1,6,2,"H"
"2380",1948-09-18,1948,"Stade Red Star","FC Metz","2-6",2,6,"1",1,8,-4,"D"
"2381",1948-09-19,1948,"OGC Nice","Olympique Marseille","0-5",0,5,"1",1,5,-5,"D"
"2382",1948-09-19,1948,"Stade Reims","RC Strasbourg","3-0",3,0,"1",1,3,3,"H"
"2383",1948-09-19,1948,"Stade Rennes","RC Roubaix","3-1",3,1,"1",1,4,2,"H"
"2384",1948-09-19,1948,"Lille OSC","Toulouse FC","1-1",1,1,"1",1,2,0,"D"
"2385",1948-09-19,1948,"FC Sochaux","Racing Club de France","1-2",1,2,"1",1,3,-1,"D"
"2386",1948-09-19,1948,"FC Sete","Stade Olympique Montpellierain","2-1",2,1,"1",1,3,1,"H"
"2387",1948-09-19,1948,"AS Saint-Etienne","AS Cannes-Grasse","3-1",3,1,"1",1,4,2,"H"
"2388",1948-09-19,1948,"AS Nancy","SR Colmar","1-2",1,2,"1",1,3,-1,"D"
"2389",1948-09-23,1948,"Olympique Marseille","Stade Rennes","1-3",1,3,"1",1,4,-2,"D"
"2390",1948-09-23,1948,"Racing Club de France","AS Nancy","5-1",5,1,"1",1,6,4,"H"
"2391",1948-09-23,1948,"AS Cannes-Grasse","FC Sete","0-2",0,2,"1",1,2,-2,"D"
"2392",1948-09-23,1948,"Toulouse FC","Stade Reims","2-0",2,0,"1",1,2,2,"H"
"2393",1948-09-23,1948,"FC Metz","Lille OSC","3-1",3,1,"1",1,4,2,"H"
"2394",1948-09-23,1948,"Stade Olympique Montpellierain","OGC Nice","1-1",1,1,"1",1,2,0,"D"
"2395",1948-09-23,1948,"RC Roubaix","FC Sochaux","5-1",5,1,"1",1,6,4,"H"
"2396",1948-09-23,1948,"SR Colmar","Stade Red Star","3-0",3,0,"1",1,3,3,"H"
"2397",1948-09-23,1948,"RC Strasbourg","AS Saint-Etienne","1-2",1,2,"1",1,3,-1,"D"
"2398",1948-09-26,1948,"Racing Club de France","Stade Rennes","2-3",2,3,"1",1,5,-1,"D"
"2399",1948-09-26,1948,"AS Cannes-Grasse","Stade Reims","1-3",1,3,"1",1,4,-2,"D"
"2400",1948-09-26,1948,"RC Strasbourg","Lille OSC","0-6",0,6,"1",1,6,-6,"D"
"2401",1948-09-26,1948,"SR Colmar","FC Metz","5-1",5,1,"1",1,6,4,"H"
"2402",1948-09-26,1948,"RC Roubaix","OGC Nice","2-1",2,1,"1",1,3,1,"H"
"2403",1948-09-26,1948,"Olympique Marseille","FC Sete","3-1",3,1,"1",1,4,2,"H"
"2404",1948-09-26,1948,"AS Nancy","FC Sochaux","2-2",2,2,"1",1,4,0,"D"
"2405",1948-09-26,1948,"Stade Olympique Montpellierain","AS Saint-Etienne","2-2",2,2,"1",1,4,0,"D"
"2406",1948-09-26,1948,"Toulouse FC","Stade Red Star","4-1",4,1,"1",1,5,3,"H"
"2407",1948-10-03,1948,"Stade Rennes","AS Nancy","4-0",4,0,"1",1,4,4,"H"
"2408",1948-10-03,1948,"Stade Reims","Stade Olympique Montpellierain","6-4",6,4,"1",1,10,2,"H"
"2409",1948-10-03,1948,"Lille OSC","AS Cannes-Grasse","2-0",2,0,"1",1,2,2,"H"
"2410",1948-10-03,1948,"AS Saint-Etienne","Olympique Marseille","4-1",4,1,"1",1,5,3,"H"
"2411",1948-10-03,1948,"FC Sete","RC Roubaix","0-0",0,0,"1",1,0,0,"D"
"2412",1948-10-03,1948,"FC Sochaux","SR Colmar","2-0",2,0,"1",1,2,2,"H"
"2413",1948-10-03,1948,"OGC Nice","Racing Club de France","3-0",3,0,"1",1,3,3,"H"
"2414",1948-10-03,1948,"FC Metz","Toulouse FC","2-1",2,1,"1",1,3,1,"H"
"2415",1948-10-03,1948,"Stade Red Star","RC Strasbourg","1-1",1,1,"1",1,2,0,"D"
"2416",1948-10-07,1948,"AS Nancy","Lille OSC","0-1",0,1,"1",1,1,-1,"D"
"2417",1948-10-07,1948,"Olympique Marseille","Toulouse FC","4-0",4,0,"1",1,4,4,"H"
"2418",1948-10-07,1948,"FC Sochaux","Stade Reims","3-0",3,0,"1",1,3,3,"H"
"2419",1948-10-07,1948,"Racing Club de France","Stade Red Star","4-0",4,0,"1",1,4,4,"H"
"2420",1948-10-07,1948,"OGC Nice","FC Sete","4-1",4,1,"1",1,5,3,"H"
"2421",1948-10-07,1948,"RC Roubaix","FC Metz","2-2",2,2,"1",1,4,0,"D"
"2422",1948-10-07,1948,"SR Colmar","AS Cannes-Grasse","1-1",1,1,"1",1,2,0,"D"
"2423",1948-10-07,1948,"Stade Olympique Montpellierain","RC Strasbourg","2-0",2,0,"1",1,2,2,"H"
"2424",1948-10-07,1948,"Stade Rennes","AS Saint-Etienne","1-3",1,3,"1",1,4,-2,"D"
"2425",1948-10-10,1948,"Lille OSC","FC Sochaux","3-1",3,1,"1",1,4,2,"H"
"2426",1948-10-10,1948,"RC Strasbourg","Olympique Marseille","1-2",1,2,"1",1,3,-1,"D"
"2427",1948-10-10,1948,"Stade Reims","Stade Rennes","4-2",4,2,"1",1,6,2,"H"
"2428",1948-10-10,1948,"FC Metz","Racing Club de France","1-2",1,2,"1",1,3,-1,"D"
"2429",1948-10-10,1948,"AS Saint-Etienne","OGC Nice","2-0",2,0,"1",1,2,2,"H"
"2430",1948-10-10,1948,"FC Sete","SR Colmar","3-4",3,4,"1",1,7,-1,"D"
"2431",1948-10-10,1948,"Toulouse FC","RC Roubaix","2-0",2,0,"1",1,2,2,"H"
"2432",1948-10-10,1948,"AS Cannes-Grasse","Stade Olympique Montpellierain","3-0",3,0,"1",1,3,3,"H"
"2433",1948-10-10,1948,"Stade Red Star","AS Nancy","3-3",3,3,"1",1,6,0,"D"
"2434",1948-10-24,1948,"Lille OSC","Olympique Marseille","2-2",2,2,"1",1,4,0,"D"
"2435",1948-10-24,1948,"Stade Reims","RC Roubaix","1-0",1,0,"1",1,1,1,"H"
"2436",1948-10-24,1948,"Stade Rennes","SR Colmar","2-0",2,0,"1",1,2,2,"H"
"2437",1948-10-24,1948,"AS Saint-Etienne","Racing Club de France","3-3",3,3,"1",1,6,0,"D"
"2438",1948-10-24,1948,"OGC Nice","FC Sochaux","5-4",5,4,"1",1,9,1,"H"
"2439",1948-10-24,1948,"FC Sete","AS Nancy","1-0",1,0,"1",1,1,1,"H"
"2440",1948-10-24,1948,"FC Metz","AS Cannes-Grasse","2-1",2,1,"1",1,3,1,"H"
"2441",1948-10-24,1948,"Toulouse FC","RC Strasbourg","5-1",5,1,"1",1,6,4,"H"
"2442",1948-10-24,1948,"Stade Red Star","Stade Olympique Montpellierain","3-0",3,0,"1",1,3,3,"H"
"2443",1948-10-31,1948,"Olympique Marseille","Stade Reims","3-4",3,4,"1",1,7,-1,"D"
"2444",1948-10-31,1948,"Stade Olympique Montpellierain","Lille OSC","2-1",2,1,"1",1,3,1,"H"
"2445",1948-10-31,1948,"Racing Club de France","FC Sete","5-1",5,1,"1",1,6,4,"H"
"2446",1948-10-31,1948,"FC Sochaux","Stade Rennes","3-1",3,1,"1",1,4,2,"H"
"2447",1948-10-31,1948,"RC Roubaix","AS Saint-Etienne","2-2",2,2,"1",1,4,0,"D"
"2448",1948-10-31,1948,"AS Nancy","OGC Nice","1-1",1,1,"1",1,2,0,"D"
"2449",1948-10-31,1948,"SR Colmar","Toulouse FC","2-0",2,0,"1",1,2,2,"H"
"2450",1948-10-31,1948,"RC Strasbourg","FC Metz","2-1",2,1,"1",1,3,1,"H"
"2451",1948-10-31,1948,"AS Cannes-Grasse","Stade Red Star","4-1",4,1,"1",1,5,3,"H"
"2452",1948-11-07,1948,"Stade Reims","AS Nancy","3-3",3,3,"1",1,6,0,"D"
"2453",1948-11-07,1948,"Lille OSC","Racing Club de France","2-3",2,3,"1",1,5,-1,"D"
"2454",1948-11-07,1948,"FC Metz","Olympique Marseille","1-4",1,4,"1",1,5,-3,"D"
"2455",1948-11-07,1948,"FC Sete","Stade Rennes","0-0",0,0,"1",1,0,0,"D"
"2456",1948-11-07,1948,"OGC Nice","SR Colmar","2-0",2,0,"1",1,2,2,"H"
"2457",1948-11-07,1948,"AS Saint-Etienne","FC Sochaux","1-1",1,1,"1",1,2,0,"D"
"2458",1948-11-07,1948,"Toulouse FC","Stade Olympique Montpellierain","4-1",4,1,"1",1,5,3,"H"
"2459",1948-11-07,1948,"Stade Red Star","RC Roubaix","1-1",1,1,"1",1,2,0,"D"
"2460",1948-11-07,1948,"RC Strasbourg","AS Cannes-Grasse","1-0",1,0,"1",1,1,1,"H"
"2461",1948-11-11,1948,"RC Roubaix","RC Strasbourg","1-0",1,0,"1",1,1,1,"H"
"2462",1948-11-11,1948,"FC Sete","AS Saint-Etienne","1-1",1,1,"1",1,2,0,"D"
"2463",1948-11-14,1948,"Racing Club de France","Stade Reims","3-1",3,1,"1",1,4,2,"H"
"2464",1948-11-14,1948,"Olympique Marseille","Stade Red Star","1-1",1,1,"1",1,2,0,"D"
"2465",1948-11-14,1948,"RC Roubaix","Lille OSC","1-4",1,4,"1",1,5,-3,"D"
"2466",1948-11-14,1948,"Stade Rennes","OGC Nice","2-0",2,0,"1",1,2,2,"H"
"2467",1948-11-14,1948,"AS Nancy","AS Saint-Etienne","4-2",4,2,"1",1,6,2,"H"
"2468",1948-11-14,1948,"FC Sochaux","FC Sete","7-0",7,0,"1",1,7,7,"H"
"2469",1948-11-14,1948,"SR Colmar","RC Strasbourg","2-1",2,1,"1",1,3,1,"H"
"2470",1948-11-14,1948,"AS Cannes-Grasse","Toulouse FC","2-1",2,1,"1",1,3,1,"H"
"2471",1948-11-14,1948,"Stade Olympique Montpellierain","FC Metz","4-1",4,1,"1",1,5,3,"H"
"2472",1948-11-21,1948,"Racing Club de France","Toulouse FC","5-0",5,0,"1",1,5,5,"H"
"2473",1948-11-21,1948,"Olympique Marseille","AS Cannes-Grasse","1-0",1,0,"1",1,1,1,"H"
"2474",1948-11-21,1948,"OGC Nice","Stade Reims","2-2",2,2,"1",1,4,0,"D"
"2475",1948-11-21,1948,"Stade Rennes","Lille OSC","1-1",1,1,"1",1,2,0,"D"
"2476",1948-11-21,1948,"FC Sochaux","Stade Red Star","0-2",0,2,"1",1,2,-2,"D"
"2477",1948-11-21,1948,"SR Colmar","Stade Olympique Montpellierain","1-3",1,3,"1",1,4,-2,"D"
"2478",1948-11-21,1948,"AS Nancy","FC Metz","2-1",2,1,"1",1,3,1,"H"
"2479",1948-11-28,1948,"RC Strasbourg","Racing Club de France","3-1",3,1,"1",1,4,2,"H"
"2480",1948-11-28,1948,"Stade Olympique Montpellierain","Olympique Marseille","1-2",1,2,"1",1,3,-1,"D"
"2481",1948-11-28,1948,"Stade Reims","FC Sete","2-0",2,0,"1",1,2,2,"H"
"2482",1948-11-28,1948,"Lille OSC","OGC Nice","4-1",4,1,"1",1,5,3,"H"
"2483",1948-11-28,1948,"Stade Red Star","Stade Rennes","0-0",0,0,"1",1,0,0,"D"
"2484",1948-11-28,1948,"AS Saint-Etienne","SR Colmar","5-2",5,2,"1",1,7,3,"H"
"2485",1948-11-28,1948,"FC Metz","FC Sochaux","4-1",4,1,"1",1,5,3,"H"
"2486",1948-11-28,1948,"Toulouse FC","AS Nancy","2-1",2,1,"1",1,3,1,"H"
"2487",1948-11-28,1948,"AS Cannes-Grasse","RC Roubaix","3-0",3,0,"1",1,3,3,"H"
"2488",1948-12-05,1948,"Racing Club de France","AS Cannes-Grasse","3-0",3,0,"1",1,3,3,"H"
"2489",1948-12-05,1948,"Lille OSC","FC Sete","6-1",6,1,"1",1,7,5,"H"
"2490",1948-12-05,1948,"SR Colmar","Olympique Marseille","1-1",1,1,"1",1,2,0,"D"
"2491",1948-12-05,1948,"Stade Rennes","FC Metz","4-3",4,3,"1",1,7,1,"H"
"2492",1948-12-05,1948,"Stade Reims","AS Saint-Etienne","2-3",2,3,"1",1,5,-1,"D"
"2493",1948-12-05,1948,"OGC Nice","Stade Red Star","2-2",2,2,"1",1,4,0,"D"
"2494",1948-12-05,1948,"Toulouse FC","FC Sochaux","3-0",3,0,"1",1,3,3,"H"
"2495",1948-12-05,1948,"Stade Olympique Montpellierain","RC Roubaix","4-1",4,1,"1",1,5,3,"H"
"2496",1948-12-05,1948,"AS Nancy","RC Strasbourg","3-3",3,3,"1",1,6,0,"D"
"2497",1948-12-19,1948,"RC Roubaix","Olympique Marseille","2-10",2,10,"1",1,12,-8,"D"
"2498",1948-12-19,1948,"Racing Club de France","Stade Olympique Montpellierain","1-1",1,1,"1",1,2,0,"D"
"2499",1948-12-19,1948,"AS Saint-Etienne","Lille OSC","2-2",2,2,"1",1,4,0,"D"
"2500",1948-12-19,1948,"Stade Rennes","Toulouse FC","2-0",2,0,"1",1,2,2,"H"
"2501",1948-12-19,1948,"Stade Reims","SR Colmar","1-2",1,2,"1",1,3,-1,"D"
"2502",1948-12-19,1948,"FC Metz","OGC Nice","2-2",2,2,"1",1,4,0,"D"
"2503",1948-12-19,1948,"FC Sochaux","RC Strasbourg","3-0",3,0,"1",1,3,3,"H"
"2504",1948-12-19,1948,"FC Sete","Stade Red Star","1-0",1,0,"1",1,1,1,"H"
"2505",1948-12-19,1948,"AS Cannes-Grasse","AS Nancy","4-1",4,1,"1",1,5,3,"H"
"2506",1948-12-25,1948,"Stade Red Star","AS Saint-Etienne","4-1",4,1,"1",1,5,3,"H"
"2507",1948-12-26,1948,"Olympique Marseille","Racing Club de France","3-0",3,0,"1",1,3,3,"H"
"2508",1948-12-26,1948,"Lille OSC","Stade Reims","2-1",2,1,"1",1,3,1,"H"
"2509",1948-12-26,1948,"RC Strasbourg","Stade Rennes","3-0",3,0,"1",1,3,3,"H"
"2510",1948-12-26,1948,"SR Colmar","RC Roubaix","5-0",5,0,"1",1,5,5,"H"
"2511",1948-12-26,1948,"AS Cannes-Grasse","FC Sochaux","1-1",1,1,"1",1,2,0,"D"
"2512",1948-12-26,1948,"Toulouse FC","OGC Nice","3-0",3,0,"1",1,3,3,"H"
"2513",1948-12-26,1948,"FC Metz","FC Sete","0-2",0,2,"1",1,2,-2,"D"
"2514",1948-12-26,1948,"Stade Olympique Montpellierain","AS Nancy","3-4",3,4,"1",1,7,-1,"D"
"2515",1949-01-02,1948,"Lille OSC","SR Colmar","8-0",8,0,"1",1,8,8,"H"
"2516",1949-01-02,1948,"AS Nancy","Olympique Marseille","3-2",3,2,"1",1,5,1,"H"
"2517",1949-01-02,1948,"Racing Club de France","RC Roubaix","1-1",1,1,"1",1,2,0,"D"
"2518",1949-01-02,1948,"Stade Rennes","AS Cannes-Grasse","1-0",1,0,"1",1,1,1,"H"
"2519",1949-01-02,1948,"Stade Reims","Stade Red Star","4-0",4,0,"1",1,4,4,"H"
"2520",1949-01-02,1948,"FC Sochaux","Stade Olympique Montpellierain","4-2",4,2,"1",1,6,2,"H"
"2521",1949-01-02,1948,"AS Saint-Etienne","FC Metz","3-1",3,1,"1",1,4,2,"H"
"2522",1949-01-02,1948,"OGC Nice","RC Strasbourg","1-0",1,0,"1",1,1,1,"H"
"2523",1949-01-02,1948,"FC Sete","Toulouse FC","0-0",0,0,"1",1,0,0,"D"
"2524",1949-01-16,1948,"Olympique Marseille","FC Sochaux","3-1",3,1,"1",1,4,2,"H"
"2525",1949-01-16,1948,"Stade Red Star","Lille OSC","1-0",1,0,"1",1,1,1,"H"
"2526",1949-01-16,1948,"FC Metz","Stade Reims","2-3",2,3,"1",1,5,-1,"D"
"2527",1949-01-16,1948,"Stade Olympique Montpellierain","Stade Rennes","2-1",2,1,"1",1,3,1,"H"
"2528",1949-01-16,1948,"Toulouse FC","AS Saint-Etienne","5-1",5,1,"1",1,6,4,"H"
"2529",1949-01-16,1948,"AS Cannes-Grasse","OGC Nice","1-2",1,2,"1",1,3,-1,"D"
"2530",1949-01-16,1948,"RC Strasbourg","FC Sete","0-0",0,0,"1",1,0,0,"D"
"2531",1949-01-16,1948,"RC Roubaix","AS Nancy","3-1",3,1,"1",1,4,2,"H"
"2532",1949-01-20,1948,"SR Colmar","Racing Club de France","3-0",3,0,"1",1,3,3,"H"
"2533",1949-01-23,1948,"Lille OSC","FC Metz","5-0",5,0,"1",1,5,5,"H"
"2534",1949-01-23,1948,"Stade Rennes","Olympique Marseille","6-1",6,1,"1",1,7,5,"H"
"2535",1949-01-23,1948,"Stade Reims","Toulouse FC","2-0",2,0,"1",1,2,2,"H"
"2536",1949-01-23,1948,"AS Nancy","Racing Club de France","3-1",3,1,"1",1,4,2,"H"
"2537",1949-01-23,1948,"AS Saint-Etienne","RC Strasbourg","5-1",5,1,"1",1,6,4,"H"
"2538",1949-01-23,1948,"OGC Nice","Stade Olympique Montpellierain","0-0",0,0,"1",1,0,0,"D"
"2539",1949-01-23,1948,"Stade Red Star","SR Colmar","5-2",5,2,"1",1,7,3,"H"
"2540",1949-01-23,1948,"FC Sete","AS Cannes-Grasse","1-0",1,0,"1",1,1,1,"H"
"2541",1949-01-23,1948,"FC Sochaux","RC Roubaix","5-1",5,1,"1",1,6,4,"H"
"2542",1949-02-06,1948,"Toulouse FC","Lille OSC","1-4",1,4,"1",1,5,-3,"D"
"2543",1949-02-06,1948,"Olympique Marseille","OGC Nice","2-2",2,2,"1",1,4,0,"D"
"2544",1949-02-06,1948,"RC Strasbourg","Stade Reims","1-4",1,4,"1",1,5,-3,"D"
"2545",1949-02-06,1948,"RC Roubaix","Stade Rennes","3-2",3,2,"1",1,5,1,"H"
"2546",1949-02-06,1948,"Racing Club de France","FC Sochaux","0-1",0,1,"1",1,1,-1,"D"
"2547",1949-02-06,1948,"AS Cannes-Grasse","AS Saint-Etienne","1-0",1,0,"1",1,1,1,"H"
"2548",1949-02-06,1948,"SR Colmar","AS Nancy","0-2",0,2,"1",1,2,-2,"D"
"2549",1949-02-06,1948,"Stade Olympique Montpellierain","FC Sete","1-0",1,0,"1",1,1,1,"H"
"2550",1949-02-06,1948,"FC Metz","Stade Red Star","2-3",2,3,"1",1,5,-1,"D"
"2551",1949-02-13,1948,"Lille OSC","RC Strasbourg","1-2",1,2,"1",1,3,-1,"D"
"2552",1949-02-13,1948,"Stade Reims","AS Cannes-Grasse","5-2",5,2,"1",1,7,3,"H"
"2553",1949-02-13,1948,"FC Sete","Olympique Marseille","1-1",1,1,"1",1,2,0,"D"
"2554",1949-02-13,1948,"Stade Rennes","Racing Club de France","0-0",0,0,"1",1,0,0,"D"
"2555",1949-02-13,1948,"OGC Nice","RC Roubaix","4-2",4,2,"1",1,6,2,"H"
"2556",1949-02-13,1948,"AS Saint-Etienne","Stade Olympique Montpellierain","0-4",0,4,"1",1,4,-4,"D"
"2557",1949-02-13,1948,"FC Sochaux","AS Nancy","3-2",3,2,"1",1,5,1,"H"
"2558",1949-02-13,1948,"Stade Red Star","Toulouse FC","3-1",3,1,"1",1,4,2,"H"
"2559",1949-02-13,1948,"FC Metz","SR Colmar","2-0",2,0,"1",1,2,2,"H"
"2560",1949-02-20,1948,"Racing Club de France","OGC Nice","1-1",1,1,"1",1,2,0,"D"
"2561",1949-02-20,1948,"SR Colmar","FC Sochaux","0-3",0,3,"1",1,3,-3,"D"
"2562",1949-02-20,1948,"Toulouse FC","FC Metz","1-0",1,0,"1",1,1,1,"H"
"2563",1949-02-20,1948,"RC Roubaix","FC Sete","2-1",2,1,"1",1,3,1,"H"
"2564",1949-02-20,1948,"RC Strasbourg","Stade Red Star","3-2",3,2,"1",1,5,1,"H"
"2565",1949-02-20,1948,"AS Cannes-Grasse","Lille OSC","1-6",1,6,"1",1,7,-5,"D"
"2566",1949-02-20,1948,"Stade Olympique Montpellierain","Stade Reims","0-1",0,1,"1",1,1,-1,"D"
"2567",1949-02-20,1948,"Olympique Marseille","AS Saint-Etienne","6-1",6,1,"1",1,7,5,"H"
"2568",1949-02-20,1948,"AS Nancy","Stade Rennes","1-2",1,2,"1",1,3,-1,"D"
"2569",1949-03-06,1948,"Lille OSC","Stade Olympique Montpellierain","5-0",5,0,"1",1,5,5,"H"
"2570",1949-03-06,1948,"Stade Reims","Olympique Marseille","2-0",2,0,"1",1,2,2,"H"
"2571",1949-03-06,1948,"Stade Rennes","FC Sochaux","1-0",1,0,"1",1,1,1,"H"
"2572",1949-03-06,1948,"FC Sete","Racing Club de France","0-2",0,2,"1",1,2,-2,"D"
"2573",1949-03-06,1948,"OGC Nice","AS Nancy","0-0",0,0,"1",1,0,0,"D"
"2574",1949-03-06,1948,"Toulouse FC","SR Colmar","7-0",7,0,"1",1,7,7,"H"
"2575",1949-03-06,1948,"Stade Red Star","AS Cannes-Grasse","6-3",6,3,"1",1,9,3,"H"
"2576",1949-03-06,1948,"FC Metz","RC Strasbourg","3-0",3,0,"1",1,3,3,"H"
"2577",1949-03-06,1948,"AS Saint-Etienne","RC Roubaix","6-0",6,0,"1",1,6,6,"H"
"2578",1949-03-13,1948,"RC Roubaix","Stade Reims","1-5",1,5,"1",1,6,-4,"D"
"2579",1949-03-13,1948,"Olympique Marseille","Lille OSC","2-1",2,1,"1",1,3,1,"H"
"2580",1949-03-13,1948,"SR Colmar","Stade Rennes","2-2",2,2,"1",1,4,0,"D"
"2581",1949-03-13,1948,"FC Sochaux","OGC Nice","2-0",2,0,"1",1,2,2,"H"
"2582",1949-03-13,1948,"Racing Club de France","AS Saint-Etienne","1-2",1,2,"1",1,3,-1,"D"
"2583",1949-03-13,1948,"RC Strasbourg","Toulouse FC","0-1",0,1,"1",1,1,-1,"D"
"2584",1949-03-13,1948,"Stade Olympique Montpellierain","Stade Red Star","6-1",6,1,"1",1,7,5,"H"
"2585",1949-03-13,1948,"AS Nancy","FC Sete","3-0",3,0,"1",1,3,3,"H"
"2586",1949-03-13,1948,"AS Cannes-Grasse","FC Metz","1-1",1,1,"1",1,2,0,"D"
"2587",1949-03-27,1948,"Stade Reims","Racing Club de France","1-0",1,0,"1",1,1,1,"H"
"2588",1949-03-27,1948,"Lille OSC","RC Roubaix","6-2",6,2,"1",1,8,4,"H"
"2589",1949-03-27,1948,"Stade Red Star","Olympique Marseille","1-0",1,0,"1",1,1,1,"H"
"2590",1949-03-27,1948,"OGC Nice","Stade Rennes","8-0",8,0,"1",1,8,8,"H"
"2591",1949-03-27,1948,"AS Saint-Etienne","AS Nancy","4-1",4,1,"1",1,5,3,"H"
"2592",1949-03-27,1948,"FC Sete","FC Sochaux","3-0",3,0,"1",1,3,3,"H"
"2593",1949-03-27,1948,"Toulouse FC","AS Cannes-Grasse","1-0",1,0,"1",1,1,1,"H"
"2594",1949-03-27,1948,"FC Metz","Stade Olympique Montpellierain","2-2",2,2,"1",1,4,0,"D"
"2595",1949-03-27,1948,"RC Strasbourg","SR Colmar","0-0",0,0,"1",1,0,0,"D"
"2596",1949-04-10,1948,"Stade Rennes","FC Sete","3-1",3,1,"1",1,4,2,"H"
"2597",1949-04-14,1948,"AS Nancy","Stade Reims","0-1",0,1,"1",1,1,-1,"D"
"2598",1949-04-14,1948,"Racing Club de France","Lille OSC","4-3",4,3,"1",1,7,1,"H"
"2599",1949-04-14,1948,"Olympique Marseille","FC Metz","4-2",4,2,"1",1,6,2,"H"
"2600",1949-04-14,1948,"AS Cannes-Grasse","RC Strasbourg","1-1",1,1,"1",1,2,0,"D"
"2601",1949-04-14,1948,"FC Sochaux","AS Saint-Etienne","6-0",6,0,"1",1,6,6,"H"
"2602",1949-04-14,1948,"SR Colmar","OGC Nice","1-2",1,2,"1",1,3,-1,"D"
"2603",1949-04-14,1948,"Stade Olympique Montpellierain","Toulouse FC","2-1",2,1,"1",1,3,1,"H"
"2604",1949-04-14,1948,"RC Roubaix","Stade Red Star","2-2",2,2,"1",1,4,0,"D"
"2605",1949-04-17,1948,"Stade Reims","FC Sochaux","2-2",2,2,"1",1,4,0,"D"
"2606",1949-04-17,1948,"Lille OSC","AS Nancy","4-0",4,0,"1",1,4,4,"H"
"2607",1949-04-17,1948,"Toulouse FC","Olympique Marseille","2-1",2,1,"1",1,3,1,"H"
"2608",1949-04-17,1948,"AS Saint-Etienne","Stade Rennes","1-1",1,1,"1",1,2,0,"D"
"2609",1949-04-17,1948,"FC Sete","OGC Nice","3-2",3,2,"1",1,5,1,"H"
"2610",1949-04-17,1948,"Stade Red Star","Racing Club de France","1-0",1,0,"1",1,1,1,"H"
"2611",1949-04-17,1948,"RC Strasbourg","Stade Olympique Montpellierain","3-0",3,0,"1",1,3,3,"H"
"2612",1949-04-17,1948,"AS Cannes-Grasse","SR Colmar","4-2",4,2,"1",1,6,2,"H"
"2613",1949-04-17,1948,"FC Metz","RC Roubaix","3-0",3,0,"1",1,3,3,"H"
"2614",1949-05-01,1948,"FC Sochaux","Lille OSC","1-3",1,3,"1",1,4,-2,"D"
"2615",1949-05-01,1948,"Stade Rennes","Stade Reims","1-0",1,0,"1",1,1,1,"H"
"2616",1949-05-01,1948,"Olympique Marseille","RC Strasbourg","5-0",5,0,"1",1,5,5,"H"
"2617",1949-05-01,1948,"OGC Nice","AS Saint-Etienne","1-0",1,0,"1",1,1,1,"H"
"2618",1949-05-01,1948,"Racing Club de France","FC Metz","2-2",2,2,"1",1,4,0,"D"
"2619",1949-05-01,1948,"RC Roubaix","Toulouse FC","3-1",3,1,"1",1,4,2,"H"
"2620",1949-05-01,1948,"AS Nancy","Stade Red Star","3-1",3,1,"1",1,4,2,"H"
"2621",1949-05-01,1948,"Stade Olympique Montpellierain","AS Cannes-Grasse","1-3",1,3,"1",1,4,-2,"D"
"2622",1949-05-01,1948,"SR Colmar","FC Sete","5-1",5,1,"1",1,6,4,"H"
"2623",1949-05-14,1948,"Stade Red Star","FC Sochaux","2-2",2,2,"1",1,4,0,"D"
"2624",1949-05-15,1948,"Stade Reims","OGC Nice","6-1",6,1,"1",1,7,5,"H"
"2625",1949-05-15,1948,"Lille OSC","Stade Rennes","3-0",3,0,"1",1,3,3,"H"
"2626",1949-05-15,1948,"AS Cannes-Grasse","Olympique Marseille","1-0",1,0,"1",1,1,1,"H"
"2627",1949-05-15,1948,"AS Saint-Etienne","FC Sete","0-0",0,0,"1",1,0,0,"D"
"2628",1949-05-15,1948,"Toulouse FC","Racing Club de France","2-1",2,1,"1",1,3,1,"H"
"2629",1949-05-15,1948,"Stade Olympique Montpellierain","SR Colmar","0-1",0,1,"1",1,1,-1,"D"
"2630",1949-05-15,1948,"RC Strasbourg","RC Roubaix","1-2",1,2,"1",1,3,-1,"D"
"2631",1949-05-15,1948,"FC Metz","AS Nancy","2-0",2,0,"1",1,2,2,"H"
"2632",1949-05-29,1948,"OGC Nice","Lille OSC","1-2",1,2,"1",1,3,-1,"D"
"2633",1949-05-29,1948,"Olympique Marseille","Stade Olympique Montpellierain","6-3",6,3,"1",1,9,3,"H"
"2634",1949-05-29,1948,"Stade Rennes","Stade Red Star","1-1",1,1,"1",1,2,0,"D"
"2635",1949-05-29,1948,"FC Sochaux","FC Metz","2-1",2,1,"1",1,3,1,"H"
"2636",1949-05-29,1948,"Racing Club de France","RC Strasbourg","4-2",4,2,"1",1,6,2,"H"
"2637",1949-05-29,1948,"SR Colmar","AS Saint-Etienne","3-1",3,1,"1",1,4,2,"H"
"2638",1949-05-29,1948,"AS Nancy","Toulouse FC","2-0",2,0,"1",1,2,2,"H"
"2639",1949-05-29,1948,"RC Roubaix","AS Cannes-Grasse","4-0",4,0,"1",1,4,4,"H"
"2640",1949-06-01,1948,"FC Sete","Stade Reims","1-2",1,2,"1",1,3,-1,"D"
"2641",1949-08-21,1949,"Olympique Marseille","Girondins Bordeaux","3-0",3,0,"1",1,3,3,"H"
"2642",1949-08-21,1949,"Stade Red Star","Stade Rennes","3-1",3,1,"1",1,4,2,"H"
"2643",1949-08-21,1949,"FC Sochaux","Racing Club de France","0-2",0,2,"1",1,2,-2,"D"
"2644",1949-08-21,1949,"AS Saint-Etienne","Lille OSC","3-4",3,4,"1",1,7,-1,"D"
"2645",1949-08-21,1949,"RC Strasbourg","Stade Reims","2-1",2,1,"1",1,3,1,"H"
"2646",1949-08-21,1949,"Stade Olympique Montpellierain","AS Nancy","2-1",2,1,"1",1,3,1,"H"
"2647",1949-08-21,1949,"RC Lens","OGC Nice","2-1",2,1,"1",1,3,1,"H"
"2648",1949-08-21,1949,"RC Roubaix","Toulouse FC","0-1",0,1,"1",1,1,-1,"D"
"2649",1949-08-21,1949,"FC Metz","FC Sete","1-1",1,1,"1",1,2,0,"D"
"2650",1949-08-28,1949,"Lille OSC","Stade Olympique Montpellierain","5-0",5,0,"1",1,5,5,"H"
"2651",1949-08-28,1949,"RC Lens","FC Metz","5-3",5,3,"1",1,8,2,"H"
"2652",1949-08-28,1949,"AS Nancy","Olympique Marseille","4-0",4,0,"1",1,4,4,"H"
"2653",1949-08-28,1949,"AS Saint-Etienne","Toulouse FC","3-0",3,0,"1",1,3,3,"H"
"2654",1949-08-28,1949,"Girondins Bordeaux","Stade Red Star","2-1",2,1,"1",1,3,1,"H"
"2655",1949-08-28,1949,"Racing Club de France","OGC Nice","1-2",1,2,"1",1,3,-1,"D"
"2656",1949-08-28,1949,"FC Sete","RC Roubaix","3-3",3,3,"1",1,6,0,"D"
"2657",1949-08-28,1949,"RC Strasbourg","FC Sochaux","0-1",0,1,"1",1,1,-1,"D"
"2658",1949-08-28,1949,"Stade Rennes","Stade Reims","1-1",1,1,"1",1,2,0,"D"
"2659",1949-09-03,1949,"Stade Red Star","AS Nancy","0-4",0,4,"1",1,4,-4,"D"
"2660",1949-09-04,1949,"Olympique Marseille","Lille OSC","2-3",2,3,"1",1,5,-1,"D"
"2661",1949-09-04,1949,"OGC Nice","RC Strasbourg","5-1",5,1,"1",1,6,4,"H"
"2662",1949-09-04,1949,"FC Metz","Racing Club de France","1-4",1,4,"1",1,5,-3,"D"
"2663",1949-09-04,1949,"RC Roubaix","RC Lens","1-0",1,0,"1",1,1,1,"H"
"2664",1949-09-04,1949,"Stade Reims","Girondins Bordeaux","0-2",0,2,"1",1,2,-2,"D"
"2665",1949-09-04,1949,"Toulouse FC","FC Sete","3-1",3,1,"1",1,4,2,"H"
"2666",1949-09-04,1949,"FC Sochaux","Stade Rennes","2-1",2,1,"1",1,3,1,"H"
"2667",1949-09-04,1949,"Stade Olympique Montpellierain","AS Saint-Etienne","1-1",1,1,"1",1,2,0,"D"
"2668",1949-09-11,1949,"AS Nancy","Lille OSC","0-1",0,1,"1",1,1,-1,"D"
"2669",1949-09-11,1949,"Girondins Bordeaux","Stade Olympique Montpellierain","7-0",7,0,"1",1,7,7,"H"
"2670",1949-09-11,1949,"Toulouse FC","FC Metz","8-2",8,2,"1",1,10,6,"H"
"2671",1949-09-11,1949,"RC Lens","FC Sochaux","1-2",1,2,"1",1,3,-1,"D"
"2672",1949-09-11,1949,"RC Roubaix","AS Saint-Etienne","2-0",2,0,"1",1,2,2,"H"
"2673",1949-09-11,1949,"FC Sete","OGC Nice","1-0",1,0,"1",1,1,1,"H"
"2674",1949-09-11,1949,"Racing Club de France","Stade Reims","2-4",2,4,"1",1,6,-2,"D"
"2675",1949-09-11,1949,"RC Strasbourg","Stade Red Star","3-1",3,1,"1",1,4,2,"H"
"2676",1949-09-11,1949,"Stade Rennes","Olympique Marseille","1-1",1,1,"1",1,2,0,"D"
"2677",1949-09-18,1949,"Lille OSC","Girondins Bordeaux","4-2",4,2,"1",1,6,2,"H"
"2678",1949-09-18,1949,"OGC Nice","Toulouse FC","0-5",0,5,"1",1,5,-5,"D"
"2679",1949-09-18,1949,"FC Sochaux","FC Sete","8-1",8,1,"1",1,9,7,"H"
"2680",1949-09-18,1949,"FC Metz","RC Roubaix","2-2",2,2,"1",1,4,0,"D"
"2681",1949-09-18,1949,"Stade Reims","RC Lens","5-0",5,0,"1",1,5,5,"H"
"2682",1949-09-18,1949,"Olympique Marseille","RC Strasbourg","2-2",2,2,"1",1,4,0,"D"
"2683",1949-09-18,1949,"Stade Red Star","Racing Club de France","2-1",2,1,"1",1,3,1,"H"
"2684",1949-09-18,1949,"Stade Olympique Montpellierain","Stade Rennes","5-6",5,6,"1",1,11,-1,"D"
"2685",1949-09-18,1949,"AS Saint-Etienne","AS Nancy","3-5",3,5,"1",1,8,-2,"D"
"2686",1949-09-22,1949,"Stade Rennes","Lille OSC","0-3",0,3,"1",1,3,-3,"D"
"2687",1949-09-22,1949,"Toulouse FC","FC Sochaux","0-0",0,0,"1",1,0,0,"D"
"2688",1949-09-22,1949,"Girondins Bordeaux","AS Nancy","5-0",5,0,"1",1,5,5,"H"
"2689",1949-09-22,1949,"RC Roubaix","OGC Nice","1-0",1,0,"1",1,1,1,"H"
"2690",1949-09-22,1949,"RC Strasbourg","Stade Olympique Montpellierain","2-1",2,1,"1",1,3,1,"H"
"2691",1949-09-22,1949,"Racing Club de France","Olympique Marseille","5-0",5,0,"1",1,5,5,"H"
"2692",1949-09-22,1949,"RC Lens","Stade Red Star","2-1",2,1,"1",1,3,1,"H"
"2693",1949-09-22,1949,"FC Sete","Stade Reims","3-1",3,1,"1",1,4,2,"H"
"2694",1949-09-22,1949,"FC Metz","AS Saint-Etienne","1-4",1,4,"1",1,5,-3,"D"
"2695",1949-09-24,1949,"Stade Red Star","FC Sete","4-0",4,0,"1",1,4,4,"H"
"2696",1949-09-25,1949,"Lille OSC","RC Strasbourg","7-1",7,1,"1",1,8,6,"H"
"2697",1949-09-25,1949,"Girondins Bordeaux","AS Saint-Etienne","5-2",5,2,"1",1,7,3,"H"
"2698",1949-09-25,1949,"FC Sochaux","RC Roubaix","1-1",1,1,"1",1,2,0,"D"
"2699",1949-09-25,1949,"Stade Reims","Toulouse FC","1-0",1,0,"1",1,1,1,"H"
"2700",1949-09-25,1949,"AS Nancy","Stade Rennes","3-1",3,1,"1",1,4,2,"H"
"2701",1949-09-25,1949,"Olympique Marseille","RC Lens","1-4",1,4,"1",1,5,-3,"D"
"2702",1949-09-25,1949,"Stade Olympique Montpellierain","Racing Club de France","3-1",3,1,"1",1,4,2,"H"
"2703",1949-09-25,1949,"OGC Nice","FC Metz","0-2",0,2,"1",1,2,-2,"D"
"2704",1949-10-02,1949,"Racing Club de France","Lille OSC","3-1",3,1,"1",1,4,2,"H"
"2705",1949-10-02,1949,"FC Metz","FC Sochaux","0-2",0,2,"1",1,2,-2,"D"
"2706",1949-10-02,1949,"Stade Rennes","Girondins Bordeaux","0-0",0,0,"1",1,0,0,"D"
"2707",1949-10-02,1949,"Toulouse FC","Stade Red Star","5-2",5,2,"1",1,7,3,"H"
"2708",1949-10-02,1949,"RC Roubaix","Stade Reims","1-1",1,1,"1",1,2,0,"D"
"2709",1949-10-02,1949,"RC Strasbourg","AS Nancy","3-0",3,0,"1",1,3,3,"H"
"2710",1949-10-02,1949,"AS Saint-Etienne","OGC Nice","2-0",2,0,"1",1,2,2,"H"
"2711",1949-10-02,1949,"FC Sete","Olympique Marseille","1-2",1,2,"1",1,3,-1,"D"
"2712",1949-10-02,1949,"RC Lens","Stade Olympique Montpellierain","3-0",3,0,"1",1,3,3,"H"
"2713",1949-10-16,1949,"Lille OSC","RC Lens","4-1",4,1,"1",1,5,3,"H"
"2714",1949-10-16,1949,"Girondins Bordeaux","RC Strasbourg","6-0",6,0,"1",1,6,6,"H"
"2715",1949-10-16,1949,"Olympique Marseille","Toulouse FC","2-2",2,2,"1",1,4,0,"D"
"2716",1949-10-16,1949,"OGC Nice","FC Sochaux","5-0",5,0,"1",1,5,5,"H"
"2717",1949-10-16,1949,"Stade Red Star","RC Roubaix","2-2",2,2,"1",1,4,0,"D"
"2718",1949-10-16,1949,"Stade Reims","FC Metz","6-2",6,2,"1",1,8,4,"H"
"2719",1949-10-16,1949,"AS Nancy","Racing Club de France","1-1",1,1,"1",1,2,0,"D"
"2720",1949-10-16,1949,"AS Saint-Etienne","Stade Rennes","2-2",2,2,"1",1,4,0,"D"
"2721",1949-10-16,1949,"Stade Olympique Montpellierain","FC Sete","3-2",3,2,"1",1,5,1,"H"
"2722",1949-10-23,1949,"FC Sete","Lille OSC","0-2",0,2,"1",1,2,-2,"D"
"2723",1949-10-23,1949,"Racing Club de France","Girondins Bordeaux","3-4",3,4,"1",1,7,-1,"D"
"2724",1949-10-23,1949,"Toulouse FC","Stade Olympique Montpellierain","3-1",3,1,"1",1,4,2,"H"
"2725",1949-10-23,1949,"FC Sochaux","AS Saint-Etienne","6-2",6,2,"1",1,8,4,"H"
"2726",1949-10-23,1949,"RC Roubaix","Olympique Marseille","1-1",1,1,"1",1,2,0,"D"
"2727",1949-10-23,1949,"RC Lens","AS Nancy","2-1",2,1,"1",1,3,1,"H"
"2728",1949-10-23,1949,"OGC Nice","Stade Reims","1-1",1,1,"1",1,2,0,"D"
"2729",1949-10-23,1949,"RC Strasbourg","Stade Rennes","2-3",2,3,"1",1,5,-1,"D"
"2730",1949-10-23,1949,"FC Metz","Stade Red Star","1-1",1,1,"1",1,2,0,"D"
"2731",1949-11-06,1949,"Stade Reims","FC Sochaux","5-3",5,3,"1",1,8,2,"H"
"2732",1949-11-06,1949,"Stade Olympique Montpellierain","RC Roubaix","0-1",0,1,"1",1,1,-1,"D"
"2733",1949-11-06,1949,"Stade Rennes","Racing Club de France","1-2",1,2,"1",1,3,-1,"D"
"2734",1949-11-06,1949,"AS Nancy","FC Sete","4-0",4,0,"1",1,4,4,"H"
"2735",1949-11-06,1949,"AS Saint-Etienne","RC Strasbourg","5-0",5,0,"1",1,5,5,"H"
"2736",1949-11-06,1949,"Olympique Marseille","FC Metz","4-0",4,0,"1",1,4,4,"H"
"2737",1949-11-06,1949,"Stade Red Star","OGC Nice","0-2",0,2,"1",1,2,-2,"D"
"2738",1949-11-06,1949,"Lille OSC","Toulouse FC","4-1",4,1,"1",1,5,3,"H"
"2739",1949-11-06,1949,"Girondins Bordeaux","RC Lens","5-1",5,1,"1",1,6,4,"H"
"2740",1949-11-20,1949,"RC Roubaix","Lille OSC","1-2",1,2,"1",1,3,-1,"D"
"2741",1949-11-20,1949,"FC Sete","Girondins Bordeaux","2-2",2,2,"1",1,4,0,"D"
"2742",1949-11-20,1949,"Toulouse FC","AS Nancy","2-0",2,0,"1",1,2,2,"H"
"2743",1949-11-20,1949,"Stade Reims","AS Saint-Etienne","0-0",0,0,"1",1,0,0,"D"
"2744",1949-11-20,1949,"FC Sochaux","Stade Red Star","1-2",1,2,"1",1,3,-1,"D"
"2745",1949-11-20,1949,"Racing Club de France","RC Strasbourg","3-0",3,0,"1",1,3,3,"H"
"2746",1949-11-20,1949,"RC Lens","Stade Rennes","3-3",3,3,"1",1,6,0,"D"
"2747",1949-11-20,1949,"OGC Nice","Olympique Marseille","6-4",6,4,"1",1,10,2,"H"
"2748",1949-11-20,1949,"FC Metz","Stade Olympique Montpellierain","5-2",5,2,"1",1,7,3,"H"
"2749",1949-11-27,1949,"Lille OSC","FC Metz","2-1",2,1,"1",1,3,1,"H"
"2750",1949-11-27,1949,"Girondins Bordeaux","Toulouse FC","1-2",1,2,"1",1,3,-1,"D"
"2751",1949-11-27,1949,"AS Nancy","RC Roubaix","2-2",2,2,"1",1,4,0,"D"
"2752",1949-11-27,1949,"AS Saint-Etienne","Racing Club de France","1-1",1,1,"1",1,2,0,"D"
"2753",1949-11-27,1949,"Stade Red Star","Stade Reims","2-0",2,0,"1",1,2,2,"H"
"2754",1949-11-27,1949,"Olympique Marseille","FC Sochaux","3-0",3,0,"1",1,3,3,"H"
"2755",1949-11-27,1949,"RC Strasbourg","RC Lens","3-2",3,2,"1",1,5,1,"H"
"2756",1949-11-27,1949,"Stade Olympique Montpellierain","OGC Nice","2-2",2,2,"1",1,4,0,"D"
"2757",1949-11-27,1949,"Stade Rennes","FC Sete","4-2",4,2,"1",1,6,2,"H"
"2758",1949-12-04,1949,"OGC Nice","Lille OSC","3-2",3,2,"1",1,5,1,"H"
"2759",1949-12-04,1949,"Toulouse FC","Stade Rennes","3-2",3,2,"1",1,5,1,"H"
"2760",1949-12-04,1949,"RC Roubaix","Girondins Bordeaux","0-0",0,0,"1",1,0,0,"D"
"2761",1949-12-04,1949,"Stade Reims","Olympique Marseille","2-0",2,0,"1",1,2,2,"H"
"2762",1949-12-04,1949,"RC Lens","Racing Club de France","0-0",0,0,"1",1,0,0,"D"
"2763",1949-12-04,1949,"FC Sochaux","Stade Olympique Montpellierain","2-2",2,2,"1",1,4,0,"D"
"2764",1949-12-04,1949,"Stade Red Star","AS Saint-Etienne","2-2",2,2,"1",1,4,0,"D"
"2765",1949-12-04,1949,"FC Metz","AS Nancy","3-0",3,0,"1",1,3,3,"H"
"2766",1949-12-04,1949,"FC Sete","RC Strasbourg","2-1",2,1,"1",1,3,1,"H"
"2767",1949-12-18,1949,"Stade Reims","Lille OSC","2-1",2,1,"1",1,3,1,"H"
"2768",1949-12-18,1949,"Toulouse FC","Racing Club de France","2-0",2,0,"1",1,2,2,"H"
"2769",1949-12-18,1949,"OGC Nice","Girondins Bordeaux","3-2",3,2,"1",1,5,1,"H"
"2770",1949-12-18,1949,"RC Roubaix","RC Strasbourg","2-0",2,0,"1",1,2,2,"H"
"2771",1949-12-18,1949,"FC Sochaux","AS Nancy","3-4",3,4,"1",1,7,-1,"D"
"2772",1949-12-18,1949,"Olympique Marseille","AS Saint-Etienne","2-0",2,0,"1",1,2,2,"H"
"2773",1949-12-18,1949,"FC Sete","RC Lens","3-1",3,1,"1",1,4,2,"H"
"2774",1949-12-18,1949,"Stade Red Star","Stade Olympique Montpellierain","1-2",1,2,"1",1,3,-1,"D"
"2775",1949-12-18,1949,"FC Metz","Stade Rennes","1-2",1,2,"1",1,3,-1,"D"
"2776",1949-12-25,1949,"Lille OSC","Stade Red Star","5-1",5,1,"1",1,6,4,"H"
"2777",1949-12-25,1949,"RC Lens","Toulouse FC","0-3",0,3,"1",1,3,-3,"D"
"2778",1949-12-25,1949,"Girondins Bordeaux","FC Sochaux","2-1",2,1,"1",1,3,1,"H"
"2779",1949-12-25,1949,"AS Nancy","Stade Reims","0-2",0,2,"1",1,2,-2,"D"
"2780",1949-12-25,1949,"Racing Club de France","RC Roubaix","1-1",1,1,"1",1,2,0,"D"
"2781",1949-12-25,1949,"Stade Rennes","OGC Nice","5-2",5,2,"1",1,7,3,"H"
"2782",1949-12-25,1949,"AS Saint-Etienne","FC Sete","1-0",1,0,"1",1,1,1,"H"
"2783",1949-12-25,1949,"Stade Olympique Montpellierain","Olympique Marseille","1-0",1,0,"1",1,1,1,"H"
"2784",1949-12-25,1949,"RC Strasbourg","FC Metz","2-1",2,1,"1",1,3,1,"H"
"2785",1950-01-01,1949,"Lille OSC","FC Sochaux","2-0",2,0,"1",1,2,2,"H"
"2786",1950-01-01,1949,"RC Strasbourg","Toulouse FC","4-1",4,1,"1",1,5,3,"H"
"2787",1950-01-01,1949,"Girondins Bordeaux","FC Metz","1-1",1,1,"1",1,2,0,"D"
"2788",1950-01-01,1949,"Stade Olympique Montpellierain","Stade Reims","0-1",0,1,"1",1,1,-1,"D"
"2789",1950-01-01,1949,"Stade Rennes","RC Roubaix","1-1",1,1,"1",1,2,0,"D"
"2790",1950-01-01,1949,"Racing Club de France","FC Sete","2-1",2,1,"1",1,3,1,"H"
"2791",1950-01-01,1949,"AS Saint-Etienne","RC Lens","2-0",2,0,"1",1,2,2,"H"
"2792",1950-01-01,1949,"AS Nancy","OGC Nice","2-2",2,2,"1",1,4,0,"D"
"2793",1950-01-02,1949,"Olympique Marseille","Stade Red Star","2-1",2,1,"1",1,3,1,"H"
"2794",1950-01-14,1949,"RC Roubaix","FC Sete","3-1",3,1,"1",1,4,2,"H"
"2795",1950-01-14,1949,"Olympique Marseille","AS Nancy","1-2",1,2,"1",1,3,-1,"D"
"2796",1950-01-15,1949,"Stade Olympique Montpellierain","Lille OSC","4-3",4,3,"1",1,7,1,"H"
"2797",1950-01-15,1949,"Toulouse FC","AS Saint-Etienne","2-0",2,0,"1",1,2,2,"H"
"2798",1950-01-15,1949,"Stade Red Star","Girondins Bordeaux","0-4",0,4,"1",1,4,-4,"D"
"2799",1950-01-15,1949,"Stade Reims","Stade Rennes","3-1",3,1,"1",1,4,2,"H"
"2800",1950-01-15,1949,"OGC Nice","Racing Club de France","1-4",1,4,"1",1,5,-3,"D"
"2801",1950-01-15,1949,"FC Sochaux","RC Strasbourg","0-0",0,0,"1",1,0,0,"D"
"2802",1950-01-15,1949,"FC Metz","RC Lens","1-1",1,1,"1",1,2,0,"D"
"2803",1950-01-22,1949,"Lille OSC","Olympique Marseille","1-2",1,2,"1",1,3,-1,"D"
"2804",1950-01-22,1949,"FC Sete","Toulouse FC","1-1",1,1,"1",1,2,0,"D"
"2805",1950-01-22,1949,"Girondins Bordeaux","Stade Reims","4-0",4,0,"1",1,4,4,"H"
"2806",1950-01-22,1949,"RC Lens","RC Roubaix","3-2",3,2,"1",1,5,1,"H"
"2807",1950-01-22,1949,"Racing Club de France","FC Metz","2-2",2,2,"1",1,4,0,"D"
"2808",1950-01-22,1949,"AS Saint-Etienne","Stade Olympique Montpellierain","5-1",5,1,"1",1,6,4,"H"
"2809",1950-01-22,1949,"AS Nancy","Stade Red Star","1-1",1,1,"1",1,2,0,"D"
"2810",1950-01-22,1949,"Stade Rennes","FC Sochaux","1-2",1,2,"1",1,3,-1,"D"
"2811",1950-01-22,1949,"RC Strasbourg","OGC Nice","0-0",0,0,"1",1,0,0,"D"
"2812",1950-01-29,1949,"Lille OSC","AS Nancy","2-1",2,1,"1",1,3,1,"H"
"2813",1950-01-29,1949,"FC Metz","Toulouse FC","1-4",1,4,"1",1,5,-3,"D"
"2814",1950-01-29,1949,"Stade Olympique Montpellierain","Girondins Bordeaux","0-1",0,1,"1",1,1,-1,"D"
"2815",1950-01-29,1949,"Stade Reims","Racing Club de France","3-2",3,2,"1",1,5,1,"H"
"2816",1950-01-29,1949,"OGC Nice","FC Sete","5-0",5,0,"1",1,5,5,"H"
"2817",1950-01-29,1949,"FC Sochaux","RC Lens","1-0",1,0,"1",1,1,1,"H"
"2818",1950-01-29,1949,"Olympique Marseille","Stade Rennes","3-1",3,1,"1",1,4,2,"H"
"2819",1950-01-29,1949,"Stade Red Star","RC Strasbourg","0-0",0,0,"1",1,0,0,"D"
"2820",1950-02-05,1949,"AS Saint-Etienne","RC Roubaix","0-0",0,0,"1",1,0,0,"D"
"2821",1950-02-12,1949,"Girondins Bordeaux","Lille OSC","1-1",1,1,"1",1,2,0,"D"
"2822",1950-02-12,1949,"Toulouse FC","OGC Nice","2-3",2,3,"1",1,5,-1,"D"
"2823",1950-02-12,1949,"RC Lens","Stade Reims","0-0",0,0,"1",1,0,0,"D"
"2824",1950-02-12,1949,"RC Roubaix","FC Metz","3-1",3,1,"1",1,4,2,"H"
"2825",1950-02-12,1949,"Racing Club de France","Stade Red Star","2-1",2,1,"1",1,3,1,"H"
"2826",1950-02-12,1949,"FC Sete","FC Sochaux","1-2",1,2,"1",1,3,-1,"D"
"2827",1950-02-12,1949,"RC Strasbourg","Olympique Marseille","1-1",1,1,"1",1,2,0,"D"
"2828",1950-02-12,1949,"AS Nancy","AS Saint-Etienne","2-1",2,1,"1",1,3,1,"H"
"2829",1950-02-12,1949,"Stade Rennes","Stade Olympique Montpellierain","5-1",5,1,"1",1,6,4,"H"
"2830",1950-02-16,1949,"Lille OSC","Stade Rennes","1-0",1,0,"1",1,1,1,"H"
"2831",1950-02-16,1949,"FC Sochaux","Toulouse FC","1-2",1,2,"1",1,3,-1,"D"
"2832",1950-02-16,1949,"AS Nancy","Girondins Bordeaux","0-0",0,0,"1",1,0,0,"D"
"2833",1950-02-16,1949,"Stade Reims","FC Sete","2-1",2,1,"1",1,3,1,"H"
"2834",1950-02-16,1949,"OGC Nice","RC Roubaix","3-2",3,2,"1",1,5,1,"H"
"2835",1950-02-16,1949,"Olympique Marseille","Racing Club de France","1-1",1,1,"1",1,2,0,"D"
"2836",1950-02-16,1949,"AS Saint-Etienne","FC Metz","1-3",1,3,"1",1,4,-2,"D"
"2837",1950-02-16,1949,"Stade Olympique Montpellierain","RC Strasbourg","3-0",3,0,"1",1,3,3,"H"
"2838",1950-02-16,1949,"Stade Red Star","RC Lens","4-3",4,3,"1",1,7,1,"H"
"2839",1950-02-19,1949,"RC Strasbourg","Lille OSC","2-1",2,1,"1",1,3,1,"H"
"2840",1950-02-19,1949,"Toulouse FC","Stade Reims","1-1",1,1,"1",1,2,0,"D"
"2841",1950-02-19,1949,"AS Saint-Etienne","Girondins Bordeaux","1-1",1,1,"1",1,2,0,"D"
"2842",1950-02-19,1949,"Racing Club de France","Stade Olympique Montpellierain","6-0",6,0,"1",1,6,6,"H"
"2843",1950-02-19,1949,"FC Metz","OGC Nice","0-3",0,3,"1",1,3,-3,"D"
"2844",1950-02-19,1949,"RC Roubaix","FC Sochaux","0-2",0,2,"1",1,2,-2,"D"
"2845",1950-02-19,1949,"RC Lens","Olympique Marseille","1-2",1,2,"1",1,3,-1,"D"
"2846",1950-02-19,1949,"Stade Rennes","AS Nancy","2-1",2,1,"1",1,3,1,"H"
"2847",1950-02-19,1949,"FC Sete","Stade Red Star","3-2",3,2,"1",1,5,1,"H"
"2848",1950-03-05,1949,"Lille OSC","Racing Club de France","2-2",2,2,"1",1,4,0,"D"
"2849",1950-03-05,1949,"Stade Red Star","Toulouse FC","1-3",1,3,"1",1,4,-2,"D"
"2850",1950-03-05,1949,"Girondins Bordeaux","Stade Rennes","2-1",2,1,"1",1,3,1,"H"
"2851",1950-03-05,1949,"Stade Reims","RC Roubaix","2-1",2,1,"1",1,3,1,"H"
"2852",1950-03-05,1949,"OGC Nice","AS Saint-Etienne","1-1",1,1,"1",1,2,0,"D"
"2853",1950-03-05,1949,"FC Sochaux","FC Metz","3-1",3,1,"1",1,4,2,"H"
"2854",1950-03-05,1949,"Olympique Marseille","FC Sete","3-4",3,4,"1",1,7,-1,"D"
"2855",1950-03-05,1949,"AS Nancy","RC Strasbourg","1-2",1,2,"1",1,3,-1,"D"
"2856",1950-03-05,1949,"Stade Olympique Montpellierain","RC Lens","4-2",4,2,"1",1,6,2,"H"
"2857",1950-03-12,1949,"Toulouse FC","Olympique Marseille","1-1",1,1,"1",1,2,0,"D"
"2858",1950-03-12,1949,"RC Strasbourg","Girondins Bordeaux","1-1",1,1,"1",1,2,0,"D"
"2859",1950-03-12,1949,"RC Lens","Lille OSC","1-0",1,0,"1",1,1,1,"H"
"2860",1950-03-12,1949,"FC Metz","Stade Reims","2-4",2,4,"1",1,6,-2,"D"
"2861",1950-03-12,1949,"Racing Club de France","AS Nancy","4-1",4,1,"1",1,5,3,"H"
"2862",1950-03-12,1949,"FC Sochaux","OGC Nice","0-3",0,3,"1",1,3,-3,"D"
"2863",1950-03-12,1949,"RC Roubaix","Stade Red Star","2-2",2,2,"1",1,4,0,"D"
"2864",1950-03-12,1949,"Stade Rennes","AS Saint-Etienne","3-1",3,1,"1",1,4,2,"H"
"2865",1950-03-12,1949,"FC Sete","Stade Olympique Montpellierain","2-0",2,0,"1",1,2,2,"H"
"2866",1950-03-19,1949,"Girondins Bordeaux","Olympique Marseille","3-1",3,1,"1",1,4,2,"H"
"2867",1950-03-19,1949,"Toulouse FC","RC Roubaix","1-1",1,1,"1",1,2,0,"D"
"2868",1950-03-19,1949,"OGC Nice","RC Lens","1-1",1,1,"1",1,2,0,"D"
"2869",1950-03-19,1949,"Stade Rennes","Stade Red Star","5-0",5,0,"1",1,5,5,"H"
"2870",1950-03-26,1949,"Girondins Bordeaux","Racing Club de France","4-0",4,0,"1",1,4,4,"H"
"2871",1950-03-26,1949,"Lille OSC","FC Sete","3-2",3,2,"1",1,5,1,"H"
"2872",1950-03-26,1949,"Stade Olympique Montpellierain","Toulouse FC","1-0",1,0,"1",1,1,1,"H"
"2873",1950-03-26,1949,"Stade Reims","OGC Nice","1-1",1,1,"1",1,2,0,"D"
"2874",1950-03-26,1949,"Olympique Marseille","RC Roubaix","2-0",2,0,"1",1,2,2,"H"
"2875",1950-03-26,1949,"AS Saint-Etienne","FC Sochaux","1-0",1,0,"1",1,1,1,"H"
"2876",1950-03-26,1949,"Stade Rennes","RC Strasbourg","1-1",1,1,"1",1,2,0,"D"
"2877",1950-03-26,1949,"AS Nancy","RC Lens","0-0",0,0,"1",1,0,0,"D"
"2878",1950-03-26,1949,"Stade Red Star","FC Metz","5-0",5,0,"1",1,5,5,"H"
"2879",1950-03-28,1949,"Racing Club de France","FC Sochaux","2-1",2,1,"1",1,3,1,"H"
"2880",1950-03-28,1949,"Lille OSC","AS Saint-Etienne","3-1",3,1,"1",1,4,2,"H"
"2881",1950-04-02,1949,"Stade Reims","RC Strasbourg","6-1",6,1,"1",1,7,5,"H"
"2882",1950-04-02,1949,"AS Nancy","Stade Olympique Montpellierain","2-1",2,1,"1",1,3,1,"H"
"2883",1950-04-02,1949,"FC Sete","FC Metz","4-1",4,1,"1",1,5,3,"H"
"2884",1950-04-06,1949,"AS Saint-Etienne","Stade Reims","1-2",1,2,"1",1,3,-1,"D"
"2885",1950-04-06,1949,"RC Strasbourg","Racing Club de France","2-0",2,0,"1",1,2,2,"H"
"2886",1950-04-09,1949,"RC Lens","Girondins Bordeaux","1-3",1,3,"1",1,4,-2,"D"
"2887",1950-04-09,1949,"FC Sochaux","Stade Reims","2-0",2,0,"1",1,2,2,"H"
"2888",1950-04-09,1949,"Toulouse FC","Lille OSC","2-0",2,0,"1",1,2,2,"H"
"2889",1950-04-09,1949,"OGC Nice","Stade Red Star","3-0",3,0,"1",1,3,3,"H"
"2890",1950-04-09,1949,"Racing Club de France","Stade Rennes","1-2",1,2,"1",1,3,-1,"D"
"2891",1950-04-09,1949,"RC Roubaix","Stade Olympique Montpellierain","4-0",4,0,"1",1,4,4,"H"
"2892",1950-04-09,1949,"FC Metz","Olympique Marseille","1-3",1,3,"1",1,4,-2,"D"
"2893",1950-04-09,1949,"RC Strasbourg","AS Saint-Etienne","1-3",1,3,"1",1,4,-2,"D"
"2894",1950-04-09,1949,"FC Sete","AS Nancy","4-0",4,0,"1",1,4,4,"H"
"2895",1950-04-15,1949,"Girondins Bordeaux","FC Sete","4-2",4,2,"1",1,6,2,"H"
"2896",1950-04-15,1949,"Stade Red Star","FC Sochaux","2-5",2,5,"1",1,7,-3,"D"
"2897",1950-04-16,1949,"Lille OSC","RC Roubaix","0-0",0,0,"1",1,0,0,"D"
"2898",1950-04-16,1949,"AS Nancy","Toulouse FC","2-1",2,1,"1",1,3,1,"H"
"2899",1950-04-16,1949,"Olympique Marseille","OGC Nice","1-0",1,0,"1",1,1,1,"H"
"2900",1950-04-16,1949,"Stade Rennes","RC Lens","1-1",1,1,"1",1,2,0,"D"
"2901",1950-04-16,1949,"Stade Olympique Montpellierain","FC Metz","5-2",5,2,"1",1,7,3,"H"
"2902",1950-04-23,1949,"Toulouse FC","Girondins Bordeaux","1-2",1,2,"1",1,3,-1,"D"
"2903",1950-04-23,1949,"FC Metz","Lille OSC","0-0",0,0,"1",1,0,0,"D"
"2904",1950-04-23,1949,"Stade Reims","Stade Red Star","0-3",0,3,"1",1,3,-3,"D"
"2905",1950-04-23,1949,"OGC Nice","Stade Olympique Montpellierain","1-0",1,0,"1",1,1,1,"H"
"2906",1950-04-23,1949,"Racing Club de France","AS Saint-Etienne","4-3",4,3,"1",1,7,1,"H"
"2907",1950-04-23,1949,"FC Sochaux","Olympique Marseille","4-0",4,0,"1",1,4,4,"H"
"2908",1950-04-23,1949,"FC Sete","Stade Rennes","0-1",0,1,"1",1,1,-1,"D"
"2909",1950-04-23,1949,"RC Roubaix","AS Nancy","0-1",0,1,"1",1,1,-1,"D"
"2910",1950-04-23,1949,"RC Lens","RC Strasbourg","1-2",1,2,"1",1,3,-1,"D"
"2911",1950-04-29,1949,"Girondins Bordeaux","RC Roubaix","4-2",4,2,"1",1,6,2,"H"
"2912",1950-04-30,1949,"Lille OSC","OGC Nice","4-1",4,1,"1",1,5,3,"H"
"2913",1950-04-30,1949,"Olympique Marseille","Stade Reims","2-2",2,2,"1",1,4,0,"D"
"2914",1950-04-30,1949,"Stade Rennes","Toulouse FC","0-0",0,0,"1",1,0,0,"D"
"2915",1950-04-30,1949,"Stade Olympique Montpellierain","FC Sochaux","1-4",1,4,"1",1,5,-3,"D"
"2916",1950-04-30,1949,"AS Nancy","FC Metz","7-2",7,2,"1",1,9,5,"H"
"2917",1950-04-30,1949,"RC Strasbourg","FC Sete","1-1",1,1,"1",1,2,0,"D"
"2918",1950-04-30,1949,"AS Saint-Etienne","Stade Red Star","2-0",2,0,"1",1,2,2,"H"
"2919",1950-05-01,1949,"Racing Club de France","RC Lens","1-2",1,2,"1",1,3,-1,"D"
"2920",1950-05-04,1949,"Lille OSC","Stade Reims","4-0",4,0,"1",1,4,4,"H"
"2921",1950-05-04,1949,"Racing Club de France","Toulouse FC","1-1",1,1,"1",1,2,0,"D"
"2922",1950-05-06,1949,"Stade Red Star","Olympique Marseille","1-1",1,1,"1",1,2,0,"D"
"2923",1950-05-06,1949,"RC Roubaix","Stade Rennes","2-2",2,2,"1",1,4,0,"D"
"2924",1950-05-07,1949,"FC Metz","Girondins Bordeaux","2-3",2,3,"1",1,5,-1,"D"
"2925",1950-05-07,1949,"FC Sochaux","Lille OSC","3-1",3,1,"1",1,4,2,"H"
"2926",1950-05-07,1949,"Stade Reims","Stade Olympique Montpellierain","2-1",2,1,"1",1,3,1,"H"
"2927",1950-05-07,1949,"Toulouse FC","RC Strasbourg","1-1",1,1,"1",1,2,0,"D"
"2928",1950-05-07,1949,"OGC Nice","AS Nancy","4-0",4,0,"1",1,4,4,"H"
"2929",1950-05-07,1949,"FC Sete","Racing Club de France","5-0",5,0,"1",1,5,5,"H"
"2930",1950-05-07,1949,"RC Lens","AS Saint-Etienne","2-4",2,4,"1",1,6,-2,"D"
"2931",1950-05-13,1949,"Girondins Bordeaux","OGC Nice","2-1",2,1,"1",1,3,1,"H"
"2932",1950-05-14,1949,"AS Nancy","FC Sochaux","0-0",0,0,"1",1,0,0,"D"
"2933",1950-05-14,1949,"Stade Rennes","FC Metz","3-1",3,1,"1",1,4,2,"H"
"2934",1950-05-14,1949,"RC Strasbourg","RC Roubaix","2-4",2,4,"1",1,6,-2,"D"
"2935",1950-05-14,1949,"AS Saint-Etienne","Olympique Marseille","2-0",2,0,"1",1,2,2,"H"
"2936",1950-05-14,1949,"RC Lens","FC Sete","2-3",2,3,"1",1,5,-1,"D"
"2937",1950-05-14,1949,"Stade Olympique Montpellierain","Stade Red Star","1-2",1,2,"1",1,3,-1,"D"
"2938",1950-05-20,1949,"Stade Red Star","Lille OSC","1-1",1,1,"1",1,2,0,"D"
"2939",1950-05-20,1949,"OGC Nice","Stade Rennes","2-1",2,1,"1",1,3,1,"H"
"2940",1950-05-21,1949,"FC Sochaux","Girondins Bordeaux","3-3",3,3,"1",1,6,0,"D"
"2941",1950-05-21,1949,"Stade Reims","AS Nancy","1-0",1,0,"1",1,1,1,"H"
"2942",1950-05-21,1949,"Toulouse FC","RC Lens","1-1",1,1,"1",1,2,0,"D"
"2943",1950-05-21,1949,"RC Roubaix","Racing Club de France","1-3",1,3,"1",1,4,-2,"D"
"2944",1950-05-21,1949,"Olympique Marseille","Stade Olympique Montpellierain","3-2",3,2,"1",1,5,1,"H"
"2945",1950-05-21,1949,"FC Sete","AS Saint-Etienne","2-0",2,0,"1",1,2,2,"H"
"2946",1950-05-21,1949,"FC Metz","RC Strasbourg","6-3",6,3,"1",1,9,3,"H"
"2947",1950-08-26,1950,"Girondins Bordeaux","OGC Nice","2-0",2,0,"1",1,2,2,"H"
"2948",1950-08-27,1950,"Stade Rennes","AS Saint-Etienne","6-0",6,0,"1",1,6,6,"H"
"2949",1950-08-27,1950,"FC Sete","Stade Reims","5-2",5,2,"1",1,7,3,"H"
"2950",1950-08-27,1950,"Racing Club de France","FC Sochaux","4-1",4,1,"1",1,5,3,"H"
"2951",1950-08-27,1950,"RC Lens","AS Nancy","0-2",0,2,"1",1,2,-2,"D"
"2952",1950-08-27,1950,"RC Strasbourg","Nimes Olympique","2-1",2,1,"1",1,3,1,"H"
"2953",1950-08-27,1950,"Le Havre AC","Olympique Marseille","1-0",1,0,"1",1,1,1,"H"
"2954",1950-08-27,1950,"Lille OSC","Stade Francais FC","1-1",1,1,"1",1,2,0,"D"
"2955",1950-08-27,1950,"Toulouse FC","RC Roubaix","1-1",1,1,"1",1,2,0,"D"
"2956",1950-09-03,1950,"OGC Nice","Stade Rennes","3-6",3,6,"1",1,9,-3,"D"
"2957",1950-09-03,1950,"RC Roubaix","Racing Club de France","1-4",1,4,"1",1,5,-3,"D"
"2958",1950-09-03,1950,"FC Sochaux","Lille OSC","0-4",0,4,"1",1,4,-4,"D"
"2959",1950-09-03,1950,"AS Nancy","FC Sete","2-2",2,2,"1",1,4,0,"D"
"2960",1950-09-03,1950,"Nimes Olympique","Girondins Bordeaux","2-2",2,2,"1",1,4,0,"D"
"2961",1950-09-03,1950,"Stade Francais FC","RC Strasbourg","0-0",0,0,"1",1,0,0,"D"
"2962",1950-09-03,1950,"Olympique Marseille","Toulouse FC","3-1",3,1,"1",1,4,2,"H"
"2963",1950-09-03,1950,"Stade Reims","Le Havre AC","2-0",2,0,"1",1,2,2,"H"
"2964",1950-09-03,1950,"AS Saint-Etienne","RC Lens","4-1",4,1,"1",1,5,3,"H"
"2965",1950-09-10,1950,"Stade Rennes","Toulouse FC","6-0",6,0,"1",1,6,6,"H"
"2966",1950-09-10,1950,"Girondins Bordeaux","Racing Club de France","0-3",0,3,"1",1,3,-3,"D"
"2967",1950-09-10,1950,"Lille OSC","Olympique Marseille","2-1",2,1,"1",1,3,1,"H"
"2968",1950-09-10,1950,"RC Strasbourg","RC Roubaix","3-1",3,1,"1",1,4,2,"H"
"2969",1950-09-10,1950,"FC Sete","FC Sochaux","1-1",1,1,"1",1,2,0,"D"
"2970",1950-09-10,1950,"Nimes Olympique","AS Nancy","3-0",3,0,"1",1,3,3,"H"
"2971",1950-09-10,1950,"Stade Francais FC","Stade Reims","1-1",1,1,"1",1,2,0,"D"
"2972",1950-09-10,1950,"OGC Nice","AS Saint-Etienne","0-0",0,0,"1",1,0,0,"D"
"2973",1950-09-10,1950,"RC Lens","Le Havre AC","2-1",2,1,"1",1,3,1,"H"
"2974",1950-09-17,1950,"Racing Club de France","Stade Rennes","4-2",4,2,"1",1,6,2,"H"
"2975",1950-09-17,1950,"Olympique Marseille","RC Strasbourg","2-2",2,2,"1",1,4,0,"D"
"2976",1950-09-17,1950,"Stade Reims","Lille OSC","4-3",4,3,"1",1,7,1,"H"
"2977",1950-09-17,1950,"AS Nancy","Stade Francais FC","2-1",2,1,"1",1,3,1,"H"
"2978",1950-09-17,1950,"Le Havre AC","FC Sete","1-0",1,0,"1",1,1,1,"H"
"2979",1950-09-17,1950,"AS Saint-Etienne","Nimes Olympique","1-1",1,1,"1",1,2,0,"D"
"2980",1950-09-17,1950,"RC Roubaix","Girondins Bordeaux","1-1",1,1,"1",1,2,0,"D"
"2981",1950-09-17,1950,"FC Sochaux","OGC Nice","3-2",3,2,"1",1,5,1,"H"
"2982",1950-09-17,1950,"Toulouse FC","RC Lens","3-2",3,2,"1",1,5,1,"H"
"2983",1950-09-21,1950,"Lille OSC","Racing Club de France","1-1",1,1,"1",1,2,0,"D"
"2984",1950-09-21,1950,"Stade Rennes","FC Sete","2-0",2,0,"1",1,2,2,"H"
"2985",1950-09-21,1950,"RC Strasbourg","Toulouse FC","6-1",6,1,"1",1,7,5,"H"
"2986",1950-09-21,1950,"OGC Nice","Stade Reims","1-2",1,2,"1",1,3,-1,"D"
"2987",1950-09-21,1950,"Nimes Olympique","Olympique Marseille","2-1",2,1,"1",1,3,1,"H"
"2988",1950-09-21,1950,"Girondins Bordeaux","Le Havre AC","0-1",0,1,"1",1,1,-1,"D"
"2989",1950-09-21,1950,"AS Saint-Etienne","AS Nancy","3-1",3,1,"1",1,4,2,"H"
"2990",1950-09-21,1950,"Stade Francais FC","RC Roubaix","1-0",1,0,"1",1,1,1,"H"
"2991",1950-09-21,1950,"RC Lens","FC Sochaux","3-1",3,1,"1",1,4,2,"H"
"2992",1950-09-24,1950,"RC Lens","Stade Rennes","1-2",1,2,"1",1,3,-1,"D"
"2993",1950-09-24,1950,"Racing Club de France","Stade Francais FC","1-1",1,1,"1",1,2,0,"D"
"2994",1950-09-24,1950,"Le Havre AC","RC Strasbourg","0-1",0,1,"1",1,1,-1,"D"
"2995",1950-09-24,1950,"Toulouse FC","Lille OSC","0-2",0,2,"1",1,2,-2,"D"
"2996",1950-09-24,1950,"Stade Reims","AS Saint-Etienne","0-0",0,0,"1",1,0,0,"D"
"2997",1950-09-24,1950,"RC Roubaix","Nimes Olympique","2-0",2,0,"1",1,2,2,"H"
"2998",1950-09-24,1950,"FC Sete","Girondins Bordeaux","1-0",1,0,"1",1,1,1,"H"
"2999",1950-09-24,1950,"FC Sochaux","AS Nancy","3-3",3,3,"1",1,6,0,"D"
"3000",1950-09-24,1950,"Olympique Marseille","OGC Nice","3-0",3,0,"1",1,3,3,"H"
"3001",1950-10-01,1950,"Racing Club de France","RC Strasbourg","2-4",2,4,"1",1,6,-2,"D"
"3002",1950-10-01,1950,"Le Havre AC","Stade Rennes","3-1",3,1,"1",1,4,2,"H"
"3003",1950-10-01,1950,"Stade Reims","Nimes Olympique","1-1",1,1,"1",1,2,0,"D"
"3004",1950-10-01,1950,"FC Sochaux","AS Saint-Etienne","0-2",0,2,"1",1,2,-2,"D"
"3005",1950-10-01,1950,"RC Roubaix","Lille OSC","3-0",3,0,"1",1,3,3,"H"
"3006",1950-10-01,1950,"FC Sete","RC Lens","1-1",1,1,"1",1,2,0,"D"
"3007",1950-10-01,1950,"Olympique Marseille","Stade Francais FC","0-0",0,0,"1",1,0,0,"D"
"3008",1950-10-01,1950,"Toulouse FC","Girondins Bordeaux","1-2",1,2,"1",1,3,-1,"D"
"3009",1950-10-01,1950,"AS Nancy","OGC Nice","1-2",1,2,"1",1,3,-1,"D"
"3010",1950-10-08,1950,"RC Strasbourg","FC Sete","1-0",1,0,"1",1,1,1,"H"
"3011",1950-10-08,1950,"Stade Rennes","FC Sochaux","2-1",2,1,"1",1,3,1,"H"
"3012",1950-10-08,1950,"AS Nancy","Stade Reims","0-2",0,2,"1",1,2,-2,"D"
"3013",1950-10-08,1950,"Nimes Olympique","Racing Club de France","4-2",4,2,"1",1,6,2,"H"
"3014",1950-10-08,1950,"Lille OSC","Le Havre AC","1-0",1,0,"1",1,1,1,"H"
"3015",1950-10-08,1950,"AS Saint-Etienne","Olympique Marseille","1-2",1,2,"1",1,3,-1,"D"
"3016",1950-10-08,1950,"Girondins Bordeaux","RC Lens","4-0",4,0,"1",1,4,4,"H"
"3017",1950-10-08,1950,"Stade Francais FC","Toulouse FC","1-2",1,2,"1",1,3,-1,"D"
"3018",1950-10-08,1950,"OGC Nice","RC Roubaix","3-0",3,0,"1",1,3,3,"H"
"3019",1950-10-15,1950,"RC Lens","RC Strasbourg","1-1",1,1,"1",1,2,0,"D"
"3020",1950-10-15,1950,"Stade Rennes","Girondins Bordeaux","4-2",4,2,"1",1,6,2,"H"
"3021",1950-10-15,1950,"FC Sete","Lille OSC","1-1",1,1,"1",1,2,0,"D"
"3022",1950-10-15,1950,"FC Sochaux","Stade Reims","2-0",2,0,"1",1,2,2,"H"
"3023",1950-10-15,1950,"Racing Club de France","OGC Nice","0-3",0,3,"1",1,3,-3,"D"
"3024",1950-10-15,1950,"Olympique Marseille","AS Nancy","2-1",2,1,"1",1,3,1,"H"
"3025",1950-10-15,1950,"Toulouse FC","Nimes Olympique","1-1",1,1,"1",1,2,0,"D"
"3026",1950-10-15,1950,"Le Havre AC","Stade Francais FC","3-0",3,0,"1",1,3,3,"H"
"3027",1950-10-15,1950,"RC Roubaix","AS Saint-Etienne","2-2",2,2,"1",1,4,0,"D"
"3028",1950-10-22,1950,"RC Strasbourg","Stade Rennes","1-0",1,0,"1",1,1,1,"H"
"3029",1950-10-22,1950,"Lille OSC","RC Lens","5-0",5,0,"1",1,5,5,"H"
"3030",1950-10-22,1950,"Nimes Olympique","Le Havre AC","2-3",2,3,"1",1,5,-1,"D"
"3031",1950-10-22,1950,"Stade Reims","Olympique Marseille","1-1",1,1,"1",1,2,0,"D"
"3032",1950-10-22,1950,"AS Saint-Etienne","Racing Club de France","2-1",2,1,"1",1,3,1,"H"
"3033",1950-10-22,1950,"Girondins Bordeaux","FC Sochaux","3-1",3,1,"1",1,4,2,"H"
"3034",1950-10-22,1950,"OGC Nice","Toulouse FC","2-1",2,1,"1",1,3,1,"H"
"3035",1950-10-22,1950,"Stade Francais FC","FC Sete","3-2",3,2,"1",1,5,1,"H"
"3036",1950-10-22,1950,"AS Nancy","RC Roubaix","2-1",2,1,"1",1,3,1,"H"
"3037",1950-10-29,1950,"RC Strasbourg","Lille OSC","1-0",1,0,"1",1,1,1,"H"
"3038",1950-10-29,1950,"Stade Rennes","Nimes Olympique","1-2",1,2,"1",1,3,-1,"D"
"3039",1950-10-29,1950,"Toulouse FC","Stade Reims","1-3",1,3,"1",1,4,-2,"D"
"3040",1950-10-29,1950,"Le Havre AC","AS Nancy","1-1",1,1,"1",1,2,0,"D"
"3041",1950-10-29,1950,"Girondins Bordeaux","Stade Francais FC","4-1",4,1,"1",1,5,3,"H"
"3042",1950-10-29,1950,"Racing Club de France","Olympique Marseille","1-1",1,1,"1",1,2,0,"D"
"3043",1950-10-29,1950,"FC Sete","AS Saint-Etienne","4-1",4,1,"1",1,5,3,"H"
"3044",1950-10-29,1950,"RC Lens","OGC Nice","2-0",2,0,"1",1,2,2,"H"
"3045",1950-10-29,1950,"RC Roubaix","FC Sochaux","1-2",1,2,"1",1,3,-1,"D"
"3046",1950-11-05,1950,"FC Sochaux","RC Strasbourg","5-0",5,0,"1",1,5,5,"H"
"3047",1950-11-05,1950,"Lille OSC","Girondins Bordeaux","3-0",3,0,"1",1,3,3,"H"
"3048",1950-11-05,1950,"Stade Reims","Racing Club de France","2-2",2,2,"1",1,4,0,"D"
"3049",1950-11-05,1950,"Stade Francais FC","Stade Rennes","6-0",6,0,"1",1,6,6,"H"
"3050",1950-11-05,1950,"Nimes Olympique","RC Lens","5-3",5,3,"1",1,8,2,"H"
"3051",1950-11-05,1950,"AS Saint-Etienne","Le Havre AC","1-0",1,0,"1",1,1,1,"H"
"3052",1950-11-05,1950,"Olympique Marseille","RC Roubaix","1-2",1,2,"1",1,3,-1,"D"
"3053",1950-11-05,1950,"OGC Nice","FC Sete","2-1",2,1,"1",1,3,1,"H"
"3054",1950-11-05,1950,"AS Nancy","Toulouse FC","0-3",0,3,"1",1,3,-3,"D"
"3055",1950-11-11,1950,"Racing Club de France","AS Nancy","2-0",2,0,"1",1,2,2,"H"
"3056",1950-11-12,1950,"Girondins Bordeaux","RC Strasbourg","3-0",3,0,"1",1,3,3,"H"
"3057",1950-11-12,1950,"Stade Rennes","Lille OSC","0-0",0,0,"1",1,0,0,"D"
"3058",1950-11-12,1950,"Le Havre AC","OGC Nice","4-1",4,1,"1",1,5,3,"H"
"3059",1950-11-12,1950,"FC Sete","Nimes Olympique","1-1",1,1,"1",1,2,0,"D"
"3060",1950-11-12,1950,"RC Roubaix","Stade Reims","2-1",2,1,"1",1,3,1,"H"
"3061",1950-11-12,1950,"Toulouse FC","AS Saint-Etienne","3-2",3,2,"1",1,5,1,"H"
"3062",1950-11-12,1950,"RC Lens","Stade Francais FC","5-0",5,0,"1",1,5,5,"H"
"3063",1950-11-19,1950,"RC Strasbourg","AS Saint-Etienne","2-6",2,6,"1",1,8,-4,"D"
"3064",1950-11-19,1950,"Le Havre AC","Racing Club de France","2-0",2,0,"1",1,2,2,"H"
"3065",1950-11-19,1950,"Stade Francais FC","Nimes Olympique","2-3",2,3,"1",1,5,-1,"D"
"3066",1950-11-19,1950,"Stade Rennes","Stade Reims","2-2",2,2,"1",1,4,0,"D"
"3067",1950-11-19,1950,"Lille OSC","OGC Nice","1-3",1,3,"1",1,4,-2,"D"
"3068",1950-11-19,1950,"Girondins Bordeaux","AS Nancy","3-1",3,1,"1",1,4,2,"H"
"3069",1950-11-19,1950,"FC Sete","RC Roubaix","2-0",2,0,"1",1,2,2,"H"
"3070",1950-11-19,1950,"RC Lens","Olympique Marseille","1-1",1,1,"1",1,2,0,"D"
"3071",1950-11-19,1950,"Toulouse FC","FC Sochaux","0-2",0,2,"1",1,2,-2,"D"
"3072",1950-11-23,1950,"FC Sochaux","Olympique Marseille","1-2",1,2,"1",1,3,-1,"D"
"3073",1950-11-26,1950,"RC Roubaix","Le Havre AC","2-3",2,3,"1",1,5,-1,"D"
"3074",1950-11-26,1950,"OGC Nice","RC Strasbourg","4-1",4,1,"1",1,5,3,"H"
"3075",1950-11-26,1950,"Nimes Olympique","Lille OSC","2-4",2,4,"1",1,6,-2,"D"
"3076",1950-11-26,1950,"Stade Reims","RC Lens","4-2",4,2,"1",1,6,2,"H"
"3077",1950-11-26,1950,"AS Saint-Etienne","Girondins Bordeaux","1-0",1,0,"1",1,1,1,"H"
"3078",1950-11-26,1950,"AS Nancy","Stade Rennes","3-2",3,2,"1",1,5,1,"H"
"3079",1950-11-26,1950,"Olympique Marseille","FC Sete","1-2",1,2,"1",1,3,-1,"D"
"3080",1950-11-26,1950,"Racing Club de France","Toulouse FC","1-1",1,1,"1",1,2,0,"D"
"3081",1950-11-26,1950,"FC Sochaux","Stade Francais FC","0-1",0,1,"1",1,1,-1,"D"
"3082",1950-12-03,1950,"RC Strasbourg","Stade Reims","0-1",0,1,"1",1,1,-1,"D"
"3083",1950-12-03,1950,"Lille OSC","AS Nancy","0-0",0,0,"1",1,0,0,"D"
"3084",1950-12-03,1950,"Stade Rennes","RC Roubaix","4-1",4,1,"1",1,5,3,"H"
"3085",1950-12-03,1950,"Nimes Olympique","OGC Nice","1-1",1,1,"1",1,2,0,"D"
"3086",1950-12-03,1950,"Stade Francais FC","AS Saint-Etienne","4-0",4,0,"1",1,4,4,"H"
"3087",1950-12-03,1950,"Girondins Bordeaux","Olympique Marseille","0-0",0,0,"1",1,0,0,"D"
"3088",1950-12-03,1950,"RC Lens","Racing Club de France","1-1",1,1,"1",1,2,0,"D"
"3089",1950-12-03,1950,"FC Sete","Toulouse FC","0-1",0,1,"1",1,1,-1,"D"
"3090",1950-12-05,1950,"Le Havre AC","FC Sochaux","3-1",3,1,"1",1,4,2,"H"
"3091",1950-12-17,1950,"Toulouse FC","Le Havre AC","2-0",2,0,"1",1,2,2,"H"
"3092",1950-12-17,1950,"Stade Reims","Girondins Bordeaux","2-3",2,3,"1",1,5,-1,"D"
"3093",1950-12-17,1950,"AS Saint-Etienne","Lille OSC","5-1",5,1,"1",1,6,4,"H"
"3094",1950-12-17,1950,"Olympique Marseille","Stade Rennes","1-1",1,1,"1",1,2,0,"D"
"3095",1950-12-17,1950,"AS Nancy","RC Strasbourg","2-1",2,1,"1",1,3,1,"H"
"3096",1950-12-17,1950,"Racing Club de France","FC Sete","3-2",3,2,"1",1,5,1,"H"
"3097",1950-12-17,1950,"OGC Nice","Stade Francais FC","5-1",5,1,"1",1,6,4,"H"
"3098",1950-12-17,1950,"FC Sochaux","Nimes Olympique","4-0",4,0,"1",1,4,4,"H"
"3099",1950-12-17,1950,"RC Roubaix","RC Lens","4-1",4,1,"1",1,5,3,"H"
"3100",1950-12-24,1950,"AS Saint-Etienne","Stade Rennes","3-0",3,0,"1",1,3,3,"H"
"3101",1950-12-24,1950,"Stade Reims","FC Sete","3-1",3,1,"1",1,4,2,"H"
"3102",1950-12-24,1950,"Stade Francais FC","Lille OSC","0-2",0,2,"1",1,2,-2,"D"
"3103",1950-12-24,1950,"Olympique Marseille","Le Havre AC","3-1",3,1,"1",1,4,2,"H"
"3104",1950-12-24,1950,"OGC Nice","Girondins Bordeaux","4-1",4,1,"1",1,5,3,"H"
"3105",1950-12-24,1950,"FC Sochaux","Racing Club de France","0-1",0,1,"1",1,1,-1,"D"
"3106",1950-12-24,1950,"Nimes Olympique","RC Strasbourg","1-0",1,0,"1",1,1,1,"H"
"3107",1950-12-24,1950,"AS Nancy","RC Lens","4-2",4,2,"1",1,6,2,"H"
"3108",1950-12-24,1950,"RC Roubaix","Toulouse FC","3-2",3,2,"1",1,5,1,"H"
"3109",1950-12-31,1950,"RC Lens","AS Saint-Etienne","2-3",2,3,"1",1,5,-1,"D"
"3110",1950-12-31,1950,"Lille OSC","FC Sochaux","2-1",2,1,"1",1,3,1,"H"
"3111",1950-12-31,1950,"Le Havre AC","Stade Reims","3-0",3,0,"1",1,3,3,"H"
"3112",1950-12-31,1950,"Stade Rennes","OGC Nice","3-1",3,1,"1",1,4,2,"H"
"3113",1950-12-31,1950,"Toulouse FC","Olympique Marseille","0-4",0,4,"1",1,4,-4,"D"
"3114",1950-12-31,1950,"Girondins Bordeaux","Nimes Olympique","2-1",2,1,"1",1,3,1,"H"
"3115",1950-12-31,1950,"RC Strasbourg","Stade Francais FC","2-1",2,1,"1",1,3,1,"H"
"3116",1950-12-31,1950,"Racing Club de France","RC Roubaix","1-2",1,2,"1",1,3,-1,"D"
"3117",1950-12-31,1950,"FC Sete","AS Nancy","2-1",2,1,"1",1,3,1,"H"
"3118",1951-01-07,1950,"AS Saint-Etienne","OGC Nice","3-2",3,2,"1",1,5,1,"H"
"3119",1951-01-07,1950,"Le Havre AC","RC Lens","4-1",4,1,"1",1,5,3,"H"
"3120",1951-01-07,1950,"Olympique Marseille","Lille OSC","1-1",1,1,"1",1,2,0,"D"
"3121",1951-01-07,1950,"Stade Reims","Stade Francais FC","2-0",2,0,"1",1,2,2,"H"
"3122",1951-01-07,1950,"Toulouse FC","Stade Rennes","0-1",0,1,"1",1,1,-1,"D"
"3123",1951-01-07,1950,"RC Roubaix","RC Strasbourg","0-1",0,1,"1",1,1,-1,"D"
"3124",1951-01-07,1950,"Racing Club de France","Girondins Bordeaux","1-0",1,0,"1",1,1,1,"H"
"3125",1951-01-07,1950,"AS Nancy","Nimes Olympique","3-0",3,0,"1",1,3,3,"H"
"3126",1951-01-07,1950,"FC Sochaux","FC Sete","1-0",1,0,"1",1,1,1,"H"
"3127",1951-01-21,1950,"FC Sete","Le Havre AC","1-2",1,2,"1",1,3,-1,"D"
"3128",1951-01-21,1950,"Nimes Olympique","AS Saint-Etienne","1-0",1,0,"1",1,1,1,"H"
"3129",1951-01-21,1950,"Lille OSC","Stade Reims","1-1",1,1,"1",1,2,0,"D"
"3130",1951-01-21,1950,"Stade Rennes","Racing Club de France","3-4",3,4,"1",1,7,-1,"D"
"3131",1951-01-21,1950,"RC Strasbourg","Olympique Marseille","2-2",2,2,"1",1,4,0,"D"
"3132",1951-01-21,1950,"OGC Nice","FC Sochaux","2-1",2,1,"1",1,3,1,"H"
"3133",1951-01-21,1950,"Girondins Bordeaux","RC Roubaix","2-2",2,2,"1",1,4,0,"D"
"3134",1951-01-21,1950,"Stade Francais FC","AS Nancy","1-4",1,4,"1",1,5,-3,"D"
"3135",1951-01-21,1950,"RC Lens","Toulouse FC","2-2",2,2,"1",1,4,0,"D"
"3136",1951-01-28,1950,"Le Havre AC","Girondins Bordeaux","2-2",2,2,"1",1,4,0,"D"
"3137",1951-01-28,1950,"Racing Club de France","Lille OSC","2-0",2,0,"1",1,2,2,"H"
"3138",1951-01-28,1950,"AS Nancy","AS Saint-Etienne","4-2",4,2,"1",1,6,2,"H"
"3139",1951-01-28,1950,"FC Sete","Stade Rennes","1-2",1,2,"1",1,3,-1,"D"
"3140",1951-01-28,1950,"Stade Reims","OGC Nice","2-4",2,4,"1",1,6,-2,"D"
"3141",1951-01-28,1950,"Olympique Marseille","Nimes Olympique","1-1",1,1,"1",1,2,0,"D"
"3142",1951-01-28,1950,"Toulouse FC","RC Strasbourg","1-0",1,0,"1",1,1,1,"H"
"3143",1951-01-28,1950,"RC Roubaix","Stade Francais FC","3-1",3,1,"1",1,4,2,"H"
"3144",1951-01-28,1950,"FC Sochaux","RC Lens","3-2",3,2,"1",1,5,1,"H"
"3145",1951-02-11,1950,"RC Strasbourg","Le Havre AC","1-4",1,4,"1",1,5,-3,"D"
"3146",1951-02-11,1950,"Stade Francais FC","Racing Club de France","0-3",0,3,"1",1,3,-3,"D"
"3147",1951-02-11,1950,"AS Saint-Etienne","Stade Reims","1-1",1,1,"1",1,2,0,"D"
"3148",1951-02-11,1950,"Stade Rennes","RC Lens","1-2",1,2,"1",1,3,-1,"D"
"3149",1951-02-11,1950,"OGC Nice","Olympique Marseille","2-2",2,2,"1",1,4,0,"D"
"3150",1951-02-11,1950,"Girondins Bordeaux","FC Sete","4-0",4,0,"1",1,4,4,"H"
"3151",1951-02-11,1950,"Lille OSC","Toulouse FC","1-2",1,2,"1",1,3,-1,"D"
"3152",1951-02-11,1950,"Nimes Olympique","RC Roubaix","2-1",2,1,"1",1,3,1,"H"
"3153",1951-02-11,1950,"AS Nancy","FC Sochaux","3-4",3,4,"1",1,7,-1,"D"
"3154",1951-02-18,1950,"Stade Rennes","Le Havre AC","0-4",0,4,"1",1,4,-4,"D"
"3155",1951-02-18,1950,"AS Saint-Etienne","FC Sochaux","3-0",3,0,"1",1,3,3,"H"
"3156",1951-02-18,1950,"RC Strasbourg","Racing Club de France","3-0",3,0,"1",1,3,3,"H"
"3157",1951-02-18,1950,"OGC Nice","AS Nancy","5-0",5,0,"1",1,5,5,"H"
"3158",1951-02-18,1950,"Stade Francais FC","Olympique Marseille","2-4",2,4,"1",1,6,-2,"D"
"3159",1951-02-18,1950,"Girondins Bordeaux","Toulouse FC","3-1",3,1,"1",1,4,2,"H"
"3160",1951-02-18,1950,"Nimes Olympique","Stade Reims","3-0",3,0,"1",1,3,3,"H"
"3161",1951-02-18,1950,"Lille OSC","RC Roubaix","0-1",0,1,"1",1,1,-1,"D"
"3162",1951-02-18,1950,"RC Lens","FC Sete","3-0",3,0,"1",1,3,3,"H"
"3163",1951-03-04,1950,"Le Havre AC","Lille OSC","0-1",0,1,"1",1,1,-1,"D"
"3164",1951-03-04,1950,"Olympique Marseille","AS Saint-Etienne","7-0",7,0,"1",1,7,7,"H"
"3165",1951-03-04,1950,"Racing Club de France","Nimes Olympique","0-2",0,2,"1",1,2,-2,"D"
"3166",1951-03-04,1950,"RC Roubaix","OGC Nice","0-0",0,0,"1",1,0,0,"D"
"3167",1951-03-04,1950,"RC Lens","Girondins Bordeaux","1-1",1,1,"1",1,2,0,"D"
"3168",1951-03-04,1950,"Stade Reims","AS Nancy","2-2",2,2,"1",1,4,0,"D"
"3169",1951-03-04,1950,"FC Sete","RC Strasbourg","2-1",2,1,"1",1,3,1,"H"
"3170",1951-03-04,1950,"FC Sochaux","Stade Rennes","2-2",2,2,"1",1,4,0,"D"
"3171",1951-03-04,1950,"Toulouse FC","Stade Francais FC","0-0",0,0,"1",1,0,0,"D"
"3172",1951-03-11,1950,"Stade Francais FC","Le Havre AC","1-0",1,0,"1",1,1,1,"H"
"3173",1951-03-11,1950,"Nimes Olympique","Toulouse FC","3-1",3,1,"1",1,4,2,"H"
"3174",1951-03-11,1950,"AS Saint-Etienne","RC Roubaix","3-0",3,0,"1",1,3,3,"H"
"3175",1951-03-11,1950,"OGC Nice","Racing Club de France","3-0",3,0,"1",1,3,3,"H"
"3176",1951-03-11,1950,"AS Nancy","Olympique Marseille","5-1",5,1,"1",1,6,4,"H"
"3177",1951-03-11,1950,"Girondins Bordeaux","Stade Rennes","1-1",1,1,"1",1,2,0,"D"
"3178",1951-03-11,1950,"Lille OSC","FC Sete","3-1",3,1,"1",1,4,2,"H"
"3179",1951-03-11,1950,"Stade Reims","FC Sochaux","3-1",3,1,"1",1,4,2,"H"
"3180",1951-03-11,1950,"RC Strasbourg","RC Lens","1-1",1,1,"1",1,2,0,"D"
"3181",1951-03-24,1950,"Racing Club de France","AS Saint-Etienne","2-2",2,2,"1",1,4,0,"D"
"3182",1951-03-24,1950,"Stade Rennes","RC Strasbourg","2-4",2,4,"1",1,6,-2,"D"
"3183",1951-03-24,1950,"RC Roubaix","AS Nancy","3-0",3,0,"1",1,3,3,"H"
"3184",1951-03-25,1950,"Le Havre AC","Nimes Olympique","2-4",2,4,"1",1,6,-2,"D"
"3185",1951-03-25,1950,"Toulouse FC","OGC Nice","0-1",0,1,"1",1,1,-1,"D"
"3186",1951-03-25,1950,"Olympique Marseille","Stade Reims","0-2",0,2,"1",1,2,-2,"D"
"3187",1951-03-25,1950,"FC Sochaux","Girondins Bordeaux","1-0",1,0,"1",1,1,1,"H"
"3188",1951-03-25,1950,"RC Lens","Lille OSC","2-1",2,1,"1",1,3,1,"H"
"3189",1951-03-25,1950,"FC Sete","Stade Francais FC","2-0",2,0,"1",1,2,2,"H"
"3190",1951-04-01,1950,"Nimes Olympique","Stade Rennes","3-0",3,0,"1",1,3,3,"H"
"3191",1951-04-01,1950,"OGC Nice","RC Lens","5-0",5,0,"1",1,5,5,"H"
"3192",1951-04-01,1950,"Stade Reims","Toulouse FC","4-1",4,1,"1",1,5,3,"H"
"3193",1951-04-01,1950,"AS Nancy","Le Havre AC","6-1",6,1,"1",1,7,5,"H"
"3194",1951-04-01,1950,"AS Saint-Etienne","FC Sete","0-2",0,2,"1",1,2,-2,"D"
"3195",1951-04-01,1950,"Olympique Marseille","Racing Club de France","4-2",4,2,"1",1,6,2,"H"
"3196",1951-04-01,1950,"Stade Francais FC","Girondins Bordeaux","1-2",1,2,"1",1,3,-1,"D"
"3197",1951-04-01,1950,"Lille OSC","RC Strasbourg","3-1",3,1,"1",1,4,2,"H"
"3198",1951-04-01,1950,"FC Sochaux","RC Roubaix","1-1",1,1,"1",1,2,0,"D"
"3199",1951-04-07,1950,"RC Roubaix","Olympique Marseille","1-1",1,1,"1",1,2,0,"D"
"3200",1951-04-08,1950,"RC Lens","Nimes Olympique","4-2",4,2,"1",1,6,2,"H"
"3201",1951-04-08,1950,"FC Sete","OGC Nice","2-1",2,1,"1",1,3,1,"H"
"3202",1951-04-08,1950,"Le Havre AC","AS Saint-Etienne","4-1",4,1,"1",1,5,3,"H"
"3203",1951-04-08,1950,"Racing Club de France","Stade Reims","0-0",0,0,"1",1,0,0,"D"
"3204",1951-04-08,1950,"Girondins Bordeaux","Lille OSC","1-3",1,3,"1",1,4,-2,"D"
"3205",1951-04-08,1950,"RC Strasbourg","FC Sochaux","2-0",2,0,"1",1,2,2,"H"
"3206",1951-04-08,1950,"Stade Rennes","Stade Francais FC","1-3",1,3,"1",1,4,-2,"D"
"3207",1951-04-08,1950,"Toulouse FC","AS Nancy","3-0",3,0,"1",1,3,3,"H"
"3208",1951-04-15,1950,"Lille OSC","Nimes Olympique","1-0",1,0,"1",1,1,1,"H"
"3209",1951-04-21,1950,"Stade Francais FC","RC Lens","2-2",2,2,"1",1,4,0,"D"
"3210",1951-04-22,1950,"Lille OSC","Stade Rennes","2-0",2,0,"1",1,2,2,"H"
"3211",1951-04-22,1950,"Nimes Olympique","FC Sete","1-0",1,0,"1",1,1,1,"H"
"3212",1951-04-22,1950,"Stade Reims","RC Roubaix","3-1",3,1,"1",1,4,2,"H"
"3213",1951-04-22,1950,"OGC Nice","Le Havre AC","0-0",0,0,"1",1,0,0,"D"
"3214",1951-04-22,1950,"AS Saint-Etienne","Toulouse FC","4-0",4,0,"1",1,4,4,"H"
"3215",1951-04-22,1950,"Olympique Marseille","FC Sochaux","0-0",0,0,"1",1,0,0,"D"
"3216",1951-04-22,1950,"RC Strasbourg","Girondins Bordeaux","0-2",0,2,"1",1,2,-2,"D"
"3217",1951-04-22,1950,"AS Nancy","Racing Club de France","0-1",0,1,"1",1,1,-1,"D"
"3218",1951-04-29,1950,"Nimes Olympique","Stade Francais FC","6-2",6,2,"1",1,8,4,"H"
"3219",1951-04-29,1950,"OGC Nice","Lille OSC","4-1",4,1,"1",1,5,3,"H"
"3220",1951-04-29,1950,"Racing Club de France","Le Havre AC","2-3",2,3,"1",1,5,-1,"D"
"3221",1951-04-29,1950,"Stade Reims","Stade Rennes","0-1",0,1,"1",1,1,-1,"D"
"3222",1951-04-29,1950,"Olympique Marseille","RC Lens","3-0",3,0,"1",1,3,3,"H"
"3223",1951-04-29,1950,"AS Saint-Etienne","RC Strasbourg","1-1",1,1,"1",1,2,0,"D"
"3224",1951-04-29,1950,"AS Nancy","Girondins Bordeaux","2-2",2,2,"1",1,4,0,"D"
"3225",1951-04-29,1950,"RC Roubaix","FC Sete","6-0",6,0,"1",1,6,6,"H"
"3226",1951-04-29,1950,"FC Sochaux","Toulouse FC","2-1",2,1,"1",1,3,1,"H"
"3227",1951-05-05,1950,"Stade Rennes","AS Nancy","3-5",3,5,"1",1,8,-2,"D"
"3228",1951-05-05,1950,"Stade Francais FC","FC Sochaux","0-3",0,3,"1",1,3,-3,"D"
"3229",1951-05-06,1950,"Le Havre AC","RC Roubaix","1-0",1,0,"1",1,1,1,"H"
"3230",1951-05-06,1950,"Girondins Bordeaux","AS Saint-Etienne","1-0",1,0,"1",1,1,1,"H"
"3231",1951-05-06,1950,"RC Lens","Stade Reims","2-1",2,1,"1",1,3,1,"H"
"3232",1951-05-06,1950,"FC Sete","Olympique Marseille","3-1",3,1,"1",1,4,2,"H"
"3233",1951-05-06,1950,"Toulouse FC","Racing Club de France","1-0",1,0,"1",1,1,1,"H"
"3234",1951-05-13,1950,"RC Strasbourg","OGC Nice","2-1",2,1,"1",1,3,1,"H"
"3235",1951-05-20,1950,"OGC Nice","Nimes Olympique","2-0",2,0,"1",1,2,2,"H"
"3236",1951-05-20,1950,"FC Sochaux","Le Havre AC","1-0",1,0,"1",1,1,1,"H"
"3237",1951-05-20,1950,"AS Nancy","Lille OSC","1-2",1,2,"1",1,3,-1,"D"
"3238",1951-05-20,1950,"Stade Reims","RC Strasbourg","3-1",3,1,"1",1,4,2,"H"
"3239",1951-05-20,1950,"Olympique Marseille","Girondins Bordeaux","3-3",3,3,"1",1,6,0,"D"
"3240",1951-05-20,1950,"AS Saint-Etienne","Stade Francais FC","3-0",3,0,"1",1,3,3,"H"
"3241",1951-05-20,1950,"Racing Club de France","RC Lens","1-3",1,3,"1",1,4,-2,"D"
"3242",1951-05-20,1950,"RC Roubaix","Stade Rennes","3-0",3,0,"1",1,3,3,"H"
"3243",1951-05-20,1950,"Toulouse FC","FC Sete","0-0",0,0,"1",1,0,0,"D"
"3244",1951-05-27,1950,"Stade Francais FC","OGC Nice","0-4",0,4,"1",1,4,-4,"D"
"3245",1951-05-27,1950,"Lille OSC","AS Saint-Etienne","4-3",4,3,"1",1,7,1,"H"
"3246",1951-05-27,1950,"Le Havre AC","Toulouse FC","2-2",2,2,"1",1,4,0,"D"
"3247",1951-05-27,1950,"Nimes Olympique","FC Sochaux","3-3",3,3,"1",1,6,0,"D"
"3248",1951-05-27,1950,"Girondins Bordeaux","Stade Reims","2-4",2,4,"1",1,6,-2,"D"
"3249",1951-05-27,1950,"Stade Rennes","Olympique Marseille","2-1",2,1,"1",1,3,1,"H"
"3250",1951-05-27,1950,"RC Strasbourg","AS Nancy","1-5",1,5,"1",1,6,-4,"D"
"3251",1951-05-27,1950,"RC Lens","RC Roubaix","4-4",4,4,"1",1,8,0,"D"
"3252",1951-05-27,1950,"FC Sete","Racing Club de France","5-1",5,1,"1",1,6,4,"H"
"3253",1951-08-26,1951,"AS Saint-Etienne","Racing Club de France","0-3",0,3,"1",1,3,-3,"D"
"3254",1951-08-26,1951,"RC Roubaix","Le Havre AC","3-1",3,1,"1",1,4,2,"H"
"3255",1951-08-26,1951,"FC Sochaux","OGC Nice","2-0",2,0,"1",1,2,2,"H"
"3256",1951-08-26,1951,"Stade Rennes","Olympique Marseille","1-2",1,2,"1",1,3,-1,"D"
"3257",1951-08-26,1951,"RC Lens","FC Metz","0-1",0,1,"1",1,1,-1,"D"
"3258",1951-08-26,1951,"Girondins Bordeaux","RC Strasbourg","1-1",1,1,"1",1,2,0,"D"
"3259",1951-08-26,1951,"AS Nancy","Stade Reims","1-1",1,1,"1",1,2,0,"D"
"3260",1951-08-26,1951,"Nimes Olympique","Olympique Lyon","0-0",0,0,"1",1,0,0,"D"
"3261",1951-08-26,1951,"FC Sete","Lille OSC","0-0",0,0,"1",1,0,0,"D"
"3262",1951-09-02,1951,"FC Sochaux","RC Roubaix","1-2",1,2,"1",1,3,-1,"D"
"3263",1951-09-02,1951,"Olympique Marseille","Nimes Olympique","3-1",3,1,"1",1,4,2,"H"
"3264",1951-09-02,1951,"Racing Club de France","FC Metz","1-2",1,2,"1",1,3,-1,"D"
"3265",1951-09-02,1951,"Lille OSC","Stade Rennes","9-1",9,1,"1",1,10,8,"H"
"3266",1951-09-02,1951,"Olympique Lyon","Le Havre AC","3-0",3,0,"1",1,3,3,"H"
"3267",1951-09-02,1951,"AS Nancy","AS Saint-Etienne","2-0",2,0,"1",1,2,2,"H"
"3268",1951-09-02,1951,"OGC Nice","Girondins Bordeaux","3-1",3,1,"1",1,4,2,"H"
"3269",1951-09-02,1951,"Stade Reims","RC Strasbourg","0-0",0,0,"1",1,0,0,"D"
"3270",1951-09-02,1951,"FC Sete","RC Lens","1-1",1,1,"1",1,2,0,"D"
"3271",1951-09-09,1951,"RC Roubaix","OGC Nice","3-0",3,0,"1",1,3,3,"H"
"3272",1951-09-09,1951,"FC Metz","Olympique Marseille","2-1",2,1,"1",1,3,1,"H"
"3273",1951-09-09,1951,"RC Strasbourg","Olympique Lyon","1-2",1,2,"1",1,3,-1,"D"
"3274",1951-09-09,1951,"Nimes Olympique","AS Nancy","1-2",1,2,"1",1,3,-1,"D"
"3275",1951-09-09,1951,"Le Havre AC","Racing Club de France","0-2",0,2,"1",1,2,-2,"D"
"3276",1951-09-09,1951,"Girondins Bordeaux","Lille OSC","6-0",6,0,"1",1,6,6,"H"
"3277",1951-09-09,1951,"RC Lens","FC Sochaux","3-1",3,1,"1",1,4,2,"H"
"3278",1951-09-09,1951,"AS Saint-Etienne","FC Sete","2-1",2,1,"1",1,3,1,"H"
"3279",1951-09-09,1951,"Stade Rennes","Stade Reims","2-0",2,0,"1",1,2,2,"H"
"3280",1951-09-13,1951,"FC Metz","Stade Rennes","4-0",4,0,"1",1,4,4,"H"
"3281",1951-09-13,1951,"Olympique Lyon","RC Roubaix","0-0",0,0,"1",1,0,0,"D"
"3282",1951-09-13,1951,"Racing Club de France","Girondins Bordeaux","1-0",1,0,"1",1,1,1,"H"
"3283",1951-09-13,1951,"Lille OSC","AS Saint-Etienne","5-1",5,1,"1",1,6,4,"H"
"3284",1951-09-13,1951,"Olympique Marseille","FC Sete","2-2",2,2,"1",1,4,0,"D"
"3285",1951-09-13,1951,"FC Sochaux","AS Nancy","3-1",3,1,"1",1,4,2,"H"
"3286",1951-09-13,1951,"Stade Reims","RC Lens","5-2",5,2,"1",1,7,3,"H"
"3287",1951-09-13,1951,"OGC Nice","Nimes Olympique","3-0",3,0,"1",1,3,3,"H"
"3288",1951-09-13,1951,"Le Havre AC","RC Strasbourg","5-1",5,1,"1",1,6,4,"H"
"3289",1951-09-16,1951,"AS Nancy","RC Roubaix","0-2",0,2,"1",1,2,-2,"D"
"3290",1951-09-16,1951,"Stade Reims","FC Metz","2-0",2,0,"1",1,2,2,"H"
"3291",1951-09-16,1951,"Olympique Lyon","Racing Club de France","1-1",1,1,"1",1,2,0,"D"
"3292",1951-09-16,1951,"FC Sochaux","Stade Rennes","5-1",5,1,"1",1,6,4,"H"
"3293",1951-09-16,1951,"OGC Nice","RC Strasbourg","2-1",2,1,"1",1,3,1,"H"
"3294",1951-09-16,1951,"Lille OSC","Le Havre AC","1-3",1,3,"1",1,4,-2,"D"
"3295",1951-09-16,1951,"FC Sete","Girondins Bordeaux","1-0",1,0,"1",1,1,1,"H"
"3296",1951-09-16,1951,"Olympique Marseille","AS Saint-Etienne","3-10",3,10,"1",1,13,-7,"D"
"3297",1951-09-16,1951,"Nimes Olympique","RC Lens","4-1",4,1,"1",1,5,3,"H"
"3298",1951-09-23,1951,"RC Roubaix","FC Sete","4-0",4,0,"1",1,4,4,"H"
"3299",1951-09-23,1951,"FC Metz","Olympique Lyon","2-0",2,0,"1",1,2,2,"H"
"3300",1951-09-23,1951,"Racing Club de France","Olympique Marseille","5-1",5,1,"1",1,6,4,"H"
"3301",1951-09-23,1951,"Stade Rennes","OGC Nice","0-3",0,3,"1",1,3,-3,"D"
"3302",1951-09-23,1951,"RC Strasbourg","Lille OSC","0-2",0,2,"1",1,2,-2,"D"
"3303",1951-09-23,1951,"Girondins Bordeaux","FC Sochaux","2-1",2,1,"1",1,3,1,"H"
"3304",1951-09-23,1951,"Le Havre AC","Stade Reims","4-2",4,2,"1",1,6,2,"H"
"3305",1951-09-23,1951,"RC Lens","AS Nancy","4-0",4,0,"1",1,4,4,"H"
"3306",1951-09-23,1951,"AS Saint-Etienne","Nimes Olympique","0-2",0,2,"1",1,2,-2,"D"
"3307",1951-09-30,1951,"RC Roubaix","Stade Reims","1-0",1,0,"1",1,1,1,"H"
"3308",1951-09-30,1951,"RC Strasbourg","FC Metz","1-2",1,2,"1",1,3,-1,"D"
"3309",1951-09-30,1951,"RC Lens","Lille OSC","0-2",0,2,"1",1,2,-2,"D"
"3310",1951-09-30,1951,"Stade Rennes","Racing Club de France","4-1",4,1,"1",1,5,3,"H"
"3311",1951-09-30,1951,"AS Saint-Etienne","OGC Nice","1-1",1,1,"1",1,2,0,"D"
"3312",1951-09-30,1951,"Le Havre AC","Olympique Marseille","2-0",2,0,"1",1,2,2,"H"
"3313",1951-09-30,1951,"Girondins Bordeaux","Olympique Lyon","6-1",6,1,"1",1,7,5,"H"
"3314",1951-09-30,1951,"Nimes Olympique","FC Sochaux","3-1",3,1,"1",1,4,2,"H"
"3315",1951-09-30,1951,"AS Nancy","FC Sete","2-2",2,2,"1",1,4,0,"D"
"3316",1951-10-07,1951,"Lille OSC","RC Roubaix","2-1",2,1,"1",1,3,1,"H"
"3317",1951-10-07,1951,"FC Metz","Le Havre AC","0-4",0,4,"1",1,4,-4,"D"
"3318",1951-10-07,1951,"Racing Club de France","RC Strasbourg","5-2",5,2,"1",1,7,3,"H"
"3319",1951-10-07,1951,"OGC Nice","RC Lens","3-2",3,2,"1",1,5,1,"H"
"3320",1951-10-07,1951,"FC Sete","Nimes Olympique","1-3",1,3,"1",1,4,-2,"D"
"3321",1951-10-07,1951,"Olympique Lyon","Stade Rennes","3-2",3,2,"1",1,5,1,"H"
"3322",1951-10-07,1951,"Stade Reims","Girondins Bordeaux","6-1",6,1,"1",1,7,5,"H"
"3323",1951-10-07,1951,"FC Sochaux","AS Saint-Etienne","1-1",1,1,"1",1,2,0,"D"
"3324",1951-10-07,1951,"Olympique Marseille","AS Nancy","3-2",3,2,"1",1,5,1,"H"
"3325",1951-10-18,1951,"RC Roubaix","Racing Club de France","3-2",3,2,"1",1,5,1,"H"
"3326",1951-10-18,1951,"AS Nancy","OGC Nice","1-1",1,1,"1",1,2,0,"D"
"3327",1951-10-18,1951,"Girondins Bordeaux","FC Metz","3-2",3,2,"1",1,5,1,"H"
"3328",1951-10-18,1951,"Nimes Olympique","Lille OSC","5-0",5,0,"1",1,5,5,"H"
"3329",1951-10-18,1951,"Stade Rennes","Le Havre AC","2-2",2,2,"1",1,4,0,"D"
"3330",1951-10-18,1951,"AS Saint-Etienne","Stade Reims","1-1",1,1,"1",1,2,0,"D"
"3331",1951-10-18,1951,"RC Lens","Olympique Lyon","4-2",4,2,"1",1,6,2,"H"
"3332",1951-10-18,1951,"FC Sete","FC Sochaux","3-1",3,1,"1",1,4,2,"H"
"3333",1951-10-18,1951,"RC Strasbourg","Olympique Marseille","1-1",1,1,"1",1,2,0,"D"
"3334",1951-10-21,1951,"Girondins Bordeaux","RC Roubaix","4-0",4,0,"1",1,4,4,"H"
"3335",1951-10-21,1951,"FC Metz","AS Nancy","4-2",4,2,"1",1,6,2,"H"
"3336",1951-10-21,1951,"Le Havre AC","Nimes Olympique","2-0",2,0,"1",1,2,2,"H"
"3337",1951-10-21,1951,"Lille OSC","Olympique Marseille","3-3",3,3,"1",1,6,0,"D"
"3338",1951-10-21,1951,"Stade Reims","OGC Nice","2-1",2,1,"1",1,3,1,"H"
"3339",1951-10-21,1951,"Racing Club de France","FC Sete","0-2",0,2,"1",1,2,-2,"D"
"3340",1951-10-21,1951,"AS Saint-Etienne","RC Strasbourg","5-0",5,0,"1",1,5,5,"H"
"3341",1951-10-21,1951,"FC Sochaux","Olympique Lyon","2-0",2,0,"1",1,2,2,"H"
"3342",1951-10-21,1951,"Stade Rennes","RC Lens","0-0",0,0,"1",1,0,0,"D"
"3343",1951-10-28,1951,"RC Roubaix","FC Metz","0-0",0,0,"1",1,0,0,"D"
"3344",1951-10-28,1951,"Le Havre AC","Girondins Bordeaux","0-0",0,0,"1",1,0,0,"D"
"3345",1951-10-28,1951,"AS Nancy","Lille OSC","0-2",0,2,"1",1,2,-2,"D"
"3346",1951-10-28,1951,"OGC Nice","FC Sete","2-1",2,1,"1",1,3,1,"H"
"3347",1951-10-28,1951,"Racing Club de France","RC Lens","3-1",3,1,"1",1,4,2,"H"
"3348",1951-10-28,1951,"Stade Reims","Nimes Olympique","1-0",1,0,"1",1,1,1,"H"
"3349",1951-10-28,1951,"Olympique Lyon","AS Saint-Etienne","4-2",4,2,"1",1,6,2,"H"
"3350",1951-10-28,1951,"Olympique Marseille","FC Sochaux","1-1",1,1,"1",1,2,0,"D"
"3351",1951-10-28,1951,"RC Strasbourg","Stade Rennes","1-2",1,2,"1",1,3,-1,"D"
"3352",1951-11-04,1951,"Olympique Marseille","RC Roubaix","1-1",1,1,"1",1,2,0,"D"
"3353",1951-11-04,1951,"OGC Nice","Olympique Lyon","6-1",6,1,"1",1,7,5,"H"
"3354",1951-11-04,1951,"Lille OSC","Stade Reims","1-0",1,0,"1",1,1,1,"H"
"3355",1951-11-04,1951,"FC Sete","FC Metz","1-0",1,0,"1",1,1,1,"H"
"3356",1951-11-04,1951,"AS Nancy","Le Havre AC","2-1",2,1,"1",1,3,1,"H"
"3357",1951-11-04,1951,"RC Lens","Girondins Bordeaux","0-0",0,0,"1",1,0,0,"D"
"3358",1951-11-04,1951,"FC Sochaux","Racing Club de France","1-0",1,0,"1",1,1,1,"H"
"3359",1951-11-04,1951,"Nimes Olympique","RC Strasbourg","2-1",2,1,"1",1,3,1,"H"
"3360",1951-11-04,1951,"AS Saint-Etienne","Stade Rennes","5-0",5,0,"1",1,5,5,"H"
"3361",1951-11-11,1951,"RC Roubaix","Nimes Olympique","1-2",1,2,"1",1,3,-1,"D"
"3362",1951-11-11,1951,"FC Metz","Lille OSC","2-1",2,1,"1",1,3,1,"H"
"3363",1951-11-11,1951,"Le Havre AC","OGC Nice","3-1",3,1,"1",1,4,2,"H"
"3364",1951-11-11,1951,"Girondins Bordeaux","AS Nancy","4-1",4,1,"1",1,5,3,"H"
"3365",1951-11-11,1951,"Racing Club de France","Stade Reims","5-2",5,2,"1",1,7,3,"H"
"3366",1951-11-11,1951,"RC Lens","AS Saint-Etienne","2-5",2,5,"1",1,7,-3,"D"
"3367",1951-11-11,1951,"RC Strasbourg","FC Sochaux","1-1",1,1,"1",1,2,0,"D"
"3368",1951-11-11,1951,"Stade Rennes","FC Sete","2-0",2,0,"1",1,2,2,"H"
"3369",1951-11-11,1951,"Olympique Lyon","Olympique Marseille","2-2",2,2,"1",1,4,0,"D"
"3370",1951-11-18,1951,"FC Sochaux","Le Havre AC","0-1",0,1,"1",1,1,-1,"D"
"3371",1951-11-18,1951,"Lille OSC","Racing Club de France","5-1",5,1,"1",1,6,4,"H"
"3372",1951-11-18,1951,"OGC Nice","FC Metz","2-0",2,0,"1",1,2,2,"H"
"3373",1951-11-18,1951,"Nimes Olympique","Girondins Bordeaux","2-3",2,3,"1",1,5,-1,"D"
"3374",1951-11-18,1951,"AS Saint-Etienne","RC Roubaix","1-0",1,0,"1",1,1,1,"H"
"3375",1951-11-18,1951,"Stade Reims","Olympique Lyon","1-0",1,0,"1",1,1,1,"H"
"3376",1951-11-18,1951,"Olympique Marseille","RC Lens","1-0",1,0,"1",1,1,1,"H"
"3377",1951-11-18,1951,"FC Sete","RC Strasbourg","0-0",0,0,"1",1,0,0,"D"
"3378",1951-11-18,1951,"AS Nancy","Stade Rennes","9-1",9,1,"1",1,10,8,"H"
"3379",1951-11-25,1951,"Olympique Lyon","Lille OSC","0-3",0,3,"1",1,3,-3,"D"
"3380",1951-11-25,1951,"Le Havre AC","FC Sete","3-2",3,2,"1",1,5,1,"H"
"3381",1951-11-25,1951,"Girondins Bordeaux","AS Saint-Etienne","9-0",9,0,"1",1,9,9,"H"
"3382",1951-11-25,1951,"FC Metz","FC Sochaux","3-1",3,1,"1",1,4,2,"H"
"3383",1951-11-25,1951,"Racing Club de France","OGC Nice","3-2",3,2,"1",1,5,1,"H"
"3384",1951-11-25,1951,"Stade Reims","Olympique Marseille","8-1",8,1,"1",1,9,7,"H"
"3385",1951-11-25,1951,"RC Roubaix","RC Lens","1-2",1,2,"1",1,3,-1,"D"
"3386",1951-11-25,1951,"Stade Rennes","Nimes Olympique","2-0",2,0,"1",1,2,2,"H"
"3387",1951-11-25,1951,"RC Strasbourg","AS Nancy","3-2",3,2,"1",1,5,1,"H"
"3388",1951-12-02,1951,"Girondins Bordeaux","Olympique Marseille","6-1",6,1,"1",1,7,5,"H"
"3389",1951-12-02,1951,"AS Saint-Etienne","Le Havre AC","1-1",1,1,"1",1,2,0,"D"
"3390",1951-12-02,1951,"OGC Nice","Lille OSC","3-1",3,1,"1",1,4,2,"H"
"3391",1951-12-02,1951,"Nimes Olympique","FC Metz","0-0",0,0,"1",1,0,0,"D"
"3392",1951-12-02,1951,"RC Roubaix","Stade Rennes","2-0",2,0,"1",1,2,2,"H"
"3393",1951-12-02,1951,"FC Sochaux","Stade Reims","4-1",4,1,"1",1,5,3,"H"
"3394",1951-12-02,1951,"AS Nancy","Racing Club de France","6-3",6,3,"1",1,9,3,"H"
"3395",1951-12-02,1951,"FC Sete","Olympique Lyon","0-2",0,2,"1",1,2,-2,"D"
"3396",1951-12-02,1951,"RC Lens","RC Strasbourg","5-1",5,1,"1",1,6,4,"H"
"3397",1951-12-09,1951,"Stade Rennes","Girondins Bordeaux","2-2",2,2,"1",1,4,0,"D"
"3398",1951-12-09,1951,"Lille OSC","FC Sochaux","7-3",7,3,"1",1,10,4,"H"
"3399",1951-12-09,1951,"Olympique Marseille","OGC Nice","2-4",2,4,"1",1,6,-2,"D"
"3400",1951-12-09,1951,"Le Havre AC","RC Lens","0-1",0,1,"1",1,1,-1,"D"
"3401",1951-12-09,1951,"FC Metz","AS Saint-Etienne","2-2",2,2,"1",1,4,0,"D"
"3402",1951-12-09,1951,"RC Strasbourg","RC Roubaix","2-2",2,2,"1",1,4,0,"D"
"3403",1951-12-09,1951,"Stade Reims","FC Sete","6-0",6,0,"1",1,6,6,"H"
"3404",1951-12-09,1951,"Racing Club de France","Nimes Olympique","1-2",1,2,"1",1,3,-1,"D"
"3405",1951-12-09,1951,"Olympique Lyon","AS Nancy","0-1",0,1,"1",1,1,-1,"D"
"3406",1951-12-16,1951,"RC Strasbourg","Girondins Bordeaux","2-5",2,5,"1",1,7,-3,"D"
"3407",1951-12-16,1951,"Lille OSC","FC Sete","6-1",6,1,"1",1,7,5,"H"
"3408",1951-12-16,1951,"Le Havre AC","RC Roubaix","2-0",2,0,"1",1,2,2,"H"
"3409",1951-12-16,1951,"OGC Nice","FC Sochaux","0-1",0,1,"1",1,1,-1,"D"
"3410",1951-12-16,1951,"FC Metz","RC Lens","1-1",1,1,"1",1,2,0,"D"
"3411",1951-12-16,1951,"Stade Reims","AS Nancy","0-0",0,0,"1",1,0,0,"D"
"3412",1951-12-16,1951,"Olympique Lyon","Nimes Olympique","4-3",4,3,"1",1,7,1,"H"
"3413",1951-12-16,1951,"Racing Club de France","AS Saint-Etienne","1-3",1,3,"1",1,4,-2,"D"
"3414",1951-12-16,1951,"Olympique Marseille","Stade Rennes","1-1",1,1,"1",1,2,0,"D"
"3415",1951-12-23,1951,"Stade Rennes","Lille OSC","2-2",2,2,"1",1,4,0,"D"
"3416",1951-12-23,1951,"Le Havre AC","Olympique Lyon","2-0",2,0,"1",1,2,2,"H"
"3417",1951-12-23,1951,"Girondins Bordeaux","OGC Nice","1-3",1,3,"1",1,4,-2,"D"
"3418",1951-12-23,1951,"FC Metz","Racing Club de France","2-2",2,2,"1",1,4,0,"D"
"3419",1951-12-23,1951,"RC Strasbourg","Stade Reims","2-3",2,3,"1",1,5,-1,"D"
"3420",1951-12-23,1951,"RC Roubaix","FC Sochaux","2-0",2,0,"1",1,2,2,"H"
"3421",1951-12-23,1951,"Nimes Olympique","Olympique Marseille","1-0",1,0,"1",1,1,1,"H"
"3422",1951-12-23,1951,"AS Saint-Etienne","AS Nancy","1-2",1,2,"1",1,3,-1,"D"
"3423",1951-12-23,1951,"RC Lens","FC Sete","4-2",4,2,"1",1,6,2,"H"
"3424",1951-12-30,1951,"Racing Club de France","Le Havre AC","2-6",2,6,"1",1,8,-4,"D"
"3425",1951-12-30,1951,"Lille OSC","Girondins Bordeaux","2-2",2,2,"1",1,4,0,"D"
"3426",1951-12-30,1951,"OGC Nice","RC Roubaix","2-1",2,1,"1",1,3,1,"H"
"3427",1951-12-30,1951,"Stade Reims","Stade Rennes","4-0",4,0,"1",1,4,4,"H"
"3428",1951-12-30,1951,"Olympique Marseille","FC Metz","4-0",4,0,"1",1,4,4,"H"
"3429",1951-12-30,1951,"AS Nancy","Nimes Olympique","0-0",0,0,"1",1,0,0,"D"
"3430",1951-12-30,1951,"FC Sochaux","RC Lens","3-1",3,1,"1",1,4,2,"H"
"3431",1951-12-30,1951,"FC Sete","AS Saint-Etienne","4-2",4,2,"1",1,6,2,"H"
"3432",1951-12-30,1951,"Olympique Lyon","RC Strasbourg","2-3",2,3,"1",1,5,-1,"D"
"3433",1952-01-06,1951,"RC Strasbourg","Le Havre AC","0-2",0,2,"1",1,2,-2,"D"
"3434",1952-01-06,1951,"AS Saint-Etienne","Lille OSC","1-3",1,3,"1",1,4,-2,"D"
"3435",1952-01-06,1951,"Nimes Olympique","OGC Nice","3-1",3,1,"1",1,4,2,"H"
"3436",1952-01-06,1951,"Stade Rennes","FC Metz","0-1",0,1,"1",1,1,-1,"D"
"3437",1952-01-06,1951,"RC Lens","Stade Reims","3-1",3,1,"1",1,4,2,"H"
"3438",1952-01-06,1951,"RC Roubaix","Olympique Lyon","3-0",3,0,"1",1,3,3,"H"
"3439",1952-01-06,1951,"AS Nancy","FC Sochaux","2-1",2,1,"1",1,3,1,"H"
"3440",1952-01-06,1951,"FC Sete","Olympique Marseille","2-0",2,0,"1",1,2,2,"H"
"3441",1952-01-20,1951,"Le Havre AC","Lille OSC","2-0",2,0,"1",1,2,2,"H"
"3442",1952-01-20,1951,"RC Strasbourg","OGC Nice","1-3",1,3,"1",1,4,-2,"D"
"3443",1952-01-20,1951,"Girondins Bordeaux","FC Sete","2-1",2,1,"1",1,3,1,"H"
"3444",1952-01-20,1951,"RC Roubaix","AS Nancy","2-1",2,1,"1",1,3,1,"H"
"3445",1952-01-20,1951,"FC Metz","Stade Reims","0-0",0,0,"1",1,0,0,"D"
"3446",1952-01-20,1951,"RC Lens","Nimes Olympique","0-1",0,1,"1",1,1,-1,"D"
"3447",1952-01-20,1951,"AS Saint-Etienne","Olympique Marseille","4-2",4,2,"1",1,6,2,"H"
"3448",1952-01-20,1951,"Racing Club de France","Olympique Lyon","4-0",4,0,"1",1,4,4,"H"
"3449",1952-01-20,1951,"Stade Rennes","FC Sochaux","5-1",5,1,"1",1,6,4,"H"
"3450",1952-01-27,1951,"Stade Reims","Le Havre AC","3-1",3,1,"1",1,4,2,"H"
"3451",1952-01-27,1951,"OGC Nice","Stade Rennes","3-0",3,0,"1",1,3,3,"H"
"3452",1952-01-27,1951,"Nimes Olympique","AS Saint-Etienne","5-1",5,1,"1",1,6,4,"H"
"3453",1952-01-27,1951,"Olympique Lyon","FC Metz","2-2",2,2,"1",1,4,0,"D"
"3454",1952-01-27,1951,"FC Sete","RC Roubaix","2-1",2,1,"1",1,3,1,"H"
"3455",1952-01-27,1951,"AS Nancy","RC Lens","3-2",3,2,"1",1,5,1,"H"
"3456",1952-01-27,1951,"Olympique Marseille","Racing Club de France","0-0",0,0,"1",1,0,0,"D"
"3457",1952-02-11,1951,"OGC Nice","AS Saint-Etienne","3-0",3,0,"1",1,3,3,"H"
"3458",1952-02-11,1951,"Lille OSC","RC Lens","5-0",5,0,"1",1,5,5,"H"
"3459",1952-02-11,1951,"Olympique Lyon","Girondins Bordeaux","0-1",0,1,"1",1,1,-1,"D"
"3460",1952-02-11,1951,"Stade Reims","RC Roubaix","2-1",2,1,"1",1,3,1,"H"
"3461",1952-02-11,1951,"FC Metz","RC Strasbourg","2-0",2,0,"1",1,2,2,"H"
"3462",1952-02-11,1951,"FC Sochaux","Nimes Olympique","2-0",2,0,"1",1,2,2,"H"
"3463",1952-02-11,1951,"Racing Club de France","Stade Rennes","1-5",1,5,"1",1,6,-4,"D"
"3464",1952-02-11,1951,"FC Sete","AS Nancy","0-0",0,0,"1",1,0,0,"D"
"3465",1952-02-14,1951,"Lille OSC","RC Strasbourg","3-1",3,1,"1",1,4,2,"H"
"3466",1952-02-14,1951,"FC Sochaux","Girondins Bordeaux","0-2",0,2,"1",1,2,-2,"D"
"3467",1952-02-17,1951,"RC Lens","OGC Nice","1-2",1,2,"1",1,3,-1,"D"
"3468",1952-02-17,1951,"Girondins Bordeaux","Stade Reims","2-0",2,0,"1",1,2,2,"H"
"3469",1952-02-17,1951,"RC Roubaix","Lille OSC","2-2",2,2,"1",1,4,0,"D"
"3470",1952-02-17,1951,"Le Havre AC","FC Metz","1-1",1,1,"1",1,2,0,"D"
"3471",1952-02-17,1951,"Nimes Olympique","FC Sete","1-2",1,2,"1",1,3,-1,"D"
"3472",1952-02-17,1951,"AS Nancy","Olympique Marseille","0-1",0,1,"1",1,1,-1,"D"
"3473",1952-02-17,1951,"RC Strasbourg","Racing Club de France","2-2",2,2,"1",1,4,0,"D"
"3474",1952-02-17,1951,"AS Saint-Etienne","FC Sochaux","4-1",4,1,"1",1,5,3,"H"
"3475",1952-02-17,1951,"Stade Rennes","Olympique Lyon","2-0",2,0,"1",1,2,2,"H"
"3476",1952-02-26,1951,"Girondins Bordeaux","Racing Club de France","3-0",3,0,"1",1,3,3,"H"
"3477",1952-02-27,1951,"Olympique Marseille","Le Havre AC","0-0",0,0,"1",1,0,0,"D"
"3478",1952-03-02,1951,"FC Metz","Girondins Bordeaux","2-1",2,1,"1",1,3,1,"H"
"3479",1952-03-02,1951,"Lille OSC","Nimes Olympique","2-1",2,1,"1",1,3,1,"H"
"3480",1952-03-02,1951,"OGC Nice","AS Nancy","1-1",1,1,"1",1,2,0,"D"
"3481",1952-03-02,1951,"Le Havre AC","Stade Rennes","1-2",1,2,"1",1,3,-1,"D"
"3482",1952-03-02,1951,"Stade Reims","AS Saint-Etienne","1-0",1,0,"1",1,1,1,"H"
"3483",1952-03-02,1951,"Racing Club de France","RC Roubaix","2-1",2,1,"1",1,3,1,"H"
"3484",1952-03-02,1951,"FC Sochaux","FC Sete","0-3",0,3,"1",1,3,-3,"D"
"3485",1952-03-02,1951,"Olympique Marseille","RC Strasbourg","2-1",2,1,"1",1,3,1,"H"
"3486",1952-03-02,1951,"Olympique Lyon","RC Lens","4-1",4,1,"1",1,5,3,"H"
"3487",1952-03-09,1951,"Olympique Marseille","Lille OSC","0-2",0,2,"1",1,2,-2,"D"
"3488",1952-03-09,1951,"OGC Nice","Stade Reims","2-1",2,1,"1",1,3,1,"H"
"3489",1952-03-09,1951,"RC Roubaix","Girondins Bordeaux","2-1",2,1,"1",1,3,1,"H"
"3490",1952-03-09,1951,"Nimes Olympique","Le Havre AC","2-0",2,0,"1",1,2,2,"H"
"3491",1952-03-09,1951,"AS Nancy","FC Metz","2-2",2,2,"1",1,4,0,"D"
"3492",1952-03-09,1951,"FC Sete","Racing Club de France","2-0",2,0,"1",1,2,2,"H"
"3493",1952-03-09,1951,"RC Strasbourg","AS Saint-Etienne","1-3",1,3,"1",1,4,-2,"D"
"3494",1952-03-09,1951,"RC Lens","Stade Rennes","3-0",3,0,"1",1,3,3,"H"
"3495",1952-03-09,1951,"Olympique Lyon","FC Sochaux","0-0",0,0,"1",1,0,0,"D"
"3496",1952-03-23,1951,"FC Sete","OGC Nice","1-1",1,1,"1",1,2,0,"D"
"3497",1952-03-23,1951,"Girondins Bordeaux","Le Havre AC","4-1",4,1,"1",1,5,3,"H"
"3498",1952-03-23,1951,"Lille OSC","AS Nancy","0-3",0,3,"1",1,3,-3,"D"
"3499",1952-03-23,1951,"FC Metz","RC Roubaix","3-0",3,0,"1",1,3,3,"H"
"3500",1952-03-23,1951,"Nimes Olympique","Stade Reims","2-0",2,0,"1",1,2,2,"H"
"3501",1952-03-23,1951,"AS Saint-Etienne","Olympique Lyon","1-0",1,0,"1",1,1,1,"H"
"3502",1952-03-23,1951,"RC Lens","Racing Club de France","3-1",3,1,"1",1,4,2,"H"
"3503",1952-03-23,1951,"Stade Rennes","RC Strasbourg","2-1",2,1,"1",1,3,1,"H"
"3504",1952-03-23,1951,"FC Sochaux","Olympique Marseille","1-1",1,1,"1",1,2,0,"D"
"3505",1952-03-29,1951,"Girondins Bordeaux","RC Lens","4-1",4,1,"1",1,5,3,"H"
"3506",1952-03-30,1951,"Olympique Lyon","OGC Nice","0-2",0,2,"1",1,2,-2,"D"
"3507",1952-03-30,1951,"Stade Reims","Lille OSC","1-0",1,0,"1",1,1,1,"H"
"3508",1952-03-30,1951,"FC Metz","FC Sete","3-1",3,1,"1",1,4,2,"H"
"3509",1952-03-30,1951,"Le Havre AC","AS Nancy","1-1",1,1,"1",1,2,0,"D"
"3510",1952-03-30,1951,"RC Strasbourg","Nimes Olympique","3-1",3,1,"1",1,4,2,"H"
"3511",1952-03-30,1951,"RC Roubaix","Olympique Marseille","5-2",5,2,"1",1,7,3,"H"
"3512",1952-03-30,1951,"Stade Rennes","AS Saint-Etienne","2-3",2,3,"1",1,5,-1,"D"
"3513",1952-03-30,1951,"Racing Club de France","FC Sochaux","0-4",0,4,"1",1,4,-4,"D"
"3514",1952-04-13,1951,"OGC Nice","Le Havre AC","0-1",0,1,"1",1,1,-1,"D"
"3515",1952-04-13,1951,"AS Nancy","Girondins Bordeaux","2-1",2,1,"1",1,3,1,"H"
"3516",1952-04-13,1951,"Lille OSC","FC Metz","3-2",3,2,"1",1,5,1,"H"
"3517",1952-04-13,1951,"Stade Reims","Racing Club de France","1-1",1,1,"1",1,2,0,"D"
"3518",1952-04-13,1951,"Nimes Olympique","RC Roubaix","3-3",3,3,"1",1,6,0,"D"
"3519",1952-04-13,1951,"AS Saint-Etienne","RC Lens","1-1",1,1,"1",1,2,0,"D"
"3520",1952-04-13,1951,"FC Sete","Stade Rennes","3-3",3,3,"1",1,6,0,"D"
"3521",1952-04-13,1951,"FC Sochaux","RC Strasbourg","0-1",0,1,"1",1,1,-1,"D"
"3522",1952-04-13,1951,"Olympique Marseille","Olympique Lyon","3-1",3,1,"1",1,4,2,"H"
"3523",1952-04-26,1951,"Le Havre AC","FC Sochaux","1-2",1,2,"1",1,3,-1,"D"
"3524",1952-04-27,1951,"FC Metz","OGC Nice","0-2",0,2,"1",1,2,-2,"D"
"3525",1952-04-27,1951,"Girondins Bordeaux","Nimes Olympique","4-2",4,2,"1",1,6,2,"H"
"3526",1952-04-27,1951,"Racing Club de France","Lille OSC","2-1",2,1,"1",1,3,1,"H"
"3527",1952-04-27,1951,"Olympique Lyon","Stade Reims","2-5",2,5,"1",1,7,-3,"D"
"3528",1952-04-27,1951,"RC Lens","Olympique Marseille","2-1",2,1,"1",1,3,1,"H"
"3529",1952-04-27,1951,"RC Roubaix","AS Saint-Etienne","1-2",1,2,"1",1,3,-1,"D"
"3530",1952-04-27,1951,"Stade Rennes","AS Nancy","1-1",1,1,"1",1,2,0,"D"
"3531",1952-04-27,1951,"RC Strasbourg","FC Sete","0-2",0,2,"1",1,2,-2,"D"
"3532",1952-05-11,1951,"OGC Nice","Racing Club de France","1-0",1,0,"1",1,1,1,"H"
"3533",1952-05-11,1951,"AS Saint-Etienne","Girondins Bordeaux","1-4",1,4,"1",1,5,-3,"D"
"3534",1952-05-11,1951,"Lille OSC","Olympique Lyon","3-0",3,0,"1",1,3,3,"H"
"3535",1952-05-11,1951,"Olympique Marseille","Stade Reims","1-3",1,3,"1",1,4,-2,"D"
"3536",1952-05-11,1951,"FC Sochaux","FC Metz","0-0",0,0,"1",1,0,0,"D"
"3537",1952-05-11,1951,"FC Sete","Le Havre AC","3-1",3,1,"1",1,4,2,"H"
"3538",1952-05-11,1951,"Nimes Olympique","Stade Rennes","7-0",7,0,"1",1,7,7,"H"
"3539",1952-05-11,1951,"RC Lens","RC Roubaix","0-0",0,0,"1",1,0,0,"D"
"3540",1952-05-11,1951,"AS Nancy","RC Strasbourg","2-2",2,2,"1",1,4,0,"D"
"3541",1952-05-18,1951,"Lille OSC","OGC Nice","6-0",6,0,"1",1,6,6,"H"
"3542",1952-05-18,1951,"Olympique Marseille","Girondins Bordeaux","6-0",6,0,"1",1,6,6,"H"
"3543",1952-05-18,1951,"Stade Reims","FC Sochaux","1-5",1,5,"1",1,6,-4,"D"
"3544",1952-05-18,1951,"FC Metz","Nimes Olympique","1-2",1,2,"1",1,3,-1,"D"
"3545",1952-05-18,1951,"Le Havre AC","AS Saint-Etienne","0-2",0,2,"1",1,2,-2,"D"
"3546",1952-05-18,1951,"Stade Rennes","RC Roubaix","2-2",2,2,"1",1,4,0,"D"
"3547",1952-05-18,1951,"Olympique Lyon","FC Sete","2-6",2,6,"1",1,8,-4,"D"
"3548",1952-05-18,1951,"Racing Club de France","AS Nancy","3-1",3,1,"1",1,4,2,"H"
"3549",1952-05-18,1951,"RC Strasbourg","RC Lens","1-2",1,2,"1",1,3,-1,"D"
"3550",1952-05-25,1951,"OGC Nice","Olympique Marseille","2-0",2,0,"1",1,2,2,"H"
"3551",1952-05-25,1951,"Girondins Bordeaux","Stade Rennes","3-2",3,2,"1",1,5,1,"H"
"3552",1952-05-25,1951,"FC Sochaux","Lille OSC","1-1",1,1,"1",1,2,0,"D"
"3553",1952-05-25,1951,"FC Sete","Stade Reims","2-0",2,0,"1",1,2,2,"H"
"3554",1952-05-25,1951,"AS Saint-Etienne","FC Metz","3-0",3,0,"1",1,3,3,"H"
"3555",1952-05-25,1951,"Nimes Olympique","Racing Club de France","2-2",2,2,"1",1,4,0,"D"
"3556",1952-05-25,1951,"RC Lens","Le Havre AC","1-1",1,1,"1",1,2,0,"D"
"3557",1952-05-25,1951,"RC Roubaix","RC Strasbourg","5-0",5,0,"1",1,5,5,"H"
"3558",1952-05-25,1951,"AS Nancy","Olympique Lyon","4-0",4,0,"1",1,4,4,"H"
"3559",1952-08-24,1952,"AS Saint-Etienne","Stade Reims","2-6",2,6,"1",1,8,-4,"D"
"3560",1952-08-24,1952,"Olympique Marseille","Stade Olympique Montpellierain","5-1",5,1,"1",1,6,4,"H"
"3561",1952-08-24,1952,"Le Havre AC","FC Metz","3-0",3,0,"1",1,3,3,"H"
"3562",1952-08-24,1952,"AS Nancy","Lille OSC","1-3",1,3,"1",1,4,-2,"D"
"3563",1952-08-24,1952,"Racing Club de France","Stade Rennes","2-0",2,0,"1",1,2,2,"H"
"3564",1952-08-24,1952,"Girondins Bordeaux","Stade Francais FC","2-1",2,1,"1",1,3,1,"H"
"3565",1952-08-24,1952,"RC Lens","Nimes Olympique","2-1",2,1,"1",1,3,1,"H"
"3566",1952-08-24,1952,"RC Roubaix","OGC Nice","2-2",2,2,"1",1,4,0,"D"
"3567",1952-08-24,1952,"FC Sete","FC Sochaux","0-0",0,0,"1",1,0,0,"D"
"3568",1952-08-31,1952,"Stade Reims","Le Havre AC","5-0",5,0,"1",1,5,5,"H"
"3569",1952-08-31,1952,"Stade Francais FC","Olympique Marseille","2-3",2,3,"1",1,5,-1,"D"
"3570",1952-08-31,1952,"FC Metz","Lille OSC","0-3",0,3,"1",1,3,-3,"D"
"3571",1952-08-31,1952,"FC Sochaux","Racing Club de France","3-3",3,3,"1",1,6,0,"D"
"3572",1952-08-31,1952,"OGC Nice","RC Lens","3-1",3,1,"1",1,4,2,"H"
"3573",1952-08-31,1952,"Nimes Olympique","FC Sete","3-1",3,1,"1",1,4,2,"H"
"3574",1952-08-31,1952,"RC Roubaix","AS Nancy","2-2",2,2,"1",1,4,0,"D"
"3575",1952-08-31,1952,"Stade Rennes","Girondins Bordeaux","1-0",1,0,"1",1,1,1,"H"
"3576",1952-08-31,1952,"Stade Olympique Montpellierain","AS Saint-Etienne","2-0",2,0,"1",1,2,2,"H"
"3577",1952-09-07,1952,"Lille OSC","Stade Reims","2-5",2,5,"1",1,7,-3,"D"
"3578",1952-09-07,1952,"Olympique Marseille","Stade Rennes","2-2",2,2,"1",1,4,0,"D"
"3579",1952-09-07,1952,"Girondins Bordeaux","FC Sochaux","4-1",4,1,"1",1,5,3,"H"
"3580",1952-09-07,1952,"RC Lens","RC Roubaix","1-3",1,3,"1",1,4,-2,"D"
"3581",1952-09-07,1952,"Racing Club de France","Nimes Olympique","1-2",1,2,"1",1,3,-1,"D"
"3582",1952-09-07,1952,"FC Sete","OGC Nice","1-0",1,0,"1",1,1,1,"H"
"3583",1952-09-07,1952,"Le Havre AC","Stade Olympique Montpellierain","1-1",1,1,"1",1,2,0,"D"
"3584",1952-09-07,1952,"FC Metz","AS Nancy","2-0",2,0,"1",1,2,2,"H"
"3585",1952-09-07,1952,"AS Saint-Etienne","Stade Francais FC","1-1",1,1,"1",1,2,0,"D"
"3586",1952-09-11,1952,"RC Lens","Lille OSC","0-3",0,3,"1",1,3,-3,"D"
"3587",1952-09-11,1952,"Girondins Bordeaux","Olympique Marseille","2-0",2,0,"1",1,2,2,"H"
"3588",1952-09-11,1952,"Nimes Olympique","Stade Olympique Montpellierain","4-2",4,2,"1",1,6,2,"H"
"3589",1952-09-11,1952,"RC Roubaix","FC Metz","1-0",1,0,"1",1,1,1,"H"
"3590",1952-09-11,1952,"Racing Club de France","AS Saint-Etienne","2-1",2,1,"1",1,3,1,"H"
"3591",1952-09-11,1952,"AS Nancy","Stade Rennes","1-2",1,2,"1",1,3,-1,"D"
"3592",1952-09-11,1952,"FC Sochaux","Stade Francais FC","1-3",1,3,"1",1,4,-2,"D"
"3593",1952-09-14,1952,"Stade Reims","RC Lens","5-0",5,0,"1",1,5,5,"H"
"3594",1952-09-14,1952,"Lille OSC","Racing Club de France","3-0",3,0,"1",1,3,3,"H"
"3595",1952-09-14,1952,"Stade Olympique Montpellierain","RC Roubaix","1-1",1,1,"1",1,2,0,"D"
"3596",1952-09-14,1952,"Stade Rennes","Nimes Olympique","2-0",2,0,"1",1,2,2,"H"
"3597",1952-09-14,1952,"AS Saint-Etienne","Olympique Marseille","2-2",2,2,"1",1,4,0,"D"
"3598",1952-09-14,1952,"Le Havre AC","Girondins Bordeaux","3-1",3,1,"1",1,4,2,"H"
"3599",1952-09-14,1952,"Stade Francais FC","OGC Nice","0-1",0,1,"1",1,1,-1,"D"
"3600",1952-09-14,1952,"FC Metz","FC Sete","0-1",0,1,"1",1,1,-1,"D"
"3601",1952-09-14,1952,"FC Sochaux","AS Nancy","1-0",1,0,"1",1,1,1,"H"
"3602",1952-09-18,1952,"OGC Nice","Stade Reims","0-4",0,4,"1",1,4,-4,"D"
"3603",1952-09-18,1952,"FC Sete","Le Havre AC","3-1",3,1,"1",1,4,2,"H"
"3604",1952-09-21,1952,"FC Sete","Stade Reims","2-1",2,1,"1",1,3,1,"H"
"3605",1952-09-21,1952,"Girondins Bordeaux","Lille OSC","1-5",1,5,"1",1,6,-4,"D"
"3606",1952-09-21,1952,"Olympique Marseille","Le Havre AC","3-1",3,1,"1",1,4,2,"H"
"3607",1952-09-21,1952,"Nimes Olympique","FC Sochaux","2-0",2,0,"1",1,2,2,"H"
"3608",1952-09-21,1952,"RC Roubaix","Stade Francais FC","0-0",0,0,"1",1,0,0,"D"
"3609",1952-09-21,1952,"OGC Nice","Stade Rennes","3-1",3,1,"1",1,4,2,"H"
"3610",1952-09-21,1952,"Racing Club de France","FC Metz","0-2",0,2,"1",1,2,-2,"D"
"3611",1952-09-21,1952,"RC Lens","Stade Olympique Montpellierain","2-1",2,1,"1",1,3,1,"H"
"3612",1952-09-21,1952,"AS Nancy","AS Saint-Etienne","3-2",3,2,"1",1,5,1,"H"
"3613",1952-09-27,1952,"Nimes Olympique","AS Nancy","2-1",2,1,"1",1,3,1,"H"
"3614",1952-09-28,1952,"Stade Reims","Racing Club de France","5-1",5,1,"1",1,6,4,"H"
"3615",1952-09-28,1952,"Lille OSC","Olympique Marseille","2-0",2,0,"1",1,2,2,"H"
"3616",1952-09-28,1952,"Stade Olympique Montpellierain","FC Sete","1-1",1,1,"1",1,2,0,"D"
"3617",1952-09-28,1952,"Stade Rennes","RC Roubaix","3-2",3,2,"1",1,5,1,"H"
"3618",1952-09-28,1952,"FC Metz","Girondins Bordeaux","0-2",0,2,"1",1,2,-2,"D"
"3619",1952-09-28,1952,"Le Havre AC","AS Saint-Etienne","3-0",3,0,"1",1,3,3,"H"
"3620",1952-09-28,1952,"FC Sochaux","OGC Nice","3-2",3,2,"1",1,5,1,"H"
"3621",1952-09-28,1952,"Stade Francais FC","RC Lens","1-1",1,1,"1",1,2,0,"D"
"3622",1952-10-05,1952,"AS Saint-Etienne","Girondins Bordeaux","1-1",1,1,"1",1,2,0,"D"
"3623",1952-10-09,1952,"Stade Reims","RC Roubaix","1-0",1,0,"1",1,1,1,"H"
"3624",1952-10-09,1952,"Lille OSC","FC Sete","5-0",5,0,"1",1,5,5,"H"
"3625",1952-10-09,1952,"Olympique Marseille","AS Nancy","4-3",4,3,"1",1,7,1,"H"
"3626",1952-10-09,1952,"Stade Francais FC","Nimes Olympique","4-2",4,2,"1",1,6,2,"H"
"3627",1952-10-09,1952,"Stade Rennes","FC Sochaux","1-1",1,1,"1",1,2,0,"D"
"3628",1952-10-09,1952,"Le Havre AC","Racing Club de France","4-1",4,1,"1",1,5,3,"H"
"3629",1952-10-09,1952,"Stade Olympique Montpellierain","OGC Nice","2-1",2,1,"1",1,3,1,"H"
"3630",1952-10-09,1952,"FC Metz","RC Lens","3-0",3,0,"1",1,3,3,"H"
"3631",1952-10-12,1952,"Girondins Bordeaux","Stade Reims","1-0",1,0,"1",1,1,1,"H"
"3632",1952-10-12,1952,"AS Saint-Etienne","Lille OSC","2-1",2,1,"1",1,3,1,"H"
"3633",1952-10-12,1952,"Olympique Marseille","FC Metz","3-0",3,0,"1",1,3,3,"H"
"3634",1952-10-12,1952,"AS Nancy","Le Havre AC","0-3",0,3,"1",1,3,-3,"D"
"3635",1952-10-12,1952,"FC Sete","Stade Francais FC","2-2",2,2,"1",1,4,0,"D"
"3636",1952-10-12,1952,"OGC Nice","Nimes Olympique","2-0",2,0,"1",1,2,2,"H"
"3637",1952-10-12,1952,"RC Lens","Stade Rennes","5-0",5,0,"1",1,5,5,"H"
"3638",1952-10-12,1952,"RC Roubaix","FC Sochaux","2-2",2,2,"1",1,4,0,"D"
"3639",1952-10-12,1952,"Racing Club de France","Stade Olympique Montpellierain","2-1",2,1,"1",1,3,1,"H"
"3640",1952-10-26,1952,"Stade Reims","Olympique Marseille","3-1",3,1,"1",1,4,2,"H"
"3641",1952-10-26,1952,"Lille OSC","Le Havre AC","3-1",3,1,"1",1,4,2,"H"
"3642",1952-10-26,1952,"Nimes Olympique","RC Roubaix","1-0",1,0,"1",1,1,1,"H"
"3643",1952-10-26,1952,"Stade Rennes","FC Sete","3-0",3,0,"1",1,3,3,"H"
"3644",1952-10-26,1952,"OGC Nice","AS Nancy","2-1",2,1,"1",1,3,1,"H"
"3645",1952-10-26,1952,"Stade Olympique Montpellierain","Girondins Bordeaux","4-1",4,1,"1",1,5,3,"H"
"3646",1952-10-26,1952,"Stade Francais FC","Racing Club de France","5-0",5,0,"1",1,5,5,"H"
"3647",1952-10-26,1952,"FC Sochaux","RC Lens","1-0",1,0,"1",1,1,1,"H"
"3648",1952-10-26,1952,"FC Metz","AS Saint-Etienne","5-0",5,0,"1",1,5,5,"H"
"3649",1952-11-02,1952,"Stade Reims","FC Sochaux","3-0",3,0,"1",1,3,3,"H"
"3650",1952-11-02,1952,"Lille OSC","OGC Nice","1-1",1,1,"1",1,2,0,"D"
"3651",1952-11-02,1952,"Olympique Marseille","FC Sete","3-3",3,3,"1",1,6,0,"D"
"3652",1952-11-02,1952,"Le Havre AC","RC Roubaix","2-0",2,0,"1",1,2,2,"H"
"3653",1952-11-02,1952,"Girondins Bordeaux","Racing Club de France","3-1",3,1,"1",1,4,2,"H"
"3654",1952-11-02,1952,"Stade Olympique Montpellierain","Stade Rennes","2-2",2,2,"1",1,4,0,"D"
"3655",1952-11-02,1952,"Stade Francais FC","AS Nancy","4-1",4,1,"1",1,5,3,"H"
"3656",1952-11-02,1952,"FC Metz","Nimes Olympique","2-0",2,0,"1",1,2,2,"H"
"3657",1952-11-02,1952,"AS Saint-Etienne","RC Lens","2-3",2,3,"1",1,5,-1,"D"
"3658",1952-11-09,1952,"RC Roubaix","Lille OSC","1-2",1,2,"1",1,3,-1,"D"
"3659",1952-11-09,1952,"Nimes Olympique","Stade Reims","1-0",1,0,"1",1,1,1,"H"
"3660",1952-11-09,1952,"Racing Club de France","Olympique Marseille","1-1",1,1,"1",1,2,0,"D"
"3661",1952-11-09,1952,"FC Sete","AS Saint-Etienne","5-0",5,0,"1",1,5,5,"H"
"3662",1952-11-09,1952,"Stade Rennes","Stade Francais FC","0-0",0,0,"1",1,0,0,"D"
"3663",1952-11-09,1952,"RC Lens","Le Havre AC","2-0",2,0,"1",1,2,2,"H"
"3664",1952-11-09,1952,"AS Nancy","Girondins Bordeaux","3-0",3,0,"1",1,3,3,"H"
"3665",1952-11-09,1952,"OGC Nice","FC Metz","1-2",1,2,"1",1,3,-1,"D"
"3666",1952-11-09,1952,"FC Sochaux","Stade Olympique Montpellierain","2-1",2,1,"1",1,3,1,"H"
"3667",1952-11-23,1952,"Stade Reims","FC Metz","2-1",2,1,"1",1,3,1,"H"
"3668",1952-11-23,1952,"Stade Olympique Montpellierain","Lille OSC","1-1",1,1,"1",1,2,0,"D"
"3669",1952-11-23,1952,"Girondins Bordeaux","Nimes Olympique","3-2",3,2,"1",1,5,1,"H"
"3670",1952-11-23,1952,"Stade Francais FC","Le Havre AC","2-2",2,2,"1",1,4,0,"D"
"3671",1952-11-23,1952,"FC Sochaux","Olympique Marseille","2-1",2,1,"1",1,3,1,"H"
"3672",1952-11-23,1952,"RC Roubaix","FC Sete","2-0",2,0,"1",1,2,2,"H"
"3673",1952-11-23,1952,"Stade Rennes","AS Saint-Etienne","0-1",0,1,"1",1,1,-1,"D"
"3674",1952-11-23,1952,"AS Nancy","RC Lens","1-3",1,3,"1",1,4,-2,"D"
"3675",1952-11-23,1952,"OGC Nice","Racing Club de France","1-2",1,2,"1",1,3,-1,"D"
"3676",1952-11-30,1952,"Stade Reims","Stade Olympique Montpellierain","3-2",3,2,"1",1,5,1,"H"
"3677",1952-11-30,1952,"Lille OSC","Stade Rennes","1-1",1,1,"1",1,2,0,"D"
"3678",1952-11-30,1952,"Girondins Bordeaux","RC Roubaix","4-2",4,2,"1",1,6,2,"H"
"3679",1952-11-30,1952,"Olympique Marseille","OGC Nice","3-1",3,1,"1",1,4,2,"H"
"3680",1952-11-30,1952,"Le Havre AC","FC Sochaux","2-2",2,2,"1",1,4,0,"D"
"3681",1952-11-30,1952,"FC Metz","Stade Francais FC","2-0",2,0,"1",1,2,2,"H"
"3682",1952-11-30,1952,"AS Saint-Etienne","Nimes Olympique","4-2",4,2,"1",1,6,2,"H"
"3683",1952-11-30,1952,"FC Sete","AS Nancy","1-2",1,2,"1",1,3,-1,"D"
"3684",1952-11-30,1952,"Racing Club de France","RC Lens","1-1",1,1,"1",1,2,0,"D"
"3685",1952-12-07,1952,"AS Nancy","Stade Reims","1-1",1,1,"1",1,2,0,"D"
"3686",1952-12-07,1952,"Stade Francais FC","Lille OSC","2-0",2,0,"1",1,2,2,"H"
"3687",1952-12-07,1952,"OGC Nice","Girondins Bordeaux","1-2",1,2,"1",1,3,-1,"D"
"3688",1952-12-07,1952,"Stade Rennes","Le Havre AC","2-0",2,0,"1",1,2,2,"H"
"3689",1952-12-07,1952,"FC Sochaux","AS Saint-Etienne","3-0",3,0,"1",1,3,3,"H"
"3690",1952-12-07,1952,"Nimes Olympique","Olympique Marseille","2-0",2,0,"1",1,2,2,"H"
"3691",1952-12-07,1952,"RC Lens","FC Sete","3-0",3,0,"1",1,3,3,"H"
"3692",1952-12-07,1952,"Stade Olympique Montpellierain","FC Metz","1-1",1,1,"1",1,2,0,"D"
"3693",1952-12-07,1952,"RC Roubaix","Racing Club de France","0-1",0,1,"1",1,1,-1,"D"
"3694",1952-12-14,1952,"Stade Reims","Stade Francais FC","1-2",1,2,"1",1,3,-1,"D"
"3695",1952-12-14,1952,"Lille OSC","FC Sochaux","3-1",3,1,"1",1,4,2,"H"
"3696",1952-12-14,1952,"Girondins Bordeaux","RC Lens","2-0",2,0,"1",1,2,2,"H"
"3697",1952-12-14,1952,"Olympique Marseille","RC Roubaix","4-2",4,2,"1",1,6,2,"H"
"3698",1952-12-14,1952,"FC Metz","Stade Rennes","2-1",2,1,"1",1,3,1,"H"
"3699",1952-12-14,1952,"Le Havre AC","Nimes Olympique","1-1",1,1,"1",1,2,0,"D"
"3700",1952-12-14,1952,"Racing Club de France","FC Sete","2-1",2,1,"1",1,3,1,"H"
"3701",1952-12-14,1952,"Stade Olympique Montpellierain","AS Nancy","0-1",0,1,"1",1,1,-1,"D"
"3702",1952-12-14,1952,"AS Saint-Etienne","OGC Nice","2-1",2,1,"1",1,3,1,"H"
"3703",1952-12-21,1952,"Stade Rennes","Stade Reims","0-1",0,1,"1",1,1,-1,"D"
"3704",1952-12-21,1952,"Nimes Olympique","Lille OSC","2-0",2,0,"1",1,2,2,"H"
"3705",1952-12-21,1952,"FC Sete","Girondins Bordeaux","2-0",2,0,"1",1,2,2,"H"
"3706",1952-12-21,1952,"RC Lens","Olympique Marseille","1-1",1,1,"1",1,2,0,"D"
"3707",1952-12-21,1952,"Stade Francais FC","Stade Olympique Montpellierain","2-4",2,4,"1",1,6,-2,"D"
"3708",1952-12-21,1952,"FC Sochaux","FC Metz","1-1",1,1,"1",1,2,0,"D"
"3709",1952-12-21,1952,"OGC Nice","Le Havre AC","0-2",0,2,"1",1,2,-2,"D"
"3710",1952-12-21,1952,"AS Nancy","Racing Club de France","1-0",1,0,"1",1,1,1,"H"
"3711",1952-12-21,1952,"RC Roubaix","AS Saint-Etienne","2-0",2,0,"1",1,2,2,"H"
"3712",1952-12-28,1952,"Stade Reims","AS Saint-Etienne","2-0",2,0,"1",1,2,2,"H"
"3713",1952-12-28,1952,"Lille OSC","AS Nancy","6-2",6,2,"1",1,8,4,"H"
"3714",1952-12-28,1952,"Stade Francais FC","Girondins Bordeaux","0-2",0,2,"1",1,2,-2,"D"
"3715",1952-12-28,1952,"FC Metz","Le Havre AC","6-1",6,1,"1",1,7,5,"H"
"3716",1952-12-28,1952,"Nimes Olympique","RC Lens","0-0",0,0,"1",1,0,0,"D"
"3717",1952-12-28,1952,"FC Sochaux","FC Sete","4-2",4,2,"1",1,6,2,"H"
"3718",1952-12-28,1952,"Stade Olympique Montpellierain","Olympique Marseille","2-1",2,1,"1",1,3,1,"H"
"3719",1952-12-28,1952,"Stade Rennes","Racing Club de France","1-0",1,0,"1",1,1,1,"H"
"3720",1952-12-28,1952,"OGC Nice","RC Roubaix","4-1",4,1,"1",1,5,3,"H"
"3721",1953-01-04,1952,"Le Havre AC","Stade Reims","3-4",3,4,"1",1,7,-1,"D"
"3722",1953-01-04,1952,"Lille OSC","FC Metz","1-2",1,2,"1",1,3,-1,"D"
"3723",1953-01-04,1952,"Girondins Bordeaux","Stade Rennes","7-0",7,0,"1",1,7,7,"H"
"3724",1953-01-04,1952,"FC Sete","Nimes Olympique","1-1",1,1,"1",1,2,0,"D"
"3725",1953-01-04,1952,"RC Lens","OGC Nice","2-0",2,0,"1",1,2,2,"H"
"3726",1953-01-04,1952,"AS Saint-Etienne","Stade Olympique Montpellierain","2-0",2,0,"1",1,2,2,"H"
"3727",1953-01-04,1952,"AS Nancy","RC Roubaix","1-0",1,0,"1",1,1,1,"H"
"3728",1953-01-11,1952,"Stade Reims","Lille OSC","1-1",1,1,"1",1,2,0,"D"
"3729",1953-01-11,1952,"FC Sochaux","Girondins Bordeaux","8-2",8,2,"1",1,10,6,"H"
"3730",1953-01-11,1952,"Nimes Olympique","Racing Club de France","4-2",4,2,"1",1,6,2,"H"
"3731",1953-01-11,1952,"AS Nancy","FC Metz","1-0",1,0,"1",1,1,1,"H"
"3732",1953-01-11,1952,"RC Roubaix","RC Lens","0-1",0,1,"1",1,1,-1,"D"
"3733",1953-01-11,1952,"Stade Rennes","Olympique Marseille","3-1",3,1,"1",1,4,2,"H"
"3734",1953-01-11,1952,"Stade Francais FC","AS Saint-Etienne","2-1",2,1,"1",1,3,1,"H"
"3735",1953-01-11,1952,"Stade Olympique Montpellierain","Le Havre AC","2-1",2,1,"1",1,3,1,"H"
"3736",1953-01-11,1952,"OGC Nice","FC Sete","3-2",3,2,"1",1,5,1,"H"
"3737",1953-01-25,1952,"Stade Reims","OGC Nice","3-1",3,1,"1",1,4,2,"H"
"3738",1953-01-25,1952,"Lille OSC","RC Lens","0-0",0,0,"1",1,0,0,"D"
"3739",1953-01-25,1952,"Stade Olympique Montpellierain","Nimes Olympique","2-5",2,5,"1",1,7,-3,"D"
"3740",1953-01-25,1952,"Olympique Marseille","Girondins Bordeaux","3-0",3,0,"1",1,3,3,"H"
"3741",1953-01-25,1952,"Stade Francais FC","FC Sochaux","1-2",1,2,"1",1,3,-1,"D"
"3742",1953-01-25,1952,"FC Metz","RC Roubaix","1-1",1,1,"1",1,2,0,"D"
"3743",1953-01-25,1952,"Stade Rennes","AS Nancy","0-1",0,1,"1",1,1,-1,"D"
"3744",1953-01-25,1952,"Le Havre AC","FC Sete","2-0",2,0,"1",1,2,2,"H"
"3745",1953-01-25,1952,"AS Saint-Etienne","Racing Club de France","3-1",3,1,"1",1,4,2,"H"
"3746",1953-01-29,1952,"Olympique Marseille","Stade Francais FC","1-0",1,0,"1",1,1,1,"H"
"3747",1953-01-31,1952,"Girondins Bordeaux","Le Havre AC","6-0",6,0,"1",1,6,6,"H"
"3748",1953-02-01,1952,"RC Lens","Stade Reims","1-3",1,3,"1",1,4,-2,"D"
"3749",1953-02-01,1952,"Racing Club de France","Lille OSC","1-0",1,0,"1",1,1,1,"H"
"3750",1953-02-01,1952,"Nimes Olympique","Stade Rennes","2-0",2,0,"1",1,2,2,"H"
"3751",1953-02-01,1952,"AS Nancy","FC Sochaux","1-2",1,2,"1",1,3,-1,"D"
"3752",1953-02-01,1952,"Olympique Marseille","AS Saint-Etienne","1-0",1,0,"1",1,1,1,"H"
"3753",1953-02-01,1952,"FC Sete","FC Metz","0-0",0,0,"1",1,0,0,"D"
"3754",1953-02-01,1952,"OGC Nice","Stade Francais FC","2-1",2,1,"1",1,3,1,"H"
"3755",1953-02-01,1952,"RC Roubaix","Stade Olympique Montpellierain","1-0",1,0,"1",1,1,1,"H"
"3756",1953-02-12,1952,"Racing Club de France","FC Sochaux","2-1",2,1,"1",1,3,1,"H"
"3757",1953-02-15,1952,"Stade Reims","FC Sete","2-0",2,0,"1",1,2,2,"H"
"3758",1953-02-15,1952,"Lille OSC","Girondins Bordeaux","0-0",0,0,"1",1,0,0,"D"
"3759",1953-02-15,1952,"FC Sochaux","Nimes Olympique","1-1",1,1,"1",1,2,0,"D"
"3760",1953-02-15,1952,"Le Havre AC","Olympique Marseille","2-1",2,1,"1",1,3,1,"H"
"3761",1953-02-15,1952,"FC Metz","Racing Club de France","0-2",0,2,"1",1,2,-2,"D"
"3762",1953-02-15,1952,"Stade Olympique Montpellierain","RC Lens","2-1",2,1,"1",1,3,1,"H"
"3763",1953-02-15,1952,"Stade Rennes","OGC Nice","0-0",0,0,"1",1,0,0,"D"
"3764",1953-02-15,1952,"Stade Francais FC","RC Roubaix","1-3",1,3,"1",1,4,-2,"D"
"3765",1953-02-15,1952,"AS Saint-Etienne","AS Nancy","6-0",6,0,"1",1,6,6,"H"
"3766",1953-02-22,1952,"Racing Club de France","Stade Reims","1-3",1,3,"1",1,4,-2,"D"
"3767",1953-02-22,1952,"Girondins Bordeaux","FC Metz","4-0",4,0,"1",1,4,4,"H"
"3768",1953-02-22,1952,"Olympique Marseille","Lille OSC","3-0",3,0,"1",1,3,3,"H"
"3769",1953-02-22,1952,"AS Nancy","Nimes Olympique","2-0",2,0,"1",1,2,2,"H"
"3770",1953-02-22,1952,"OGC Nice","FC Sochaux","5-3",5,3,"1",1,8,2,"H"
"3771",1953-02-22,1952,"RC Lens","Stade Francais FC","1-1",1,1,"1",1,2,0,"D"
"3772",1953-02-22,1952,"AS Saint-Etienne","Le Havre AC","1-0",1,0,"1",1,1,1,"H"
"3773",1953-02-22,1952,"RC Roubaix","Stade Rennes","3-2",3,2,"1",1,5,1,"H"
"3774",1953-02-22,1952,"FC Sete","Stade Olympique Montpellierain","1-0",1,0,"1",1,1,1,"H"
"3775",1953-03-08,1952,"RC Roubaix","Stade Reims","1-1",1,1,"1",1,2,0,"D"
"3776",1953-03-08,1952,"Girondins Bordeaux","AS Saint-Etienne","0-0",0,0,"1",1,0,0,"D"
"3777",1953-03-08,1952,"Nimes Olympique","Stade Francais FC","0-0",0,0,"1",1,0,0,"D"
"3778",1953-03-08,1952,"FC Sochaux","Stade Rennes","2-0",2,0,"1",1,2,2,"H"
"3779",1953-03-08,1952,"FC Sete","Lille OSC","3-1",3,1,"1",1,4,2,"H"
"3780",1953-03-08,1952,"AS Nancy","Olympique Marseille","1-0",1,0,"1",1,1,1,"H"
"3781",1953-03-08,1952,"RC Lens","FC Metz","3-1",3,1,"1",1,4,2,"H"
"3782",1953-03-08,1952,"Racing Club de France","Le Havre AC","1-1",1,1,"1",1,2,0,"D"
"3783",1953-03-08,1952,"OGC Nice","Stade Olympique Montpellierain","0-0",0,0,"1",1,0,0,"D"
"3784",1953-03-15,1952,"Stade Reims","Girondins Bordeaux","2-3",2,3,"1",1,5,-1,"D"
"3785",1953-03-15,1952,"Nimes Olympique","OGC Nice","1-0",1,0,"1",1,1,1,"H"
"3786",1953-03-15,1952,"FC Sochaux","RC Roubaix","3-1",3,1,"1",1,4,2,"H"
"3787",1953-03-15,1952,"FC Metz","Olympique Marseille","1-3",1,3,"1",1,4,-2,"D"
"3788",1953-03-15,1952,"Lille OSC","AS Saint-Etienne","0-2",0,2,"1",1,2,-2,"D"
"3789",1953-03-15,1952,"Stade Rennes","RC Lens","3-2",3,2,"1",1,5,1,"H"
"3790",1953-03-15,1952,"Stade Francais FC","FC Sete","2-0",2,0,"1",1,2,2,"H"
"3791",1953-03-15,1952,"Le Havre AC","AS Nancy","0-1",0,1,"1",1,1,-1,"D"
"3792",1953-03-15,1952,"Stade Olympique Montpellierain","Racing Club de France","0-1",0,1,"1",1,1,-1,"D"
"3793",1953-03-22,1952,"Olympique Marseille","Stade Reims","2-1",2,1,"1",1,3,1,"H"
"3794",1953-03-22,1952,"Girondins Bordeaux","Stade Olympique Montpellierain","6-0",6,0,"1",1,6,6,"H"
"3795",1953-03-22,1952,"RC Roubaix","Nimes Olympique","2-4",2,4,"1",1,6,-2,"D"
"3796",1953-03-22,1952,"RC Lens","FC Sochaux","5-1",5,1,"1",1,6,4,"H"
"3797",1953-03-22,1952,"Le Havre AC","Lille OSC","0-1",0,1,"1",1,1,-1,"D"
"3798",1953-03-22,1952,"AS Nancy","OGC Nice","2-1",2,1,"1",1,3,1,"H"
"3799",1953-03-22,1952,"Racing Club de France","Stade Francais FC","2-2",2,2,"1",1,4,0,"D"
"3800",1953-03-22,1952,"AS Saint-Etienne","FC Metz","2-2",2,2,"1",1,4,0,"D"
"3801",1953-03-22,1952,"FC Sete","Stade Rennes","2-0",2,0,"1",1,2,2,"H"
"3802",1953-04-05,1952,"FC Sochaux","Stade Reims","1-0",1,0,"1",1,1,1,"H"
"3803",1953-04-05,1952,"Racing Club de France","Girondins Bordeaux","3-3",3,3,"1",1,6,0,"D"
"3804",1953-04-05,1952,"Nimes Olympique","FC Metz","2-1",2,1,"1",1,3,1,"H"
"3805",1953-04-05,1952,"OGC Nice","Lille OSC","0-0",0,0,"1",1,0,0,"D"
"3806",1953-04-05,1952,"FC Sete","Olympique Marseille","2-0",2,0,"1",1,2,2,"H"
"3807",1953-04-05,1952,"RC Lens","AS Saint-Etienne","1-2",1,2,"1",1,3,-1,"D"
"3808",1953-04-05,1952,"AS Nancy","Stade Francais FC","5-1",5,1,"1",1,6,4,"H"
"3809",1953-04-05,1952,"RC Roubaix","Le Havre AC","0-0",0,0,"1",1,0,0,"D"
"3810",1953-04-05,1952,"Stade Rennes","Stade Olympique Montpellierain","0-1",0,1,"1",1,1,-1,"D"
"3811",1953-04-12,1952,"Stade Reims","Nimes Olympique","2-0",2,0,"1",1,2,2,"H"
"3812",1953-04-12,1952,"Girondins Bordeaux","AS Nancy","4-1",4,1,"1",1,5,3,"H"
"3813",1953-04-12,1952,"Stade Olympique Montpellierain","FC Sochaux","2-3",2,3,"1",1,5,-1,"D"
"3814",1953-04-12,1952,"Lille OSC","RC Roubaix","2-1",2,1,"1",1,3,1,"H"
"3815",1953-04-12,1952,"Olympique Marseille","Racing Club de France","3-0",3,0,"1",1,3,3,"H"
"3816",1953-04-12,1952,"Le Havre AC","RC Lens","1-0",1,0,"1",1,1,1,"H"
"3817",1953-04-12,1952,"Stade Francais FC","Stade Rennes","2-0",2,0,"1",1,2,2,"H"
"3818",1953-04-12,1952,"FC Metz","OGC Nice","2-0",2,0,"1",1,2,2,"H"
"3819",1953-04-12,1952,"AS Saint-Etienne","FC Sete","2-2",2,2,"1",1,4,0,"D"
"3820",1953-04-19,1952,"FC Metz","Stade Reims","0-0",0,0,"1",1,0,0,"D"
"3821",1953-04-19,1952,"Nimes Olympique","Girondins Bordeaux","5-1",5,1,"1",1,6,4,"H"
"3822",1953-04-19,1952,"Olympique Marseille","FC Sochaux","1-6",1,6,"1",1,7,-5,"D"
"3823",1953-04-19,1952,"Lille OSC","Stade Olympique Montpellierain","2-2",2,2,"1",1,4,0,"D"
"3824",1953-04-19,1952,"RC Lens","AS Nancy","4-1",4,1,"1",1,5,3,"H"
"3825",1953-04-19,1952,"Le Havre AC","Stade Francais FC","1-3",1,3,"1",1,4,-2,"D"
"3826",1953-04-19,1952,"FC Sete","RC Roubaix","1-0",1,0,"1",1,1,1,"H"
"3827",1953-04-19,1952,"AS Saint-Etienne","Stade Rennes","1-0",1,0,"1",1,1,1,"H"
"3828",1953-04-19,1952,"Racing Club de France","OGC Nice","1-3",1,3,"1",1,4,-2,"D"
"3829",1953-05-03,1952,"Stade Olympique Montpellierain","Stade Reims","2-6",2,6,"1",1,8,-4,"D"
"3830",1953-05-03,1952,"FC Sochaux","Le Havre AC","3-2",3,2,"1",1,5,1,"H"
"3831",1953-05-03,1952,"RC Roubaix","Girondins Bordeaux","3-1",3,1,"1",1,4,2,"H"
"3832",1953-05-03,1952,"Nimes Olympique","AS Saint-Etienne","0-0",0,0,"1",1,0,0,"D"
"3833",1953-05-03,1952,"Stade Rennes","Lille OSC","1-1",1,1,"1",1,2,0,"D"
"3834",1953-05-03,1952,"OGC Nice","Olympique Marseille","3-1",3,1,"1",1,4,2,"H"
"3835",1953-05-03,1952,"RC Lens","Racing Club de France","2-1",2,1,"1",1,3,1,"H"
"3836",1953-05-03,1952,"Stade Francais FC","FC Metz","2-1",2,1,"1",1,3,1,"H"
"3837",1953-05-03,1952,"AS Nancy","FC Sete","0-1",0,1,"1",1,1,-1,"D"
"3838",1953-05-10,1952,"Stade Reims","AS Nancy","0-2",0,2,"1",1,2,-2,"D"
"3839",1953-05-10,1952,"AS Saint-Etienne","FC Sochaux","1-3",1,3,"1",1,4,-2,"D"
"3840",1953-05-10,1952,"Girondins Bordeaux","OGC Nice","7-3",7,3,"1",1,10,4,"H"
"3841",1953-05-10,1952,"Olympique Marseille","Nimes Olympique","4-1",4,1,"1",1,5,3,"H"
"3842",1953-05-10,1952,"Lille OSC","Stade Francais FC","2-1",2,1,"1",1,3,1,"H"
"3843",1953-05-10,1952,"FC Sete","RC Lens","2-0",2,0,"1",1,2,2,"H"
"3844",1953-05-10,1952,"FC Metz","Stade Olympique Montpellierain","1-1",1,1,"1",1,2,0,"D"
"3845",1953-05-10,1952,"Le Havre AC","Stade Rennes","1-1",1,1,"1",1,2,0,"D"
"3846",1953-05-10,1952,"Racing Club de France","RC Roubaix","0-2",0,2,"1",1,2,-2,"D"
"3847",1953-05-17,1952,"Stade Francais FC","Stade Reims","1-5",1,5,"1",1,6,-4,"D"
"3848",1953-05-17,1952,"FC Sochaux","Lille OSC","3-3",3,3,"1",1,6,0,"D"
"3849",1953-05-17,1952,"RC Lens","Girondins Bordeaux","1-1",1,1,"1",1,2,0,"D"
"3850",1953-05-17,1952,"Nimes Olympique","Le Havre AC","7-1",7,1,"1",1,8,6,"H"
"3851",1953-05-17,1952,"RC Roubaix","Olympique Marseille","0-0",0,0,"1",1,0,0,"D"
"3852",1953-05-17,1952,"FC Sete","Racing Club de France","0-1",0,1,"1",1,1,-1,"D"
"3853",1953-05-17,1952,"AS Nancy","Stade Olympique Montpellierain","3-0",3,0,"1",1,3,3,"H"
"3854",1953-05-17,1952,"Stade Rennes","FC Metz","4-2",4,2,"1",1,6,2,"H"
"3855",1953-05-17,1952,"OGC Nice","AS Saint-Etienne","2-0",2,0,"1",1,2,2,"H"
"3856",1953-05-24,1952,"Stade Reims","Stade Rennes","5-1",5,1,"1",1,6,4,"H"
"3857",1953-05-24,1952,"FC Metz","FC Sochaux","1-2",1,2,"1",1,3,-1,"D"
"3858",1953-05-24,1952,"Girondins Bordeaux","FC Sete","3-0",3,0,"1",1,3,3,"H"
"3859",1953-05-24,1952,"Lille OSC","Nimes Olympique","3-2",3,2,"1",1,5,1,"H"
"3860",1953-05-24,1952,"Olympique Marseille","RC Lens","1-1",1,1,"1",1,2,0,"D"
"3861",1953-05-24,1952,"Racing Club de France","AS Nancy","1-2",1,2,"1",1,3,-1,"D"
"3862",1953-05-24,1952,"Stade Olympique Montpellierain","Stade Francais FC","0-3",0,3,"1",1,3,-3,"D"
"3863",1953-05-24,1952,"AS Saint-Etienne","RC Roubaix","1-1",1,1,"1",1,2,0,"D"
"3864",1953-05-24,1952,"Le Havre AC","OGC Nice","2-0",2,0,"1",1,2,2,"H"
"3865",1953-08-23,1953,"Olympique Marseille","Nimes Olympique","0-4",0,4,"1",1,4,-4,"D"
"3866",1953-08-23,1953,"Le Havre AC","AS Saint-Etienne","2-0",2,0,"1",1,2,2,"H"
"3867",1953-08-23,1953,"RC Lens","OGC Nice","2-3",2,3,"1",1,5,-1,"D"
"3868",1953-08-23,1953,"AS Monaco","Toulouse FC","2-3",2,3,"1",1,5,-1,"D"
"3869",1953-08-23,1953,"RC Strasbourg","Lille OSC","2-1",2,1,"1",1,3,1,"H"
"3870",1953-08-23,1953,"FC Metz","Stade Reims","0-1",0,1,"1",1,1,-1,"D"
"3871",1953-08-23,1953,"FC Sete","AS Nancy","1-0",1,0,"1",1,1,1,"H"
"3872",1953-08-23,1953,"FC Sochaux","Girondins Bordeaux","1-1",1,1,"1",1,2,0,"D"
"3873",1953-08-23,1953,"RC Roubaix","Stade Francais FC","1-1",1,1,"1",1,2,0,"D"
"3874",1953-08-29,1953,"Stade Francais FC","Olympique Marseille","1-1",1,1,"1",1,2,0,"D"
"3875",1953-08-30,1953,"Nimes Olympique","FC Sete","5-2",5,2,"1",1,7,3,"H"
"3876",1953-08-30,1953,"Stade Reims","FC Sochaux","4-1",4,1,"1",1,5,3,"H"
"3877",1953-08-30,1953,"OGC Nice","RC Roubaix","3-1",3,1,"1",1,4,2,"H"
"3878",1953-08-30,1953,"Girondins Bordeaux","RC Strasbourg","5-2",5,2,"1",1,7,3,"H"
"3879",1953-08-30,1953,"RC Lens","Toulouse FC","1-1",1,1,"1",1,2,0,"D"
"3880",1953-08-30,1953,"Lille OSC","Le Havre AC","2-1",2,1,"1",1,3,1,"H"
"3881",1953-08-30,1953,"AS Nancy","FC Metz","2-1",2,1,"1",1,3,1,"H"
"3882",1953-08-30,1953,"AS Saint-Etienne","AS Monaco","1-1",1,1,"1",1,2,0,"D"
"3883",1953-09-06,1953,"Stade Reims","Nimes Olympique","2-1",2,1,"1",1,3,1,"H"
"3884",1953-09-06,1953,"Girondins Bordeaux","Stade Francais FC","3-2",3,2,"1",1,5,1,"H"
"3885",1953-09-06,1953,"Toulouse FC","AS Nancy","3-2",3,2,"1",1,5,1,"H"
"3886",1953-09-06,1953,"RC Strasbourg","FC Sete","4-0",4,0,"1",1,4,4,"H"
"3887",1953-09-06,1953,"Lille OSC","OGC Nice","3-1",3,1,"1",1,4,2,"H"
"3888",1953-09-06,1953,"Le Havre AC","Olympique Marseille","1-0",1,0,"1",1,1,1,"H"
"3889",1953-09-06,1953,"AS Saint-Etienne","RC Lens","5-2",5,2,"1",1,7,3,"H"
"3890",1953-09-06,1953,"AS Monaco","RC Roubaix","0-2",0,2,"1",1,2,-2,"D"
"3891",1953-09-06,1953,"FC Metz","FC Sochaux","1-1",1,1,"1",1,2,0,"D"
"3892",1953-09-10,1953,"RC Roubaix","Girondins Bordeaux","0-2",0,2,"1",1,2,-2,"D"
"3893",1953-09-10,1953,"RC Lens","Stade Reims","0-0",0,0,"1",1,0,0,"D"
"3894",1953-09-10,1953,"Stade Francais FC","Nimes Olympique","1-3",1,3,"1",1,4,-2,"D"
"3895",1953-09-10,1953,"RC Strasbourg","Toulouse FC","2-0",2,0,"1",1,2,2,"H"
"3896",1953-09-10,1953,"FC Sochaux","Le Havre AC","0-1",0,1,"1",1,1,-1,"D"
"3897",1953-09-10,1953,"OGC Nice","AS Nancy","2-1",2,1,"1",1,3,1,"H"
"3898",1953-09-10,1953,"FC Sete","AS Saint-Etienne","1-2",1,2,"1",1,3,-1,"D"
"3899",1953-09-10,1953,"Olympique Marseille","Lille OSC","1-1",1,1,"1",1,2,0,"D"
"3900",1953-09-10,1953,"FC Metz","AS Monaco","1-0",1,0,"1",1,1,1,"H"
"3901",1953-09-13,1953,"Girondins Bordeaux","FC Metz","3-0",3,0,"1",1,3,3,"H"
"3902",1953-09-13,1953,"FC Sete","Stade Reims","0-2",0,2,"1",1,2,-2,"D"
"3903",1953-09-13,1953,"Nimes Olympique","RC Roubaix","1-0",1,0,"1",1,1,1,"H"
"3904",1953-09-13,1953,"Toulouse FC","OGC Nice","4-1",4,1,"1",1,5,3,"H"
"3905",1953-09-13,1953,"AS Saint-Etienne","RC Strasbourg","1-0",1,0,"1",1,1,1,"H"
"3906",1953-09-13,1953,"Lille OSC","FC Sochaux","0-0",0,0,"1",1,0,0,"D"
"3907",1953-09-13,1953,"AS Monaco","Le Havre AC","4-1",4,1,"1",1,5,3,"H"
"3908",1953-09-13,1953,"Stade Francais FC","RC Lens","5-2",5,2,"1",1,7,3,"H"
"3909",1953-09-13,1953,"AS Nancy","Olympique Marseille","2-1",2,1,"1",1,3,1,"H"
"3910",1953-09-27,1953,"FC Sete","Girondins Bordeaux","0-2",0,2,"1",1,2,-2,"D"
"3911",1953-09-27,1953,"Olympique Marseille","Stade Reims","0-2",0,2,"1",1,2,-2,"D"
"3912",1953-09-27,1953,"FC Sochaux","AS Saint-Etienne","1-2",1,2,"1",1,3,-1,"D"
"3913",1953-09-27,1953,"RC Lens","Nimes Olympique","4-1",4,1,"1",1,5,3,"H"
"3914",1953-09-27,1953,"RC Strasbourg","AS Monaco","3-0",3,0,"1",1,3,3,"H"
"3915",1953-09-27,1953,"Le Havre AC","Toulouse FC","1-1",1,1,"1",1,2,0,"D"
"3916",1953-09-27,1953,"FC Metz","Lille OSC","2-2",2,2,"1",1,4,0,"D"
"3917",1953-09-27,1953,"OGC Nice","Stade Francais FC","1-1",1,1,"1",1,2,0,"D"
"3918",1953-09-27,1953,"RC Roubaix","AS Nancy","4-2",4,2,"1",1,6,2,"H"
"3919",1953-10-04,1953,"Toulouse FC","Stade Francais FC","2-1",2,1,"1",1,3,1,"H"
"3920",1953-10-04,1953,"Le Havre AC","RC Strasbourg","1-2",1,2,"1",1,3,-1,"D"
"3921",1953-10-04,1953,"Lille OSC","FC Sete","3-1",3,1,"1",1,4,2,"H"
"3922",1953-10-08,1953,"Girondins Bordeaux","Olympique Marseille","3-0",3,0,"1",1,3,3,"H"
"3923",1953-10-08,1953,"Stade Reims","RC Roubaix","2-2",2,2,"1",1,4,0,"D"
"3924",1953-10-08,1953,"AS Saint-Etienne","FC Metz","3-2",3,2,"1",1,5,1,"H"
"3925",1953-10-08,1953,"Nimes Olympique","OGC Nice","1-1",1,1,"1",1,2,0,"D"
"3926",1953-10-08,1953,"AS Nancy","RC Lens","3-1",3,1,"1",1,4,2,"H"
"3927",1953-10-08,1953,"AS Monaco","FC Sochaux","0-0",0,0,"1",1,0,0,"D"
"3928",1953-10-11,1953,"OGC Nice","Girondins Bordeaux","3-4",3,4,"1",1,7,-1,"D"
"3929",1953-10-11,1953,"Stade Francais FC","Stade Reims","1-2",1,2,"1",1,3,-1,"D"
"3930",1953-10-11,1953,"RC Roubaix","AS Saint-Etienne","0-1",0,1,"1",1,1,-1,"D"
"3931",1953-10-11,1953,"FC Sochaux","Toulouse FC","1-3",1,3,"1",1,4,-2,"D"
"3932",1953-10-11,1953,"Nimes Olympique","AS Nancy","1-0",1,0,"1",1,1,1,"H"
"3933",1953-10-11,1953,"RC Lens","Lille OSC","0-2",0,2,"1",1,2,-2,"D"
"3934",1953-10-11,1953,"FC Metz","RC Strasbourg","2-1",2,1,"1",1,3,1,"H"
"3935",1953-10-11,1953,"FC Sete","Le Havre AC","4-4",4,4,"1",1,8,0,"D"
"3936",1953-10-11,1953,"Olympique Marseille","AS Monaco","5-1",5,1,"1",1,6,4,"H"
"3937",1953-10-25,1953,"Girondins Bordeaux","AS Monaco","4-3",4,3,"1",1,7,1,"H"
"3938",1953-10-25,1953,"Stade Reims","Le Havre AC","4-2",4,2,"1",1,6,2,"H"
"3939",1953-10-25,1953,"Toulouse FC","RC Roubaix","3-1",3,1,"1",1,4,2,"H"
"3940",1953-10-25,1953,"Nimes Olympique","FC Sochaux","4-1",4,1,"1",1,5,3,"H"
"3941",1953-10-25,1953,"Lille OSC","AS Saint-Etienne","1-0",1,0,"1",1,1,1,"H"
"3942",1953-10-25,1953,"AS Nancy","RC Strasbourg","0-0",0,0,"1",1,0,0,"D"
"3943",1953-10-25,1953,"OGC Nice","FC Sete","5-0",5,0,"1",1,5,5,"H"
"3944",1953-10-25,1953,"Stade Francais FC","FC Metz","2-1",2,1,"1",1,3,1,"H"
"3945",1953-10-25,1953,"RC Lens","Olympique Marseille","4-1",4,1,"1",1,5,3,"H"
"3946",1953-11-01,1953,"Le Havre AC","Girondins Bordeaux","2-3",2,3,"1",1,5,-1,"D"
"3947",1953-11-01,1953,"FC Sochaux","AS Nancy","7-1",7,1,"1",1,8,6,"H"
"3948",1953-11-01,1953,"RC Strasbourg","Stade Reims","2-4",2,4,"1",1,6,-2,"D"
"3949",1953-11-01,1953,"AS Saint-Etienne","Toulouse FC","1-1",1,1,"1",1,2,0,"D"
"3950",1953-11-01,1953,"AS Monaco","Lille OSC","0-1",0,1,"1",1,1,-1,"D"
"3951",1953-11-01,1953,"FC Metz","Nimes Olympique","2-0",2,0,"1",1,2,2,"H"
"3952",1953-11-01,1953,"Olympique Marseille","OGC Nice","0-0",0,0,"1",1,0,0,"D"
"3953",1953-11-01,1953,"RC Roubaix","RC Lens","0-4",0,4,"1",1,4,-4,"D"
"3954",1953-11-01,1953,"FC Sete","Stade Francais FC","0-0",0,0,"1",1,0,0,"D"
"3955",1953-11-08,1953,"Girondins Bordeaux","AS Nancy","1-0",1,0,"1",1,1,1,"H"
"3956",1953-11-08,1953,"Stade Reims","Toulouse FC","1-1",1,1,"1",1,2,0,"D"
"3957",1953-11-08,1953,"Lille OSC","Nimes Olympique","0-0",0,0,"1",1,0,0,"D"
"3958",1953-11-08,1953,"AS Saint-Etienne","Stade Francais FC","2-1",2,1,"1",1,3,1,"H"
"3959",1953-11-08,1953,"AS Monaco","OGC Nice","0-3",0,3,"1",1,3,-3,"D"
"3960",1953-11-08,1953,"RC Strasbourg","RC Roubaix","4-2",4,2,"1",1,6,2,"H"
"3961",1953-11-08,1953,"Le Havre AC","RC Lens","1-2",1,2,"1",1,3,-1,"D"
"3962",1953-11-08,1953,"FC Metz","FC Sete","1-0",1,0,"1",1,1,1,"H"
"3963",1953-11-08,1953,"FC Sochaux","Olympique Marseille","1-1",1,1,"1",1,2,0,"D"
"3964",1953-11-15,1953,"Nimes Olympique","Girondins Bordeaux","2-0",2,0,"1",1,2,2,"H"
"3965",1953-11-15,1953,"AS Nancy","Stade Reims","1-0",1,0,"1",1,1,1,"H"
"3966",1953-11-15,1953,"Toulouse FC","FC Metz","0-0",0,0,"1",1,0,0,"D"
"3967",1953-11-15,1953,"Stade Francais FC","Lille OSC","0-0",0,0,"1",1,0,0,"D"
"3968",1953-11-15,1953,"OGC Nice","AS Saint-Etienne","5-2",5,2,"1",1,7,3,"H"
"3969",1953-11-15,1953,"Olympique Marseille","RC Strasbourg","5-1",5,1,"1",1,6,4,"H"
"3970",1953-11-15,1953,"RC Lens","AS Monaco","0-0",0,0,"1",1,0,0,"D"
"3971",1953-11-15,1953,"FC Sete","FC Sochaux","0-0",0,0,"1",1,0,0,"D"
"3972",1953-11-15,1953,"RC Roubaix","Le Havre AC","3-1",3,1,"1",1,4,2,"H"
"3973",1953-11-22,1953,"Girondins Bordeaux","Lille OSC","1-3",1,3,"1",1,4,-2,"D"
"3974",1953-11-22,1953,"Stade Reims","AS Saint-Etienne","0-1",0,1,"1",1,1,-1,"D"
"3975",1953-11-22,1953,"Nimes Olympique","Le Havre AC","2-0",2,0,"1",1,2,2,"H"
"3976",1953-11-22,1953,"Toulouse FC","Olympique Marseille","2-2",2,2,"1",1,4,0,"D"
"3977",1953-11-22,1953,"OGC Nice","FC Sochaux","4-1",4,1,"1",1,5,3,"H"
"3978",1953-11-22,1953,"Stade Francais FC","RC Strasbourg","0-1",0,1,"1",1,1,-1,"D"
"3979",1953-11-22,1953,"RC Lens","FC Metz","4-0",4,0,"1",1,4,4,"H"
"3980",1953-11-22,1953,"RC Roubaix","FC Sete","1-0",1,0,"1",1,1,1,"H"
"3981",1953-11-22,1953,"AS Nancy","AS Monaco","1-1",1,1,"1",1,2,0,"D"
"3982",1953-11-29,1953,"AS Saint-Etienne","Girondins Bordeaux","2-0",2,0,"1",1,2,2,"H"
"3983",1953-11-29,1953,"Lille OSC","Toulouse FC","1-0",1,0,"1",1,1,1,"H"
"3984",1953-11-29,1953,"AS Monaco","Stade Reims","2-1",2,1,"1",1,3,1,"H"
"3985",1953-11-29,1953,"FC Metz","OGC Nice","0-0",0,0,"1",1,0,0,"D"
"3986",1953-11-29,1953,"RC Strasbourg","Nimes Olympique","2-1",2,1,"1",1,3,1,"H"
"3987",1953-11-29,1953,"FC Sete","RC Lens","3-1",3,1,"1",1,4,2,"H"
"3988",1953-11-29,1953,"Olympique Marseille","RC Roubaix","3-2",3,2,"1",1,5,1,"H"
"3989",1953-11-29,1953,"Le Havre AC","AS Nancy","2-2",2,2,"1",1,4,0,"D"
"3990",1953-11-29,1953,"FC Sochaux","Stade Francais FC","4-0",4,0,"1",1,4,4,"H"
"3991",1953-12-06,1953,"Lille OSC","RC Roubaix","2-0",2,0,"1",1,2,2,"H"
"3992",1953-12-06,1953,"Stade Reims","OGC Nice","4-3",4,3,"1",1,7,1,"H"
"3993",1953-12-06,1953,"Girondins Bordeaux","RC Lens","1-2",1,2,"1",1,3,-1,"D"
"3994",1953-12-06,1953,"AS Saint-Etienne","Olympique Marseille","0-0",0,0,"1",1,0,0,"D"
"3995",1953-12-06,1953,"Toulouse FC","Nimes Olympique","1-0",1,0,"1",1,1,1,"H"
"3996",1953-12-06,1953,"RC Strasbourg","FC Sochaux","1-0",1,0,"1",1,1,1,"H"
"3997",1953-12-06,1953,"AS Nancy","Stade Francais FC","0-0",0,0,"1",1,0,0,"D"
"3998",1953-12-06,1953,"Le Havre AC","FC Metz","3-1",3,1,"1",1,4,2,"H"
"3999",1953-12-06,1953,"AS Monaco","FC Sete","2-1",2,1,"1",1,3,1,"H"
"4000",1953-12-13,1953,"Lille OSC","Stade Reims","0-1",0,1,"1",1,1,-1,"D"
"4001",1953-12-13,1953,"AS Saint-Etienne","AS Nancy","3-1",3,1,"1",1,4,2,"H"
"4002",1953-12-13,1953,"Girondins Bordeaux","Toulouse FC","0-0",0,0,"1",1,0,0,"D"
"4003",1953-12-13,1953,"RC Strasbourg","OGC Nice","2-2",2,2,"1",1,4,0,"D"
"4004",1953-12-13,1953,"AS Monaco","Nimes Olympique","2-0",2,0,"1",1,2,2,"H"
"4005",1953-12-13,1953,"FC Sochaux","RC Lens","1-1",1,1,"1",1,2,0,"D"
"4006",1953-12-13,1953,"FC Metz","RC Roubaix","4-2",4,2,"1",1,6,2,"H"
"4007",1953-12-13,1953,"Le Havre AC","Stade Francais FC","1-3",1,3,"1",1,4,-2,"D"
"4008",1953-12-13,1953,"FC Sete","Olympique Marseille","2-1",2,1,"1",1,3,1,"H"
"4009",1953-12-20,1953,"Stade Reims","Girondins Bordeaux","1-2",1,2,"1",1,3,-1,"D"
"4010",1953-12-20,1953,"AS Nancy","Lille OSC","1-1",1,1,"1",1,2,0,"D"
"4011",1953-12-20,1953,"Toulouse FC","FC Sete","2-0",2,0,"1",1,2,2,"H"
"4012",1953-12-20,1953,"Nimes Olympique","AS Saint-Etienne","1-0",1,0,"1",1,1,1,"H"
"4013",1953-12-20,1953,"OGC Nice","Le Havre AC","4-0",4,0,"1",1,4,4,"H"
"4014",1953-12-20,1953,"RC Lens","RC Strasbourg","3-1",3,1,"1",1,4,2,"H"
"4015",1953-12-20,1953,"Olympique Marseille","FC Metz","1-1",1,1,"1",1,2,0,"D"
"4016",1953-12-20,1953,"Stade Francais FC","AS Monaco","0-4",0,4,"1",1,4,-4,"D"
"4017",1953-12-20,1953,"RC Roubaix","FC Sochaux","1-1",1,1,"1",1,2,0,"D"
"4018",1953-12-27,1953,"Stade Reims","FC Sete","2-0",2,0,"1",1,2,2,"H"
"4019",1953-12-27,1953,"FC Metz","Girondins Bordeaux","2-2",2,2,"1",1,4,0,"D"
"4020",1953-12-27,1953,"OGC Nice","Toulouse FC","0-2",0,2,"1",1,2,-2,"D"
"4021",1953-12-27,1953,"FC Sochaux","Lille OSC","2-2",2,2,"1",1,4,0,"D"
"4022",1953-12-27,1953,"RC Strasbourg","AS Saint-Etienne","2-1",2,1,"1",1,3,1,"H"
"4023",1953-12-27,1953,"RC Roubaix","Nimes Olympique","4-2",4,2,"1",1,6,2,"H"
"4024",1953-12-27,1953,"RC Lens","Stade Francais FC","1-2",1,2,"1",1,3,-1,"D"
"4025",1953-12-27,1953,"Le Havre AC","AS Monaco","1-2",1,2,"1",1,3,-1,"D"
"4026",1953-12-27,1953,"Olympique Marseille","AS Nancy","0-1",0,1,"1",1,1,-1,"D"
"4027",1954-01-03,1953,"Girondins Bordeaux","FC Sochaux","7-1",7,1,"1",1,8,6,"H"
"4028",1954-01-03,1953,"Stade Reims","FC Metz","3-1",3,1,"1",1,4,2,"H"
"4029",1954-01-03,1953,"Lille OSC","RC Strasbourg","3-0",3,0,"1",1,3,3,"H"
"4030",1954-01-03,1953,"Toulouse FC","AS Monaco","1-1",1,1,"1",1,2,0,"D"
"4031",1954-01-03,1953,"OGC Nice","RC Lens","6-1",6,1,"1",1,7,5,"H"
"4032",1954-01-03,1953,"AS Saint-Etienne","Le Havre AC","0-1",0,1,"1",1,1,-1,"D"
"4033",1954-01-03,1953,"Nimes Olympique","Olympique Marseille","2-1",2,1,"1",1,3,1,"H"
"4034",1954-01-03,1953,"AS Nancy","FC Sete","3-1",3,1,"1",1,4,2,"H"
"4035",1954-01-03,1953,"Stade Francais FC","RC Roubaix","1-1",1,1,"1",1,2,0,"D"
"4036",1954-01-10,1953,"RC Strasbourg","Girondins Bordeaux","1-2",1,2,"1",1,3,-1,"D"
"4037",1954-01-10,1953,"FC Sochaux","Stade Reims","1-3",1,3,"1",1,4,-2,"D"
"4038",1954-01-10,1953,"Le Havre AC","Lille OSC","1-1",1,1,"1",1,2,0,"D"
"4039",1954-01-10,1953,"Toulouse FC","RC Lens","1-1",1,1,"1",1,2,0,"D"
"4040",1954-01-10,1953,"AS Monaco","AS Saint-Etienne","1-1",1,1,"1",1,2,0,"D"
"4041",1954-01-10,1953,"RC Roubaix","OGC Nice","3-2",3,2,"1",1,5,1,"H"
"4042",1954-01-10,1953,"FC Sete","Nimes Olympique","2-1",2,1,"1",1,3,1,"H"
"4043",1954-01-10,1953,"FC Metz","AS Nancy","2-4",2,4,"1",1,6,-2,"D"
"4044",1954-01-10,1953,"Olympique Marseille","Stade Francais FC","3-1",3,1,"1",1,4,2,"H"
"4045",1954-01-24,1953,"Stade Francais FC","Girondins Bordeaux","0-1",0,1,"1",1,1,-1,"D"
"4046",1954-01-24,1953,"Nimes Olympique","Stade Reims","1-1",1,1,"1",1,2,0,"D"
"4047",1954-01-24,1953,"OGC Nice","Lille OSC","3-0",3,0,"1",1,3,3,"H"
"4048",1954-01-24,1953,"AS Nancy","Toulouse FC","4-2",4,2,"1",1,6,2,"H"
"4049",1954-01-24,1953,"RC Lens","AS Saint-Etienne","2-0",2,0,"1",1,2,2,"H"
"4050",1954-01-24,1953,"FC Sete","RC Strasbourg","0-0",0,0,"1",1,0,0,"D"
"4051",1954-01-24,1953,"RC Roubaix","AS Monaco","2-0",2,0,"1",1,2,2,"H"
"4052",1954-01-24,1953,"Olympique Marseille","Le Havre AC","5-1",5,1,"1",1,6,4,"H"
"4053",1954-01-24,1953,"FC Sochaux","FC Metz","3-0",3,0,"1",1,3,3,"H"
"4054",1954-01-31,1953,"Girondins Bordeaux","OGC Nice","4-1",4,1,"1",1,5,3,"H"
"4055",1954-01-31,1953,"Stade Reims","Stade Francais FC","1-3",1,3,"1",1,4,-2,"D"
"4056",1954-01-31,1953,"Lille OSC","RC Lens","1-0",1,0,"1",1,1,1,"H"
"4057",1954-01-31,1953,"Toulouse FC","FC Sochaux","2-2",2,2,"1",1,4,0,"D"
"4058",1954-01-31,1953,"AS Saint-Etienne","RC Roubaix","2-1",2,1,"1",1,3,1,"H"
"4059",1954-01-31,1953,"RC Strasbourg","FC Metz","2-2",2,2,"1",1,4,0,"D"
"4060",1954-01-31,1953,"AS Nancy","Nimes Olympique","4-2",4,2,"1",1,6,2,"H"
"4061",1954-01-31,1953,"AS Monaco","Olympique Marseille","1-1",1,1,"1",1,2,0,"D"
"4062",1954-01-31,1953,"Le Havre AC","FC Sete","10-0",10,0,"1",1,10,10,"H"
"4063",1954-02-07,1953,"Girondins Bordeaux","FC Sete","1-0",1,0,"1",1,1,1,"H"
"4064",1954-02-07,1953,"Stade Reims","Olympique Marseille","6-0",6,0,"1",1,6,6,"H"
"4065",1954-02-07,1953,"Lille OSC","FC Metz","2-2",2,2,"1",1,4,0,"D"
"4066",1954-02-07,1953,"Stade Francais FC","OGC Nice","1-1",1,1,"1",1,2,0,"D"
"4067",1954-02-07,1953,"AS Saint-Etienne","FC Sochaux","2-4",2,4,"1",1,6,-2,"D"
"4068",1954-02-07,1953,"Nimes Olympique","RC Lens","3-1",3,1,"1",1,4,2,"H"
"4069",1954-02-07,1953,"AS Nancy","RC Roubaix","2-1",2,1,"1",1,3,1,"H"
"4070",1954-02-07,1953,"AS Monaco","RC Strasbourg","4-2",4,2,"1",1,6,2,"H"
"4071",1954-02-21,1953,"Olympique Marseille","Girondins Bordeaux","3-2",3,2,"1",1,5,1,"H"
"4072",1954-02-21,1953,"RC Roubaix","Stade Reims","2-2",2,2,"1",1,4,0,"D"
"4073",1954-02-21,1953,"FC Sete","Lille OSC","0-1",0,1,"1",1,1,-1,"D"
"4074",1954-02-21,1953,"Stade Francais FC","Toulouse FC","0-0",0,0,"1",1,0,0,"D"
"4075",1954-02-21,1953,"OGC Nice","Nimes Olympique","1-1",1,1,"1",1,2,0,"D"
"4076",1954-02-21,1953,"RC Strasbourg","Le Havre AC","4-0",4,0,"1",1,4,4,"H"
"4077",1954-02-21,1953,"FC Metz","AS Saint-Etienne","5-1",5,1,"1",1,6,4,"H"
"4078",1954-02-21,1953,"RC Lens","AS Nancy","3-2",3,2,"1",1,5,1,"H"
"4079",1954-02-21,1953,"FC Sochaux","AS Monaco","1-0",1,0,"1",1,1,1,"H"
"4080",1954-02-28,1953,"Girondins Bordeaux","RC Roubaix","5-0",5,0,"1",1,5,5,"H"
"4081",1954-02-28,1953,"Lille OSC","Olympique Marseille","4-0",4,0,"1",1,4,4,"H"
"4082",1954-02-28,1953,"Stade Reims","RC Lens","0-0",0,0,"1",1,0,0,"D"
"4083",1954-02-28,1953,"Toulouse FC","RC Strasbourg","3-1",3,1,"1",1,4,2,"H"
"4084",1954-02-28,1953,"AS Nancy","OGC Nice","1-5",1,5,"1",1,6,-4,"D"
"4085",1954-02-28,1953,"AS Saint-Etienne","FC Sete","6-3",6,3,"1",1,9,3,"H"
"4086",1954-02-28,1953,"Nimes Olympique","Stade Francais FC","1-0",1,0,"1",1,1,1,"H"
"4087",1954-02-28,1953,"AS Monaco","FC Metz","2-0",2,0,"1",1,2,2,"H"
"4088",1954-02-28,1953,"Le Havre AC","FC Sochaux","2-1",2,1,"1",1,3,1,"H"
"4089",1954-03-11,1953,"Girondins Bordeaux","Nimes Olympique","2-1",2,1,"1",1,3,1,"H"
"4090",1954-03-11,1953,"Stade Reims","AS Nancy","4-1",4,1,"1",1,5,3,"H"
"4091",1954-03-11,1953,"Lille OSC","Stade Francais FC","1-1",1,1,"1",1,2,0,"D"
"4092",1954-03-11,1953,"FC Metz","Toulouse FC","2-2",2,2,"1",1,4,0,"D"
"4093",1954-03-11,1953,"AS Saint-Etienne","OGC Nice","2-1",2,1,"1",1,3,1,"H"
"4094",1954-03-11,1953,"RC Strasbourg","Olympique Marseille","2-1",2,1,"1",1,3,1,"H"
"4095",1954-03-11,1953,"AS Monaco","RC Lens","0-1",0,1,"1",1,1,-1,"D"
"4096",1954-03-11,1953,"FC Sochaux","FC Sete","2-2",2,2,"1",1,4,0,"D"
"4097",1954-03-11,1953,"Le Havre AC","RC Roubaix","3-1",3,1,"1",1,4,2,"H"
"4098",1954-03-14,1953,"AS Monaco","Girondins Bordeaux","1-2",1,2,"1",1,3,-1,"D"
"4099",1954-03-14,1953,"Le Havre AC","Stade Reims","0-0",0,0,"1",1,0,0,"D"
"4100",1954-03-14,1953,"AS Saint-Etienne","Lille OSC","0-0",0,0,"1",1,0,0,"D"
"4101",1954-03-14,1953,"RC Roubaix","Toulouse FC","4-1",4,1,"1",1,5,3,"H"
"4102",1954-03-14,1953,"FC Sete","OGC Nice","1-1",1,1,"1",1,2,0,"D"
"4103",1954-03-14,1953,"RC Strasbourg","AS Nancy","1-2",1,2,"1",1,3,-1,"D"
"4104",1954-03-14,1953,"FC Sochaux","Nimes Olympique","2-1",2,1,"1",1,3,1,"H"
"4105",1954-03-14,1953,"Olympique Marseille","RC Lens","2-0",2,0,"1",1,2,2,"H"
"4106",1954-03-14,1953,"FC Metz","Stade Francais FC","1-0",1,0,"1",1,1,1,"H"
"4107",1954-03-21,1953,"Girondins Bordeaux","Le Havre AC","1-4",1,4,"1",1,5,-3,"D"
"4108",1954-03-21,1953,"Stade Reims","RC Strasbourg","2-2",2,2,"1",1,4,0,"D"
"4109",1954-03-21,1953,"Lille OSC","AS Monaco","0-0",0,0,"1",1,0,0,"D"
"4110",1954-03-21,1953,"Toulouse FC","AS Saint-Etienne","1-1",1,1,"1",1,2,0,"D"
"4111",1954-03-21,1953,"OGC Nice","Olympique Marseille","2-4",2,4,"1",1,6,-2,"D"
"4112",1954-03-21,1953,"Nimes Olympique","FC Metz","2-1",2,1,"1",1,3,1,"H"
"4113",1954-03-21,1953,"RC Lens","RC Roubaix","4-1",4,1,"1",1,5,3,"H"
"4114",1954-03-21,1953,"AS Nancy","FC Sochaux","2-3",2,3,"1",1,5,-1,"D"
"4115",1954-03-21,1953,"Stade Francais FC","FC Sete","2-2",2,2,"1",1,4,0,"D"
"4116",1954-03-25,1953,"Toulouse FC","Le Havre AC","5-1",5,1,"1",1,6,4,"H"
"4117",1954-04-04,1953,"AS Nancy","Girondins Bordeaux","2-2",2,2,"1",1,4,0,"D"
"4118",1954-04-04,1953,"Toulouse FC","Stade Reims","1-3",1,3,"1",1,4,-2,"D"
"4119",1954-04-04,1953,"Nimes Olympique","Lille OSC","1-1",1,1,"1",1,2,0,"D"
"4120",1954-04-04,1953,"Stade Francais FC","AS Saint-Etienne","1-2",1,2,"1",1,3,-1,"D"
"4121",1954-04-04,1953,"OGC Nice","AS Monaco","1-2",1,2,"1",1,3,-1,"D"
"4122",1954-04-04,1953,"RC Lens","Le Havre AC","3-1",3,1,"1",1,4,2,"H"
"4123",1954-04-04,1953,"RC Roubaix","RC Strasbourg","0-0",0,0,"1",1,0,0,"D"
"4124",1954-04-04,1953,"Olympique Marseille","FC Sochaux","0-0",0,0,"1",1,0,0,"D"
"4125",1954-04-04,1953,"FC Sete","FC Metz","4-1",4,1,"1",1,5,3,"H"
"4126",1954-04-15,1953,"RC Lens","Girondins Bordeaux","1-1",1,1,"1",1,2,0,"D"
"4127",1954-04-15,1953,"OGC Nice","Stade Reims","1-1",1,1,"1",1,2,0,"D"
"4128",1954-04-15,1953,"RC Roubaix","Lille OSC","0-3",0,3,"1",1,3,-3,"D"
"4129",1954-04-15,1953,"Nimes Olympique","Toulouse FC","0-1",0,1,"1",1,1,-1,"D"
"4130",1954-04-15,1953,"Olympique Marseille","AS Saint-Etienne","3-1",3,1,"1",1,4,2,"H"
"4131",1954-04-15,1953,"FC Sochaux","RC Strasbourg","7-1",7,1,"1",1,8,6,"H"
"4132",1954-04-15,1953,"Stade Francais FC","AS Nancy","4-0",4,0,"1",1,4,4,"H"
"4133",1954-04-15,1953,"FC Sete","AS Monaco","1-1",1,1,"1",1,2,0,"D"
"4134",1954-04-15,1953,"FC Metz","Le Havre AC","2-1",2,1,"1",1,3,1,"H"
"4135",1954-04-18,1953,"AS Saint-Etienne","Stade Reims","0-1",0,1,"1",1,1,-1,"D"
"4136",1954-04-18,1953,"Lille OSC","Girondins Bordeaux","1-0",1,0,"1",1,1,1,"H"
"4137",1954-04-18,1953,"Olympique Marseille","Toulouse FC","0-1",0,1,"1",1,1,-1,"D"
"4138",1954-04-18,1953,"Le Havre AC","Nimes Olympique","0-1",0,1,"1",1,1,-1,"D"
"4139",1954-04-18,1953,"FC Metz","RC Lens","1-1",1,1,"1",1,2,0,"D"
"4140",1954-04-18,1953,"RC Strasbourg","Stade Francais FC","2-0",2,0,"1",1,2,2,"H"
"4141",1954-04-18,1953,"FC Sochaux","OGC Nice","4-1",4,1,"1",1,5,3,"H"
"4142",1954-04-18,1953,"AS Monaco","AS Nancy","2-0",2,0,"1",1,2,2,"H"
"4143",1954-04-18,1953,"FC Sete","RC Roubaix","4-0",4,0,"1",1,4,4,"H"
"4144",1954-05-02,1953,"Stade Reims","AS Monaco","2-1",2,1,"1",1,3,1,"H"
"4145",1954-05-02,1953,"Girondins Bordeaux","AS Saint-Etienne","1-0",1,0,"1",1,1,1,"H"
"4146",1954-05-02,1953,"Toulouse FC","Lille OSC","1-0",1,0,"1",1,1,1,"H"
"4147",1954-05-02,1953,"Nimes Olympique","RC Strasbourg","1-2",1,2,"1",1,3,-1,"D"
"4148",1954-05-02,1953,"RC Lens","FC Sete","2-2",2,2,"1",1,4,0,"D"
"4149",1954-05-02,1953,"OGC Nice","FC Metz","0-1",0,1,"1",1,1,-1,"D"
"4150",1954-05-02,1953,"Stade Francais FC","FC Sochaux","4-1",4,1,"1",1,5,3,"H"
"4151",1954-05-02,1953,"AS Nancy","Le Havre AC","3-0",3,0,"1",1,3,3,"H"
"4152",1954-05-02,1953,"RC Roubaix","Olympique Marseille","1-0",1,0,"1",1,1,1,"H"
"4153",1954-05-09,1953,"Stade Reims","Lille OSC","0-3",0,3,"1",1,3,-3,"D"
"4154",1954-05-09,1953,"Toulouse FC","Girondins Bordeaux","3-1",3,1,"1",1,4,2,"H"
"4155",1954-05-09,1953,"AS Nancy","AS Saint-Etienne","0-1",0,1,"1",1,1,-1,"D"
"4156",1954-05-09,1953,"RC Lens","FC Sochaux","2-0",2,0,"1",1,2,2,"H"
"4157",1954-05-09,1953,"OGC Nice","RC Strasbourg","4-3",4,3,"1",1,7,1,"H"
"4158",1954-05-09,1953,"Nimes Olympique","AS Monaco","1-3",1,3,"1",1,4,-2,"D"
"4159",1954-05-09,1953,"Olympique Marseille","FC Sete","2-0",2,0,"1",1,2,2,"H"
"4160",1954-05-09,1953,"RC Roubaix","FC Metz","3-0",3,0,"1",1,3,3,"H"
"4161",1954-05-09,1953,"Stade Francais FC","Le Havre AC","1-2",1,2,"1",1,3,-1,"D"
"4162",1954-05-16,1953,"Lille OSC","AS Nancy","3-0",3,0,"1",1,3,3,"H"
"4163",1954-05-16,1953,"Girondins Bordeaux","Stade Reims","0-0",0,0,"1",1,0,0,"D"
"4164",1954-05-16,1953,"FC Sete","Toulouse FC","1-1",1,1,"1",1,2,0,"D"
"4165",1954-05-16,1953,"AS Saint-Etienne","Nimes Olympique","2-1",2,1,"1",1,3,1,"H"
"4166",1954-05-16,1953,"RC Strasbourg","RC Lens","5-2",5,2,"1",1,7,3,"H"
"4167",1954-05-16,1953,"Le Havre AC","OGC Nice","2-2",2,2,"1",1,4,0,"D"
"4168",1954-05-16,1953,"AS Monaco","Stade Francais FC","1-4",1,4,"1",1,5,-3,"D"
"4169",1954-05-16,1953,"FC Sochaux","RC Roubaix","0-1",0,1,"1",1,1,-1,"D"
"4170",1954-05-16,1953,"FC Metz","Olympique Marseille","3-2",3,2,"1",1,5,1,"H"
"4171",1954-08-22,1954,"Lille OSC","Racing Club de France","6-0",6,0,"1",1,6,6,"H"
"4172",1954-08-22,1954,"Stade Reims","AS Monaco","3-1",3,1,"1",1,4,2,"H"
"4173",1954-08-22,1954,"Girondins Bordeaux","RC Lens","2-1",2,1,"1",1,3,1,"H"
"4174",1954-08-22,1954,"AS Saint-Etienne","Nimes Olympique","4-2",4,2,"1",1,6,2,"H"
"4175",1954-08-22,1954,"OGC Nice","Olympique Lyon","7-3",7,3,"1",1,10,4,"H"
"4176",1954-08-22,1954,"AS Nancy","RC Strasbourg","1-5",1,5,"1",1,6,-4,"D"
"4177",1954-08-22,1954,"Olympique Marseille","FC Sochaux","3-0",3,0,"1",1,3,3,"H"
"4178",1954-08-22,1954,"AS Troyes-Savinienne","FC Metz","0-1",0,1,"1",1,1,-1,"D"
"4179",1954-08-22,1954,"Toulouse FC","RC Roubaix","6-2",6,2,"1",1,8,4,"H"
"4180",1954-08-28,1954,"Racing Club de France","Olympique Marseille","3-3",3,3,"1",1,6,0,"D"
"4181",1954-08-29,1954,"RC Strasbourg","AS Troyes-Savinienne","4-0",4,0,"1",1,4,4,"H"
"4182",1954-08-29,1954,"Nimes Olympique","Lille OSC","0-1",0,1,"1",1,1,-1,"D"
"4183",1954-08-29,1954,"AS Saint-Etienne","AS Nancy","2-0",2,0,"1",1,2,2,"H"
"4184",1954-08-29,1954,"FC Metz","Girondins Bordeaux","1-0",1,0,"1",1,1,1,"H"
"4185",1954-08-29,1954,"AS Monaco","Toulouse FC","1-1",1,1,"1",1,2,0,"D"
"4186",1954-08-29,1954,"RC Lens","Stade Reims","0-0",0,0,"1",1,0,0,"D"
"4187",1954-08-29,1954,"FC Sochaux","Olympique Lyon","2-0",2,0,"1",1,2,2,"H"
"4188",1954-08-29,1954,"RC Roubaix","OGC Nice","4-2",4,2,"1",1,6,2,"H"
"4189",1954-09-04,1954,"AS Nancy","Nimes Olympique","3-1",3,1,"1",1,4,2,"H"
"4190",1954-09-05,1954,"Lille OSC","AS Monaco","3-1",3,1,"1",1,4,2,"H"
"4191",1954-09-05,1954,"Stade Reims","AS Saint-Etienne","2-4",2,4,"1",1,6,-2,"D"
"4192",1954-09-05,1954,"OGC Nice","FC Metz","2-3",2,3,"1",1,5,-1,"D"
"4193",1954-09-05,1954,"Toulouse FC","RC Strasbourg","4-1",4,1,"1",1,5,3,"H"
"4194",1954-09-05,1954,"Girondins Bordeaux","FC Sochaux","1-2",1,2,"1",1,3,-1,"D"
"4195",1954-09-05,1954,"Olympique Lyon","RC Lens","1-1",1,1,"1",1,2,0,"D"
"4196",1954-09-05,1954,"AS Troyes-Savinienne","Racing Club de France","3-1",3,1,"1",1,4,2,"H"
"4197",1954-09-05,1954,"Olympique Marseille","RC Roubaix","5-2",5,2,"1",1,7,3,"H"
"4198",1954-09-09,1954,"Olympique Marseille","AS Saint-Etienne","4-0",4,0,"1",1,4,4,"H"
"4199",1954-09-09,1954,"Toulouse FC","AS Nancy","3-1",3,1,"1",1,4,2,"H"
"4200",1954-09-09,1954,"Lille OSC","RC Lens","3-3",3,3,"1",1,6,0,"D"
"4201",1954-09-09,1954,"FC Sochaux","Racing Club de France","3-2",3,2,"1",1,5,1,"H"
"4202",1954-09-09,1954,"Olympique Lyon","RC Strasbourg","2-1",2,1,"1",1,3,1,"H"
"4203",1954-09-09,1954,"OGC Nice","Nimes Olympique","1-0",1,0,"1",1,1,1,"H"
"4204",1954-09-09,1954,"Girondins Bordeaux","AS Monaco","4-1",4,1,"1",1,5,3,"H"
"4205",1954-09-09,1954,"AS Troyes-Savinienne","Stade Reims","2-2",2,2,"1",1,4,0,"D"
"4206",1954-09-09,1954,"FC Metz","RC Roubaix","0-0",0,0,"1",1,0,0,"D"
"4207",1954-09-12,1954,"AS Monaco","Olympique Marseille","1-2",1,2,"1",1,3,-1,"D"
"4208",1954-09-12,1954,"AS Saint-Etienne","Toulouse FC","2-3",2,3,"1",1,5,-1,"D"
"4209",1954-09-12,1954,"FC Metz","FC Sochaux","1-0",1,0,"1",1,1,1,"H"
"4210",1954-09-12,1954,"Stade Reims","Lille OSC","4-2",4,2,"1",1,6,2,"H"
"4211",1954-09-12,1954,"RC Strasbourg","OGC Nice","7-1",7,1,"1",1,8,6,"H"
"4212",1954-09-12,1954,"Racing Club de France","Girondins Bordeaux","2-0",2,0,"1",1,2,2,"H"
"4213",1954-09-12,1954,"RC Lens","AS Nancy","1-1",1,1,"1",1,2,0,"D"
"4214",1954-09-12,1954,"Nimes Olympique","AS Troyes-Savinienne","1-0",1,0,"1",1,1,1,"H"
"4215",1954-09-12,1954,"RC Roubaix","Olympique Lyon","2-1",2,1,"1",1,3,1,"H"
"4216",1954-09-19,1954,"Olympique Marseille","RC Strasbourg","2-0",2,0,"1",1,2,2,"H"
"4217",1954-09-19,1954,"Toulouse FC","Nimes Olympique","2-0",2,0,"1",1,2,2,"H"
"4218",1954-09-19,1954,"Olympique Lyon","FC Metz","4-2",4,2,"1",1,6,2,"H"
"4219",1954-09-19,1954,"AS Nancy","Stade Reims","2-4",2,4,"1",1,6,-2,"D"
"4220",1954-09-19,1954,"Lille OSC","AS Saint-Etienne","0-1",0,1,"1",1,1,-1,"D"
"4221",1954-09-19,1954,"FC Sochaux","RC Lens","1-1",1,1,"1",1,2,0,"D"
"4222",1954-09-19,1954,"OGC Nice","Racing Club de France","3-2",3,2,"1",1,5,1,"H"
"4223",1954-09-19,1954,"AS Troyes-Savinienne","AS Monaco","1-1",1,1,"1",1,2,0,"D"
"4224",1954-09-19,1954,"Girondins Bordeaux","RC Roubaix","5-1",5,1,"1",1,6,4,"H"
"4225",1954-09-26,1954,"FC Metz","Toulouse FC","1-5",1,5,"1",1,6,-4,"D"
"4226",1954-09-26,1954,"Olympique Lyon","Olympique Marseille","3-0",3,0,"1",1,3,3,"H"
"4227",1954-09-26,1954,"RC Strasbourg","Stade Reims","1-1",1,1,"1",1,2,0,"D"
"4228",1954-09-26,1954,"Girondins Bordeaux","OGC Nice","7-2",7,2,"1",1,9,5,"H"
"4229",1954-09-26,1954,"AS Monaco","AS Saint-Etienne","2-0",2,0,"1",1,2,2,"H"
"4230",1954-09-26,1954,"FC Sochaux","AS Troyes-Savinienne","0-0",0,0,"1",1,0,0,"D"
"4231",1954-09-26,1954,"RC Lens","Nimes Olympique","3-1",3,1,"1",1,4,2,"H"
"4232",1954-09-26,1954,"Racing Club de France","AS Nancy","0-0",0,0,"1",1,0,0,"D"
"4233",1954-09-26,1954,"RC Roubaix","Lille OSC","3-1",3,1,"1",1,4,2,"H"
"4234",1954-09-30,1954,"Stade Reims","Toulouse FC","2-1",2,1,"1",1,3,1,"H"
"4235",1954-09-30,1954,"Nimes Olympique","Olympique Marseille","2-2",2,2,"1",1,4,0,"D"
"4236",1954-09-30,1954,"RC Lens","FC Metz","2-3",2,3,"1",1,5,-1,"D"
"4237",1954-09-30,1954,"RC Strasbourg","Girondins Bordeaux","1-1",1,1,"1",1,2,0,"D"
"4238",1954-09-30,1954,"AS Saint-Etienne","AS Troyes-Savinienne","0-2",0,2,"1",1,2,-2,"D"
"4239",1954-09-30,1954,"AS Nancy","Lille OSC","1-0",1,0,"1",1,1,1,"H"
"4240",1954-09-30,1954,"Racing Club de France","Olympique Lyon","5-0",5,0,"1",1,5,5,"H"
"4241",1954-09-30,1954,"AS Monaco","OGC Nice","1-1",1,1,"1",1,2,0,"D"
"4242",1954-09-30,1954,"RC Roubaix","FC Sochaux","2-0",2,0,"1",1,2,2,"H"
"4243",1954-10-03,1954,"Toulouse FC","FC Sochaux","2-1",2,1,"1",1,3,1,"H"
"4244",1954-10-03,1954,"Olympique Marseille","Girondins Bordeaux","3-1",3,1,"1",1,4,2,"H"
"4245",1954-10-03,1954,"Stade Reims","Racing Club de France","0-3",0,3,"1",1,3,-3,"D"
"4246",1954-10-03,1954,"Lille OSC","FC Metz","4-2",4,2,"1",1,6,2,"H"
"4247",1954-10-03,1954,"AS Saint-Etienne","RC Strasbourg","5-1",5,1,"1",1,6,4,"H"
"4248",1954-10-03,1954,"OGC Nice","RC Lens","1-2",1,2,"1",1,3,-1,"D"
"4249",1954-10-03,1954,"AS Troyes-Savinienne","Olympique Lyon","2-2",2,2,"1",1,4,0,"D"
"4250",1954-10-03,1954,"Nimes Olympique","AS Monaco","2-0",2,0,"1",1,2,2,"H"
"4251",1954-10-03,1954,"AS Nancy","RC Roubaix","4-0",4,0,"1",1,4,4,"H"
"4252",1954-10-10,1954,"Toulouse FC","Lille OSC","2-1",2,1,"1",1,3,1,"H"
"4253",1954-10-10,1954,"Olympique Marseille","Stade Reims","1-3",1,3,"1",1,4,-2,"D"
"4254",1954-10-10,1954,"Girondins Bordeaux","Nimes Olympique","3-1",3,1,"1",1,4,2,"H"
"4255",1954-10-10,1954,"FC Metz","Racing Club de France","1-4",1,4,"1",1,5,-3,"D"
"4256",1954-10-10,1954,"FC Sochaux","RC Strasbourg","1-2",1,2,"1",1,3,-1,"D"
"4257",1954-10-10,1954,"OGC Nice","AS Saint-Etienne","2-0",2,0,"1",1,2,2,"H"
"4258",1954-10-10,1954,"AS Troyes-Savinienne","AS Nancy","2-1",2,1,"1",1,3,1,"H"
"4259",1954-10-10,1954,"Olympique Lyon","AS Monaco","0-2",0,2,"1",1,2,-2,"D"
"4260",1954-10-10,1954,"RC Roubaix","RC Lens","2-2",2,2,"1",1,4,0,"D"
"4261",1954-10-24,1954,"Racing Club de France","Toulouse FC","2-0",2,0,"1",1,2,2,"H"
"4262",1954-10-24,1954,"Nimes Olympique","Stade Reims","0-2",0,2,"1",1,2,-2,"D"
"4263",1954-10-24,1954,"FC Metz","Olympique Marseille","2-1",2,1,"1",1,3,1,"H"
"4264",1954-10-24,1954,"RC Strasbourg","Lille OSC","2-1",2,1,"1",1,3,1,"H"
"4265",1954-10-24,1954,"RC Lens","AS Saint-Etienne","2-1",2,1,"1",1,3,1,"H"
"4266",1954-10-24,1954,"Olympique Lyon","Girondins Bordeaux","3-1",3,1,"1",1,4,2,"H"
"4267",1954-10-24,1954,"FC Sochaux","OGC Nice","4-1",4,1,"1",1,5,3,"H"
"4268",1954-10-24,1954,"AS Monaco","AS Nancy","0-2",0,2,"1",1,2,-2,"D"
"4269",1954-10-24,1954,"RC Roubaix","AS Troyes-Savinienne","1-6",1,6,"1",1,7,-5,"D"
"4270",1954-10-31,1954,"Toulouse FC","Girondins Bordeaux","1-1",1,1,"1",1,2,0,"D"
"4271",1954-10-31,1954,"Stade Reims","FC Metz","6-0",6,0,"1",1,6,6,"H"
"4272",1954-10-31,1954,"Olympique Marseille","RC Lens","4-0",4,0,"1",1,4,4,"H"
"4273",1954-10-31,1954,"Nimes Olympique","Racing Club de France","2-0",2,0,"1",1,2,2,"H"
"4274",1954-10-31,1954,"AS Troyes-Savinienne","OGC Nice","3-4",3,4,"1",1,7,-1,"D"
"4275",1954-10-31,1954,"AS Monaco","RC Strasbourg","4-0",4,0,"1",1,4,4,"H"
"4276",1954-10-31,1954,"Lille OSC","Olympique Lyon","3-1",3,1,"1",1,4,2,"H"
"4277",1954-10-31,1954,"AS Nancy","FC Sochaux","2-2",2,2,"1",1,4,0,"D"
"4278",1954-10-31,1954,"AS Saint-Etienne","RC Roubaix","5-1",5,1,"1",1,6,4,"H"
"4279",1954-11-07,1954,"Olympique Lyon","Toulouse FC","3-2",3,2,"1",1,5,1,"H"
"4280",1954-11-07,1954,"OGC Nice","Olympique Marseille","0-0",0,0,"1",1,0,0,"D"
"4281",1954-11-07,1954,"Girondins Bordeaux","AS Troyes-Savinienne","3-1",3,1,"1",1,4,2,"H"
"4282",1954-11-07,1954,"Racing Club de France","AS Saint-Etienne","4-0",4,0,"1",1,4,4,"H"
"4283",1954-11-07,1954,"RC Strasbourg","Nimes Olympique","3-2",3,2,"1",1,5,1,"H"
"4284",1954-11-07,1954,"RC Lens","AS Monaco","2-0",2,0,"1",1,2,2,"H"
"4285",1954-11-07,1954,"FC Metz","AS Nancy","0-0",0,0,"1",1,0,0,"D"
"4286",1954-11-07,1954,"FC Sochaux","Lille OSC","1-2",1,2,"1",1,3,-1,"D"
"4287",1954-11-07,1954,"RC Roubaix","Stade Reims","2-1",2,1,"1",1,3,1,"H"
"4288",1954-11-14,1954,"Toulouse FC","Olympique Marseille","1-0",1,0,"1",1,1,1,"H"
"4289",1954-11-14,1954,"Stade Reims","Olympique Lyon","3-1",3,1,"1",1,4,2,"H"
"4290",1954-11-14,1954,"RC Strasbourg","Racing Club de France","3-1",3,1,"1",1,4,2,"H"
"4291",1954-11-14,1954,"AS Nancy","Girondins Bordeaux","1-1",1,1,"1",1,2,0,"D"
"4292",1954-11-14,1954,"AS Troyes-Savinienne","RC Lens","2-1",2,1,"1",1,3,1,"H"
"4293",1954-11-14,1954,"AS Saint-Etienne","FC Sochaux","3-1",3,1,"1",1,4,2,"H"
"4294",1954-11-14,1954,"Lille OSC","OGC Nice","1-3",1,3,"1",1,4,-2,"D"
"4295",1954-11-14,1954,"Nimes Olympique","FC Metz","2-0",2,0,"1",1,2,2,"H"
"4296",1954-11-14,1954,"AS Monaco","RC Roubaix","1-0",1,0,"1",1,1,1,"H"
"4297",1954-11-21,1954,"OGC Nice","Toulouse FC","5-0",5,0,"1",1,5,5,"H"
"4298",1954-11-21,1954,"Olympique Marseille","AS Troyes-Savinienne","3-0",3,0,"1",1,3,3,"H"
"4299",1954-11-21,1954,"FC Sochaux","Stade Reims","4-1",4,1,"1",1,5,3,"H"
"4300",1954-11-21,1954,"Girondins Bordeaux","Lille OSC","4-2",4,2,"1",1,6,2,"H"
"4301",1954-11-21,1954,"RC Lens","RC Strasbourg","2-1",2,1,"1",1,3,1,"H"
"4302",1954-11-21,1954,"FC Metz","AS Saint-Etienne","0-2",0,2,"1",1,2,-2,"D"
"4303",1954-11-21,1954,"Racing Club de France","AS Monaco","1-2",1,2,"1",1,3,-1,"D"
"4304",1954-11-21,1954,"Olympique Lyon","AS Nancy","2-1",2,1,"1",1,3,1,"H"
"4305",1954-11-21,1954,"RC Roubaix","Nimes Olympique","1-5",1,5,"1",1,6,-4,"D"
"4306",1954-11-28,1954,"Stade Reims","Girondins Bordeaux","3-0",3,0,"1",1,3,3,"H"
"4307",1954-11-28,1954,"Toulouse FC","AS Troyes-Savinienne","1-1",1,1,"1",1,2,0,"D"
"4308",1954-11-28,1954,"Lille OSC","Olympique Marseille","2-1",2,1,"1",1,3,1,"H"
"4309",1954-11-28,1954,"RC Strasbourg","RC Roubaix","3-0",3,0,"1",1,3,3,"H"
"4310",1954-11-28,1954,"AS Saint-Etienne","Olympique Lyon","4-2",4,2,"1",1,6,2,"H"
"4311",1954-11-28,1954,"Racing Club de France","RC Lens","1-1",1,1,"1",1,2,0,"D"
"4312",1954-11-28,1954,"AS Nancy","OGC Nice","4-1",4,1,"1",1,5,3,"H"
"4313",1954-11-28,1954,"Nimes Olympique","FC Sochaux","2-1",2,1,"1",1,3,1,"H"
"4314",1954-11-28,1954,"AS Monaco","FC Metz","5-0",5,0,"1",1,5,5,"H"
"4315",1954-12-05,1954,"OGC Nice","Stade Reims","3-3",3,3,"1",1,6,0,"D"
"4316",1954-12-05,1954,"RC Lens","Toulouse FC","1-1",1,1,"1",1,2,0,"D"
"4317",1954-12-05,1954,"Olympique Marseille","AS Nancy","2-2",2,2,"1",1,4,0,"D"
"4318",1954-12-05,1954,"Girondins Bordeaux","AS Saint-Etienne","2-1",2,1,"1",1,3,1,"H"
"4319",1954-12-05,1954,"FC Metz","RC Strasbourg","3-3",3,3,"1",1,6,0,"D"
"4320",1954-12-05,1954,"AS Troyes-Savinienne","Lille OSC","1-0",1,0,"1",1,1,1,"H"
"4321",1954-12-05,1954,"RC Roubaix","Racing Club de France","3-3",3,3,"1",1,6,0,"D"
"4322",1954-12-05,1954,"FC Sochaux","AS Monaco","5-2",5,2,"1",1,7,3,"H"
"4323",1954-12-05,1954,"Olympique Lyon","Nimes Olympique","2-2",2,2,"1",1,4,0,"D"
"4324",1954-12-12,1954,"AS Monaco","Stade Reims","1-2",1,2,"1",1,3,-1,"D"
"4325",1954-12-12,1954,"RC Roubaix","Toulouse FC","2-2",2,2,"1",1,4,0,"D"
"4326",1954-12-12,1954,"RC Strasbourg","AS Nancy","4-0",4,0,"1",1,4,4,"H"
"4327",1954-12-12,1954,"RC Lens","Girondins Bordeaux","1-3",1,3,"1",1,4,-2,"D"
"4328",1954-12-12,1954,"FC Sochaux","Olympique Marseille","4-0",4,0,"1",1,4,4,"H"
"4329",1954-12-12,1954,"Olympique Lyon","OGC Nice","3-4",3,4,"1",1,7,-1,"D"
"4330",1954-12-12,1954,"Nimes Olympique","AS Saint-Etienne","1-0",1,0,"1",1,1,1,"H"
"4331",1954-12-12,1954,"Racing Club de France","Lille OSC","1-3",1,3,"1",1,4,-2,"D"
"4332",1954-12-12,1954,"FC Metz","AS Troyes-Savinienne","4-2",4,2,"1",1,6,2,"H"
"4333",1954-12-19,1954,"Stade Reims","RC Lens","4-2",4,2,"1",1,6,2,"H"
"4334",1954-12-19,1954,"Toulouse FC","AS Monaco","3-2",3,2,"1",1,5,1,"H"
"4335",1954-12-19,1954,"Girondins Bordeaux","FC Metz","2-0",2,0,"1",1,2,2,"H"
"4336",1954-12-19,1954,"Olympique Marseille","Racing Club de France","3-1",3,1,"1",1,4,2,"H"
"4337",1954-12-19,1954,"AS Troyes-Savinienne","RC Strasbourg","2-1",2,1,"1",1,3,1,"H"
"4338",1954-12-19,1954,"OGC Nice","RC Roubaix","5-2",5,2,"1",1,7,3,"H"
"4339",1954-12-19,1954,"Lille OSC","Nimes Olympique","6-1",6,1,"1",1,7,5,"H"
"4340",1954-12-19,1954,"AS Nancy","AS Saint-Etienne","2-1",2,1,"1",1,3,1,"H"
"4341",1954-12-19,1954,"Olympique Lyon","FC Sochaux","3-2",3,2,"1",1,5,1,"H"
"4342",1954-12-26,1954,"AS Saint-Etienne","Stade Reims","0-2",0,2,"1",1,2,-2,"D"
"4343",1954-12-26,1954,"RC Strasbourg","Toulouse FC","2-0",2,0,"1",1,2,2,"H"
"4344",1954-12-26,1954,"FC Sochaux","Girondins Bordeaux","3-2",3,2,"1",1,5,1,"H"
"4345",1954-12-26,1954,"RC Roubaix","Olympique Marseille","1-1",1,1,"1",1,2,0,"D"
"4346",1954-12-26,1954,"FC Metz","OGC Nice","4-0",4,0,"1",1,4,4,"H"
"4347",1954-12-26,1954,"AS Monaco","Lille OSC","1-1",1,1,"1",1,2,0,"D"
"4348",1954-12-26,1954,"RC Lens","Olympique Lyon","1-0",1,0,"1",1,1,1,"H"
"4349",1954-12-26,1954,"Racing Club de France","AS Troyes-Savinienne","4-1",4,1,"1",1,5,3,"H"
"4350",1954-12-26,1954,"Nimes Olympique","AS Nancy","1-0",1,0,"1",1,1,1,"H"
"4351",1955-01-02,1954,"Stade Reims","AS Troyes-Savinienne","3-0",3,0,"1",1,3,3,"H"
"4352",1955-01-02,1954,"AS Nancy","Toulouse FC","0-1",0,1,"1",1,1,-1,"D"
"4353",1955-01-02,1954,"RC Strasbourg","Olympique Lyon","1-1",1,1,"1",1,2,0,"D"
"4354",1955-01-02,1954,"AS Monaco","Girondins Bordeaux","1-0",1,0,"1",1,1,1,"H"
"4355",1955-01-02,1954,"RC Lens","Lille OSC","2-1",2,1,"1",1,3,1,"H"
"4356",1955-01-02,1954,"AS Saint-Etienne","Olympique Marseille","3-0",3,0,"1",1,3,3,"H"
"4357",1955-01-02,1954,"Racing Club de France","FC Sochaux","0-3",0,3,"1",1,3,-3,"D"
"4358",1955-01-02,1954,"Nimes Olympique","OGC Nice","6-2",6,2,"1",1,8,4,"H"
"4359",1955-01-02,1954,"RC Roubaix","FC Metz","0-2",0,2,"1",1,2,-2,"D"
"4360",1955-01-09,1954,"Lille OSC","Stade Reims","3-2",3,2,"1",1,5,1,"H"
"4361",1955-01-09,1954,"Toulouse FC","AS Saint-Etienne","2-0",2,0,"1",1,2,2,"H"
"4362",1955-01-09,1954,"Olympique Marseille","AS Monaco","1-1",1,1,"1",1,2,0,"D"
"4363",1955-01-09,1954,"OGC Nice","RC Strasbourg","2-1",2,1,"1",1,3,1,"H"
"4364",1955-01-09,1954,"Girondins Bordeaux","Racing Club de France","0-0",0,0,"1",1,0,0,"D"
"4365",1955-01-09,1954,"FC Sochaux","FC Metz","1-0",1,0,"1",1,1,1,"H"
"4366",1955-01-09,1954,"AS Troyes-Savinienne","Nimes Olympique","0-0",0,0,"1",1,0,0,"D"
"4367",1955-01-09,1954,"Olympique Lyon","RC Roubaix","4-2",4,2,"1",1,6,2,"H"
"4368",1955-01-16,1954,"Stade Reims","AS Nancy","5-2",5,2,"1",1,7,3,"H"
"4369",1955-01-16,1954,"Nimes Olympique","Toulouse FC","0-0",0,0,"1",1,0,0,"D"
"4370",1955-01-16,1954,"RC Strasbourg","Olympique Marseille","4-1",4,1,"1",1,5,3,"H"
"4371",1955-01-16,1954,"RC Roubaix","Girondins Bordeaux","3-0",3,0,"1",1,3,3,"H"
"4372",1955-01-16,1954,"RC Lens","FC Sochaux","6-2",6,2,"1",1,8,4,"H"
"4373",1955-01-16,1954,"AS Saint-Etienne","Lille OSC","2-2",2,2,"1",1,4,0,"D"
"4374",1955-01-16,1954,"Racing Club de France","OGC Nice","3-1",3,1,"1",1,4,2,"H"
"4375",1955-01-16,1954,"AS Monaco","AS Troyes-Savinienne","1-2",1,2,"1",1,3,-1,"D"
"4376",1955-01-20,1954,"AS Nancy","RC Lens","1-3",1,3,"1",1,4,-2,"D"
"4377",1955-01-23,1954,"Girondins Bordeaux","RC Strasbourg","0-1",0,1,"1",1,1,-1,"D"
"4378",1955-01-23,1954,"FC Metz","RC Lens","1-1",1,1,"1",1,2,0,"D"
"4379",1955-01-23,1954,"FC Sochaux","RC Roubaix","5-0",5,0,"1",1,5,5,"H"
"4380",1955-01-23,1954,"Olympique Marseille","Nimes Olympique","0-1",0,1,"1",1,1,-1,"D"
"4381",1955-01-23,1954,"OGC Nice","AS Monaco","1-1",1,1,"1",1,2,0,"D"
"4382",1955-01-23,1954,"Lille OSC","AS Nancy","2-5",2,5,"1",1,7,-3,"D"
"4383",1955-01-23,1954,"Olympique Lyon","Racing Club de France","2-2",2,2,"1",1,4,0,"D"
"4384",1955-01-30,1954,"Stade Reims","RC Strasbourg","1-2",1,2,"1",1,3,-1,"D"
"4385",1955-01-30,1954,"Toulouse FC","FC Metz","6-2",6,2,"1",1,8,4,"H"
"4386",1955-01-30,1954,"Nimes Olympique","RC Lens","1-0",1,0,"1",1,1,1,"H"
"4387",1955-01-30,1954,"Olympique Marseille","Olympique Lyon","1-0",1,0,"1",1,1,1,"H"
"4388",1955-01-30,1954,"Lille OSC","RC Roubaix","4-0",4,0,"1",1,4,4,"H"
"4389",1955-01-30,1954,"AS Troyes-Savinienne","FC Sochaux","2-0",2,0,"1",1,2,2,"H"
"4390",1955-01-30,1954,"OGC Nice","Girondins Bordeaux","1-1",1,1,"1",1,2,0,"D"
"4391",1955-01-30,1954,"AS Nancy","Racing Club de France","1-0",1,0,"1",1,1,1,"H"
"4392",1955-01-30,1954,"AS Saint-Etienne","AS Monaco","0-0",0,0,"1",1,0,0,"D"
"4393",1955-02-03,1954,"Toulouse FC","Stade Reims","1-1",1,1,"1",1,2,0,"D"
"4394",1955-02-13,1954,"Racing Club de France","Stade Reims","2-5",2,5,"1",1,7,-3,"D"
"4395",1955-02-13,1954,"FC Sochaux","Toulouse FC","1-0",1,0,"1",1,1,1,"H"
"4396",1955-02-13,1954,"RC Strasbourg","AS Saint-Etienne","5-0",5,0,"1",1,5,5,"H"
"4397",1955-02-13,1954,"RC Lens","OGC Nice","2-2",2,2,"1",1,4,0,"D"
"4398",1955-02-13,1954,"Girondins Bordeaux","Olympique Marseille","2-1",2,1,"1",1,3,1,"H"
"4399",1955-02-13,1954,"FC Metz","Lille OSC","0-0",0,0,"1",1,0,0,"D"
"4400",1955-02-13,1954,"AS Monaco","Nimes Olympique","1-0",1,0,"1",1,1,1,"H"
"4401",1955-02-13,1954,"Olympique Lyon","AS Troyes-Savinienne","1-0",1,0,"1",1,1,1,"H"
"4402",1955-02-13,1954,"RC Roubaix","AS Nancy","2-1",2,1,"1",1,3,1,"H"
"4403",1955-02-17,1954,"FC Metz","Olympique Lyon","1-2",1,2,"1",1,3,-1,"D"
"4404",1955-02-20,1954,"Stade Reims","Olympique Marseille","2-0",2,0,"1",1,2,2,"H"
"4405",1955-02-20,1954,"Lille OSC","Toulouse FC","1-1",1,1,"1",1,2,0,"D"
"4406",1955-02-20,1954,"RC Strasbourg","FC Sochaux","2-5",2,5,"1",1,7,-3,"D"
"4407",1955-02-20,1954,"RC Lens","RC Roubaix","4-3",4,3,"1",1,7,1,"H"
"4408",1955-02-20,1954,"Nimes Olympique","Girondins Bordeaux","2-0",2,0,"1",1,2,2,"H"
"4409",1955-02-20,1954,"AS Monaco","Olympique Lyon","0-0",0,0,"1",1,0,0,"D"
"4410",1955-02-20,1954,"AS Saint-Etienne","OGC Nice","4-2",4,2,"1",1,6,2,"H"
"4411",1955-02-20,1954,"Racing Club de France","FC Metz","4-0",4,0,"1",1,4,4,"H"
"4412",1955-02-20,1954,"AS Nancy","AS Troyes-Savinienne","4-1",4,1,"1",1,5,3,"H"
"4413",1955-02-27,1954,"Stade Reims","Nimes Olympique","4-1",4,1,"1",1,5,3,"H"
"4414",1955-02-27,1954,"Toulouse FC","Racing Club de France","0-1",0,1,"1",1,1,-1,"D"
"4415",1955-02-27,1954,"Lille OSC","RC Strasbourg","0-0",0,0,"1",1,0,0,"D"
"4416",1955-02-27,1954,"AS Saint-Etienne","RC Lens","1-1",1,1,"1",1,2,0,"D"
"4417",1955-02-27,1954,"OGC Nice","FC Sochaux","4-0",4,0,"1",1,4,4,"H"
"4418",1955-02-27,1954,"Girondins Bordeaux","Olympique Lyon","3-1",3,1,"1",1,4,2,"H"
"4419",1955-02-27,1954,"Olympique Marseille","FC Metz","1-1",1,1,"1",1,2,0,"D"
"4420",1955-02-27,1954,"AS Nancy","AS Monaco","0-0",0,0,"1",1,0,0,"D"
"4421",1955-02-27,1954,"AS Troyes-Savinienne","RC Roubaix","2-5",2,5,"1",1,7,-3,"D"
"4422",1955-03-03,1954,"AS Troyes-Savinienne","AS Saint-Etienne","0-3",0,3,"1",1,3,-3,"D"
"4423",1955-03-13,1954,"FC Metz","Stade Reims","1-0",1,0,"1",1,1,1,"H"
"4424",1955-03-13,1954,"RC Strasbourg","AS Monaco","5-0",5,0,"1",1,5,5,"H"
"4425",1955-03-13,1954,"RC Lens","Olympique Marseille","1-0",1,0,"1",1,1,1,"H"
"4426",1955-03-13,1954,"FC Sochaux","AS Nancy","3-2",3,2,"1",1,5,1,"H"
"4427",1955-03-13,1954,"OGC Nice","AS Troyes-Savinienne","5-1",5,1,"1",1,6,4,"H"
"4428",1955-03-13,1954,"RC Roubaix","AS Saint-Etienne","1-4",1,4,"1",1,5,-3,"D"
"4429",1955-03-13,1954,"Olympique Lyon","Lille OSC","2-1",2,1,"1",1,3,1,"H"
"4430",1955-03-13,1954,"Racing Club de France","Nimes Olympique","1-0",1,0,"1",1,1,1,"H"
"4431",1955-03-20,1954,"Stade Reims","RC Roubaix","0-2",0,2,"1",1,2,-2,"D"
"4432",1955-03-20,1954,"Toulouse FC","Olympique Lyon","1-0",1,0,"1",1,1,1,"H"
"4433",1955-03-20,1954,"Nimes Olympique","RC Strasbourg","2-1",2,1,"1",1,3,1,"H"
"4434",1955-03-20,1954,"AS Monaco","RC Lens","6-0",6,0,"1",1,6,6,"H"
"4435",1955-03-20,1954,"Lille OSC","FC Sochaux","0-0",0,0,"1",1,0,0,"D"
"4436",1955-03-20,1954,"AS Troyes-Savinienne","Girondins Bordeaux","1-3",1,3,"1",1,4,-2,"D"
"4437",1955-03-20,1954,"AS Saint-Etienne","Racing Club de France","0-1",0,1,"1",1,1,-1,"D"
"4438",1955-03-20,1954,"Olympique Marseille","OGC Nice","2-0",2,0,"1",1,2,2,"H"
"4439",1955-03-20,1954,"AS Nancy","FC Metz","7-0",7,0,"1",1,7,7,"H"
"4440",1955-04-03,1954,"Girondins Bordeaux","Toulouse FC","1-1",1,1,"1",1,2,0,"D"
"4441",1955-04-10,1954,"Olympique Lyon","Stade Reims","1-1",1,1,"1",1,2,0,"D"
"4442",1955-04-10,1954,"Olympique Marseille","Toulouse FC","4-0",4,0,"1",1,4,4,"H"
"4443",1955-04-10,1954,"Racing Club de France","RC Strasbourg","4-2",4,2,"1",1,6,2,"H"
"4444",1955-04-10,1954,"RC Lens","AS Troyes-Savinienne","2-0",2,0,"1",1,2,2,"H"
"4445",1955-04-10,1954,"FC Sochaux","AS Saint-Etienne","0-0",0,0,"1",1,0,0,"D"
"4446",1955-04-10,1954,"Girondins Bordeaux","AS Nancy","2-3",2,3,"1",1,5,-1,"D"
"4447",1955-04-10,1954,"OGC Nice","Lille OSC","2-1",2,1,"1",1,3,1,"H"
"4448",1955-04-10,1954,"FC Metz","Nimes Olympique","1-0",1,0,"1",1,1,1,"H"
"4449",1955-04-10,1954,"RC Roubaix","AS Monaco","0-1",0,1,"1",1,1,-1,"D"
"4450",1955-04-24,1954,"Stade Reims","FC Sochaux","3-1",3,1,"1",1,4,2,"H"
"4451",1955-04-24,1954,"RC Strasbourg","RC Lens","2-2",2,2,"1",1,4,0,"D"
"4452",1955-04-24,1954,"Lille OSC","Girondins Bordeaux","2-2",2,2,"1",1,4,0,"D"
"4453",1955-04-24,1954,"AS Monaco","Racing Club de France","1-1",1,1,"1",1,2,0,"D"
"4454",1955-04-24,1954,"AS Saint-Etienne","FC Metz","2-0",2,0,"1",1,2,2,"H"
"4455",1955-04-24,1954,"Nimes Olympique","RC Roubaix","3-0",3,0,"1",1,3,3,"H"
"4456",1955-04-24,1954,"AS Troyes-Savinienne","Olympique Marseille","4-2",4,2,"1",1,6,2,"H"
"4457",1955-04-24,1954,"AS Nancy","Olympique Lyon","0-1",0,1,"1",1,1,-1,"D"
"4458",1955-05-01,1954,"Girondins Bordeaux","Stade Reims","5-0",5,0,"1",1,5,5,"H"
"4459",1955-05-01,1954,"RC Lens","Racing Club de France","3-1",3,1,"1",1,4,2,"H"
"4460",1955-05-01,1954,"AS Troyes-Savinienne","Toulouse FC","2-1",2,1,"1",1,3,1,"H"
"4461",1955-05-01,1954,"RC Roubaix","RC Strasbourg","1-0",1,0,"1",1,1,1,"H"
"4462",1955-05-01,1954,"FC Sochaux","Nimes Olympique","6-2",6,2,"1",1,8,4,"H"
"4463",1955-05-01,1954,"Olympique Marseille","Lille OSC","5-1",5,1,"1",1,6,4,"H"
"4464",1955-05-01,1954,"Olympique Lyon","AS Saint-Etienne","1-1",1,1,"1",1,2,0,"D"
"4465",1955-05-01,1954,"OGC Nice","AS Nancy","2-2",2,2,"1",1,4,0,"D"
"4466",1955-05-01,1954,"FC Metz","AS Monaco","2-1",2,1,"1",1,3,1,"H"
"4467",1955-05-19,1954,"Toulouse FC","OGC Nice","1-1",1,1,"1",1,2,0,"D"
"4468",1955-05-21,1954,"AS Monaco","FC Sochaux","0-0",0,0,"1",1,0,0,"D"
"4469",1955-05-22,1954,"Stade Reims","OGC Nice","3-2",3,2,"1",1,5,1,"H"
"4470",1955-05-22,1954,"Toulouse FC","RC Lens","2-0",2,0,"1",1,2,2,"H"
"4471",1955-05-22,1954,"RC Strasbourg","FC Metz","3-3",3,3,"1",1,6,0,"D"
"4472",1955-05-22,1954,"Lille OSC","AS Troyes-Savinienne","1-2",1,2,"1",1,3,-1,"D"
"4473",1955-05-22,1954,"AS Saint-Etienne","Girondins Bordeaux","3-1",3,1,"1",1,4,2,"H"
"4474",1955-05-22,1954,"Racing Club de France","RC Roubaix","2-2",2,2,"1",1,4,0,"D"
"4475",1955-05-22,1954,"AS Nancy","Olympique Marseille","3-0",3,0,"1",1,3,3,"H"
"4476",1955-05-22,1954,"Nimes Olympique","Olympique Lyon","2-2",2,2,"1",1,4,0,"D"
"4477",1955-08-21,1955,"Nimes Olympique","Racing Club de France","1-5",1,5,"1",1,6,-4,"D"
"4478",1955-08-21,1955,"AS Saint-Etienne","Stade Reims","3-1",3,1,"1",1,4,2,"H"
"4479",1955-08-21,1955,"FC Metz","FC Sochaux","3-1",3,1,"1",1,4,2,"H"
"4480",1955-08-21,1955,"AS Troyes-Savinienne","Toulouse FC","0-2",0,2,"1",1,2,-2,"D"
"4481",1955-08-21,1955,"Lille OSC","AS Monaco","2-0",2,0,"1",1,2,2,"H"
"4482",1955-08-21,1955,"OGC Nice","RC Strasbourg","2-1",2,1,"1",1,3,1,"H"
"4483",1955-08-21,1955,"Girondins Bordeaux","AS Nancy","3-3",3,3,"1",1,6,0,"D"
"4484",1955-08-21,1955,"Olympique Marseille","RC Lens","2-2",2,2,"1",1,4,0,"D"
"4485",1955-08-21,1955,"UA Sedan-Torcy","Olympique Lyon","2-2",2,2,"1",1,4,0,"D"
"4486",1955-08-28,1955,"Racing Club de France","Girondins Bordeaux","3-0",3,0,"1",1,3,3,"H"
"4487",1955-08-28,1955,"AS Monaco","AS Saint-Etienne","2-3",2,3,"1",1,5,-1,"D"
"4488",1955-08-28,1955,"Olympique Lyon","OGC Nice","2-4",2,4,"1",1,6,-2,"D"
"4489",1955-08-28,1955,"AS Nancy","FC Metz","1-2",1,2,"1",1,3,-1,"D"
"4490",1955-08-28,1955,"RC Lens","Nimes Olympique","3-1",3,1,"1",1,4,2,"H"
"4491",1955-08-28,1955,"Toulouse FC","UA Sedan-Torcy","1-1",1,1,"1",1,2,0,"D"
"4492",1955-08-28,1955,"FC Sochaux","AS Troyes-Savinienne","5-1",5,1,"1",1,6,4,"H"
"4493",1955-08-28,1955,"RC Strasbourg","Lille OSC","3-1",3,1,"1",1,4,2,"H"
"4494",1955-08-28,1955,"Stade Reims","Olympique Marseille","1-1",1,1,"1",1,2,0,"D"
"4495",1955-09-04,1955,"AS Saint-Etienne","AS Troyes-Savinienne","4-0",4,0,"1",1,4,4,"H"
"4496",1955-09-04,1955,"Stade Reims","OGC Nice","1-3",1,3,"1",1,4,-2,"D"
"4497",1955-09-04,1955,"RC Lens","RC Strasbourg","1-0",1,0,"1",1,1,1,"H"
"4498",1955-09-04,1955,"AS Nancy","Toulouse FC","1-2",1,2,"1",1,3,-1,"D"
"4499",1955-09-04,1955,"Olympique Marseille","FC Metz","4-0",4,0,"1",1,4,4,"H"
"4500",1955-09-04,1955,"AS Monaco","UA Sedan-Torcy","0-2",0,2,"1",1,2,-2,"D"
"4501",1955-09-04,1955,"FC Sochaux","Lille OSC","3-3",3,3,"1",1,6,0,"D"
"4502",1955-09-04,1955,"Nimes Olympique","Girondins Bordeaux","3-0",3,0,"1",1,3,3,"H"
"4503",1955-09-04,1955,"Racing Club de France","Olympique Lyon","1-2",1,2,"1",1,3,-1,"D"
"4504",1955-09-11,1955,"OGC Nice","RC Lens","5-2",5,2,"1",1,7,3,"H"
"4505",1955-09-11,1955,"RC Strasbourg","Racing Club de France","1-4",1,4,"1",1,5,-3,"D"
"4506",1955-09-11,1955,"FC Metz","AS Saint-Etienne","5-2",5,2,"1",1,7,3,"H"
"4507",1955-09-11,1955,"Toulouse FC","FC Sochaux","0-1",0,1,"1",1,1,-1,"D"
"4508",1955-09-11,1955,"UA Sedan-Torcy","Stade Reims","1-1",1,1,"1",1,2,0,"D"
"4509",1955-09-11,1955,"Lille OSC","Nimes Olympique","3-2",3,2,"1",1,5,1,"H"
"4510",1955-09-11,1955,"Olympique Lyon","AS Nancy","2-0",2,0,"1",1,2,2,"H"
"4511",1955-09-11,1955,"Girondins Bordeaux","Olympique Marseille","1-0",1,0,"1",1,1,1,"H"
"4512",1955-09-11,1955,"AS Troyes-Savinienne","AS Monaco","2-5",2,5,"1",1,7,-3,"D"
"4513",1955-09-18,1955,"OGC Nice","Lille OSC","7-1",7,1,"1",1,8,6,"H"
"4514",1955-09-18,1955,"Racing Club de France","Olympique Marseille","4-0",4,0,"1",1,4,4,"H"
"4515",1955-09-18,1955,"Toulouse FC","FC Metz","4-1",4,1,"1",1,5,3,"H"
"4516",1955-09-18,1955,"RC Lens","AS Saint-Etienne","2-2",2,2,"1",1,4,0,"D"
"4517",1955-09-18,1955,"Olympique Lyon","AS Troyes-Savinienne","3-0",3,0,"1",1,3,3,"H"
"4518",1955-09-18,1955,"FC Sochaux","Girondins Bordeaux","2-4",2,4,"1",1,6,-2,"D"
"4519",1955-09-18,1955,"RC Strasbourg","UA Sedan-Torcy","3-0",3,0,"1",1,3,3,"H"
"4520",1955-09-18,1955,"Stade Reims","AS Monaco","0-2",0,2,"1",1,2,-2,"D"
"4521",1955-09-18,1955,"AS Nancy","Nimes Olympique","3-1",3,1,"1",1,4,2,"H"
"4522",1955-09-25,1955,"UA Sedan-Torcy","OGC Nice","0-1",0,1,"1",1,1,-1,"D"
"4523",1955-09-25,1955,"Girondins Bordeaux","Toulouse FC","3-4",3,4,"1",1,7,-1,"D"
"4524",1955-09-25,1955,"AS Saint-Etienne","Racing Club de France","3-2",3,2,"1",1,5,1,"H"
"4525",1955-09-25,1955,"FC Metz","Olympique Lyon","1-1",1,1,"1",1,2,0,"D"
"4526",1955-09-25,1955,"FC Sochaux","Nimes Olympique","1-0",1,0,"1",1,1,1,"H"
"4527",1955-09-25,1955,"AS Monaco","RC Lens","5-2",5,2,"1",1,7,3,"H"
"4528",1955-09-25,1955,"Lille OSC","Stade Reims","2-2",2,2,"1",1,4,0,"D"
"4529",1955-09-25,1955,"Olympique Marseille","AS Nancy","1-2",1,2,"1",1,3,-1,"D"
"4530",1955-09-25,1955,"AS Troyes-Savinienne","RC Strasbourg","3-0",3,0,"1",1,3,3,"H"
"4531",1955-10-02,1955,"Nimes Olympique","OGC Nice","1-1",1,1,"1",1,2,0,"D"
"4532",1955-10-02,1955,"Racing Club de France","Lille OSC","2-1",2,1,"1",1,3,1,"H"
"4533",1955-10-02,1955,"AS Saint-Etienne","Olympique Lyon","0-1",0,1,"1",1,1,-1,"D"
"4534",1955-10-02,1955,"AS Monaco","Toulouse FC","1-0",1,0,"1",1,1,1,"H"
"4535",1955-10-02,1955,"FC Metz","AS Troyes-Savinienne","2-1",2,1,"1",1,3,1,"H"
"4536",1955-10-02,1955,"RC Lens","AS Nancy","3-2",3,2,"1",1,5,1,"H"
"4537",1955-10-02,1955,"Stade Reims","FC Sochaux","3-0",3,0,"1",1,3,3,"H"
"4538",1955-10-02,1955,"Girondins Bordeaux","UA Sedan-Torcy","2-1",2,1,"1",1,3,1,"H"
"4539",1955-10-02,1955,"Olympique Marseille","RC Strasbourg","3-1",3,1,"1",1,4,2,"H"
"4540",1955-10-12,1955,"AS Troyes-Savinienne","Girondins Bordeaux","1-1",1,1,"1",1,2,0,"D"
"4541",1955-10-13,1955,"OGC Nice","Olympique Marseille","1-2",1,2,"1",1,3,-1,"D"
"4542",1955-10-13,1955,"AS Nancy","Racing Club de France","2-3",2,3,"1",1,5,-1,"D"
"4543",1955-10-13,1955,"Olympique Lyon","AS Monaco","1-1",1,1,"1",1,2,0,"D"
"4544",1955-10-13,1955,"Toulouse FC","Stade Reims","0-2",0,2,"1",1,2,-2,"D"
"4545",1955-10-13,1955,"RC Strasbourg","AS Saint-Etienne","5-2",5,2,"1",1,7,3,"H"
"4546",1955-10-13,1955,"FC Sochaux","RC Lens","3-1",3,1,"1",1,4,2,"H"
"4547",1955-10-13,1955,"Lille OSC","FC Metz","4-1",4,1,"1",1,5,3,"H"
"4548",1955-10-13,1955,"UA Sedan-Torcy","Nimes Olympique","2-1",2,1,"1",1,3,1,"H"
"4549",1955-10-16,1955,"OGC Nice","Toulouse FC","1-0",1,0,"1",1,1,1,"H"
"4550",1955-10-16,1955,"FC Metz","Racing Club de France","1-3",1,3,"1",1,4,-2,"D"
"4551",1955-10-16,1955,"RC Strasbourg","Olympique Lyon","1-2",1,2,"1",1,3,-1,"D"
"4552",1955-10-16,1955,"Lille OSC","AS Saint-Etienne","0-2",0,2,"1",1,2,-2,"D"
"4553",1955-10-16,1955,"Olympique Marseille","AS Monaco","1-1",1,1,"1",1,2,0,"D"
"4554",1955-10-16,1955,"Girondins Bordeaux","RC Lens","1-2",1,2,"1",1,3,-1,"D"
"4555",1955-10-16,1955,"UA Sedan-Torcy","FC Sochaux","2-1",2,1,"1",1,3,1,"H"
"4556",1955-10-16,1955,"Nimes Olympique","Stade Reims","2-2",2,2,"1",1,4,0,"D"
"4557",1955-10-16,1955,"AS Troyes-Savinienne","AS Nancy","4-4",4,4,"1",1,8,0,"D"
"4558",1955-10-30,1955,"FC Sochaux","OGC Nice","0-0",0,0,"1",1,0,0,"D"
"4559",1955-10-30,1955,"Racing Club de France","AS Troyes-Savinienne","1-1",1,1,"1",1,2,0,"D"
"4560",1955-10-30,1955,"Olympique Lyon","Lille OSC","2-1",2,1,"1",1,3,1,"H"
"4561",1955-10-30,1955,"AS Saint-Etienne","Olympique Marseille","3-1",3,1,"1",1,4,2,"H"
"4562",1955-10-30,1955,"AS Monaco","Nimes Olympique","1-0",1,0,"1",1,1,1,"H"
"4563",1955-10-30,1955,"Toulouse FC","RC Strasbourg","4-4",4,4,"1",1,8,0,"D"
"4564",1955-10-30,1955,"Stade Reims","Girondins Bordeaux","3-0",3,0,"1",1,3,3,"H"
"4565",1955-10-30,1955,"AS Nancy","UA Sedan-Torcy","4-2",4,2,"1",1,6,2,"H"
"4566",1955-10-30,1955,"RC Lens","FC Metz","4-1",4,1,"1",1,5,3,"H"
"4567",1955-11-01,1955,"FC Metz","OGC Nice","2-0",2,0,"1",1,2,2,"H"
"4568",1955-11-01,1955,"Stade Reims","Racing Club de France","2-1",2,1,"1",1,3,1,"H"
"4569",1955-11-01,1955,"AS Saint-Etienne","FC Sochaux","0-0",0,0,"1",1,0,0,"D"
"4570",1955-11-01,1955,"RC Lens","Lille OSC","1-0",1,0,"1",1,1,1,"H"
"4571",1955-11-01,1955,"AS Monaco","AS Nancy","2-2",2,2,"1",1,4,0,"D"
"4572",1955-11-01,1955,"Olympique Marseille","Toulouse FC","3-0",3,0,"1",1,3,3,"H"
"4573",1955-11-01,1955,"Girondins Bordeaux","RC Strasbourg","3-0",3,0,"1",1,3,3,"H"
"4574",1955-11-01,1955,"AS Troyes-Savinienne","UA Sedan-Torcy","2-1",2,1,"1",1,3,1,"H"
"4575",1955-11-06,1955,"OGC Nice","Girondins Bordeaux","2-0",2,0,"1",1,2,2,"H"
"4576",1955-11-06,1955,"Olympique Lyon","Olympique Marseille","1-1",1,1,"1",1,2,0,"D"
"4577",1955-11-06,1955,"Racing Club de France","RC Lens","0-1",0,1,"1",1,1,-1,"D"
"4578",1955-11-06,1955,"Toulouse FC","AS Saint-Etienne","2-2",2,2,"1",1,4,0,"D"
"4579",1955-11-06,1955,"AS Nancy","Stade Reims","1-4",1,4,"1",1,5,-3,"D"
"4580",1955-11-06,1955,"FC Sochaux","AS Monaco","3-1",3,1,"1",1,4,2,"H"
"4581",1955-11-06,1955,"UA Sedan-Torcy","FC Metz","4-2",4,2,"1",1,6,2,"H"
"4582",1955-11-06,1955,"Lille OSC","AS Troyes-Savinienne","4-0",4,0,"1",1,4,4,"H"
"4583",1955-11-06,1955,"RC Strasbourg","Nimes Olympique","2-1",2,1,"1",1,3,1,"H"
"4584",1955-11-12,1955,"Girondins Bordeaux","FC Metz","2-1",2,1,"1",1,3,1,"H"
"4585",1955-11-13,1955,"AS Saint-Etienne","OGC Nice","3-3",3,3,"1",1,6,0,"D"
"4586",1955-11-13,1955,"RC Lens","Toulouse FC","1-0",1,0,"1",1,1,1,"H"
"4587",1955-11-13,1955,"Stade Reims","Olympique Lyon","3-0",3,0,"1",1,3,3,"H"
"4588",1955-11-13,1955,"Racing Club de France","FC Sochaux","2-5",2,5,"1",1,7,-3,"D"
"4589",1955-11-13,1955,"AS Monaco","RC Strasbourg","0-0",0,0,"1",1,0,0,"D"
"4590",1955-11-13,1955,"Olympique Marseille","UA Sedan-Torcy","2-2",2,2,"1",1,4,0,"D"
"4591",1955-11-13,1955,"AS Nancy","Lille OSC","3-1",3,1,"1",1,4,2,"H"
"4592",1955-11-13,1955,"Nimes Olympique","AS Troyes-Savinienne","5-2",5,2,"1",1,7,3,"H"
"4593",1955-11-20,1955,"Olympique Lyon","RC Lens","0-1",0,1,"1",1,1,-1,"D"
"4594",1955-11-20,1955,"AS Monaco","OGC Nice","4-2",4,2,"1",1,6,2,"H"
"4595",1955-11-20,1955,"RC Strasbourg","Stade Reims","0-1",0,1,"1",1,1,-1,"D"
"4596",1955-11-20,1955,"Toulouse FC","Racing Club de France","0-0",0,0,"1",1,0,0,"D"
"4597",1955-11-20,1955,"FC Sochaux","AS Nancy","0-0",0,0,"1",1,0,0,"D"
"4598",1955-11-20,1955,"UA Sedan-Torcy","AS Saint-Etienne","3-0",3,0,"1",1,3,3,"H"
"4599",1955-11-20,1955,"AS Troyes-Savinienne","Olympique Marseille","0-1",0,1,"1",1,1,-1,"D"
"4600",1955-11-20,1955,"Lille OSC","Girondins Bordeaux","2-1",2,1,"1",1,3,1,"H"
"4601",1955-11-20,1955,"FC Metz","Nimes Olympique","2-2",2,2,"1",1,4,0,"D"
"4602",1955-11-24,1955,"Nimes Olympique","Olympique Lyon","2-1",2,1,"1",1,3,1,"H"
"4603",1955-11-27,1955,"OGC Nice","AS Troyes-Savinienne","2-0",2,0,"1",1,2,2,"H"
"4604",1955-11-27,1955,"Stade Reims","RC Lens","3-0",3,0,"1",1,3,3,"H"
"4605",1955-11-27,1955,"Racing Club de France","AS Monaco","2-1",2,1,"1",1,3,1,"H"
"4606",1955-11-27,1955,"Olympique Marseille","FC Sochaux","1-0",1,0,"1",1,1,1,"H"
"4607",1955-11-27,1955,"AS Saint-Etienne","AS Nancy","1-1",1,1,"1",1,2,0,"D"
"4608",1955-11-27,1955,"Lille OSC","UA Sedan-Torcy","0-1",0,1,"1",1,1,-1,"D"
"4609",1955-11-27,1955,"Girondins Bordeaux","Olympique Lyon","2-0",2,0,"1",1,2,2,"H"
"4610",1955-11-27,1955,"FC Metz","RC Strasbourg","2-2",2,2,"1",1,4,0,"D"
"4611",1955-11-27,1955,"Nimes Olympique","Toulouse FC","2-1",2,1,"1",1,3,1,"H"
"4612",1955-12-04,1955,"Stade Reims","AS Troyes-Savinienne","2-1",2,1,"1",1,3,1,"H"
"4613",1955-12-04,1955,"RC Lens","UA Sedan-Torcy","4-0",4,0,"1",1,4,4,"H"
"4614",1955-12-04,1955,"Racing Club de France","OGC Nice","4-2",4,2,"1",1,6,2,"H"
"4615",1955-12-04,1955,"Olympique Marseille","Nimes Olympique","2-0",2,0,"1",1,2,2,"H"
"4616",1955-12-04,1955,"AS Saint-Etienne","Girondins Bordeaux","3-0",3,0,"1",1,3,3,"H"
"4617",1955-12-04,1955,"AS Monaco","FC Metz","4-0",4,0,"1",1,4,4,"H"
"4618",1955-12-04,1955,"FC Sochaux","Olympique Lyon","1-2",1,2,"1",1,3,-1,"D"
"4619",1955-12-04,1955,"AS Nancy","RC Strasbourg","3-1",3,1,"1",1,4,2,"H"
"4620",1955-12-04,1955,"Toulouse FC","Lille OSC","4-2",4,2,"1",1,6,2,"H"
"4621",1955-12-11,1955,"OGC Nice","AS Nancy","3-0",3,0,"1",1,3,3,"H"
"4622",1955-12-11,1955,"FC Metz","Stade Reims","1-1",1,1,"1",1,2,0,"D"
"4623",1955-12-11,1955,"AS Troyes-Savinienne","RC Lens","3-0",3,0,"1",1,3,3,"H"
"4624",1955-12-11,1955,"Lille OSC","Olympique Marseille","0-3",0,3,"1",1,3,-3,"D"
"4625",1955-12-11,1955,"UA Sedan-Torcy","Racing Club de France","3-0",3,0,"1",1,3,3,"H"
"4626",1955-12-11,1955,"Girondins Bordeaux","AS Monaco","0-2",0,2,"1",1,2,-2,"D"
"4627",1955-12-11,1955,"Nimes Olympique","AS Saint-Etienne","1-1",1,1,"1",1,2,0,"D"
"4628",1955-12-11,1955,"Olympique Lyon","Toulouse FC","2-2",2,2,"1",1,4,0,"D"
"4629",1955-12-11,1955,"RC Strasbourg","FC Sochaux","1-0",1,0,"1",1,1,1,"H"
"4630",1955-12-18,1955,"OGC Nice","AS Saint-Etienne","2-1",2,1,"1",1,3,1,"H"
"4631",1955-12-18,1955,"Olympique Lyon","Stade Reims","2-1",2,1,"1",1,3,1,"H"
"4632",1955-12-18,1955,"Toulouse FC","RC Lens","4-2",4,2,"1",1,6,2,"H"
"4633",1955-12-18,1955,"FC Sochaux","Racing Club de France","1-1",1,1,"1",1,2,0,"D"
"4634",1955-12-18,1955,"UA Sedan-Torcy","Olympique Marseille","2-1",2,1,"1",1,3,1,"H"
"4635",1955-12-18,1955,"RC Strasbourg","AS Monaco","2-1",2,1,"1",1,3,1,"H"
"4636",1955-12-18,1955,"Lille OSC","AS Nancy","1-2",1,2,"1",1,3,-1,"D"
"4637",1955-12-18,1955,"FC Metz","Girondins Bordeaux","1-1",1,1,"1",1,2,0,"D"
"4638",1955-12-18,1955,"AS Troyes-Savinienne","Nimes Olympique","4-2",4,2,"1",1,6,2,"H"
"4639",1956-01-01,1955,"Toulouse FC","OGC Nice","1-1",1,1,"1",1,2,0,"D"
"4640",1956-01-01,1955,"Stade Reims","Nimes Olympique","1-1",1,1,"1",1,2,0,"D"
"4641",1956-01-01,1955,"RC Lens","Girondins Bordeaux","2-0",2,0,"1",1,2,2,"H"
"4642",1956-01-01,1955,"Olympique Lyon","RC Strasbourg","2-0",2,0,"1",1,2,2,"H"
"4643",1956-01-01,1955,"AS Monaco","Olympique Marseille","3-0",3,0,"1",1,3,3,"H"
"4644",1956-01-01,1955,"AS Saint-Etienne","Lille OSC","4-1",4,1,"1",1,5,3,"H"
"4645",1956-01-01,1955,"FC Sochaux","UA Sedan-Torcy","0-2",0,2,"1",1,2,-2,"D"
"4646",1956-01-01,1955,"Racing Club de France","FC Metz","1-2",1,2,"1",1,3,-1,"D"
"4647",1956-01-01,1955,"AS Nancy","AS Troyes-Savinienne","1-0",1,0,"1",1,1,1,"H"
"4648",1956-01-15,1955,"OGC Nice","FC Sochaux","1-2",1,2,"1",1,3,-1,"D"
"4649",1956-01-15,1955,"Girondins Bordeaux","Stade Reims","2-3",2,3,"1",1,5,-1,"D"
"4650",1956-01-15,1955,"FC Metz","RC Lens","2-3",2,3,"1",1,5,-1,"D"
"4651",1956-01-15,1955,"UA Sedan-Torcy","AS Nancy","1-0",1,0,"1",1,1,1,"H"
"4652",1956-01-15,1955,"AS Troyes-Savinienne","Racing Club de France","0-2",0,2,"1",1,2,-2,"D"
"4653",1956-01-15,1955,"Olympique Marseille","AS Saint-Etienne","2-2",2,2,"1",1,4,0,"D"
"4654",1956-01-15,1955,"Lille OSC","Olympique Lyon","4-1",4,1,"1",1,5,3,"H"
"4655",1956-01-15,1955,"Nimes Olympique","AS Monaco","6-2",6,2,"1",1,8,4,"H"
"4656",1956-01-15,1955,"RC Strasbourg","Toulouse FC","1-2",1,2,"1",1,3,-1,"D"
"4657",1956-01-22,1955,"OGC Nice","Nimes Olympique","2-1",2,1,"1",1,3,1,"H"
"4658",1956-01-22,1955,"FC Sochaux","Stade Reims","4-3",4,3,"1",1,7,1,"H"
"4659",1956-01-22,1955,"AS Nancy","RC Lens","1-0",1,0,"1",1,1,1,"H"
"4660",1956-01-22,1955,"UA Sedan-Torcy","Girondins Bordeaux","1-1",1,1,"1",1,2,0,"D"
"4661",1956-01-22,1955,"Olympique Lyon","AS Saint-Etienne","2-1",2,1,"1",1,3,1,"H"
"4662",1956-01-22,1955,"Lille OSC","Racing Club de France","6-1",6,1,"1",1,7,5,"H"
"4663",1956-01-22,1955,"Toulouse FC","AS Monaco","3-1",3,1,"1",1,4,2,"H"
"4664",1956-01-22,1955,"RC Strasbourg","Olympique Marseille","5-0",5,0,"1",1,5,5,"H"
"4665",1956-01-22,1955,"AS Troyes-Savinienne","FC Metz","1-1",1,1,"1",1,2,0,"D"
"4666",1956-01-29,1955,"Olympique Marseille","OGC Nice","0-0",0,0,"1",1,0,0,"D"
"4667",1956-01-29,1955,"RC Lens","FC Sochaux","2-1",2,1,"1",1,3,1,"H"
"4668",1956-01-29,1955,"Stade Reims","Toulouse FC","0-1",0,1,"1",1,1,-1,"D"
"4669",1956-01-29,1955,"AS Saint-Etienne","RC Strasbourg","3-1",3,1,"1",1,4,2,"H"
"4670",1956-01-29,1955,"Nimes Olympique","UA Sedan-Torcy","6-2",6,2,"1",1,8,4,"H"
"4671",1956-01-29,1955,"AS Monaco","Olympique Lyon","2-1",2,1,"1",1,3,1,"H"
"4672",1956-01-29,1955,"Racing Club de France","AS Nancy","3-4",3,4,"1",1,7,-1,"D"
"4673",1956-01-29,1955,"FC Metz","Lille OSC","2-0",2,0,"1",1,2,2,"H"
"4674",1956-01-29,1955,"Girondins Bordeaux","AS Troyes-Savinienne","2-2",2,2,"1",1,4,0,"D"
"4675",1956-02-12,1955,"AS Troyes-Savinienne","OGC Nice","2-2",2,2,"1",1,4,0,"D"
"4676",1956-02-12,1955,"RC Lens","Stade Reims","4-1",4,1,"1",1,5,3,"H"
"4677",1956-02-12,1955,"Olympique Lyon","Girondins Bordeaux","5-2",5,2,"1",1,7,3,"H"
"4678",1956-02-12,1955,"AS Nancy","AS Saint-Etienne","2-2",2,2,"1",1,4,0,"D"
"4679",1956-02-12,1955,"UA Sedan-Torcy","Lille OSC","2-1",2,1,"1",1,3,1,"H"
"4680",1956-02-12,1955,"AS Monaco","Racing Club de France","0-0",0,0,"1",1,0,0,"D"
"4681",1956-02-12,1955,"Toulouse FC","Nimes Olympique","2-2",2,2,"1",1,4,0,"D"
"4682",1956-02-12,1955,"FC Sochaux","Olympique Marseille","3-1",3,1,"1",1,4,2,"H"
"4683",1956-02-12,1955,"RC Strasbourg","FC Metz","3-1",3,1,"1",1,4,2,"H"
"4684",1956-03-11,1955,"OGC Nice","UA Sedan-Torcy","3-2",3,2,"1",1,5,1,"H"
"4685",1956-03-11,1955,"RC Lens","AS Monaco","1-2",1,2,"1",1,3,-1,"D"
"4686",1956-03-11,1955,"Olympique Lyon","FC Metz","2-1",2,1,"1",1,3,1,"H"
"4687",1956-03-11,1955,"Stade Reims","Lille OSC","1-1",1,1,"1",1,2,0,"D"
"4688",1956-03-11,1955,"Toulouse FC","Girondins Bordeaux","2-1",2,1,"1",1,3,1,"H"
"4689",1956-03-11,1955,"Racing Club de France","AS Saint-Etienne","3-0",3,0,"1",1,3,3,"H"
"4690",1956-03-11,1955,"Nimes Olympique","FC Sochaux","1-0",1,0,"1",1,1,1,"H"
"4691",1956-03-11,1955,"RC Strasbourg","AS Troyes-Savinienne","2-1",2,1,"1",1,3,1,"H"
"4692",1956-03-11,1955,"AS Nancy","Olympique Marseille","0-0",0,0,"1",1,0,0,"D"
"4693",1956-03-18,1955,"Lille OSC","OGC Nice","2-1",2,1,"1",1,3,1,"H"
"4694",1956-03-18,1955,"AS Troyes-Savinienne","Olympique Lyon","1-3",1,3,"1",1,4,-2,"D"
"4695",1956-03-18,1955,"AS Saint-Etienne","RC Lens","0-0",0,0,"1",1,0,0,"D"
"4696",1956-03-18,1955,"AS Monaco","Stade Reims","2-1",2,1,"1",1,3,1,"H"
"4697",1956-03-18,1955,"Olympique Marseille","Racing Club de France","1-4",1,4,"1",1,5,-3,"D"
"4698",1956-03-18,1955,"FC Metz","Toulouse FC","1-0",1,0,"1",1,1,1,"H"
"4699",1956-03-18,1955,"UA Sedan-Torcy","RC Strasbourg","5-2",5,2,"1",1,7,3,"H"
"4700",1956-03-18,1955,"Girondins Bordeaux","FC Sochaux","0-1",0,1,"1",1,1,-1,"D"
"4701",1956-03-18,1955,"Nimes Olympique","AS Nancy","6-1",6,1,"1",1,7,5,"H"
"4702",1956-04-02,1955,"OGC Nice","Olympique Lyon","2-0",2,0,"1",1,2,2,"H"
"4703",1956-04-02,1955,"Nimes Olympique","RC Lens","3-1",3,1,"1",1,4,2,"H"
"4704",1956-04-02,1955,"Girondins Bordeaux","Racing Club de France","1-4",1,4,"1",1,5,-3,"D"
"4705",1956-04-02,1955,"AS Saint-Etienne","AS Monaco","1-0",1,0,"1",1,1,1,"H"
"4706",1956-04-02,1955,"UA Sedan-Torcy","Toulouse FC","1-1",1,1,"1",1,2,0,"D"
"4707",1956-04-02,1955,"Olympique Marseille","Stade Reims","1-0",1,0,"1",1,1,1,"H"
"4708",1956-04-02,1955,"AS Troyes-Savinienne","FC Sochaux","1-1",1,1,"1",1,2,0,"D"
"4709",1956-04-02,1955,"FC Metz","AS Nancy","2-0",2,0,"1",1,2,2,"H"
"4710",1956-04-02,1955,"Lille OSC","RC Strasbourg","4-0",4,0,"1",1,4,4,"H"
"4711",1956-04-15,1955,"RC Strasbourg","OGC Nice","1-0",1,0,"1",1,1,1,"H"
"4712",1956-04-15,1955,"RC Lens","Olympique Marseille","4-0",4,0,"1",1,4,4,"H"
"4713",1956-04-15,1955,"Racing Club de France","Nimes Olympique","3-2",3,2,"1",1,5,1,"H"
"4714",1956-04-15,1955,"Olympique Lyon","UA Sedan-Torcy","0-0",0,0,"1",1,0,0,"D"
"4715",1956-04-15,1955,"AS Monaco","Lille OSC","2-0",2,0,"1",1,2,2,"H"
"4716",1956-04-15,1955,"Stade Reims","AS Saint-Etienne","1-2",1,2,"1",1,3,-1,"D"
"4717",1956-04-15,1955,"Toulouse FC","AS Troyes-Savinienne","2-1",2,1,"1",1,3,1,"H"
"4718",1956-04-15,1955,"AS Nancy","Girondins Bordeaux","1-0",1,0,"1",1,1,1,"H"
"4719",1956-04-15,1955,"FC Sochaux","FC Metz","0-1",0,1,"1",1,1,-1,"D"
"4720",1956-04-22,1955,"OGC Nice","AS Monaco","1-1",1,1,"1",1,2,0,"D"
"4721",1956-04-22,1955,"RC Lens","Olympique Lyon","1-0",1,0,"1",1,1,1,"H"
"4722",1956-04-22,1955,"Racing Club de France","Toulouse FC","3-0",3,0,"1",1,3,3,"H"
"4723",1956-04-22,1955,"AS Saint-Etienne","UA Sedan-Torcy","3-2",3,2,"1",1,5,1,"H"
"4724",1956-04-22,1955,"Stade Reims","RC Strasbourg","6-2",6,2,"1",1,8,4,"H"
"4725",1956-04-22,1955,"AS Nancy","FC Sochaux","0-1",0,1,"1",1,1,-1,"D"
"4726",1956-04-22,1955,"Olympique Marseille","AS Troyes-Savinienne","3-0",3,0,"1",1,3,3,"H"
"4727",1956-04-22,1955,"Nimes Olympique","FC Metz","0-0",0,0,"1",1,0,0,"D"
"4728",1956-04-22,1955,"Girondins Bordeaux","Lille OSC","2-1",2,1,"1",1,3,1,"H"
"4729",1956-04-29,1955,"OGC Nice","Stade Reims","1-0",1,0,"1",1,1,1,"H"
"4730",1956-04-29,1955,"RC Strasbourg","RC Lens","1-0",1,0,"1",1,1,1,"H"
"4731",1956-04-29,1955,"Olympique Lyon","Racing Club de France","3-1",3,1,"1",1,4,2,"H"
"4732",1956-04-29,1955,"AS Troyes-Savinienne","AS Saint-Etienne","1-1",1,1,"1",1,2,0,"D"
"4733",1956-04-29,1955,"UA Sedan-Torcy","AS Monaco","2-1",2,1,"1",1,3,1,"H"
"4734",1956-04-29,1955,"Toulouse FC","AS Nancy","1-0",1,0,"1",1,1,1,"H"
"4735",1956-04-29,1955,"Lille OSC","FC Sochaux","1-2",1,2,"1",1,3,-1,"D"
"4736",1956-04-29,1955,"FC Metz","Olympique Marseille","2-3",2,3,"1",1,5,-1,"D"
"4737",1956-04-29,1955,"Girondins Bordeaux","Nimes Olympique","2-1",2,1,"1",1,3,1,"H"
"4738",1956-05-01,1955,"OGC Nice","Racing Club de France","2-0",2,0,"1",1,2,2,"H"
"4739",1956-05-01,1955,"Olympique Lyon","FC Sochaux","3-1",3,1,"1",1,4,2,"H"
"4740",1956-05-01,1955,"UA Sedan-Torcy","RC Lens","1-0",1,0,"1",1,1,1,"H"
"4741",1956-05-01,1955,"FC Metz","AS Monaco","1-2",1,2,"1",1,3,-1,"D"
"4742",1956-05-01,1955,"Girondins Bordeaux","AS Saint-Etienne","4-3",4,3,"1",1,7,1,"H"
"4743",1956-05-01,1955,"Lille OSC","Toulouse FC","1-2",1,2,"1",1,3,-1,"D"
"4744",1956-05-01,1955,"AS Troyes-Savinienne","Stade Reims","2-3",2,3,"1",1,5,-1,"D"
"4745",1956-05-01,1955,"Nimes Olympique","Olympique Marseille","1-1",1,1,"1",1,2,0,"D"
"4746",1956-05-01,1955,"RC Strasbourg","AS Nancy","4-0",4,0,"1",1,4,4,"H"
"4747",1956-05-10,1955,"RC Lens","OGC Nice","4-0",4,0,"1",1,4,4,"H"
"4748",1956-05-10,1955,"AS Saint-Etienne","FC Metz","5-0",5,0,"1",1,5,5,"H"
"4749",1956-05-10,1955,"AS Nancy","Olympique Lyon","2-0",2,0,"1",1,2,2,"H"
"4750",1956-05-10,1955,"Stade Reims","UA Sedan-Torcy","1-1",1,1,"1",1,2,0,"D"
"4751",1956-05-10,1955,"Racing Club de France","RC Strasbourg","2-2",2,2,"1",1,4,0,"D"
"4752",1956-05-10,1955,"AS Monaco","AS Troyes-Savinienne","1-1",1,1,"1",1,2,0,"D"
"4753",1956-05-10,1955,"FC Sochaux","Toulouse FC","0-0",0,0,"1",1,0,0,"D"
"4754",1956-05-10,1955,"Olympique Marseille","Girondins Bordeaux","3-0",3,0,"1",1,3,3,"H"
"4755",1956-05-10,1955,"Nimes Olympique","Lille OSC","2-0",2,0,"1",1,2,2,"H"
"4756",1956-05-13,1955,"OGC Nice","FC Metz","1-0",1,0,"1",1,1,1,"H"
"4757",1956-05-13,1955,"FC Sochaux","AS Saint-Etienne","2-3",2,3,"1",1,5,-1,"D"
"4758",1956-05-13,1955,"Lille OSC","RC Lens","1-1",1,1,"1",1,2,0,"D"
"4759",1956-05-13,1955,"Racing Club de France","Stade Reims","2-1",2,1,"1",1,3,1,"H"
"4760",1956-05-13,1955,"AS Nancy","AS Monaco","1-3",1,3,"1",1,4,-2,"D"
"4761",1956-05-13,1955,"Olympique Lyon","Nimes Olympique","0-0",0,0,"1",1,0,0,"D"
"4762",1956-05-13,1955,"UA Sedan-Torcy","AS Troyes-Savinienne","1-3",1,3,"1",1,4,-2,"D"
"4763",1956-05-13,1955,"Toulouse FC","Olympique Marseille","2-3",2,3,"1",1,5,-1,"D"
"4764",1956-05-13,1955,"RC Strasbourg","Girondins Bordeaux","1-1",1,1,"1",1,2,0,"D"
"4765",1956-05-20,1955,"Girondins Bordeaux","OGC Nice","1-2",1,2,"1",1,3,-1,"D"
"4766",1956-05-20,1955,"RC Lens","Racing Club de France","7-3",7,3,"1",1,10,4,"H"
"4767",1956-05-20,1955,"AS Monaco","FC Sochaux","4-0",4,0,"1",1,4,4,"H"
"4768",1956-05-20,1955,"AS Saint-Etienne","Toulouse FC","0-0",0,0,"1",1,0,0,"D"
"4769",1956-05-20,1955,"Olympique Marseille","Olympique Lyon","5-1",5,1,"1",1,6,4,"H"
"4770",1956-05-20,1955,"FC Metz","UA Sedan-Torcy","3-1",3,1,"1",1,4,2,"H"
"4771",1956-05-20,1955,"Stade Reims","AS Nancy","1-2",1,2,"1",1,3,-1,"D"
"4772",1956-05-20,1955,"Nimes Olympique","RC Strasbourg","4-0",4,0,"1",1,4,4,"H"
"4773",1956-05-20,1955,"AS Troyes-Savinienne","Lille OSC","1-6",1,6,"1",1,7,-5,"D"
"4774",1956-06-03,1955,"AS Nancy","OGC Nice","2-0",2,0,"1",1,2,2,"H"
"4775",1956-06-03,1955,"RC Lens","AS Troyes-Savinienne","3-1",3,1,"1",1,4,2,"H"
"4776",1956-06-03,1955,"AS Monaco","Girondins Bordeaux","4-2",4,2,"1",1,6,2,"H"
"4777",1956-06-03,1955,"AS Saint-Etienne","Nimes Olympique","3-1",3,1,"1",1,4,2,"H"
"4778",1956-06-03,1955,"Racing Club de France","UA Sedan-Torcy","4-0",4,0,"1",1,4,4,"H"
"4779",1956-06-03,1955,"Olympique Marseille","Lille OSC","2-1",2,1,"1",1,3,1,"H"
"4780",1956-06-03,1955,"Toulouse FC","Olympique Lyon","2-1",2,1,"1",1,3,1,"H"
"4781",1956-06-03,1955,"Stade Reims","FC Metz","5-2",5,2,"1",1,7,3,"H"
"4782",1956-06-03,1955,"FC Sochaux","RC Strasbourg","2-2",2,2,"1",1,4,0,"D"
"4783",1956-08-19,1956,"FC Metz","RC Lens","1-5",1,5,"1",1,6,-4,"D"
"4784",1956-08-19,1956,"FC Sochaux","Stade Reims","2-0",2,0,"1",1,2,2,"H"
"4785",1956-08-19,1956,"RC Strasbourg","Stade Rennes","2-0",2,0,"1",1,2,2,"H"
"4786",1956-08-19,1956,"Olympique Marseille","AS Monaco","2-0",2,0,"1",1,2,2,"H"
"4787",1956-08-19,1956,"Toulouse FC","Racing Club de France","3-3",3,3,"1",1,6,0,"D"
"4788",1956-08-19,1956,"OGC Nice","AS Saint-Etienne","2-2",2,2,"1",1,4,0,"D"
"4789",1956-08-19,1956,"Angers SCO","Nimes Olympique","1-1",1,1,"1",1,2,0,"D"
"4790",1956-08-19,1956,"Olympique Lyon","UA Sedan-Torcy","1-1",1,1,"1",1,2,0,"D"
"4791",1956-08-19,1956,"US Valenciennes-Anzin","AS Nancy","0-0",0,0,"1",1,0,0,"D"
"4792",1956-08-26,1956,"RC Lens","RC Strasbourg","0-2",0,2,"1",1,2,-2,"D"
"4793",1956-08-26,1956,"Racing Club de France","Angers SCO","6-2",6,2,"1",1,8,4,"H"
"4794",1956-08-26,1956,"AS Saint-Etienne","Olympique Marseille","6-3",6,3,"1",1,9,3,"H"
"4795",1956-08-26,1956,"Nimes Olympique","Toulouse FC","0-1",0,1,"1",1,1,-1,"D"
"4796",1956-08-26,1956,"UA Sedan-Torcy","FC Sochaux","1-0",1,0,"1",1,1,1,"H"
"4797",1956-08-26,1956,"Stade Rennes","US Valenciennes-Anzin","3-0",3,0,"1",1,3,3,"H"
"4798",1956-08-26,1956,"Stade Reims","OGC Nice","3-1",3,1,"1",1,4,2,"H"
"4799",1956-08-26,1956,"AS Nancy","Olympique Lyon","2-2",2,2,"1",1,4,0,"D"
"4800",1956-08-26,1956,"AS Monaco","FC Metz","2-1",2,1,"1",1,3,1,"H"
"4801",1956-09-02,1956,"AS Saint-Etienne","RC Lens","3-1",3,1,"1",1,4,2,"H"
"4802",1956-09-02,1956,"Toulouse FC","UA Sedan-Torcy","2-3",2,3,"1",1,5,-1,"D"
"4803",1956-09-02,1956,"FC Metz","Racing Club de France","2-2",2,2,"1",1,4,0,"D"
"4804",1956-09-02,1956,"Stade Reims","AS Monaco","5-1",5,1,"1",1,6,4,"H"
"4805",1956-09-02,1956,"US Valenciennes-Anzin","Olympique Lyon","1-2",1,2,"1",1,3,-1,"D"
"4806",1956-09-02,1956,"Olympique Marseille","Stade Rennes","1-0",1,0,"1",1,1,1,"H"
"4807",1956-09-02,1956,"RC Strasbourg","Nimes Olympique","0-4",0,4,"1",1,4,-4,"D"
"4808",1956-09-02,1956,"OGC Nice","FC Sochaux","4-2",4,2,"1",1,6,2,"H"
"4809",1956-09-02,1956,"Angers SCO","AS Nancy","3-0",3,0,"1",1,3,3,"H"
"4810",1956-09-09,1956,"AS Nancy","AS Saint-Etienne","1-7",1,7,"1",1,8,-6,"D"
"4811",1956-09-09,1956,"Olympique Lyon","Stade Reims","0-3",0,3,"1",1,3,-3,"D"
"4812",1956-09-09,1956,"RC Strasbourg","US Valenciennes-Anzin","6-0",6,0,"1",1,6,6,"H"
"4813",1956-09-09,1956,"UA Sedan-Torcy","Olympique Marseille","1-1",1,1,"1",1,2,0,"D"
"4814",1956-09-09,1956,"Nimes Olympique","AS Monaco","3-1",3,1,"1",1,4,2,"H"
"4815",1956-09-09,1956,"Stade Rennes","Racing Club de France","2-2",2,2,"1",1,4,0,"D"
"4816",1956-09-09,1956,"RC Lens","OGC Nice","6-1",6,1,"1",1,7,5,"H"
"4817",1956-09-09,1956,"FC Sochaux","Angers SCO","0-0",0,0,"1",1,0,0,"D"
"4818",1956-09-09,1956,"Toulouse FC","FC Metz","1-2",1,2,"1",1,3,-1,"D"
"4819",1956-09-16,1956,"UA Sedan-Torcy","AS Saint-Etienne","2-6",2,6,"1",1,8,-4,"D"
"4820",1956-09-16,1956,"Stade Reims","Nimes Olympique","2-0",2,0,"1",1,2,2,"H"
"4821",1956-09-16,1956,"Racing Club de France","RC Lens","5-0",5,0,"1",1,5,5,"H"
"4822",1956-09-16,1956,"Olympique Marseille","OGC Nice","3-1",3,1,"1",1,4,2,"H"
"4823",1956-09-16,1956,"Olympique Lyon","RC Strasbourg","3-1",3,1,"1",1,4,2,"H"
"4824",1956-09-16,1956,"Angers SCO","Stade Rennes","2-0",2,0,"1",1,2,2,"H"
"4825",1956-09-16,1956,"FC Metz","FC Sochaux","1-3",1,3,"1",1,4,-2,"D"
"4826",1956-09-16,1956,"AS Monaco","AS Nancy","0-2",0,2,"1",1,2,-2,"D"
"4827",1956-09-16,1956,"US Valenciennes-Anzin","Toulouse FC","1-0",1,0,"1",1,1,1,"H"
"4828",1956-09-23,1956,"AS Saint-Etienne","FC Metz","2-0",2,0,"1",1,2,2,"H"
"4829",1956-09-23,1956,"UA Sedan-Torcy","Stade Reims","0-4",0,4,"1",1,4,-4,"D"
"4830",1956-09-23,1956,"OGC Nice","Racing Club de France","1-1",1,1,"1",1,2,0,"D"
"4831",1956-09-23,1956,"US Valenciennes-Anzin","Olympique Marseille","2-2",2,2,"1",1,4,0,"D"
"4832",1956-09-23,1956,"Angers SCO","Olympique Lyon","0-2",0,2,"1",1,2,-2,"D"
"4833",1956-09-23,1956,"AS Nancy","RC Strasbourg","3-3",3,3,"1",1,6,0,"D"
"4834",1956-09-23,1956,"Nimes Olympique","Stade Rennes","2-1",2,1,"1",1,3,1,"H"
"4835",1956-09-23,1956,"FC Sochaux","RC Lens","2-2",2,2,"1",1,4,0,"D"
"4836",1956-09-23,1956,"Toulouse FC","AS Monaco","3-0",3,0,"1",1,3,3,"H"
"4837",1956-09-30,1956,"Stade Reims","AS Saint-Etienne","4-5",4,5,"1",1,9,-1,"D"
"4838",1956-09-30,1956,"Racing Club de France","AS Nancy","6-1",6,1,"1",1,7,5,"H"
"4839",1956-09-30,1956,"Olympique Lyon","Nimes Olympique","4-1",4,1,"1",1,5,3,"H"
"4840",1956-09-30,1956,"RC Strasbourg","Toulouse FC","0-0",0,0,"1",1,0,0,"D"
"4841",1956-09-30,1956,"Olympique Marseille","FC Sochaux","2-3",2,3,"1",1,5,-1,"D"
"4842",1956-09-30,1956,"FC Metz","Angers SCO","0-1",0,1,"1",1,1,-1,"D"
"4843",1956-09-30,1956,"Stade Rennes","OGC Nice","2-3",2,3,"1",1,5,-1,"D"
"4844",1956-09-30,1956,"AS Monaco","US Valenciennes-Anzin","6-0",6,0,"1",1,6,6,"H"
"4845",1956-10-14,1956,"AS Saint-Etienne","Angers SCO","3-0",3,0,"1",1,3,3,"H"
"4846",1956-10-14,1956,"US Valenciennes-Anzin","Racing Club de France","3-1",3,1,"1",1,4,2,"H"
"4847",1956-10-14,1956,"Toulouse FC","Stade Reims","4-0",4,0,"1",1,4,4,"H"
"4848",1956-10-14,1956,"OGC Nice","Olympique Lyon","1-0",1,0,"1",1,1,1,"H"
"4849",1956-10-14,1956,"FC Sochaux","AS Monaco","1-1",1,1,"1",1,2,0,"D"
"4850",1956-10-14,1956,"Olympique Marseille","FC Metz","3-3",3,3,"1",1,6,0,"D"
"4851",1956-10-14,1956,"UA Sedan-Torcy","RC Strasbourg","3-1",3,1,"1",1,4,2,"H"
"4852",1956-10-14,1956,"Stade Rennes","RC Lens","1-4",1,4,"1",1,5,-3,"D"
"4853",1956-10-14,1956,"AS Nancy","Nimes Olympique","1-0",1,0,"1",1,1,1,"H"
"4854",1956-10-28,1956,"Olympique Lyon","AS Saint-Etienne","1-3",1,3,"1",1,4,-2,"D"
"4855",1956-10-28,1956,"Racing Club de France","RC Strasbourg","2-0",2,0,"1",1,2,2,"H"
"4856",1956-10-28,1956,"Stade Reims","AS Nancy","4-1",4,1,"1",1,5,3,"H"
"4857",1956-10-28,1956,"FC Sochaux","Stade Rennes","3-1",3,1,"1",1,4,2,"H"
"4858",1956-10-28,1956,"Angers SCO","Toulouse FC","2-5",2,5,"1",1,7,-3,"D"
"4859",1956-10-28,1956,"Nimes Olympique","Olympique Marseille","2-0",2,0,"1",1,2,2,"H"
"4860",1956-10-28,1956,"RC Lens","US Valenciennes-Anzin","0-0",0,0,"1",1,0,0,"D"
"4861",1956-10-28,1956,"AS Monaco","OGC Nice","2-1",2,1,"1",1,3,1,"H"
"4862",1956-10-28,1956,"FC Metz","UA Sedan-Torcy","3-1",3,1,"1",1,4,2,"H"
"4863",1956-11-01,1956,"RC Lens","UA Sedan-Torcy","1-0",1,0,"1",1,1,1,"H"
"4864",1956-11-04,1956,"Racing Club de France","AS Saint-Etienne","1-2",1,2,"1",1,3,-1,"D"
"4865",1956-11-04,1956,"Stade Reims","Olympique Marseille","1-1",1,1,"1",1,2,0,"D"
"4866",1956-11-04,1956,"AS Nancy","FC Sochaux","1-3",1,3,"1",1,4,-2,"D"
"4867",1956-11-04,1956,"Olympique Lyon","Toulouse FC","1-3",1,3,"1",1,4,-2,"D"
"4868",1956-11-04,1956,"RC Lens","AS Monaco","3-1",3,1,"1",1,4,2,"H"
"4869",1956-11-04,1956,"Nimes Olympique","UA Sedan-Torcy","2-1",2,1,"1",1,3,1,"H"
"4870",1956-11-04,1956,"RC Strasbourg","Angers SCO","0-2",0,2,"1",1,2,-2,"D"
"4871",1956-11-04,1956,"OGC Nice","US Valenciennes-Anzin","2-2",2,2,"1",1,4,0,"D"
"4872",1956-11-04,1956,"Stade Rennes","FC Metz","1-0",1,0,"1",1,1,1,"H"
"4873",1956-11-18,1956,"AS Saint-Etienne","RC Strasbourg","2-2",2,2,"1",1,4,0,"D"
"4874",1956-11-18,1956,"Toulouse FC","Stade Rennes","6-0",6,0,"1",1,6,6,"H"
"4875",1956-11-18,1956,"FC Sochaux","Racing Club de France","3-5",3,5,"1",1,8,-2,"D"
"4876",1956-11-18,1956,"Angers SCO","Stade Reims","2-2",2,2,"1",1,4,0,"D"
"4877",1956-11-18,1956,"Olympique Marseille","RC Lens","1-4",1,4,"1",1,5,-3,"D"
"4878",1956-11-18,1956,"US Valenciennes-Anzin","Nimes Olympique","0-0",0,0,"1",1,0,0,"D"
"4879",1956-11-18,1956,"FC Metz","OGC Nice","3-3",3,3,"1",1,6,0,"D"
"4880",1956-11-18,1956,"UA Sedan-Torcy","AS Nancy","1-1",1,1,"1",1,2,0,"D"
"4881",1956-11-19,1956,"AS Monaco","Olympique Lyon","2-0",2,0,"1",1,2,2,"H"
"4882",1956-11-25,1956,"AS Saint-Etienne","FC Sochaux","6-0",6,0,"1",1,6,6,"H"
"4883",1956-11-25,1956,"RC Lens","Olympique Lyon","3-1",3,1,"1",1,4,2,"H"
"4884",1956-11-25,1956,"AS Nancy","Toulouse FC","1-1",1,1,"1",1,2,0,"D"
"4885",1956-11-25,1956,"Stade Reims","US Valenciennes-Anzin","1-1",1,1,"1",1,2,0,"D"
"4886",1956-11-25,1956,"Racing Club de France","Olympique Marseille","1-3",1,3,"1",1,4,-2,"D"
"4887",1956-11-25,1956,"Nimes Olympique","FC Metz","1-1",1,1,"1",1,2,0,"D"
"4888",1956-11-25,1956,"OGC Nice","Angers SCO","1-1",1,1,"1",1,2,0,"D"
"4889",1956-11-25,1956,"RC Strasbourg","AS Monaco","2-4",2,4,"1",1,6,-2,"D"
"4890",1956-11-25,1956,"Stade Rennes","UA Sedan-Torcy","2-0",2,0,"1",1,2,2,"H"
"4891",1956-12-02,1956,"Stade Rennes","AS Saint-Etienne","1-0",1,0,"1",1,1,1,"H"
"4892",1956-12-02,1956,"AS Nancy","RC Lens","0-2",0,2,"1",1,2,-2,"D"
"4893",1956-12-02,1956,"RC Strasbourg","Stade Reims","1-3",1,3,"1",1,4,-2,"D"
"4894",1956-12-02,1956,"Toulouse FC","Olympique Marseille","0-1",0,1,"1",1,1,-1,"D"
"4895",1956-12-02,1956,"Nimes Olympique","Racing Club de France","4-2",4,2,"1",1,6,2,"H"
"4896",1956-12-02,1956,"US Valenciennes-Anzin","FC Sochaux","3-1",3,1,"1",1,4,2,"H"
"4897",1956-12-02,1956,"AS Monaco","Angers SCO","1-1",1,1,"1",1,2,0,"D"
"4898",1956-12-02,1956,"Olympique Lyon","FC Metz","1-0",1,0,"1",1,1,1,"H"
"4899",1956-12-02,1956,"UA Sedan-Torcy","OGC Nice","3-3",3,3,"1",1,6,0,"D"
"4900",1956-12-09,1956,"AS Saint-Etienne","AS Monaco","0-1",0,1,"1",1,1,-1,"D"
"4901",1956-12-09,1956,"RC Lens","Nimes Olympique","4-0",4,0,"1",1,4,4,"H"
"4902",1956-12-09,1956,"Stade Reims","Stade Rennes","3-1",3,1,"1",1,4,2,"H"
"4903",1956-12-09,1956,"Olympique Marseille","Olympique Lyon","3-2",3,2,"1",1,5,1,"H"
"4904",1956-12-09,1956,"OGC Nice","Toulouse FC","1-0",1,0,"1",1,1,1,"H"
"4905",1956-12-09,1956,"FC Sochaux","RC Strasbourg","6-0",6,0,"1",1,6,6,"H"
"4906",1956-12-09,1956,"Angers SCO","US Valenciennes-Anzin","2-0",2,0,"1",1,2,2,"H"
"4907",1956-12-09,1956,"Racing Club de France","UA Sedan-Torcy","1-2",1,2,"1",1,3,-1,"D"
"4908",1956-12-09,1956,"FC Metz","AS Nancy","1-1",1,1,"1",1,2,0,"D"
"4909",1956-12-16,1956,"US Valenciennes-Anzin","AS Saint-Etienne","1-1",1,1,"1",1,2,0,"D"
"4910",1956-12-16,1956,"RC Lens","Toulouse FC","4-1",4,1,"1",1,5,3,"H"
"4911",1956-12-16,1956,"Stade Reims","Racing Club de France","2-4",2,4,"1",1,6,-2,"D"
"4912",1956-12-16,1956,"Olympique Lyon","FC Sochaux","0-1",0,1,"1",1,1,-1,"D"
"4913",1956-12-16,1956,"Nimes Olympique","OGC Nice","3-2",3,2,"1",1,5,1,"H"
"4914",1956-12-16,1956,"Angers SCO","Olympique Marseille","2-2",2,2,"1",1,4,0,"D"
"4915",1956-12-16,1956,"AS Monaco","UA Sedan-Torcy","2-1",2,1,"1",1,3,1,"H"
"4916",1956-12-16,1956,"AS Nancy","Stade Rennes","4-0",4,0,"1",1,4,4,"H"
"4917",1956-12-16,1956,"RC Strasbourg","FC Metz","1-0",1,0,"1",1,1,1,"H"
"4918",1956-12-23,1956,"AS Saint-Etienne","Toulouse FC","0-0",0,0,"1",1,0,0,"D"
"4919",1956-12-23,1956,"RC Lens","Angers SCO","0-3",0,3,"1",1,3,-3,"D"
"4920",1956-12-23,1956,"FC Metz","Stade Reims","2-5",2,5,"1",1,7,-3,"D"
"4921",1956-12-23,1956,"FC Sochaux","Nimes Olympique","3-1",3,1,"1",1,4,2,"H"
"4922",1956-12-23,1956,"Olympique Marseille","RC Strasbourg","3-1",3,1,"1",1,4,2,"H"
"4923",1956-12-23,1956,"Racing Club de France","AS Monaco","2-1",2,1,"1",1,3,1,"H"
"4924",1956-12-23,1956,"OGC Nice","AS Nancy","3-2",3,2,"1",1,5,1,"H"
"4925",1956-12-23,1956,"UA Sedan-Torcy","US Valenciennes-Anzin","3-0",3,0,"1",1,3,3,"H"
"4926",1956-12-23,1956,"Stade Rennes","Olympique Lyon","2-1",2,1,"1",1,3,1,"H"
"4927",1956-12-25,1956,"AS Saint-Etienne","Nimes Olympique","4-0",4,0,"1",1,4,4,"H"
"4928",1956-12-25,1956,"RC Lens","Stade Reims","2-1",2,1,"1",1,3,1,"H"
"4929",1956-12-25,1956,"Olympique Marseille","AS Nancy","3-1",3,1,"1",1,4,2,"H"
"4930",1956-12-25,1956,"FC Sochaux","Toulouse FC","1-3",1,3,"1",1,4,-2,"D"
"4931",1956-12-25,1956,"UA Sedan-Torcy","Angers SCO","1-1",1,1,"1",1,2,0,"D"
"4932",1956-12-25,1956,"Racing Club de France","Olympique Lyon","1-2",1,2,"1",1,3,-1,"D"
"4933",1956-12-25,1956,"Stade Rennes","AS Monaco","0-1",0,1,"1",1,1,-1,"D"
"4934",1956-12-25,1956,"OGC Nice","RC Strasbourg","1-0",1,0,"1",1,1,1,"H"
"4935",1956-12-25,1956,"FC Metz","US Valenciennes-Anzin","2-2",2,2,"1",1,4,0,"D"
"4936",1956-12-30,1956,"Toulouse FC","AS Saint-Etienne","3-0",3,0,"1",1,3,3,"H"
"4937",1956-12-30,1956,"Angers SCO","RC Lens","1-0",1,0,"1",1,1,1,"H"
"4938",1956-12-30,1956,"Stade Reims","FC Metz","2-1",2,1,"1",1,3,1,"H"
"4939",1956-12-30,1956,"AS Monaco","Olympique Marseille","1-0",1,0,"1",1,1,1,"H"
"4940",1956-12-30,1956,"AS Nancy","Racing Club de France","2-5",2,5,"1",1,7,-3,"D"
"4941",1956-12-30,1956,"Nimes Olympique","FC Sochaux","3-0",3,0,"1",1,3,3,"H"
"4942",1956-12-30,1956,"US Valenciennes-Anzin","OGC Nice","2-1",2,1,"1",1,3,1,"H"
"4943",1956-12-30,1956,"Olympique Lyon","Stade Rennes","2-0",2,0,"1",1,2,2,"H"
"4944",1956-12-30,1956,"RC Strasbourg","UA Sedan-Torcy","0-0",0,0,"1",1,0,0,"D"
"4945",1957-01-01,1956,"Nimes Olympique","AS Saint-Etienne","0-0",0,0,"1",1,0,0,"D"
"4946",1957-01-01,1956,"Stade Reims","RC Lens","3-2",3,2,"1",1,5,1,"H"
"4947",1957-01-01,1956,"Toulouse FC","FC Sochaux","2-0",2,0,"1",1,2,2,"H"
"4948",1957-01-01,1956,"AS Monaco","Stade Rennes","4-0",4,0,"1",1,4,4,"H"
"4949",1957-01-01,1956,"Olympique Lyon","Olympique Marseille","2-0",2,0,"1",1,2,2,"H"
"4950",1957-01-01,1956,"RC Strasbourg","Racing Club de France","2-1",2,1,"1",1,3,1,"H"
"4951",1957-01-01,1956,"US Valenciennes-Anzin","FC Metz","1-1",1,1,"1",1,2,0,"D"
"4952",1957-01-01,1956,"AS Nancy","UA Sedan-Torcy","3-2",3,2,"1",1,5,1,"H"
"4953",1957-01-06,1956,"AS Saint-Etienne","AS Nancy","6-1",6,1,"1",1,7,5,"H"
"4954",1957-01-06,1956,"Toulouse FC","RC Lens","1-2",1,2,"1",1,3,-1,"D"
"4955",1957-01-06,1956,"Racing Club de France","Stade Reims","4-2",4,2,"1",1,6,2,"H"
"4956",1957-01-06,1956,"FC Metz","AS Monaco","1-2",1,2,"1",1,3,-1,"D"
"4957",1957-01-06,1956,"Olympique Marseille","Angers SCO","0-0",0,0,"1",1,0,0,"D"
"4958",1957-01-06,1956,"FC Sochaux","US Valenciennes-Anzin","4-0",4,0,"1",1,4,4,"H"
"4959",1957-01-06,1956,"OGC Nice","Nimes Olympique","5-2",5,2,"1",1,7,3,"H"
"4960",1957-01-06,1956,"UA Sedan-Torcy","Olympique Lyon","2-2",2,2,"1",1,4,0,"D"
"4961",1957-01-06,1956,"Stade Rennes","RC Strasbourg","2-1",2,1,"1",1,3,1,"H"
"4962",1957-01-17,1956,"Angers SCO","OGC Nice","0-1",0,1,"1",1,1,-1,"D"
"4963",1957-01-20,1956,"RC Lens","AS Saint-Etienne","0-2",0,2,"1",1,2,-2,"D"
"4964",1957-01-20,1956,"Stade Reims","FC Sochaux","1-0",1,0,"1",1,1,1,"H"
"4965",1957-01-20,1956,"AS Monaco","Toulouse FC","1-1",1,1,"1",1,2,0,"D"
"4966",1957-01-20,1956,"Racing Club de France","Stade Rennes","3-0",3,0,"1",1,3,3,"H"
"4967",1957-01-20,1956,"Olympique Marseille","Nimes Olympique","3-1",3,1,"1",1,4,2,"H"
"4968",1957-01-20,1956,"Angers SCO","UA Sedan-Torcy","0-0",0,0,"1",1,0,0,"D"
"4969",1957-01-20,1956,"RC Strasbourg","OGC Nice","2-2",2,2,"1",1,4,0,"D"
"4970",1957-01-20,1956,"Olympique Lyon","US Valenciennes-Anzin","1-0",1,0,"1",1,1,1,"H"
"4971",1957-01-20,1956,"AS Nancy","FC Metz","0-2",0,2,"1",1,2,-2,"D"
"4972",1957-01-27,1956,"AS Saint-Etienne","Racing Club de France","3-1",3,1,"1",1,4,2,"H"
"4973",1957-01-27,1956,"US Valenciennes-Anzin","Stade Reims","1-5",1,5,"1",1,6,-4,"D"
"4974",1957-01-27,1956,"AS Monaco","RC Lens","1-2",1,2,"1",1,3,-1,"D"
"4975",1957-01-27,1956,"OGC Nice","Olympique Marseille","1-3",1,3,"1",1,4,-2,"D"
"4976",1957-01-27,1956,"Toulouse FC","Angers SCO","5-0",5,0,"1",1,5,5,"H"
"4977",1957-01-27,1956,"Nimes Olympique","Olympique Lyon","2-0",2,0,"1",1,2,2,"H"
"4978",1957-01-27,1956,"Stade Rennes","AS Nancy","0-3",0,3,"1",1,3,-3,"D"
"4979",1957-01-27,1956,"FC Metz","RC Strasbourg","2-0",2,0,"1",1,2,2,"H"
"4980",1957-02-10,1956,"AS Saint-Etienne","Olympique Lyon","3-2",3,2,"1",1,5,1,"H"
"4981",1957-02-10,1956,"Olympique Marseille","Stade Reims","1-2",1,2,"1",1,3,-1,"D"
"4982",1957-02-10,1956,"RC Lens","FC Sochaux","3-1",3,1,"1",1,4,2,"H"
"4983",1957-02-10,1956,"UA Sedan-Torcy","Stade Rennes","1-1",1,1,"1",1,2,0,"D"
"4984",1957-02-10,1956,"Toulouse FC","US Valenciennes-Anzin","4-0",4,0,"1",1,4,4,"H"
"4985",1957-02-10,1956,"Racing Club de France","FC Metz","4-1",4,1,"1",1,5,3,"H"
"4986",1957-02-10,1956,"Nimes Olympique","RC Strasbourg","4-1",4,1,"1",1,5,3,"H"
"4987",1957-02-10,1956,"AS Nancy","OGC Nice","4-2",4,2,"1",1,6,2,"H"
"4988",1957-02-17,1956,"AS Monaco","AS Saint-Etienne","3-1",3,1,"1",1,4,2,"H"
"4989",1957-02-17,1956,"Stade Reims","Toulouse FC","2-0",2,0,"1",1,2,2,"H"
"4990",1957-02-17,1956,"RC Strasbourg","RC Lens","1-4",1,4,"1",1,5,-3,"D"
"4991",1957-02-17,1956,"Olympique Lyon","Racing Club de France","1-2",1,2,"1",1,3,-1,"D"
"4992",1957-02-17,1956,"Stade Rennes","Olympique Marseille","1-1",1,1,"1",1,2,0,"D"
"4993",1957-02-17,1956,"OGC Nice","UA Sedan-Torcy","1-0",1,0,"1",1,1,1,"H"
"4994",1957-02-17,1956,"FC Metz","Nimes Olympique","3-1",3,1,"1",1,4,2,"H"
"4995",1957-02-17,1956,"FC Sochaux","AS Nancy","3-1",3,1,"1",1,4,2,"H"
"4996",1957-02-17,1956,"US Valenciennes-Anzin","Angers SCO","1-0",1,0,"1",1,1,1,"H"
"4997",1957-02-24,1956,"AS Saint-Etienne","Stade Reims","0-0",0,0,"1",1,0,0,"D"
"4998",1957-02-24,1956,"RC Lens","AS Nancy","3-1",3,1,"1",1,4,2,"H"
"4999",1957-02-24,1956,"Racing Club de France","OGC Nice","3-2",3,2,"1",1,5,1,"H"
"5000",1957-02-24,1956,"AS Monaco","Nimes Olympique","4-1",4,1,"1",1,5,3,"H"
"5001",1957-02-24,1956,"Olympique Marseille","US Valenciennes-Anzin","4-1",4,1,"1",1,5,3,"H"
"5002",1957-02-24,1956,"UA Sedan-Torcy","Toulouse FC","1-1",1,1,"1",1,2,0,"D"
"5003",1957-02-24,1956,"RC Strasbourg","FC Sochaux","3-2",3,2,"1",1,5,1,"H"
"5004",1957-02-24,1956,"Stade Rennes","Angers SCO","4-1",4,1,"1",1,5,3,"H"
"5005",1957-02-24,1956,"FC Metz","Olympique Lyon","3-1",3,1,"1",1,4,2,"H"
"5006",1957-03-07,1956,"Angers SCO","AS Monaco","0-2",0,2,"1",1,2,-2,"D"
"5007",1957-03-10,1956,"AS Saint-Etienne","US Valenciennes-Anzin","5-4",5,4,"1",1,9,1,"H"
"5008",1957-03-10,1956,"RC Lens","FC Metz","3-1",3,1,"1",1,4,2,"H"
"5009",1957-03-10,1956,"Nimes Olympique","Stade Reims","1-2",1,2,"1",1,3,-1,"D"
"5010",1957-03-10,1956,"UA Sedan-Torcy","AS Monaco","3-3",3,3,"1",1,6,0,"D"
"5011",1957-03-10,1956,"Angers SCO","Racing Club de France","1-1",1,1,"1",1,2,0,"D"
"5012",1957-03-10,1956,"AS Nancy","Olympique Marseille","0-1",0,1,"1",1,1,-1,"D"
"5013",1957-03-10,1956,"Toulouse FC","RC Strasbourg","1-1",1,1,"1",1,2,0,"D"
"5014",1957-03-10,1956,"FC Sochaux","Olympique Lyon","3-1",3,1,"1",1,4,2,"H"
"5015",1957-03-10,1956,"OGC Nice","Stade Rennes","0-2",0,2,"1",1,2,-2,"D"
"5016",1957-03-17,1956,"Olympique Marseille","AS Saint-Etienne","4-3",4,3,"1",1,7,1,"H"
"5017",1957-03-17,1956,"Stade Reims","RC Strasbourg","3-1",3,1,"1",1,4,2,"H"
"5018",1957-03-17,1956,"Olympique Lyon","RC Lens","3-0",3,0,"1",1,3,3,"H"
"5019",1957-03-17,1956,"OGC Nice","AS Monaco","0-2",0,2,"1",1,2,-2,"D"
"5020",1957-03-17,1956,"Racing Club de France","FC Sochaux","3-1",3,1,"1",1,4,2,"H"
"5021",1957-03-17,1956,"FC Metz","Toulouse FC","4-1",4,1,"1",1,5,3,"H"
"5022",1957-03-17,1956,"AS Nancy","Angers SCO","2-2",2,2,"1",1,4,0,"D"
"5023",1957-03-17,1956,"Stade Rennes","Nimes Olympique","2-1",2,1,"1",1,3,1,"H"
"5024",1957-03-17,1956,"US Valenciennes-Anzin","UA Sedan-Torcy","0-4",0,4,"1",1,4,-4,"D"
"5025",1957-03-28,1956,"FC Sochaux","UA Sedan-Torcy","5-2",5,2,"1",1,7,3,"H"
"5026",1957-03-31,1956,"AS Saint-Etienne","OGC Nice","4-2",4,2,"1",1,6,2,"H"
"5027",1957-03-31,1956,"AS Monaco","Stade Reims","1-1",1,1,"1",1,2,0,"D"
"5028",1957-03-31,1956,"Nimes Olympique","RC Lens","2-3",2,3,"1",1,5,-1,"D"
"5029",1957-03-31,1956,"UA Sedan-Torcy","Racing Club de France","1-1",1,1,"1",1,2,0,"D"
"5030",1957-03-31,1956,"FC Metz","Olympique Marseille","1-0",1,0,"1",1,1,1,"H"
"5031",1957-03-31,1956,"Toulouse FC","AS Nancy","1-2",1,2,"1",1,3,-1,"D"
"5032",1957-03-31,1956,"Angers SCO","FC Sochaux","4-0",4,0,"1",1,4,4,"H"
"5033",1957-03-31,1956,"RC Strasbourg","Olympique Lyon","2-0",2,0,"1",1,2,2,"H"
"5034",1957-03-31,1956,"US Valenciennes-Anzin","Stade Rennes","5-2",5,2,"1",1,7,3,"H"
"5035",1957-04-14,1956,"Angers SCO","AS Saint-Etienne","0-1",0,1,"1",1,1,-1,"D"
"5036",1957-04-14,1956,"RC Lens","Stade Rennes","3-0",3,0,"1",1,3,3,"H"
"5037",1957-04-14,1956,"Stade Reims","UA Sedan-Torcy","0-1",0,1,"1",1,1,-1,"D"
"5038",1957-04-14,1956,"Olympique Marseille","Racing Club de France","0-3",0,3,"1",1,3,-3,"D"
"5039",1957-04-14,1956,"AS Monaco","RC Strasbourg","1-2",1,2,"1",1,3,-1,"D"
"5040",1957-04-14,1956,"Toulouse FC","OGC Nice","4-3",4,3,"1",1,7,1,"H"
"5041",1957-04-14,1956,"FC Sochaux","FC Metz","1-1",1,1,"1",1,2,0,"D"
"5042",1957-04-14,1956,"Nimes Olympique","US Valenciennes-Anzin","2-3",2,3,"1",1,5,-1,"D"
"5043",1957-04-14,1956,"Olympique Lyon","AS Nancy","0-1",0,1,"1",1,1,-1,"D"
"5044",1957-04-21,1956,"FC Sochaux","AS Saint-Etienne","1-1",1,1,"1",1,2,0,"D"
"5045",1957-04-21,1956,"UA Sedan-Torcy","RC Lens","4-4",4,4,"1",1,8,0,"D"
"5046",1957-04-21,1956,"AS Nancy","Stade Reims","0-0",0,0,"1",1,0,0,"D"
"5047",1957-04-21,1956,"Racing Club de France","Nimes Olympique","0-0",0,0,"1",1,0,0,"D"
"5048",1957-04-21,1956,"US Valenciennes-Anzin","AS Monaco","2-1",2,1,"1",1,3,1,"H"
"5049",1957-04-21,1956,"RC Strasbourg","Olympique Marseille","2-3",2,3,"1",1,5,-1,"D"
"5050",1957-04-21,1956,"Stade Rennes","Toulouse FC","1-0",1,0,"1",1,1,1,"H"
"5051",1957-04-21,1956,"Olympique Lyon","Angers SCO","2-1",2,1,"1",1,3,1,"H"
"5052",1957-04-21,1956,"OGC Nice","FC Metz","1-1",1,1,"1",1,2,0,"D"
"5053",1957-04-28,1956,"AS Saint-Etienne","UA Sedan-Torcy","2-2",2,2,"1",1,4,0,"D"
"5054",1957-04-28,1956,"RC Lens","Olympique Marseille","2-0",2,0,"1",1,2,2,"H"
"5055",1957-04-28,1956,"OGC Nice","Stade Reims","2-1",2,1,"1",1,3,1,"H"
"5056",1957-04-28,1956,"Racing Club de France","US Valenciennes-Anzin","3-1",3,1,"1",1,4,2,"H"
"5057",1957-04-28,1956,"AS Monaco","FC Sochaux","2-1",2,1,"1",1,3,1,"H"
"5058",1957-04-28,1956,"Toulouse FC","Olympique Lyon","2-2",2,2,"1",1,4,0,"D"
"5059",1957-04-28,1956,"Angers SCO","RC Strasbourg","4-1",4,1,"1",1,5,3,"H"
"5060",1957-04-28,1956,"Nimes Olympique","AS Nancy","4-0",4,0,"1",1,4,4,"H"
"5061",1957-04-28,1956,"FC Metz","Stade Rennes","1-1",1,1,"1",1,2,0,"D"
"5062",1957-05-01,1956,"FC Metz","AS Saint-Etienne","1-2",1,2,"1",1,3,-1,"D"
"5063",1957-05-01,1956,"US Valenciennes-Anzin","RC Lens","2-1",2,1,"1",1,3,1,"H"
"5064",1957-05-01,1956,"AS Monaco","Racing Club de France","1-1",1,1,"1",1,2,0,"D"
"5065",1957-05-01,1956,"Stade Reims","Angers SCO","1-2",1,2,"1",1,3,-1,"D"
"5066",1957-05-01,1956,"Olympique Marseille","UA Sedan-Torcy","3-0",3,0,"1",1,3,3,"H"
"5067",1957-05-01,1956,"Toulouse FC","Nimes Olympique","0-1",0,1,"1",1,1,-1,"D"
"5068",1957-05-01,1956,"Stade Rennes","FC Sochaux","2-0",2,0,"1",1,2,2,"H"
"5069",1957-05-01,1956,"Olympique Lyon","OGC Nice","1-0",1,0,"1",1,1,1,"H"
"5070",1957-05-01,1956,"RC Strasbourg","AS Nancy","0-0",0,0,"1",1,0,0,"D"
"5071",1957-05-12,1956,"RC Strasbourg","AS Saint-Etienne","1-1",1,1,"1",1,2,0,"D"
"5072",1957-05-12,1956,"OGC Nice","RC Lens","3-2",3,2,"1",1,5,1,"H"
"5073",1957-05-12,1956,"Racing Club de France","Toulouse FC","6-2",6,2,"1",1,8,4,"H"
"5074",1957-05-12,1956,"Stade Rennes","Stade Reims","1-1",1,1,"1",1,2,0,"D"
"5075",1957-05-12,1956,"Olympique Lyon","AS Monaco","1-0",1,0,"1",1,1,1,"H"
"5076",1957-05-12,1956,"FC Sochaux","Olympique Marseille","3-0",3,0,"1",1,3,3,"H"
"5077",1957-05-12,1956,"Nimes Olympique","Angers SCO","3-1",3,1,"1",1,4,2,"H"
"5078",1957-05-12,1956,"UA Sedan-Torcy","FC Metz","3-2",3,2,"1",1,5,1,"H"
"5079",1957-05-12,1956,"AS Nancy","US Valenciennes-Anzin","1-4",1,4,"1",1,5,-3,"D"
"5080",1957-05-19,1956,"AS Saint-Etienne","Stade Rennes","2-0",2,0,"1",1,2,2,"H"
"5081",1957-05-19,1956,"RC Lens","Racing Club de France","2-0",2,0,"1",1,2,2,"H"
"5082",1957-05-19,1956,"Stade Reims","Olympique Lyon","4-1",4,1,"1",1,5,3,"H"
"5083",1957-05-19,1956,"AS Nancy","AS Monaco","0-2",0,2,"1",1,2,-2,"D"
"5084",1957-05-19,1956,"Olympique Marseille","Toulouse FC","3-0",3,0,"1",1,3,3,"H"
"5085",1957-05-19,1956,"FC Sochaux","OGC Nice","4-2",4,2,"1",1,6,2,"H"
"5086",1957-05-19,1956,"UA Sedan-Torcy","Nimes Olympique","1-0",1,0,"1",1,1,1,"H"
"5087",1957-05-19,1956,"Angers SCO","FC Metz","0-3",0,3,"1",1,3,-3,"D"
"5088",1957-05-19,1956,"US Valenciennes-Anzin","RC Strasbourg","0-1",0,1,"1",1,1,-1,"D"
"5089",1957-08-18,1957,"OGC Nice","FC Metz","6-2",6,2,"1",1,8,4,"H"
"5090",1957-08-18,1957,"Racing Club de France","FC Sochaux","6-4",6,4,"1",1,10,2,"H"
"5091",1957-08-18,1957,"RC Lens","Toulouse FC","3-1",3,1,"1",1,4,2,"H"
"5092",1957-08-18,1957,"Olympique Marseille","Lille OSC","3-4",3,4,"1",1,7,-1,"D"
"5093",1957-08-18,1957,"UA Sedan-Torcy","AS Monaco","2-1",2,1,"1",1,3,1,"H"
"5094",1957-08-18,1957,"Olympique Lyon","Nimes Olympique","1-0",1,0,"1",1,1,1,"H"
"5095",1957-08-18,1957,"Olympique Ales","US Valenciennes-Anzin","0-1",0,1,"1",1,1,-1,"D"
"5096",1957-08-18,1957,"AS Beziers","AS Saint-Etienne","2-2",2,2,"1",1,4,0,"D"
"5097",1957-08-20,1957,"Angers SCO","Stade Reims","0-1",0,1,"1",1,1,-1,"D"
"5098",1957-08-25,1957,"Nimes Olympique","RC Lens","2-3",2,3,"1",1,5,-1,"D"
"5099",1957-08-25,1957,"US Valenciennes-Anzin","UA Sedan-Torcy","3-1",3,1,"1",1,4,2,"H"
"5100",1957-08-25,1957,"Olympique Lyon","FC Metz","2-0",2,0,"1",1,2,2,"H"
"5101",1957-08-25,1957,"Stade Reims","OGC Nice","3-2",3,2,"1",1,5,1,"H"
"5102",1957-08-25,1957,"Olympique Marseille","Racing Club de France","1-1",1,1,"1",1,2,0,"D"
"5103",1957-08-25,1957,"Lille OSC","AS Saint-Etienne","1-2",1,2,"1",1,3,-1,"D"
"5104",1957-08-25,1957,"AS Monaco","FC Sochaux","5-2",5,2,"1",1,7,3,"H"
"5105",1957-08-25,1957,"AS Beziers","Angers SCO","4-4",4,4,"1",1,8,0,"D"
"5106",1957-08-25,1957,"Toulouse FC","Olympique Ales","2-3",2,3,"1",1,5,-1,"D"
"5107",1957-09-08,1957,"RC Lens","Olympique Lyon","4-4",4,4,"1",1,8,0,"D"
"5108",1957-09-08,1957,"US Valenciennes-Anzin","OGC Nice","1-1",1,1,"1",1,2,0,"D"
"5109",1957-09-08,1957,"AS Monaco","Stade Reims","3-0",3,0,"1",1,3,3,"H"
"5110",1957-09-08,1957,"UA Sedan-Torcy","Nimes Olympique","3-1",3,1,"1",1,4,2,"H"
"5111",1957-09-08,1957,"Olympique Ales","Lille OSC","2-1",2,1,"1",1,3,1,"H"
"5112",1957-09-08,1957,"AS Saint-Etienne","Toulouse FC","1-1",1,1,"1",1,2,0,"D"
"5113",1957-09-08,1957,"Racing Club de France","Angers SCO","1-2",1,2,"1",1,3,-1,"D"
"5114",1957-09-08,1957,"FC Metz","Olympique Marseille","1-2",1,2,"1",1,3,-1,"D"
"5115",1957-09-08,1957,"FC Sochaux","AS Beziers","4-0",4,0,"1",1,4,4,"H"
"5116",1957-09-15,1957,"FC Metz","RC Lens","1-4",1,4,"1",1,5,-3,"D"
"5117",1957-09-15,1957,"Stade Reims","Olympique Lyon","4-0",4,0,"1",1,4,4,"H"
"5118",1957-09-15,1957,"OGC Nice","UA Sedan-Torcy","8-0",8,0,"1",1,8,8,"H"
"5119",1957-09-15,1957,"Lille OSC","Racing Club de France","1-3",1,3,"1",1,4,-2,"D"
"5120",1957-09-15,1957,"FC Sochaux","US Valenciennes-Anzin","1-0",1,0,"1",1,1,1,"H"
"5121",1957-09-15,1957,"Angers SCO","AS Monaco","3-2",3,2,"1",1,5,1,"H"
"5122",1957-09-15,1957,"AS Saint-Etienne","Olympique Ales","2-2",2,2,"1",1,4,0,"D"
"5123",1957-09-15,1957,"Toulouse FC","Olympique Marseille","1-1",1,1,"1",1,2,0,"D"
"5124",1957-09-15,1957,"Nimes Olympique","AS Beziers","2-0",2,0,"1",1,2,2,"H"
"5125",1957-09-18,1957,"RC Lens","OGC Nice","1-0",1,0,"1",1,1,1,"H"
"5126",1957-09-18,1957,"Racing Club de France","Nimes Olympique","3-1",3,1,"1",1,4,2,"H"
"5127",1957-09-18,1957,"FC Metz","AS Saint-Etienne","0-2",0,2,"1",1,2,-2,"D"
"5128",1957-09-18,1957,"AS Beziers","AS Monaco","0-3",0,3,"1",1,3,-3,"D"
"5129",1957-09-18,1957,"FC Sochaux","Toulouse FC","4-2",4,2,"1",1,6,2,"H"
"5130",1957-09-19,1957,"Angers SCO","Lille OSC","0-0",0,0,"1",1,0,0,"D"
"5131",1957-09-19,1957,"Stade Reims","US Valenciennes-Anzin","4-2",4,2,"1",1,6,2,"H"
"5132",1957-09-19,1957,"Olympique Ales","UA Sedan-Torcy","2-0",2,0,"1",1,2,2,"H"
"5133",1957-09-19,1957,"Olympique Marseille","Olympique Lyon","2-3",2,3,"1",1,5,-1,"D"
"5134",1957-09-21,1957,"AS Beziers","RC Lens","1-1",1,1,"1",1,2,0,"D"
"5135",1957-09-22,1957,"Olympique Lyon","Racing Club de France","2-0",2,0,"1",1,2,2,"H"
"5136",1957-09-22,1957,"Toulouse FC","Stade Reims","1-0",1,0,"1",1,1,1,"H"
"5137",1957-09-22,1957,"AS Saint-Etienne","FC Sochaux","2-2",2,2,"1",1,4,0,"D"
"5138",1957-09-22,1957,"OGC Nice","Olympique Ales","6-1",6,1,"1",1,7,5,"H"
"5139",1957-09-22,1957,"Lille OSC","AS Monaco","1-1",1,1,"1",1,2,0,"D"
"5140",1957-09-22,1957,"US Valenciennes-Anzin","FC Metz","2-2",2,2,"1",1,4,0,"D"
"5141",1957-09-22,1957,"Nimes Olympique","Angers SCO","5-1",5,1,"1",1,6,4,"H"
"5142",1957-09-22,1957,"UA Sedan-Torcy","Olympique Marseille","2-1",2,1,"1",1,3,1,"H"
"5143",1957-09-28,1957,"Stade Reims","AS Beziers","5-0",5,0,"1",1,5,5,"H"
"5144",1957-09-29,1957,"US Valenciennes-Anzin","RC Lens","1-1",1,1,"1",1,2,0,"D"
"5145",1957-09-29,1957,"Olympique Marseille","FC Sochaux","0-3",0,3,"1",1,3,-3,"D"
"5146",1957-09-29,1957,"Olympique Ales","Racing Club de France","1-3",1,3,"1",1,4,-2,"D"
"5147",1957-09-29,1957,"AS Saint-Etienne","OGC Nice","1-1",1,1,"1",1,2,0,"D"
"5148",1957-09-29,1957,"Toulouse FC","Olympique Lyon","3-1",3,1,"1",1,4,2,"H"
"5149",1957-09-29,1957,"AS Monaco","Nimes Olympique","1-1",1,1,"1",1,2,0,"D"
"5150",1957-09-29,1957,"FC Metz","Angers SCO","0-3",0,3,"1",1,3,-3,"D"
"5151",1957-09-29,1957,"Lille OSC","UA Sedan-Torcy","3-0",3,0,"1",1,3,3,"H"
"5152",1957-10-13,1957,"RC Lens","Stade Reims","0-1",0,1,"1",1,1,-1,"D"
"5153",1957-10-13,1957,"FC Sochaux","Olympique Ales","3-1",3,1,"1",1,4,2,"H"
"5154",1957-10-13,1957,"Olympique Lyon","Lille OSC","2-0",2,0,"1",1,2,2,"H"
"5155",1957-10-13,1957,"AS Monaco","US Valenciennes-Anzin","4-0",4,0,"1",1,4,4,"H"
"5156",1957-10-13,1957,"Racing Club de France","AS Saint-Etienne","1-1",1,1,"1",1,2,0,"D"
"5157",1957-10-13,1957,"Angers SCO","Olympique Marseille","2-2",2,2,"1",1,4,0,"D"
"5158",1957-10-13,1957,"Nimes Olympique","OGC Nice","3-2",3,2,"1",1,5,1,"H"
"5159",1957-10-13,1957,"UA Sedan-Torcy","Toulouse FC","3-0",3,0,"1",1,3,3,"H"
"5160",1957-10-13,1957,"AS Beziers","FC Metz","0-1",0,1,"1",1,1,-1,"D"
"5161",1957-10-20,1957,"Stade Reims","Lille OSC","3-1",3,1,"1",1,4,2,"H"
"5162",1957-10-20,1957,"Racing Club de France","AS Monaco","2-3",2,3,"1",1,5,-1,"D"
"5163",1957-10-20,1957,"RC Lens","FC Sochaux","1-1",1,1,"1",1,2,0,"D"
"5164",1957-10-20,1957,"AS Saint-Etienne","US Valenciennes-Anzin","5-1",5,1,"1",1,6,4,"H"
"5165",1957-10-20,1957,"Olympique Ales","Olympique Lyon","2-2",2,2,"1",1,4,0,"D"
"5166",1957-10-20,1957,"OGC Nice","AS Beziers","6-1",6,1,"1",1,7,5,"H"
"5167",1957-10-20,1957,"Olympique Marseille","Nimes Olympique","1-3",1,3,"1",1,4,-2,"D"
"5168",1957-10-20,1957,"Angers SCO","Toulouse FC","0-1",0,1,"1",1,1,-1,"D"
"5169",1957-10-20,1957,"FC Metz","UA Sedan-Torcy","3-2",3,2,"1",1,5,1,"H"
"5170",1957-11-01,1957,"FC Sochaux","Stade Reims","0-4",0,4,"1",1,4,-4,"D"
"5171",1957-11-01,1957,"AS Monaco","Olympique Marseille","3-2",3,2,"1",1,5,1,"H"
"5172",1957-11-01,1957,"UA Sedan-Torcy","RC Lens","2-3",2,3,"1",1,5,-1,"D"
"5173",1957-11-01,1957,"Nimes Olympique","AS Saint-Etienne","2-2",2,2,"1",1,4,0,"D"
"5174",1957-11-01,1957,"US Valenciennes-Anzin","Racing Club de France","0-5",0,5,"1",1,5,-5,"D"
"5175",1957-11-01,1957,"Olympique Lyon","Angers SCO","2-3",2,3,"1",1,5,-1,"D"
"5176",1957-11-01,1957,"Toulouse FC","OGC Nice","2-1",2,1,"1",1,3,1,"H"
"5177",1957-11-01,1957,"Lille OSC","FC Metz","2-1",2,1,"1",1,3,1,"H"
"5178",1957-11-01,1957,"AS Beziers","Olympique Ales","3-2",3,2,"1",1,5,1,"H"
"5179",1957-11-03,1957,"Stade Reims","UA Sedan-Torcy","3-0",3,0,"1",1,3,3,"H"
"5180",1957-11-03,1957,"OGC Nice","AS Monaco","0-1",0,1,"1",1,1,-1,"D"
"5181",1957-11-03,1957,"RC Lens","Lille OSC","1-0",1,0,"1",1,1,1,"H"
"5182",1957-11-03,1957,"AS Saint-Etienne","Olympique Lyon","1-1",1,1,"1",1,2,0,"D"
"5183",1957-11-03,1957,"Racing Club de France","Toulouse FC","1-2",1,2,"1",1,3,-1,"D"
"5184",1957-11-03,1957,"FC Metz","FC Sochaux","1-0",1,0,"1",1,1,1,"H"
"5185",1957-11-03,1957,"Olympique Ales","Nimes Olympique","1-1",1,1,"1",1,2,0,"D"
"5186",1957-11-03,1957,"Angers SCO","US Valenciennes-Anzin","3-4",3,4,"1",1,7,-1,"D"
"5187",1957-11-03,1957,"Olympique Marseille","AS Beziers","0-1",0,1,"1",1,1,-1,"D"
"5188",1957-11-10,1957,"Stade Reims","FC Metz","5-1",5,1,"1",1,6,4,"H"
"5189",1957-11-10,1957,"RC Lens","Angers SCO","2-1",2,1,"1",1,3,1,"H"
"5190",1957-11-10,1957,"Olympique Ales","AS Monaco","1-1",1,1,"1",1,2,0,"D"
"5191",1957-11-10,1957,"AS Saint-Etienne","Olympique Marseille","1-1",1,1,"1",1,2,0,"D"
"5192",1957-11-10,1957,"FC Sochaux","Olympique Lyon","1-0",1,0,"1",1,1,1,"H"
"5193",1957-11-10,1957,"US Valenciennes-Anzin","Nimes Olympique","0-3",0,3,"1",1,3,-3,"D"
"5194",1957-11-10,1957,"OGC Nice","Racing Club de France","2-0",2,0,"1",1,2,2,"H"
"5195",1957-11-10,1957,"Toulouse FC","Lille OSC","1-2",1,2,"1",1,3,-1,"D"
"5196",1957-11-10,1957,"AS Beziers","UA Sedan-Torcy","0-2",0,2,"1",1,2,-2,"D"
"5197",1957-11-17,1957,"Nimes Olympique","Stade Reims","3-0",3,0,"1",1,3,3,"H"
"5198",1957-11-17,1957,"AS Monaco","AS Saint-Etienne","0-0",0,0,"1",1,0,0,"D"
"5199",1957-11-17,1957,"Racing Club de France","RC Lens","5-0",5,0,"1",1,5,5,"H"
"5200",1957-11-17,1957,"Olympique Lyon","AS Beziers","2-1",2,1,"1",1,3,1,"H"
"5201",1957-11-17,1957,"UA Sedan-Torcy","FC Sochaux","4-1",4,1,"1",1,5,3,"H"
"5202",1957-11-17,1957,"Toulouse FC","FC Metz","4-1",4,1,"1",1,5,3,"H"
"5203",1957-11-17,1957,"Olympique Marseille","OGC Nice","2-1",2,1,"1",1,3,1,"H"
"5204",1957-11-17,1957,"Angers SCO","Olympique Ales","1-1",1,1,"1",1,2,0,"D"
"5205",1957-11-17,1957,"Lille OSC","US Valenciennes-Anzin","2-3",2,3,"1",1,5,-1,"D"
"5206",1957-11-24,1957,"Stade Reims","Olympique Ales","4-2",4,2,"1",1,6,2,"H"
"5207",1957-11-24,1957,"RC Lens","Olympique Marseille","3-1",3,1,"1",1,4,2,"H"
"5208",1957-11-24,1957,"Olympique Lyon","AS Monaco","2-0",2,0,"1",1,2,2,"H"
"5209",1957-11-24,1957,"Nimes Olympique","Toulouse FC","3-2",3,2,"1",1,5,1,"H"
"5210",1957-11-24,1957,"UA Sedan-Torcy","AS Saint-Etienne","1-1",1,1,"1",1,2,0,"D"
"5211",1957-11-24,1957,"FC Metz","Racing Club de France","1-1",1,1,"1",1,2,0,"D"
"5212",1957-11-24,1957,"FC Sochaux","Lille OSC","2-4",2,4,"1",1,6,-2,"D"
"5213",1957-11-24,1957,"OGC Nice","Angers SCO","0-0",0,0,"1",1,0,0,"D"
"5214",1957-12-01,1957,"AS Saint-Etienne","Stade Reims","0-0",0,0,"1",1,0,0,"D"
"5215",1957-12-01,1957,"AS Monaco","RC Lens","2-1",2,1,"1",1,3,1,"H"
"5216",1957-12-01,1957,"OGC Nice","Olympique Lyon","2-2",2,2,"1",1,4,0,"D"
"5217",1957-12-01,1957,"Racing Club de France","UA Sedan-Torcy","4-2",4,2,"1",1,6,2,"H"
"5218",1957-12-01,1957,"Lille OSC","Nimes Olympique","3-1",3,1,"1",1,4,2,"H"
"5219",1957-12-01,1957,"Angers SCO","FC Sochaux","5-1",5,1,"1",1,6,4,"H"
"5220",1957-12-01,1957,"AS Beziers","Toulouse FC","2-0",2,0,"1",1,2,2,"H"
"5221",1957-12-01,1957,"Olympique Ales","FC Metz","4-1",4,1,"1",1,5,3,"H"
"5222",1957-12-01,1957,"Olympique Marseille","US Valenciennes-Anzin","1-1",1,1,"1",1,2,0,"D"
"5223",1957-12-08,1957,"Stade Reims","Racing Club de France","4-1",4,1,"1",1,5,3,"H"
"5224",1957-12-08,1957,"AS Monaco","Toulouse FC","0-2",0,2,"1",1,2,-2,"D"
"5225",1957-12-08,1957,"AS Saint-Etienne","RC Lens","3-1",3,1,"1",1,4,2,"H"
"5226",1957-12-08,1957,"FC Metz","Nimes Olympique","0-1",0,1,"1",1,1,-1,"D"
"5227",1957-12-08,1957,"US Valenciennes-Anzin","Olympique Lyon","2-0",2,0,"1",1,2,2,"H"
"5228",1957-12-08,1957,"Lille OSC","AS Beziers","10-1",10,1,"1",1,11,9,"H"
"5229",1957-12-08,1957,"FC Sochaux","OGC Nice","4-0",4,0,"1",1,4,4,"H"
"5230",1957-12-08,1957,"UA Sedan-Torcy","Angers SCO","1-0",1,0,"1",1,1,1,"H"
"5231",1957-12-08,1957,"Olympique Ales","Olympique Marseille","1-0",1,0,"1",1,1,1,"H"
"5232",1957-12-11,1957,"US Valenciennes-Anzin","AS Beziers","1-1",1,1,"1",1,2,0,"D"
"5233",1957-12-15,1957,"Olympique Marseille","Stade Reims","3-3",3,3,"1",1,6,0,"D"
"5234",1957-12-15,1957,"RC Lens","Olympique Ales","5-0",5,0,"1",1,5,5,"H"
"5235",1957-12-15,1957,"Nimes Olympique","FC Sochaux","2-0",2,0,"1",1,2,2,"H"
"5236",1957-12-15,1957,"FC Metz","AS Monaco","0-0",0,0,"1",1,0,0,"D"
"5237",1957-12-15,1957,"Angers SCO","AS Saint-Etienne","2-2",2,2,"1",1,4,0,"D"
"5238",1957-12-15,1957,"Racing Club de France","AS Beziers","1-0",1,0,"1",1,1,1,"H"
"5239",1957-12-15,1957,"Toulouse FC","US Valenciennes-Anzin","3-2",3,2,"1",1,5,1,"H"
"5240",1957-12-15,1957,"Olympique Lyon","UA Sedan-Torcy","0-3",0,3,"1",1,3,-3,"D"
"5241",1957-12-15,1957,"OGC Nice","Lille OSC","5-5",5,5,"1",1,10,0,"D"
"5242",1957-12-22,1957,"Olympique Lyon","Stade Reims","1-2",1,2,"1",1,3,-1,"D"
"5243",1957-12-22,1957,"AS Monaco","AS Beziers","2-0",2,0,"1",1,2,2,"H"
"5244",1957-12-22,1957,"Toulouse FC","AS Saint-Etienne","2-3",2,3,"1",1,5,-1,"D"
"5245",1957-12-22,1957,"FC Sochaux","RC Lens","1-0",1,0,"1",1,1,1,"H"
"5246",1957-12-22,1957,"Nimes Olympique","Racing Club de France","0-1",0,1,"1",1,1,-1,"D"
"5247",1957-12-22,1957,"Lille OSC","Olympique Ales","1-0",1,0,"1",1,1,1,"H"
"5248",1957-12-22,1957,"UA Sedan-Torcy","US Valenciennes-Anzin","2-1",2,1,"1",1,3,1,"H"
"5249",1957-12-22,1957,"Angers SCO","OGC Nice","2-1",2,1,"1",1,3,1,"H"
"5250",1957-12-22,1957,"Olympique Marseille","FC Metz","2-2",2,2,"1",1,4,0,"D"
"5251",1957-12-29,1957,"Stade Reims","Angers SCO","2-3",2,3,"1",1,5,-1,"D"
"5252",1957-12-29,1957,"US Valenciennes-Anzin","AS Monaco","0-0",0,0,"1",1,0,0,"D"
"5253",1957-12-29,1957,"AS Saint-Etienne","UA Sedan-Torcy","3-3",3,3,"1",1,6,0,"D"
"5254",1957-12-29,1957,"RC Lens","Nimes Olympique","1-1",1,1,"1",1,2,0,"D"
"5255",1957-12-29,1957,"FC Metz","Lille OSC","2-3",2,3,"1",1,5,-1,"D"
"5256",1957-12-29,1957,"Racing Club de France","Olympique Lyon","2-4",2,4,"1",1,6,-2,"D"
"5257",1957-12-29,1957,"Olympique Ales","Toulouse FC","2-0",2,0,"1",1,2,2,"H"
"5258",1957-12-29,1957,"AS Beziers","FC Sochaux","2-1",2,1,"1",1,3,1,"H"
"5259",1957-12-29,1957,"OGC Nice","Olympique Marseille","3-0",3,0,"1",1,3,3,"H"
"5260",1958-01-05,1957,"Lille OSC","Stade Reims","2-1",2,1,"1",1,3,1,"H"
"5261",1958-01-05,1957,"AS Monaco","Olympique Ales","3-1",3,1,"1",1,4,2,"H"
"5262",1958-01-05,1957,"AS Saint-Etienne","FC Metz","2-2",2,2,"1",1,4,0,"D"
"5263",1958-01-05,1957,"Nimes Olympique","Olympique Marseille","5-0",5,0,"1",1,5,5,"H"
"5264",1958-01-05,1957,"Toulouse FC","RC Lens","3-2",3,2,"1",1,5,1,"H"
"5265",1958-01-05,1957,"Angers SCO","Olympique Lyon","2-1",2,1,"1",1,3,1,"H"
"5266",1958-01-05,1957,"UA Sedan-Torcy","OGC Nice","3-2",3,2,"1",1,5,1,"H"
"5267",1958-01-05,1957,"FC Sochaux","Racing Club de France","5-0",5,0,"1",1,5,5,"H"
"5268",1958-01-05,1957,"AS Beziers","US Valenciennes-Anzin","3-1",3,1,"1",1,4,2,"H"
"5269",1958-01-19,1957,"Stade Reims","AS Monaco","1-1",1,1,"1",1,2,0,"D"
"5270",1958-01-19,1957,"US Valenciennes-Anzin","AS Saint-Etienne","0-0",0,0,"1",1,0,0,"D"
"5271",1958-01-19,1957,"Racing Club de France","Lille OSC","1-3",1,3,"1",1,4,-2,"D"
"5272",1958-01-19,1957,"OGC Nice","Nimes Olympique","2-0",2,0,"1",1,2,2,"H"
"5273",1958-01-19,1957,"Olympique Marseille","Angers SCO","1-2",1,2,"1",1,3,-1,"D"
"5274",1958-01-19,1957,"RC Lens","UA Sedan-Torcy","2-3",2,3,"1",1,5,-1,"D"
"5275",1958-01-19,1957,"Olympique Lyon","FC Sochaux","1-1",1,1,"1",1,2,0,"D"
"5276",1958-01-19,1957,"FC Metz","Toulouse FC","2-1",2,1,"1",1,3,1,"H"
"5277",1958-01-19,1957,"Olympique Ales","AS Beziers","2-0",2,0,"1",1,2,2,"H"
"5278",1958-01-26,1957,"Olympique Ales","Stade Reims","2-0",2,0,"1",1,2,2,"H"
"5279",1958-01-26,1957,"FC Sochaux","AS Monaco","1-2",1,2,"1",1,3,-1,"D"
"5280",1958-01-26,1957,"Lille OSC","Olympique Lyon","3-0",3,0,"1",1,3,3,"H"
"5281",1958-01-26,1957,"AS Beziers","Nimes Olympique","0-1",0,1,"1",1,1,-1,"D"
"5282",1958-01-26,1957,"AS Saint-Etienne","Racing Club de France","0-1",0,1,"1",1,1,-1,"D"
"5283",1958-01-26,1957,"Toulouse FC","Angers SCO","1-3",1,3,"1",1,4,-2,"D"
"5284",1958-01-26,1957,"UA Sedan-Torcy","FC Metz","6-3",6,3,"1",1,9,3,"H"
"5285",1958-01-26,1957,"OGC Nice","RC Lens","0-2",0,2,"1",1,2,-2,"D"
"5286",1958-01-26,1957,"US Valenciennes-Anzin","Olympique Marseille","2-1",2,1,"1",1,3,1,"H"
"5287",1958-02-09,1957,"RC Lens","AS Saint-Etienne","1-3",1,3,"1",1,4,-2,"D"
"5288",1958-02-09,1957,"Angers SCO","AS Beziers","3-1",3,1,"1",1,4,2,"H"
"5289",1958-02-09,1957,"Nimes Olympique","UA Sedan-Torcy","2-2",2,2,"1",1,4,0,"D"
"5290",1958-02-09,1957,"Racing Club de France","US Valenciennes-Anzin","2-2",2,2,"1",1,4,0,"D"
"5291",1958-02-09,1957,"Olympique Lyon","Toulouse FC","3-1",3,1,"1",1,4,2,"H"
"5292",1958-02-09,1957,"Olympique Marseille","Olympique Ales","1-0",1,0,"1",1,1,1,"H"
"5293",1958-02-16,1957,"Racing Club de France","Stade Reims","1-5",1,5,"1",1,6,-4,"D"
"5294",1958-02-16,1957,"AS Monaco","FC Metz","2-1",2,1,"1",1,3,1,"H"
"5295",1958-02-16,1957,"Lille OSC","Angers SCO","2-3",2,3,"1",1,5,-1,"D"
"5296",1958-02-16,1957,"UA Sedan-Torcy","AS Beziers","8-4",8,4,"1",1,12,4,"H"
"5297",1958-02-16,1957,"FC Sochaux","Nimes Olympique","1-1",1,1,"1",1,2,0,"D"
"5298",1958-02-16,1957,"Olympique Marseille","AS Saint-Etienne","1-0",1,0,"1",1,1,1,"H"
"5299",1958-02-16,1957,"Olympique Ales","RC Lens","0-1",0,1,"1",1,1,-1,"D"
"5300",1958-02-16,1957,"Olympique Lyon","OGC Nice","1-1",1,1,"1",1,2,0,"D"
"5301",1958-02-16,1957,"US Valenciennes-Anzin","Toulouse FC","2-0",2,0,"1",1,2,2,"H"
"5302",1958-02-19,1957,"Stade Reims","FC Sochaux","3-1",3,1,"1",1,4,2,"H"
"5303",1958-02-20,1957,"AS Monaco","Lille OSC","1-0",1,0,"1",1,1,1,"H"
"5304",1958-02-23,1957,"Stade Reims","Olympique Marseille","4-1",4,1,"1",1,5,3,"H"
"5305",1958-02-23,1957,"AS Saint-Etienne","AS Monaco","2-1",2,1,"1",1,3,1,"H"
"5306",1958-02-23,1957,"Angers SCO","Racing Club de France","0-0",0,0,"1",1,0,0,"D"
"5307",1958-02-23,1957,"Nimes Olympique","Lille OSC","2-0",2,0,"1",1,2,2,"H"
"5308",1958-02-23,1957,"RC Lens","US Valenciennes-Anzin","2-0",2,0,"1",1,2,2,"H"
"5309",1958-02-23,1957,"Toulouse FC","UA Sedan-Torcy","2-1",2,1,"1",1,3,1,"H"
"5310",1958-02-23,1957,"AS Beziers","Olympique Lyon","1-1",1,1,"1",1,2,0,"D"
"5311",1958-02-23,1957,"FC Metz","Olympique Ales","0-1",0,1,"1",1,1,-1,"D"
"5312",1958-02-23,1957,"OGC Nice","FC Sochaux","4-3",4,3,"1",1,7,1,"H"
"5313",1958-03-09,1957,"OGC Nice","Stade Reims","1-2",1,2,"1",1,3,-1,"D"
"5314",1958-03-09,1957,"Toulouse FC","AS Monaco","0-0",0,0,"1",1,0,0,"D"
"5315",1958-03-09,1957,"Angers SCO","FC Metz","3-1",3,1,"1",1,4,2,"H"
"5316",1958-03-09,1957,"Nimes Olympique","US Valenciennes-Anzin","5-0",5,0,"1",1,5,5,"H"
"5317",1958-03-09,1957,"UA Sedan-Torcy","Olympique Ales","5-2",5,2,"1",1,7,3,"H"
"5318",1958-03-09,1957,"FC Sochaux","AS Saint-Etienne","4-1",4,1,"1",1,5,3,"H"
"5319",1958-03-09,1957,"Olympique Lyon","RC Lens","3-1",3,1,"1",1,4,2,"H"
"5320",1958-03-09,1957,"AS Beziers","Racing Club de France","1-0",1,0,"1",1,1,1,"H"
"5321",1958-03-16,1957,"Stade Reims","Nimes Olympique","2-1",2,1,"1",1,3,1,"H"
"5322",1958-03-16,1957,"AS Monaco","UA Sedan-Torcy","1-1",1,1,"1",1,2,0,"D"
"5323",1958-03-16,1957,"Olympique Ales","Angers SCO","0-0",0,0,"1",1,0,0,"D"
"5324",1958-03-16,1957,"AS Saint-Etienne","Lille OSC","6-2",6,2,"1",1,8,4,"H"
"5325",1958-03-16,1957,"RC Lens","AS Beziers","3-1",3,1,"1",1,4,2,"H"
"5326",1958-03-16,1957,"Racing Club de France","OGC Nice","3-1",3,1,"1",1,4,2,"H"
"5327",1958-03-16,1957,"FC Metz","Olympique Lyon","2-1",2,1,"1",1,3,1,"H"
"5328",1958-03-16,1957,"US Valenciennes-Anzin","FC Sochaux","1-1",1,1,"1",1,2,0,"D"
"5329",1958-03-16,1957,"Olympique Marseille","Toulouse FC","3-0",3,0,"1",1,3,3,"H"
"5330",1958-03-23,1957,"UA Sedan-Torcy","Stade Reims","2-5",2,5,"1",1,7,-3,"D"
"5331",1958-03-23,1957,"AS Monaco","OGC Nice","1-1",1,1,"1",1,2,0,"D"
"5332",1958-03-23,1957,"Nimes Olympique","Olympique Ales","3-0",3,0,"1",1,3,3,"H"
"5333",1958-03-23,1957,"Olympique Lyon","AS Saint-Etienne","0-2",0,2,"1",1,2,-2,"D"
"5334",1958-03-23,1957,"US Valenciennes-Anzin","Angers SCO","2-1",2,1,"1",1,3,1,"H"
"5335",1958-03-23,1957,"Lille OSC","RC Lens","4-1",4,1,"1",1,5,3,"H"
"5336",1958-03-23,1957,"Toulouse FC","Racing Club de France","1-1",1,1,"1",1,2,0,"D"
"5337",1958-03-23,1957,"FC Sochaux","FC Metz","1-0",1,0,"1",1,1,1,"H"
"5338",1958-03-23,1957,"AS Beziers","Olympique Marseille","0-0",0,0,"1",1,0,0,"D"
"5339",1958-03-30,1957,"FC Metz","Stade Reims","3-1",3,1,"1",1,4,2,"H"
"5340",1958-03-30,1957,"RC Lens","AS Monaco","0-1",0,1,"1",1,1,-1,"D"
"5341",1958-03-30,1957,"Angers SCO","Nimes Olympique","1-2",1,2,"1",1,3,-1,"D"
"5342",1958-03-30,1957,"Olympique Ales","AS Saint-Etienne","0-2",0,2,"1",1,2,-2,"D"
"5343",1958-03-30,1957,"UA Sedan-Torcy","Racing Club de France","2-0",2,0,"1",1,2,2,"H"
"5344",1958-03-30,1957,"AS Beziers","Lille OSC","2-0",2,0,"1",1,2,2,"H"
"5345",1958-03-30,1957,"Toulouse FC","FC Sochaux","0-0",0,0,"1",1,0,0,"D"
"5346",1958-03-30,1957,"Olympique Lyon","Olympique Marseille","1-1",1,1,"1",1,2,0,"D"
"5347",1958-03-30,1957,"OGC Nice","US Valenciennes-Anzin","1-1",1,1,"1",1,2,0,"D"
"5348",1958-04-06,1957,"Lille OSC","Olympique Marseille","3-1",3,1,"1",1,4,2,"H"
"5349",1958-04-09,1957,"FC Metz","OGC Nice","1-1",1,1,"1",1,2,0,"D"
"5350",1958-04-13,1957,"Stade Reims","Toulouse FC","2-2",2,2,"1",1,4,0,"D"
"5351",1958-04-13,1957,"Nimes Olympique","Olympique Lyon","2-0",2,0,"1",1,2,2,"H"
"5352",1958-04-13,1957,"AS Monaco","Angers SCO","0-2",0,2,"1",1,2,-2,"D"
"5353",1958-04-13,1957,"AS Saint-Etienne","AS Beziers","1-2",1,2,"1",1,3,-1,"D"
"5354",1958-04-13,1957,"FC Sochaux","UA Sedan-Torcy","2-1",2,1,"1",1,3,1,"H"
"5355",1958-04-13,1957,"Lille OSC","OGC Nice","1-0",1,0,"1",1,1,1,"H"
"5356",1958-04-13,1957,"Olympique Marseille","RC Lens","3-2",3,2,"1",1,5,1,"H"
"5357",1958-04-13,1957,"Racing Club de France","FC Metz","1-2",1,2,"1",1,3,-1,"D"
"5358",1958-04-13,1957,"US Valenciennes-Anzin","Olympique Ales","0-0",0,0,"1",1,0,0,"D"
"5359",1958-04-20,1957,"Stade Reims","RC Lens","5-0",5,0,"1",1,5,5,"H"
"5360",1958-04-20,1957,"AS Saint-Etienne","Nimes Olympique","1-1",1,1,"1",1,2,0,"D"
"5361",1958-04-20,1957,"AS Monaco","Olympique Lyon","1-2",1,2,"1",1,3,-1,"D"
"5362",1958-04-20,1957,"Angers SCO","UA Sedan-Torcy","1-1",1,1,"1",1,2,0,"D"
"5363",1958-04-20,1957,"Lille OSC","Toulouse FC","1-3",1,3,"1",1,4,-2,"D"
"5364",1958-04-20,1957,"Olympique Ales","FC Sochaux","2-1",2,1,"1",1,3,1,"H"
"5365",1958-04-20,1957,"Racing Club de France","Olympique Marseille","4-3",4,3,"1",1,7,1,"H"
"5366",1958-04-20,1957,"AS Beziers","OGC Nice","0-1",0,1,"1",1,1,-1,"D"
"5367",1958-04-20,1957,"FC Metz","US Valenciennes-Anzin","1-0",1,0,"1",1,1,1,"H"
"5368",1958-05-01,1957,"US Valenciennes-Anzin","Stade Reims","0-6",0,6,"1",1,6,-6,"D"
"5369",1958-05-01,1957,"Nimes Olympique","FC Metz","1-1",1,1,"1",1,2,0,"D"
"5370",1958-05-01,1957,"Olympique Marseille","AS Monaco","2-1",2,1,"1",1,3,1,"H"
"5371",1958-05-01,1957,"FC Sochaux","Angers SCO","2-1",2,1,"1",1,3,1,"H"
"5372",1958-05-01,1957,"OGC Nice","AS Saint-Etienne","6-1",6,1,"1",1,7,5,"H"
"5373",1958-05-01,1957,"UA Sedan-Torcy","Lille OSC","3-2",3,2,"1",1,5,1,"H"
"5374",1958-05-01,1957,"RC Lens","Racing Club de France","1-1",1,1,"1",1,2,0,"D"
"5375",1958-05-01,1957,"Olympique Lyon","Olympique Ales","2-0",2,0,"1",1,2,2,"H"
"5376",1958-05-01,1957,"Toulouse FC","AS Beziers","3-2",3,2,"1",1,5,1,"H"
"5377",1958-05-04,1957,"AS Beziers","Stade Reims","2-0",2,0,"1",1,2,2,"H"
"5378",1958-05-04,1957,"Nimes Olympique","AS Monaco","0-0",0,0,"1",1,0,0,"D"
"5379",1958-05-04,1957,"AS Saint-Etienne","Angers SCO","0-3",0,3,"1",1,3,-3,"D"
"5380",1958-05-04,1957,"UA Sedan-Torcy","Olympique Lyon","2-3",2,3,"1",1,5,-1,"D"
"5381",1958-05-04,1957,"US Valenciennes-Anzin","Lille OSC","0-1",0,1,"1",1,1,-1,"D"
"5382",1958-05-04,1957,"Racing Club de France","Olympique Ales","3-2",3,2,"1",1,5,1,"H"
"5383",1958-05-04,1957,"RC Lens","FC Metz","2-2",2,2,"1",1,4,0,"D"
"5384",1958-05-04,1957,"FC Sochaux","Olympique Marseille","1-2",1,2,"1",1,3,-1,"D"
"5385",1958-05-04,1957,"OGC Nice","Toulouse FC","2-2",2,2,"1",1,4,0,"D"
"5386",1958-05-10,1957,"Olympique Ales","OGC Nice","1-1",1,1,"1",1,2,0,"D"
"5387",1958-05-11,1957,"Stade Reims","AS Saint-Etienne","4-0",4,0,"1",1,4,4,"H"
"5388",1958-05-11,1957,"Toulouse FC","Nimes Olympique","4-0",4,0,"1",1,4,4,"H"
"5389",1958-05-11,1957,"Angers SCO","RC Lens","5-0",5,0,"1",1,5,5,"H"
"5390",1958-05-11,1957,"AS Monaco","Racing Club de France","3-2",3,2,"1",1,5,1,"H"
"5391",1958-05-11,1957,"Olympique Marseille","UA Sedan-Torcy","1-1",1,1,"1",1,2,0,"D"
"5392",1958-05-11,1957,"Lille OSC","FC Sochaux","3-2",3,2,"1",1,5,1,"H"
"5393",1958-05-11,1957,"Olympique Lyon","US Valenciennes-Anzin","1-1",1,1,"1",1,2,0,"D"
"5394",1958-05-11,1957,"FC Metz","AS Beziers","4-0",4,0,"1",1,4,4,"H"
"5395",1958-07-21,1958,"Nimes Olympique","Racing Club de France","0-0",0,0,"1",1,0,0,"D"
"5396",1958-07-21,1958,"AS Monaco","Stade Reims","0-2",0,2,"1",1,2,-2,"D"
"5397",1958-07-21,1958,"RC Strasbourg","Olympique Ales","2-0",2,0,"1",1,2,2,"H"
"5398",1958-07-21,1958,"UA Sedan-Torcy","OGC Nice","1-0",1,0,"1",1,1,1,"H"
"5399",1958-07-21,1958,"Stade Rennes","AS Saint-Etienne","0-2",0,2,"1",1,2,-2,"D"
"5400",1958-07-21,1958,"Limoges FC","RC Lens","2-1",2,1,"1",1,3,1,"H"
"5401",1958-07-21,1958,"US Valenciennes-Anzin","Olympique Marseille","5-1",5,1,"1",1,6,4,"H"
"5402",1958-07-21,1958,"Toulouse FC","Angers SCO","1-1",1,1,"1",1,2,0,"D"
"5403",1958-07-21,1958,"Olympique Lyon","AS Nancy","1-3",1,3,"1",1,4,-2,"D"
"5404",1958-07-21,1958,"Lille OSC","FC Sochaux","3-0",3,0,"1",1,3,3,"H"
"5405",1958-08-17,1958,"RC Lens","RC Strasbourg","6-0",6,0,"1",1,6,6,"H"
"5406",1958-08-17,1958,"UA Sedan-Torcy","Racing Club de France","0-3",0,3,"1",1,3,-3,"D"
"5407",1958-08-17,1958,"AS Nancy","Stade Reims","3-5",3,5,"1",1,8,-2,"D"
"5408",1958-08-17,1958,"Olympique Marseille","OGC Nice","2-0",2,0,"1",1,2,2,"H"
"5409",1958-08-17,1958,"FC Sochaux","Olympique Ales","4-5",4,5,"1",1,9,-1,"D"
"5410",1958-08-17,1958,"Limoges FC","Olympique Lyon","1-0",1,0,"1",1,1,1,"H"
"5411",1958-08-17,1958,"AS Saint-Etienne","Nimes Olympique","0-1",0,1,"1",1,1,-1,"D"
"5412",1958-08-17,1958,"Lille OSC","Stade Rennes","4-4",4,4,"1",1,8,0,"D"
"5413",1958-08-19,1958,"Angers SCO","US Valenciennes-Anzin","4-0",4,0,"1",1,4,4,"H"
"5414",1958-08-24,1958,"AS Monaco","Olympique Lyon","4-1",4,1,"1",1,5,3,"H"
"5415",1958-08-24,1958,"Limoges FC","Olympique Marseille","1-0",1,0,"1",1,1,1,"H"
"5416",1958-08-24,1958,"Stade Rennes","RC Lens","1-1",1,1,"1",1,2,0,"D"
"5417",1958-08-24,1958,"Racing Club de France","AS Nancy","4-4",4,4,"1",1,8,0,"D"
"5418",1958-08-24,1958,"Nimes Olympique","OGC Nice","1-1",1,1,"1",1,2,0,"D"
"5419",1958-08-24,1958,"RC Strasbourg","Angers SCO","4-2",4,2,"1",1,6,2,"H"
"5420",1958-08-24,1958,"US Valenciennes-Anzin","Stade Reims","3-1",3,1,"1",1,4,2,"H"
"5421",1958-08-24,1958,"AS Saint-Etienne","Olympique Ales","1-0",1,0,"1",1,1,1,"H"
"5422",1958-08-24,1958,"UA Sedan-Torcy","Lille OSC","1-1",1,1,"1",1,2,0,"D"
"5423",1958-08-24,1958,"Toulouse FC","FC Sochaux","1-1",1,1,"1",1,2,0,"D"
"5424",1958-08-27,1958,"Lille OSC","Racing Club de France","1-6",1,6,"1",1,7,-5,"D"
"5425",1958-08-27,1958,"RC Lens","US Valenciennes-Anzin","2-0",2,0,"1",1,2,2,"H"
"5426",1958-08-27,1958,"Stade Reims","Stade Rennes","4-0",4,0,"1",1,4,4,"H"
"5427",1958-08-27,1958,"Angers SCO","UA Sedan-Torcy","3-1",3,1,"1",1,4,2,"H"
"5428",1958-08-27,1958,"Olympique Ales","AS Monaco","2-1",2,1,"1",1,3,1,"H"
"5429",1958-08-27,1958,"OGC Nice","Limoges FC","3-1",3,1,"1",1,4,2,"H"
"5430",1958-08-27,1958,"AS Nancy","RC Strasbourg","0-1",0,1,"1",1,1,-1,"D"
"5431",1958-08-27,1958,"Toulouse FC","Olympique Marseille","3-0",3,0,"1",1,3,3,"H"
"5432",1958-08-27,1958,"FC Sochaux","AS Saint-Etienne","3-1",3,1,"1",1,4,2,"H"
"5433",1958-08-27,1958,"Olympique Lyon","Nimes Olympique","2-1",2,1,"1",1,3,1,"H"
"5434",1958-08-31,1958,"Racing Club de France","RC Lens","5-0",5,0,"1",1,5,5,"H"
"5435",1958-08-31,1958,"AS Saint-Etienne","AS Monaco","3-5",3,5,"1",1,8,-2,"D"
"5436",1958-08-31,1958,"Limoges FC","Nimes Olympique","3-2",3,2,"1",1,5,1,"H"
"5437",1958-08-31,1958,"OGC Nice","Toulouse FC","3-2",3,2,"1",1,5,1,"H"
"5438",1958-08-31,1958,"Stade Rennes","Angers SCO","3-2",3,2,"1",1,5,1,"H"
"5439",1958-08-31,1958,"Olympique Marseille","FC Sochaux","0-0",0,0,"1",1,0,0,"D"
"5440",1958-08-31,1958,"Olympique Ales","Olympique Lyon","1-2",1,2,"1",1,3,-1,"D"
"5441",1958-08-31,1958,"US Valenciennes-Anzin","RC Strasbourg","4-1",4,1,"1",1,5,3,"H"
"5442",1958-08-31,1958,"UA Sedan-Torcy","AS Nancy","1-2",1,2,"1",1,3,-1,"D"
"5443",1958-09-03,1958,"Stade Reims","Lille OSC","4-3",4,3,"1",1,7,1,"H"
"5444",1958-09-04,1958,"AS Monaco","Toulouse FC","1-0",1,0,"1",1,1,1,"H"
"5445",1958-09-07,1958,"Toulouse FC","Racing Club de France","1-1",1,1,"1",1,2,0,"D"
"5446",1958-09-07,1958,"Olympique Lyon","Stade Reims","1-5",1,5,"1",1,6,-4,"D"
"5447",1958-09-07,1958,"AS Monaco","US Valenciennes-Anzin","2-1",2,1,"1",1,3,1,"H"
"5448",1958-09-07,1958,"Angers SCO","OGC Nice","1-2",1,2,"1",1,3,-1,"D"
"5449",1958-09-07,1958,"Limoges FC","AS Nancy","0-0",0,0,"1",1,0,0,"D"
"5450",1958-09-07,1958,"RC Lens","Olympique Ales","2-4",2,4,"1",1,6,-2,"D"
"5451",1958-09-07,1958,"Stade Rennes","FC Sochaux","4-0",4,0,"1",1,4,4,"H"
"5452",1958-09-07,1958,"RC Strasbourg","Olympique Marseille","3-1",3,1,"1",1,4,2,"H"
"5453",1958-09-07,1958,"Nimes Olympique","Lille OSC","3-0",3,0,"1",1,3,3,"H"
"5454",1958-09-07,1958,"UA Sedan-Torcy","AS Saint-Etienne","5-0",5,0,"1",1,5,5,"H"
"5455",1958-09-10,1958,"Angers SCO","Racing Club de France","1-2",1,2,"1",1,3,-1,"D"
"5456",1958-09-10,1958,"AS Monaco","Nimes Olympique","1-1",1,1,"1",1,2,0,"D"
"5457",1958-09-10,1958,"RC Lens","Stade Reims","2-1",2,1,"1",1,3,1,"H"
"5458",1958-09-10,1958,"Olympique Ales","OGC Nice","0-0",0,0,"1",1,0,0,"D"
"5459",1958-09-10,1958,"Lille OSC","RC Strasbourg","2-3",2,3,"1",1,5,-1,"D"
"5460",1958-09-10,1958,"UA Sedan-Torcy","Stade Rennes","1-1",1,1,"1",1,2,0,"D"
"5461",1958-09-10,1958,"FC Sochaux","Limoges FC","3-1",3,1,"1",1,4,2,"H"
"5462",1958-09-10,1958,"AS Nancy","US Valenciennes-Anzin","1-1",1,1,"1",1,2,0,"D"
"5463",1958-09-10,1958,"Olympique Marseille","Olympique Lyon","1-1",1,1,"1",1,2,0,"D"
"5464",1958-09-11,1958,"AS Saint-Etienne","Toulouse FC","4-3",4,3,"1",1,7,1,"H"
"5465",1958-09-14,1958,"Racing Club de France","Olympique Lyon","2-2",2,2,"1",1,4,0,"D"
"5466",1958-09-14,1958,"Stade Reims","Nimes Olympique","3-1",3,1,"1",1,4,2,"H"
"5467",1958-09-14,1958,"Lille OSC","AS Monaco","2-2",2,2,"1",1,4,0,"D"
"5468",1958-09-14,1958,"OGC Nice","RC Lens","3-1",3,1,"1",1,4,2,"H"
"5469",1958-09-14,1958,"AS Saint-Etienne","RC Strasbourg","1-5",1,5,"1",1,6,-4,"D"
"5470",1958-09-14,1958,"Olympique Marseille","Stade Rennes","1-3",1,3,"1",1,4,-2,"D"
"5471",1958-09-14,1958,"Olympique Ales","UA Sedan-Torcy","1-1",1,1,"1",1,2,0,"D"
"5472",1958-09-14,1958,"FC Sochaux","US Valenciennes-Anzin","1-1",1,1,"1",1,2,0,"D"
"5473",1958-09-14,1958,"Angers SCO","Limoges FC","4-0",4,0,"1",1,4,4,"H"
"5474",1958-09-14,1958,"AS Nancy","Toulouse FC","0-1",0,1,"1",1,1,-1,"D"
"5475",1958-09-24,1958,"Racing Club de France","Stade Rennes","1-0",1,0,"1",1,1,1,"H"
"5476",1958-09-24,1958,"Stade Reims","RC Strasbourg","2-3",2,3,"1",1,5,-1,"D"
"5477",1958-09-24,1958,"Limoges FC","AS Saint-Etienne","4-0",4,0,"1",1,4,4,"H"
"5478",1958-09-24,1958,"US Valenciennes-Anzin","UA Sedan-Torcy","1-1",1,1,"1",1,2,0,"D"
"5479",1958-09-24,1958,"AS Nancy","Angers SCO","3-2",3,2,"1",1,5,1,"H"
"5480",1958-09-24,1958,"RC Lens","Lille OSC","2-2",2,2,"1",1,4,0,"D"
"5481",1958-09-25,1958,"Olympique Marseille","Olympique Ales","2-1",2,1,"1",1,3,1,"H"
"5482",1958-09-25,1958,"Nimes Olympique","Toulouse FC","3-1",3,1,"1",1,4,2,"H"
"5483",1958-09-25,1958,"Olympique Lyon","OGC Nice","1-0",1,0,"1",1,1,1,"H"
"5484",1958-09-25,1958,"AS Monaco","FC Sochaux","1-0",1,0,"1",1,1,1,"H"
"5485",1958-09-27,1958,"RC Strasbourg","Stade Rennes","0-1",0,1,"1",1,1,-1,"D"
"5486",1958-09-27,1958,"Angers SCO","Stade Reims","3-0",3,0,"1",1,3,3,"H"
"5487",1958-09-27,1958,"Lille OSC","AS Nancy","2-0",2,0,"1",1,2,2,"H"
"5488",1958-09-27,1958,"AS Saint-Etienne","Olympique Marseille","4-2",4,2,"1",1,6,2,"H"
"5489",1958-09-28,1958,"Racing Club de France","US Valenciennes-Anzin","3-0",3,0,"1",1,3,3,"H"
"5490",1958-09-28,1958,"OGC Nice","AS Monaco","2-0",2,0,"1",1,2,2,"H"
"5491",1958-09-28,1958,"Olympique Ales","Nimes Olympique","0-4",0,4,"1",1,4,-4,"D"
"5492",1958-09-28,1958,"Toulouse FC","Limoges FC","2-1",2,1,"1",1,3,1,"H"
"5493",1958-09-28,1958,"UA Sedan-Torcy","RC Lens","1-2",1,2,"1",1,3,-1,"D"
"5494",1958-09-28,1958,"FC Sochaux","Olympique Lyon","5-3",5,3,"1",1,8,2,"H"
"5495",1958-10-05,1958,"OGC Nice","AS Nancy","3-0",3,0,"1",1,3,3,"H"
"5496",1958-10-05,1958,"FC Sochaux","RC Strasbourg","3-0",3,0,"1",1,3,3,"H"
"5497",1958-10-05,1958,"Stade Rennes","AS Monaco","2-1",2,1,"1",1,3,1,"H"
"5498",1958-10-05,1958,"US Valenciennes-Anzin","Nimes Olympique","0-0",0,0,"1",1,0,0,"D"
"5499",1958-10-05,1958,"AS Saint-Etienne","RC Lens","3-0",3,0,"1",1,3,3,"H"
"5500",1958-10-05,1958,"Lille OSC","Olympique Lyon","2-1",2,1,"1",1,3,1,"H"
"5501",1958-10-05,1958,"Olympique Marseille","UA Sedan-Torcy","1-1",1,1,"1",1,2,0,"D"
"5502",1958-10-12,1958,"Racing Club de France","OGC Nice","1-1",1,1,"1",1,2,0,"D"
"5503",1958-10-12,1958,"Stade Reims","Limoges FC","1-0",1,0,"1",1,1,1,"H"
"5504",1958-10-12,1958,"Nimes Olympique","Stade Rennes","3-0",3,0,"1",1,3,3,"H"
"5505",1958-10-12,1958,"AS Monaco","RC Strasbourg","2-1",2,1,"1",1,3,1,"H"
"5506",1958-10-12,1958,"UA Sedan-Torcy","FC Sochaux","0-1",0,1,"1",1,1,-1,"D"
"5507",1958-10-12,1958,"RC Lens","Olympique Marseille","4-1",4,1,"1",1,5,3,"H"
"5508",1958-10-12,1958,"Angers SCO","AS Saint-Etienne","0-1",0,1,"1",1,1,-1,"D"
"5509",1958-10-12,1958,"Toulouse FC","Lille OSC","3-1",3,1,"1",1,4,2,"H"
"5510",1958-10-12,1958,"Olympique Lyon","US Valenciennes-Anzin","2-2",2,2,"1",1,4,0,"D"
"5511",1958-10-12,1958,"AS Nancy","Olympique Ales","3-0",3,0,"1",1,3,3,"H"
"5512",1958-10-19,1958,"Olympique Ales","Racing Club de France","1-1",1,1,"1",1,2,0,"D"
"5513",1958-10-19,1958,"Stade Reims","OGC Nice","1-2",1,2,"1",1,3,-1,"D"
"5514",1958-10-19,1958,"RC Strasbourg","Nimes Olympique","1-5",1,5,"1",1,6,-4,"D"
"5515",1958-10-19,1958,"FC Sochaux","RC Lens","2-1",2,1,"1",1,3,1,"H"
"5516",1958-10-19,1958,"AS Monaco","UA Sedan-Torcy","0-3",0,3,"1",1,3,-3,"D"
"5517",1958-10-19,1958,"AS Saint-Etienne","AS Nancy","4-0",4,0,"1",1,4,4,"H"
"5518",1958-10-19,1958,"US Valenciennes-Anzin","Toulouse FC","2-0",2,0,"1",1,2,2,"H"
"5519",1958-10-19,1958,"Stade Rennes","Olympique Lyon","2-4",2,4,"1",1,6,-2,"D"
"5520",1958-10-19,1958,"Lille OSC","Limoges FC","2-0",2,0,"1",1,2,2,"H"
"5521",1958-10-19,1958,"Olympique Marseille","Angers SCO","2-3",2,3,"1",1,5,-1,"D"
"5522",1958-10-26,1958,"Olympique Ales","Angers SCO","1-3",1,3,"1",1,4,-2,"D"
"5523",1958-10-29,1958,"Stade Reims","Toulouse FC","3-1",3,1,"1",1,4,2,"H"
"5524",1958-10-30,1958,"Limoges FC","Racing Club de France","1-1",1,1,"1",1,2,0,"D"
"5525",1958-11-02,1958,"Racing Club de France","RC Strasbourg","5-2",5,2,"1",1,7,3,"H"
"5526",1958-11-02,1958,"OGC Nice","AS Saint-Etienne","1-0",1,0,"1",1,1,1,"H"
"5527",1958-11-02,1958,"Nimes Olympique","FC Sochaux","2-1",2,1,"1",1,3,1,"H"
"5528",1958-11-02,1958,"UA Sedan-Torcy","Stade Reims","0-0",0,0,"1",1,0,0,"D"
"5529",1958-11-02,1958,"Olympique Marseille","AS Monaco","0-2",0,2,"1",1,2,-2,"D"
"5530",1958-11-02,1958,"Stade Rennes","AS Nancy","3-1",3,1,"1",1,4,2,"H"
"5531",1958-11-02,1958,"RC Lens","Angers SCO","1-1",1,1,"1",1,2,0,"D"
"5532",1958-11-02,1958,"Lille OSC","US Valenciennes-Anzin","6-1",6,1,"1",1,7,5,"H"
"5533",1958-11-02,1958,"Limoges FC","Olympique Ales","2-2",2,2,"1",1,4,0,"D"
"5534",1958-11-02,1958,"Toulouse FC","Olympique Lyon","0-1",0,1,"1",1,1,-1,"D"
"5535",1958-11-09,1958,"Toulouse FC","Olympique Ales","4-2",4,2,"1",1,6,2,"H"
"5536",1958-11-11,1958,"Stade Reims","Racing Club de France","0-0",0,0,"1",1,0,0,"D"
"5537",1958-11-11,1958,"Nimes Olympique","Olympique Marseille","1-1",1,1,"1",1,2,0,"D"
"5538",1958-11-11,1958,"FC Sochaux","OGC Nice","1-0",1,0,"1",1,1,1,"H"
"5539",1958-11-11,1958,"AS Monaco","Limoges FC","0-0",0,0,"1",1,0,0,"D"
"5540",1958-11-11,1958,"Angers SCO","Lille OSC","2-0",2,0,"1",1,2,2,"H"
"5541",1958-11-11,1958,"US Valenciennes-Anzin","Stade Rennes","1-1",1,1,"1",1,2,0,"D"
"5542",1958-11-11,1958,"Olympique Lyon","AS Saint-Etienne","2-0",2,0,"1",1,2,2,"H"
"5543",1958-11-11,1958,"RC Strasbourg","UA Sedan-Torcy","1-3",1,3,"1",1,4,-2,"D"
"5544",1958-11-11,1958,"AS Nancy","RC Lens","2-1",2,1,"1",1,3,1,"H"
"5545",1958-11-16,1958,"Racing Club de France","AS Saint-Etienne","2-2",2,2,"1",1,4,0,"D"
"5546",1958-11-16,1958,"UA Sedan-Torcy","Nimes Olympique","1-2",1,2,"1",1,3,-1,"D"
"5547",1958-11-16,1958,"OGC Nice","Lille OSC","2-1",2,1,"1",1,3,1,"H"
"5548",1958-11-16,1958,"Olympique Ales","Stade Reims","3-6",3,6,"1",1,9,-3,"D"
"5549",1958-11-16,1958,"Angers SCO","FC Sochaux","1-1",1,1,"1",1,2,0,"D"
"5550",1958-11-16,1958,"Toulouse FC","Stade Rennes","1-1",1,1,"1",1,2,0,"D"
"5551",1958-11-16,1958,"Limoges FC","US Valenciennes-Anzin","1-0",1,0,"1",1,1,1,"H"
"5552",1958-11-16,1958,"Olympique Lyon","RC Strasbourg","2-2",2,2,"1",1,4,0,"D"
"5553",1958-11-16,1958,"AS Nancy","Olympique Marseille","2-2",2,2,"1",1,4,0,"D"
"5554",1958-11-23,1958,"Olympique Marseille","Racing Club de France","1-2",1,2,"1",1,3,-1,"D"
"5555",1958-11-23,1958,"Nimes Olympique","RC Lens","4-2",4,2,"1",1,6,2,"H"
"5556",1958-11-23,1958,"AS Saint-Etienne","Stade Reims","4-4",4,4,"1",1,8,0,"D"
"5557",1958-11-23,1958,"US Valenciennes-Anzin","OGC Nice","2-1",2,1,"1",1,3,1,"H"
"5558",1958-11-23,1958,"FC Sochaux","AS Nancy","2-1",2,1,"1",1,3,1,"H"
"5559",1958-11-23,1958,"AS Monaco","Angers SCO","1-0",1,0,"1",1,1,1,"H"
"5560",1958-11-23,1958,"Stade Rennes","Limoges FC","0-1",0,1,"1",1,1,-1,"D"
"5561",1958-11-23,1958,"Olympique Lyon","UA Sedan-Torcy","4-3",4,3,"1",1,7,1,"H"
"5562",1958-11-23,1958,"Lille OSC","Olympique Ales","5-0",5,0,"1",1,5,5,"H"
"5563",1958-11-23,1958,"RC Strasbourg","Toulouse FC","1-2",1,2,"1",1,3,-1,"D"
"5564",1958-11-30,1958,"Racing Club de France","FC Sochaux","0-2",0,2,"1",1,2,-2,"D"
"5565",1958-11-30,1958,"Angers SCO","Nimes Olympique","1-1",1,1,"1",1,2,0,"D"
"5566",1958-11-30,1958,"Stade Reims","Olympique Marseille","2-1",2,1,"1",1,3,1,"H"
"5567",1958-11-30,1958,"OGC Nice","Stade Rennes","2-0",2,0,"1",1,2,2,"H"
"5568",1958-11-30,1958,"AS Nancy","AS Monaco","2-2",2,2,"1",1,4,0,"D"
"5569",1958-11-30,1958,"Limoges FC","RC Strasbourg","1-2",1,2,"1",1,3,-1,"D"
"5570",1958-11-30,1958,"RC Lens","Olympique Lyon","2-1",2,1,"1",1,3,1,"H"
"5571",1958-11-30,1958,"AS Saint-Etienne","Lille OSC","1-0",1,0,"1",1,1,1,"H"
"5572",1958-11-30,1958,"UA Sedan-Torcy","Toulouse FC","1-1",1,1,"1",1,2,0,"D"
"5573",1958-11-30,1958,"Olympique Ales","US Valenciennes-Anzin","3-0",3,0,"1",1,3,3,"H"
"5574",1958-12-07,1958,"Nimes Olympique","AS Nancy","1-0",1,0,"1",1,1,1,"H"
"5575",1958-12-07,1958,"AS Monaco","Racing Club de France","4-1",4,1,"1",1,5,3,"H"
"5576",1958-12-07,1958,"RC Strasbourg","OGC Nice","2-2",2,2,"1",1,4,0,"D"
"5577",1958-12-07,1958,"Stade Reims","FC Sochaux","1-3",1,3,"1",1,4,-2,"D"
"5578",1958-12-07,1958,"Olympique Lyon","Angers SCO","1-0",1,0,"1",1,1,1,"H"
"5579",1958-12-07,1958,"Toulouse FC","RC Lens","3-1",3,1,"1",1,4,2,"H"
"5580",1958-12-07,1958,"Stade Rennes","Olympique Ales","4-2",4,2,"1",1,6,2,"H"
"5581",1958-12-07,1958,"Limoges FC","UA Sedan-Torcy","1-1",1,1,"1",1,2,0,"D"
"5582",1958-12-14,1958,"RC Strasbourg","Racing Club de France","0-2",0,2,"1",1,2,-2,"D"
"5583",1958-12-14,1958,"OGC Nice","Nimes Olympique","2-0",2,0,"1",1,2,2,"H"
"5584",1958-12-14,1958,"FC Sochaux","Toulouse FC","2-2",2,2,"1",1,4,0,"D"
"5585",1958-12-14,1958,"Stade Reims","UA Sedan-Torcy","1-1",1,1,"1",1,2,0,"D"
"5586",1958-12-14,1958,"Olympique Lyon","AS Monaco","4-1",4,1,"1",1,5,3,"H"
"5587",1958-12-14,1958,"Angers SCO","RC Lens","2-2",2,2,"1",1,4,0,"D"
"5588",1958-12-14,1958,"AS Nancy","Stade Rennes","2-1",2,1,"1",1,3,1,"H"
"5589",1958-12-14,1958,"Olympique Marseille","Limoges FC","2-0",2,0,"1",1,2,2,"H"
"5590",1958-12-14,1958,"Olympique Ales","AS Saint-Etienne","1-1",1,1,"1",1,2,0,"D"
"5591",1958-12-14,1958,"US Valenciennes-Anzin","Lille OSC","3-2",3,2,"1",1,5,1,"H"
"5592",1958-12-17,1958,"RC Lens","AS Monaco","2-1",2,1,"1",1,3,1,"H"
"5593",1958-12-21,1958,"Nimes Olympique","Olympique Lyon","4-1",4,1,"1",1,5,3,"H"
"5594",1958-12-21,1958,"Limoges FC","OGC Nice","0-2",0,2,"1",1,2,-2,"D"
"5595",1958-12-21,1958,"Racing Club de France","Stade Reims","0-1",0,1,"1",1,1,-1,"D"
"5596",1958-12-21,1958,"AS Saint-Etienne","FC Sochaux","4-3",4,3,"1",1,7,1,"H"
"5597",1958-12-21,1958,"Olympique Marseille","Toulouse FC","1-1",1,1,"1",1,2,0,"D"
"5598",1958-12-21,1958,"Stade Rennes","US Valenciennes-Anzin","4-0",4,0,"1",1,4,4,"H"
"5599",1958-12-21,1958,"Lille OSC","Angers SCO","1-1",1,1,"1",1,2,0,"D"
"5600",1958-12-21,1958,"UA Sedan-Torcy","RC Strasbourg","1-3",1,3,"1",1,4,-2,"D"
"5601",1958-12-21,1958,"RC Lens","AS Nancy","2-4",2,4,"1",1,6,-2,"D"
"5602",1958-12-28,1958,"Nimes Olympique","AS Saint-Etienne","2-1",2,1,"1",1,3,1,"H"
"5603",1958-12-28,1958,"OGC Nice","Olympique Marseille","6-1",6,1,"1",1,7,5,"H"
"5604",1958-12-28,1958,"Stade Reims","AS Nancy","7-1",7,1,"1",1,8,6,"H"
"5605",1958-12-28,1958,"Racing Club de France","UA Sedan-Torcy","1-1",1,1,"1",1,2,0,"D"
"5606",1958-12-28,1958,"Olympique Ales","FC Sochaux","2-1",2,1,"1",1,3,1,"H"
"5607",1958-12-28,1958,"Toulouse FC","AS Monaco","1-2",1,2,"1",1,3,-1,"D"
"5608",1958-12-28,1958,"Olympique Lyon","Limoges FC","2-1",2,1,"1",1,3,1,"H"
"5609",1958-12-28,1958,"Stade Rennes","Lille OSC","3-0",3,0,"1",1,3,3,"H"
"5610",1958-12-28,1958,"RC Strasbourg","RC Lens","1-0",1,0,"1",1,1,1,"H"
"5611",1958-12-28,1958,"US Valenciennes-Anzin","Angers SCO","4-0",4,0,"1",1,4,4,"H"
"5612",1959-01-01,1958,"AS Monaco","Olympique Ales","1-1",1,1,"1",1,2,0,"D"
"5613",1959-01-04,1958,"OGC Nice","UA Sedan-Torcy","3-1",3,1,"1",1,4,2,"H"
"5614",1959-01-04,1958,"Racing Club de France","Nimes Olympique","2-2",2,2,"1",1,4,0,"D"
"5615",1959-01-04,1958,"Stade Reims","AS Monaco","3-2",3,2,"1",1,5,1,"H"
"5616",1959-01-04,1958,"FC Sochaux","Lille OSC","2-3",2,3,"1",1,5,-1,"D"
"5617",1959-01-04,1958,"AS Saint-Etienne","Stade Rennes","2-2",2,2,"1",1,4,0,"D"
"5618",1959-01-04,1958,"AS Nancy","Olympique Lyon","4-3",4,3,"1",1,7,1,"H"
"5619",1959-01-04,1958,"Angers SCO","Toulouse FC","3-1",3,1,"1",1,4,2,"H"
"5620",1959-01-04,1958,"Olympique Ales","RC Strasbourg","1-0",1,0,"1",1,1,1,"H"
"5621",1959-01-04,1958,"Olympique Marseille","US Valenciennes-Anzin","3-1",3,1,"1",1,4,2,"H"
"5622",1959-01-04,1958,"RC Lens","Limoges FC","1-1",1,1,"1",1,2,0,"D"
"5623",1959-01-18,1958,"OGC Nice","Racing Club de France","3-2",3,2,"1",1,5,1,"H"
"5624",1959-01-18,1958,"Stade Rennes","Nimes Olympique","1-2",1,2,"1",1,3,-1,"D"
"5625",1959-01-18,1958,"FC Sochaux","UA Sedan-Torcy","2-2",2,2,"1",1,4,0,"D"
"5626",1959-01-18,1958,"AS Saint-Etienne","Angers SCO","1-1",1,1,"1",1,2,0,"D"
"5627",1959-01-18,1958,"Olympique Ales","AS Nancy","0-3",0,3,"1",1,3,-3,"D"
"5628",1959-01-18,1958,"Olympique Marseille","RC Lens","0-2",0,2,"1",1,2,-2,"D"
"5629",1959-01-22,1958,"US Valenciennes-Anzin","AS Saint-Etienne","3-1",3,1,"1",1,4,2,"H"
"5630",1959-01-22,1958,"Lille OSC","Olympique Marseille","2-2",2,2,"1",1,4,0,"D"
"5631",1959-01-25,1958,"AS Nancy","OGC Nice","3-6",3,6,"1",1,9,-3,"D"
"5632",1959-01-25,1958,"Nimes Olympique","US Valenciennes-Anzin","2-0",2,0,"1",1,2,2,"H"
"5633",1959-01-25,1958,"Toulouse FC","Stade Reims","1-1",1,1,"1",1,2,0,"D"
"5634",1959-01-25,1958,"Racing Club de France","Limoges FC","4-1",4,1,"1",1,5,3,"H"
"5635",1959-01-25,1958,"AS Monaco","Stade Rennes","1-0",1,0,"1",1,1,1,"H"
"5636",1959-01-25,1958,"RC Strasbourg","FC Sochaux","2-1",2,1,"1",1,3,1,"H"
"5637",1959-01-25,1958,"Olympique Lyon","Lille OSC","1-0",1,0,"1",1,1,1,"H"
"5638",1959-01-25,1958,"Angers SCO","Olympique Ales","1-0",1,0,"1",1,1,1,"H"
"5639",1959-01-25,1958,"RC Lens","AS Saint-Etienne","0-2",0,2,"1",1,2,-2,"D"
"5640",1959-01-25,1958,"UA Sedan-Torcy","Olympique Marseille","6-1",6,1,"1",1,7,5,"H"
"5641",1959-02-08,1958,"Nimes Olympique","Olympique Ales","3-0",3,0,"1",1,3,3,"H"
"5642",1959-02-08,1958,"AS Monaco","OGC Nice","1-1",1,1,"1",1,2,0,"D"
"5643",1959-02-08,1958,"Stade Reims","Angers SCO","1-1",1,1,"1",1,2,0,"D"
"5644",1959-02-08,1958,"US Valenciennes-Anzin","Racing Club de France","1-0",1,0,"1",1,1,1,"H"
"5645",1959-02-08,1958,"Olympique Lyon","FC Sochaux","2-0",2,0,"1",1,2,2,"H"
"5646",1959-02-08,1958,"Stade Rennes","RC Strasbourg","2-2",2,2,"1",1,4,0,"D"
"5647",1959-02-08,1958,"Olympique Marseille","AS Saint-Etienne","4-1",4,1,"1",1,5,3,"H"
"5648",1959-02-08,1958,"AS Nancy","Lille OSC","1-1",1,1,"1",1,2,0,"D"
"5649",1959-02-08,1958,"RC Lens","UA Sedan-Torcy","0-2",0,2,"1",1,2,-2,"D"
"5650",1959-02-08,1958,"Limoges FC","Toulouse FC","0-0",0,0,"1",1,0,0,"D"
"5651",1959-02-15,1958,"Toulouse FC","Nimes Olympique","2-4",2,4,"1",1,6,-2,"D"
"5652",1959-02-15,1958,"OGC Nice","Olympique Lyon","2-0",2,0,"1",1,2,2,"H"
"5653",1959-02-15,1958,"RC Strasbourg","Stade Reims","0-2",0,2,"1",1,2,-2,"D"
"5654",1959-02-15,1958,"Stade Rennes","Racing Club de France","0-1",0,1,"1",1,1,-1,"D"
"5655",1959-02-15,1958,"Angers SCO","AS Nancy","4-2",4,2,"1",1,6,2,"H"
"5656",1959-02-15,1958,"FC Sochaux","AS Monaco","3-2",3,2,"1",1,5,1,"H"
"5657",1959-02-15,1958,"AS Saint-Etienne","Limoges FC","2-1",2,1,"1",1,3,1,"H"
"5658",1959-02-15,1958,"UA Sedan-Torcy","US Valenciennes-Anzin","4-0",4,0,"1",1,4,4,"H"
"5659",1959-02-15,1958,"Lille OSC","RC Lens","1-1",1,1,"1",1,2,0,"D"
"5660",1959-02-15,1958,"Olympique Ales","Olympique Marseille","2-1",2,1,"1",1,3,1,"H"
"5661",1959-03-04,1958,"US Valenciennes-Anzin","Olympique Lyon","1-0",1,0,"1",1,1,1,"H"
"5662",1959-03-05,1958,"Limoges FC","Stade Reims","2-2",2,2,"1",1,4,0,"D"
"5663",1959-03-05,1958,"RC Strasbourg","AS Monaco","1-1",1,1,"1",1,2,0,"D"
"5664",1959-03-08,1958,"OGC Nice","Stade Reims","4-0",4,0,"1",1,4,4,"H"
"5665",1959-03-08,1958,"Nimes Olympique","RC Strasbourg","1-1",1,1,"1",1,2,0,"D"
"5666",1959-03-08,1958,"Racing Club de France","Olympique Ales","5-2",5,2,"1",1,7,3,"H"
"5667",1959-03-08,1958,"Angers SCO","Olympique Marseille","3-2",3,2,"1",1,5,1,"H"
"5668",1959-03-08,1958,"UA Sedan-Torcy","AS Monaco","2-2",2,2,"1",1,4,0,"D"
"5669",1959-03-08,1958,"Olympique Lyon","Stade Rennes","5-2",5,2,"1",1,7,3,"H"
"5670",1959-03-08,1958,"AS Nancy","AS Saint-Etienne","0-1",0,1,"1",1,1,-1,"D"
"5671",1959-03-08,1958,"RC Lens","FC Sochaux","3-2",3,2,"1",1,5,1,"H"
"5672",1959-03-08,1958,"Toulouse FC","US Valenciennes-Anzin","1-2",1,2,"1",1,3,-1,"D"
"5673",1959-03-08,1958,"Limoges FC","Lille OSC","5-0",5,0,"1",1,5,5,"H"
"5674",1959-03-12,1958,"Lille OSC","Toulouse FC","3-2",3,2,"1",1,5,1,"H"
"5675",1959-03-15,1958,"Lille OSC","OGC Nice","0-0",0,0,"1",1,0,0,"D"
"5676",1959-03-15,1958,"Nimes Olympique","UA Sedan-Torcy","2-2",2,2,"1",1,4,0,"D"
"5677",1959-03-15,1958,"AS Saint-Etienne","Racing Club de France","3-3",3,3,"1",1,6,0,"D"
"5678",1959-03-15,1958,"Stade Reims","Olympique Ales","1-1",1,1,"1",1,2,0,"D"
"5679",1959-03-15,1958,"AS Monaco","RC Lens","0-0",0,0,"1",1,0,0,"D"
"5680",1959-03-15,1958,"FC Sochaux","Angers SCO","2-1",2,1,"1",1,3,1,"H"
"5681",1959-03-15,1958,"RC Strasbourg","Olympique Lyon","3-0",3,0,"1",1,3,3,"H"
"5682",1959-03-15,1958,"US Valenciennes-Anzin","Limoges FC","2-3",2,3,"1",1,5,-1,"D"
"5683",1959-03-15,1958,"Stade Rennes","Toulouse FC","3-0",3,0,"1",1,3,3,"H"
"5684",1959-03-15,1958,"Olympique Marseille","AS Nancy","4-2",4,2,"1",1,6,2,"H"
"5685",1959-03-29,1958,"OGC Nice","US Valenciennes-Anzin","1-0",1,0,"1",1,1,1,"H"
"5686",1959-03-29,1958,"RC Lens","Nimes Olympique","0-1",0,1,"1",1,1,-1,"D"
"5687",1959-03-29,1958,"Racing Club de France","Olympique Marseille","2-1",2,1,"1",1,3,1,"H"
"5688",1959-03-29,1958,"Stade Reims","AS Saint-Etienne","3-0",3,0,"1",1,3,3,"H"
"5689",1959-03-29,1958,"Angers SCO","AS Monaco","0-0",0,0,"1",1,0,0,"D"
"5690",1959-03-29,1958,"AS Nancy","FC Sochaux","2-2",2,2,"1",1,4,0,"D"
"5691",1959-03-29,1958,"UA Sedan-Torcy","Olympique Lyon","3-1",3,1,"1",1,4,2,"H"
"5692",1959-03-29,1958,"Limoges FC","Stade Rennes","2-4",2,4,"1",1,6,-2,"D"
"5693",1959-03-29,1958,"Toulouse FC","RC Strasbourg","5-1",5,1,"1",1,6,4,"H"
"5694",1959-03-29,1958,"Olympique Ales","Lille OSC","1-2",1,2,"1",1,3,-1,"D"
"5695",1959-04-05,1958,"Stade Rennes","OGC Nice","0-3",0,3,"1",1,3,-3,"D"
"5696",1959-04-05,1958,"Nimes Olympique","Angers SCO","5-3",5,3,"1",1,8,2,"H"
"5697",1959-04-05,1958,"Olympique Marseille","Stade Reims","2-3",2,3,"1",1,5,-1,"D"
"5698",1959-04-05,1958,"FC Sochaux","Racing Club de France","1-1",1,1,"1",1,2,0,"D"
"5699",1959-04-05,1958,"AS Monaco","AS Nancy","1-0",1,0,"1",1,1,1,"H"
"5700",1959-04-05,1958,"Olympique Lyon","RC Lens","2-0",2,0,"1",1,2,2,"H"
"5701",1959-04-05,1958,"Lille OSC","AS Saint-Etienne","2-4",2,4,"1",1,6,-2,"D"
"5702",1959-04-05,1958,"US Valenciennes-Anzin","Olympique Ales","1-0",1,0,"1",1,1,1,"H"
"5703",1959-04-05,1958,"RC Strasbourg","Limoges FC","1-1",1,1,"1",1,2,0,"D"
"5704",1959-04-05,1958,"Toulouse FC","UA Sedan-Torcy","4-1",4,1,"1",1,5,3,"H"
"5705",1959-04-19,1958,"OGC Nice","RC Strasbourg","4-2",4,2,"1",1,6,2,"H"
"5706",1959-04-19,1958,"AS Nancy","Nimes Olympique","2-1",2,1,"1",1,3,1,"H"
"5707",1959-04-19,1958,"Racing Club de France","AS Monaco","2-0",2,0,"1",1,2,2,"H"
"5708",1959-04-19,1958,"FC Sochaux","Stade Reims","3-1",3,1,"1",1,4,2,"H"
"5709",1959-04-19,1958,"Angers SCO","Olympique Lyon","3-1",3,1,"1",1,4,2,"H"
"5710",1959-04-19,1958,"AS Saint-Etienne","US Valenciennes-Anzin","1-1",1,1,"1",1,2,0,"D"
"5711",1959-04-19,1958,"UA Sedan-Torcy","Limoges FC","3-1",3,1,"1",1,4,2,"H"
"5712",1959-04-19,1958,"Olympique Ales","Stade Rennes","0-1",0,1,"1",1,1,-1,"D"
"5713",1959-04-19,1958,"RC Lens","Toulouse FC","0-1",0,1,"1",1,1,-1,"D"
"5714",1959-04-19,1958,"Olympique Marseille","Lille OSC","0-0",0,0,"1",1,0,0,"D"
"5715",1959-04-26,1958,"OGC Nice","Olympique Ales","4-2",4,2,"1",1,6,2,"H"
"5716",1959-04-26,1958,"Nimes Olympique","AS Monaco","1-0",1,0,"1",1,1,1,"H"
"5717",1959-04-26,1958,"Racing Club de France","Angers SCO","5-0",5,0,"1",1,5,5,"H"
"5718",1959-04-26,1958,"Stade Reims","RC Lens","4-1",4,1,"1",1,5,3,"H"
"5719",1959-04-26,1958,"Limoges FC","FC Sochaux","1-2",1,2,"1",1,3,-1,"D"
"5720",1959-04-26,1958,"Stade Rennes","UA Sedan-Torcy","3-1",3,1,"1",1,4,2,"H"
"5721",1959-04-26,1958,"Olympique Lyon","Olympique Marseille","1-1",1,1,"1",1,2,0,"D"
"5722",1959-04-26,1958,"Toulouse FC","AS Saint-Etienne","2-0",2,0,"1",1,2,2,"H"
"5723",1959-04-26,1958,"US Valenciennes-Anzin","AS Nancy","1-1",1,1,"1",1,2,0,"D"
"5724",1959-04-26,1958,"RC Strasbourg","Lille OSC","2-0",2,0,"1",1,2,2,"H"
"5725",1959-05-07,1958,"AS Saint-Etienne","OGC Nice","3-4",3,4,"1",1,7,-1,"D"
"5726",1959-05-07,1958,"FC Sochaux","Nimes Olympique","3-2",3,2,"1",1,5,1,"H"
"5727",1959-05-07,1958,"AS Nancy","Racing Club de France","1-2",1,2,"1",1,3,-1,"D"
"5728",1959-05-07,1958,"Stade Reims","US Valenciennes-Anzin","2-1",2,1,"1",1,3,1,"H"
"5729",1959-05-07,1958,"AS Monaco","Olympique Marseille","2-0",2,0,"1",1,2,2,"H"
"5730",1959-05-07,1958,"Angers SCO","RC Strasbourg","2-2",2,2,"1",1,4,0,"D"
"5731",1959-05-07,1958,"Olympique Lyon","Toulouse FC","1-1",1,1,"1",1,2,0,"D"
"5732",1959-05-07,1958,"Lille OSC","UA Sedan-Torcy","0-3",0,3,"1",1,3,-3,"D"
"5733",1959-05-07,1958,"RC Lens","Stade Rennes","2-0",2,0,"1",1,2,2,"H"
"5734",1959-05-07,1958,"Olympique Ales","Limoges FC","0-2",0,2,"1",1,2,-2,"D"
"5735",1959-05-10,1958,"OGC Nice","FC Sochaux","5-0",5,0,"1",1,5,5,"H"
"5736",1959-05-10,1958,"Olympique Marseille","Nimes Olympique","0-2",0,2,"1",1,2,-2,"D"
"5737",1959-05-10,1958,"Racing Club de France","Lille OSC","7-2",7,2,"1",1,9,5,"H"
"5738",1959-05-10,1958,"Stade Rennes","Stade Reims","2-2",2,2,"1",1,4,0,"D"
"5739",1959-05-10,1958,"Limoges FC","AS Monaco","2-1",2,1,"1",1,3,1,"H"
"5740",1959-05-10,1958,"UA Sedan-Torcy","Angers SCO","2-2",2,2,"1",1,4,0,"D"
"5741",1959-05-10,1958,"AS Saint-Etienne","Olympique Lyon","2-0",2,0,"1",1,2,2,"H"
"5742",1959-05-10,1958,"US Valenciennes-Anzin","RC Lens","3-1",3,1,"1",1,4,2,"H"
"5743",1959-05-10,1958,"RC Strasbourg","AS Nancy","1-1",1,1,"1",1,2,0,"D"
"5744",1959-05-10,1958,"Olympique Ales","Toulouse FC","1-0",1,0,"1",1,1,1,"H"
"5745",1959-05-16,1958,"RC Strasbourg","US Valenciennes-Anzin","3-2",3,2,"1",1,5,1,"H"
"5746",1959-05-16,1958,"Olympique Lyon","Olympique Ales","1-1",1,1,"1",1,2,0,"D"
"5747",1959-05-17,1958,"Toulouse FC","OGC Nice","2-2",2,2,"1",1,4,0,"D"
"5748",1959-05-17,1958,"Nimes Olympique","Limoges FC","3-0",3,0,"1",1,3,3,"H"
"5749",1959-05-17,1958,"RC Lens","Racing Club de France","2-1",2,1,"1",1,3,1,"H"
"5750",1959-05-17,1958,"Lille OSC","Stade Reims","0-2",0,2,"1",1,2,-2,"D"
"5751",1959-05-17,1958,"AS Monaco","AS Saint-Etienne","0-3",0,3,"1",1,3,-3,"D"
"5752",1959-05-17,1958,"AS Nancy","UA Sedan-Torcy","0-1",0,1,"1",1,1,-1,"D"
"5753",1959-05-17,1958,"Angers SCO","Stade Rennes","0-0",0,0,"1",1,0,0,"D"
"5754",1959-05-21,1958,"FC Sochaux","Olympique Marseille","5-1",5,1,"1",1,6,4,"H"
"5755",1959-05-23,1958,"Racing Club de France","Toulouse FC","2-0",2,0,"1",1,2,2,"H"
"5756",1959-05-23,1958,"Stade Reims","Olympique Lyon","1-2",1,2,"1",1,3,-1,"D"
"5757",1959-05-23,1958,"US Valenciennes-Anzin","AS Monaco","2-2",2,2,"1",1,4,0,"D"
"5758",1959-05-24,1958,"OGC Nice","Angers SCO","0-3",0,3,"1",1,3,-3,"D"
"5759",1959-05-24,1958,"Lille OSC","Nimes Olympique","0-0",0,0,"1",1,0,0,"D"
"5760",1959-05-24,1958,"FC Sochaux","Stade Rennes","4-3",4,3,"1",1,7,1,"H"
"5761",1959-05-24,1958,"AS Saint-Etienne","UA Sedan-Torcy","2-1",2,1,"1",1,3,1,"H"
"5762",1959-05-24,1958,"Olympique Marseille","RC Strasbourg","3-3",3,3,"1",1,6,0,"D"
"5763",1959-05-24,1958,"AS Nancy","Limoges FC","0-2",0,2,"1",1,2,-2,"D"
"5764",1959-05-24,1958,"Olympique Ales","RC Lens","2-6",2,6,"1",1,8,-4,"D"
"5765",1959-05-28,1958,"Nimes Olympique","Stade Reims","2-2",2,2,"1",1,4,0,"D"
"5766",1959-05-30,1958,"US Valenciennes-Anzin","FC Sochaux","1-1",1,1,"1",1,2,0,"D"
"5767",1959-05-30,1958,"RC Strasbourg","AS Saint-Etienne","3-3",3,3,"1",1,6,0,"D"
"5768",1959-05-31,1958,"RC Lens","OGC Nice","0-0",0,0,"1",1,0,0,"D"
"5769",1959-05-31,1958,"Toulouse FC","AS Nancy","3-2",3,2,"1",1,5,1,"H"
"5770",1959-05-31,1958,"Olympique Lyon","Racing Club de France","3-2",3,2,"1",1,5,1,"H"
"5771",1959-05-31,1958,"Limoges FC","Angers SCO","2-2",2,2,"1",1,4,0,"D"
"5772",1959-05-31,1958,"AS Monaco","Lille OSC","3-0",3,0,"1",1,3,3,"H"
"5773",1959-05-31,1958,"UA Sedan-Torcy","Olympique Ales","2-0",2,0,"1",1,2,2,"H"
"5774",1959-05-31,1958,"Stade Rennes","Olympique Marseille","2-2",2,2,"1",1,4,0,"D"
"5775",1959-08-15,1959,"Stade Reims","FC Sochaux","4-1",4,1,"1",1,5,3,"H"
"5776",1959-08-15,1959,"AS Monaco","Racing Club de France","3-3",3,3,"1",1,6,0,"D"
"5777",1959-08-16,1959,"OGC Nice","RC Lens","3-0",3,0,"1",1,3,3,"H"
"5778",1959-08-16,1959,"RC Strasbourg","Nimes Olympique","1-3",1,3,"1",1,4,-2,"D"
"5779",1959-08-16,1959,"Stade Francais FC","Stade Rennes","1-2",1,2,"1",1,3,-1,"D"
"5780",1959-08-16,1959,"Sporting Toulon Var","UA Sedan-Torcy","2-1",2,1,"1",1,3,1,"H"
"5781",1959-08-16,1959,"Limoges FC","Toulouse FC","2-1",2,1,"1",1,3,1,"H"
"5782",1959-08-16,1959,"Olympique Lyon","Girondins Bordeaux","2-2",2,2,"1",1,4,0,"D"
"5783",1959-08-16,1959,"Le Havre AC","AS Saint-Etienne","0-0",0,0,"1",1,0,0,"D"
"5784",1959-08-18,1959,"Angers SCO","US Valenciennes-Anzin","1-2",1,2,"1",1,3,-1,"D"
"5785",1959-08-22,1959,"Stade Reims","US Valenciennes-Anzin","2-1",2,1,"1",1,3,1,"H"
"5786",1959-08-22,1959,"RC Lens","Limoges FC","0-0",0,0,"1",1,0,0,"D"
"5787",1959-08-22,1959,"RC Strasbourg","Stade Francais FC","2-5",2,5,"1",1,7,-3,"D"
"5788",1959-08-23,1959,"OGC Nice","FC Sochaux","3-0",3,0,"1",1,3,3,"H"
"5789",1959-08-23,1959,"Nimes Olympique","Sporting Toulon Var","4-1",4,1,"1",1,5,3,"H"
"5790",1959-08-23,1959,"Racing Club de France","Le Havre AC","9-0",9,0,"1",1,9,9,"H"
"5791",1959-08-23,1959,"Stade Rennes","Olympique Lyon","1-2",1,2,"1",1,3,-1,"D"
"5792",1959-08-23,1959,"Toulouse FC","AS Monaco","1-1",1,1,"1",1,2,0,"D"
"5793",1959-08-23,1959,"Girondins Bordeaux","Angers SCO","1-1",1,1,"1",1,2,0,"D"
"5794",1959-08-23,1959,"AS Saint-Etienne","UA Sedan-Torcy","3-3",3,3,"1",1,6,0,"D"
"5795",1959-08-29,1959,"FC Sochaux","AS Saint-Etienne","2-0",2,0,"1",1,2,2,"H"
"5796",1959-08-29,1959,"Stade Francais FC","Toulouse FC","3-1",3,1,"1",1,4,2,"H"
"5797",1959-08-30,1959,"Olympique Lyon","OGC Nice","0-2",0,2,"1",1,2,-2,"D"
"5798",1959-08-30,1959,"Limoges FC","Stade Reims","2-2",2,2,"1",1,4,0,"D"
"5799",1959-08-30,1959,"Angers SCO","Racing Club de France","0-0",0,0,"1",1,0,0,"D"
"5800",1959-08-30,1959,"RC Lens","Nimes Olympique","3-1",3,1,"1",1,4,2,"H"
"5801",1959-08-30,1959,"AS Monaco","RC Strasbourg","4-2",4,2,"1",1,6,2,"H"
"5802",1959-08-30,1959,"UA Sedan-Torcy","Girondins Bordeaux","2-3",2,3,"1",1,5,-1,"D"
"5803",1959-08-30,1959,"Sporting Toulon Var","Stade Rennes","0-1",0,1,"1",1,1,-1,"D"
"5804",1959-08-30,1959,"Le Havre AC","US Valenciennes-Anzin","3-2",3,2,"1",1,5,1,"H"
"5805",1959-09-05,1959,"FC Sochaux","Limoges FC","0-0",0,0,"1",1,0,0,"D"
"5806",1959-09-05,1959,"US Valenciennes-Anzin","Stade Francais FC","1-0",1,0,"1",1,1,1,"H"
"5807",1959-09-06,1959,"OGC Nice","UA Sedan-Torcy","3-0",3,0,"1",1,3,3,"H"
"5808",1959-09-06,1959,"Stade Reims","Toulouse FC","5-2",5,2,"1",1,7,3,"H"
"5809",1959-09-06,1959,"Racing Club de France","Sporting Toulon Var","7-1",7,1,"1",1,8,6,"H"
"5810",1959-09-06,1959,"Nimes Olympique","AS Saint-Etienne","2-0",2,0,"1",1,2,2,"H"
"5811",1959-09-06,1959,"Stade Rennes","AS Monaco","1-2",1,2,"1",1,3,-1,"D"
"5812",1959-09-06,1959,"Girondins Bordeaux","RC Lens","2-3",2,3,"1",1,5,-1,"D"
"5813",1959-09-06,1959,"Olympique Lyon","Le Havre AC","1-1",1,1,"1",1,2,0,"D"
"5814",1959-09-06,1959,"RC Strasbourg","Angers SCO","4-2",4,2,"1",1,6,2,"H"
"5815",1959-09-12,1959,"Limoges FC","US Valenciennes-Anzin","1-1",1,1,"1",1,2,0,"D"
"5816",1959-09-13,1959,"Angers SCO","OGC Nice","2-2",2,2,"1",1,4,0,"D"
"5817",1959-09-13,1959,"AS Monaco","Stade Reims","2-2",2,2,"1",1,4,0,"D"
"5818",1959-09-13,1959,"UA Sedan-Torcy","Nimes Olympique","2-3",2,3,"1",1,5,-1,"D"
"5819",1959-09-13,1959,"RC Lens","Racing Club de France","3-2",3,2,"1",1,5,1,"H"
"5820",1959-09-13,1959,"Stade Francais FC","FC Sochaux","2-1",2,1,"1",1,3,1,"H"
"5821",1959-09-13,1959,"Le Havre AC","Stade Rennes","4-2",4,2,"1",1,6,2,"H"
"5822",1959-09-13,1959,"Sporting Toulon Var","RC Strasbourg","1-4",1,4,"1",1,5,-3,"D"
"5823",1959-09-13,1959,"AS Saint-Etienne","Girondins Bordeaux","4-2",4,2,"1",1,6,2,"H"
"5824",1959-09-13,1959,"Toulouse FC","Olympique Lyon","1-0",1,0,"1",1,1,1,"H"
"5825",1959-09-16,1959,"RC Strasbourg","RC Lens","0-0",0,0,"1",1,0,0,"D"
"5826",1959-09-16,1959,"FC Sochaux","Le Havre AC","0-0",0,0,"1",1,0,0,"D"
"5827",1959-09-16,1959,"US Valenciennes-Anzin","Olympique Lyon","1-4",1,4,"1",1,5,-3,"D"
"5828",1959-09-16,1959,"Stade Reims","Stade Rennes","2-1",2,1,"1",1,3,1,"H"
"5829",1959-09-17,1959,"Nimes Olympique","AS Monaco","5-1",5,1,"1",1,6,4,"H"
"5830",1959-09-17,1959,"OGC Nice","Racing Club de France","2-5",2,5,"1",1,7,-3,"D"
"5831",1959-09-17,1959,"Stade Francais FC","Limoges FC","2-3",2,3,"1",1,5,-1,"D"
"5832",1959-09-17,1959,"Girondins Bordeaux","Sporting Toulon Var","2-1",2,1,"1",1,3,1,"H"
"5833",1959-09-17,1959,"AS Saint-Etienne","Toulouse FC","3-3",3,3,"1",1,6,0,"D"
"5834",1959-09-17,1959,"Angers SCO","UA Sedan-Torcy","0-0",0,0,"1",1,0,0,"D"
"5835",1959-09-20,1959,"RC Lens","Stade Reims","2-5",2,5,"1",1,7,-3,"D"
"5836",1959-09-20,1959,"Racing Club de France","Nimes Olympique","1-2",1,2,"1",1,3,-1,"D"
"5837",1959-09-20,1959,"Limoges FC","Girondins Bordeaux","3-0",3,0,"1",1,3,3,"H"
"5838",1959-09-20,1959,"Toulouse FC","OGC Nice","4-1",4,1,"1",1,5,3,"H"
"5839",1959-09-20,1959,"Le Havre AC","Stade Francais FC","1-2",1,2,"1",1,3,-1,"D"
"5840",1959-09-20,1959,"Olympique Lyon","Angers SCO","2-0",2,0,"1",1,2,2,"H"
"5841",1959-09-20,1959,"AS Monaco","AS Saint-Etienne","1-1",1,1,"1",1,2,0,"D"
"5842",1959-09-20,1959,"UA Sedan-Torcy","RC Strasbourg","2-2",2,2,"1",1,4,0,"D"
"5843",1959-09-20,1959,"Stade Rennes","US Valenciennes-Anzin","2-1",2,1,"1",1,3,1,"H"
"5844",1959-09-20,1959,"Sporting Toulon Var","FC Sochaux","2-2",2,2,"1",1,4,0,"D"
"5845",1959-09-26,1959,"FC Sochaux","RC Lens","1-0",1,0,"1",1,1,1,"H"
"5846",1959-09-27,1959,"Le Havre AC","Nimes Olympique","0-3",0,3,"1",1,3,-3,"D"
"5847",1959-09-27,1959,"Stade Reims","OGC Nice","2-2",2,2,"1",1,4,0,"D"
"5848",1959-09-27,1959,"Limoges FC","UA Sedan-Torcy","2-2",2,2,"1",1,4,0,"D"
"5849",1959-09-27,1959,"US Valenciennes-Anzin","Racing Club de France","1-4",1,4,"1",1,5,-3,"D"
"5850",1959-09-27,1959,"Girondins Bordeaux","RC Strasbourg","0-1",0,1,"1",1,1,-1,"D"
"5851",1959-09-27,1959,"Toulouse FC","Stade Rennes","1-2",1,2,"1",1,3,-1,"D"
"5852",1959-09-27,1959,"AS Monaco","Sporting Toulon Var","1-3",1,3,"1",1,4,-2,"D"
"5853",1959-09-27,1959,"AS Saint-Etienne","Angers SCO","1-1",1,1,"1",1,2,0,"D"
"5854",1959-09-27,1959,"Stade Francais FC","Olympique Lyon","2-1",2,1,"1",1,3,1,"H"
"5855",1959-09-30,1959,"RC Strasbourg","Stade Reims","1-3",1,3,"1",1,4,-2,"D"
"5856",1959-09-30,1959,"Racing Club de France","Girondins Bordeaux","6-1",6,1,"1",1,7,5,"H"
"5857",1959-09-30,1959,"RC Lens","Stade Francais FC","3-2",3,2,"1",1,5,1,"H"
"5858",1959-10-01,1959,"Nimes Olympique","US Valenciennes-Anzin","3-0",3,0,"1",1,3,3,"H"
"5859",1959-10-01,1959,"Stade Rennes","Limoges FC","0-2",0,2,"1",1,2,-2,"D"
"5860",1959-10-01,1959,"OGC Nice","AS Saint-Etienne","2-0",2,0,"1",1,2,2,"H"
"5861",1959-10-01,1959,"Olympique Lyon","AS Monaco","0-4",0,4,"1",1,4,-4,"D"
"5862",1959-10-01,1959,"Sporting Toulon Var","Toulouse FC","0-1",0,1,"1",1,1,-1,"D"
"5863",1959-10-01,1959,"Angers SCO","Le Havre AC","4-2",4,2,"1",1,6,2,"H"
"5864",1959-10-01,1959,"UA Sedan-Torcy","FC Sochaux","2-1",2,1,"1",1,3,1,"H"
"5865",1959-10-03,1959,"Stade Reims","Girondins Bordeaux","8-2",8,2,"1",1,10,6,"H"
"5866",1959-10-04,1959,"Nimes Olympique","OGC Nice","5-1",5,1,"1",1,6,4,"H"
"5867",1959-10-04,1959,"Limoges FC","Racing Club de France","1-0",1,0,"1",1,1,1,"H"
"5868",1959-10-04,1959,"Stade Francais FC","Sporting Toulon Var","3-1",3,1,"1",1,4,2,"H"
"5869",1959-10-04,1959,"AS Monaco","US Valenciennes-Anzin","1-0",1,0,"1",1,1,1,"H"
"5870",1959-10-04,1959,"RC Lens","Angers SCO","4-2",4,2,"1",1,6,2,"H"
"5871",1959-10-04,1959,"FC Sochaux","Olympique Lyon","1-3",1,3,"1",1,4,-2,"D"
"5872",1959-10-04,1959,"Toulouse FC","Le Havre AC","2-1",2,1,"1",1,3,1,"H"
"5873",1959-10-04,1959,"AS Saint-Etienne","RC Strasbourg","7-3",7,3,"1",1,10,4,"H"
"5874",1959-10-04,1959,"Stade Rennes","UA Sedan-Torcy","1-2",1,2,"1",1,3,-1,"D"
"5875",1959-10-11,1959,"Angers SCO","Nimes Olympique","0-0",0,0,"1",1,0,0,"D"
"5876",1959-10-11,1959,"Olympique Lyon","Limoges FC","1-0",1,0,"1",1,1,1,"H"
"5877",1959-10-11,1959,"OGC Nice","Stade Francais FC","1-3",1,3,"1",1,4,-2,"D"
"5878",1959-10-11,1959,"UA Sedan-Torcy","RC Lens","2-2",2,2,"1",1,4,0,"D"
"5879",1959-10-11,1959,"Le Havre AC","AS Monaco","2-0",2,0,"1",1,2,2,"H"
"5880",1959-10-11,1959,"US Valenciennes-Anzin","Toulouse FC","5-3",5,3,"1",1,8,2,"H"
"5881",1959-10-11,1959,"RC Strasbourg","Stade Rennes","1-1",1,1,"1",1,2,0,"D"
"5882",1959-10-11,1959,"Girondins Bordeaux","FC Sochaux","6-4",6,4,"1",1,10,2,"H"
"5883",1959-10-18,1959,"Stade Reims","UA Sedan-Torcy","1-0",1,0,"1",1,1,1,"H"
"5884",1959-10-18,1959,"Limoges FC","Nimes Olympique","2-1",2,1,"1",1,3,1,"H"
"5885",1959-10-18,1959,"Stade Francais FC","Racing Club de France","3-3",3,3,"1",1,6,0,"D"
"5886",1959-10-18,1959,"US Valenciennes-Anzin","RC Lens","0-1",0,1,"1",1,1,-1,"D"
"5887",1959-10-18,1959,"OGC Nice","AS Monaco","3-2",3,2,"1",1,5,1,"H"
"5888",1959-10-18,1959,"AS Saint-Etienne","Olympique Lyon","2-1",2,1,"1",1,3,1,"H"
"5889",1959-10-18,1959,"Toulouse FC","Girondins Bordeaux","2-1",2,1,"1",1,3,1,"H"
"5890",1959-10-18,1959,"Le Havre AC","Sporting Toulon Var","2-0",2,0,"1",1,2,2,"H"
"5891",1959-10-18,1959,"Stade Rennes","Angers SCO","2-3",2,3,"1",1,5,-1,"D"
"5892",1959-10-18,1959,"FC Sochaux","RC Strasbourg","1-1",1,1,"1",1,2,0,"D"
"5893",1959-10-21,1959,"Racing Club de France","AS Saint-Etienne","4-0",4,0,"1",1,4,4,"H"
"5894",1959-10-25,1959,"Nimes Olympique","Stade Francais FC","3-1",3,1,"1",1,4,2,"H"
"5895",1959-10-25,1959,"Olympique Lyon","Stade Reims","0-1",0,1,"1",1,1,-1,"D"
"5896",1959-10-25,1959,"AS Monaco","Limoges FC","0-0",0,0,"1",1,0,0,"D"
"5897",1959-10-25,1959,"RC Strasbourg","OGC Nice","1-4",1,4,"1",1,5,-3,"D"
"5898",1959-10-25,1959,"RC Lens","AS Saint-Etienne","0-0",0,0,"1",1,0,0,"D"
"5899",1959-10-25,1959,"Racing Club de France","Stade Rennes","0-2",0,2,"1",1,2,-2,"D"
"5900",1959-10-25,1959,"FC Sochaux","Toulouse FC","0-2",0,2,"1",1,2,-2,"D"
"5901",1959-10-25,1959,"UA Sedan-Torcy","Le Havre AC","0-3",0,3,"1",1,3,-3,"D"
"5902",1959-10-25,1959,"Angers SCO","Sporting Toulon Var","3-2",3,2,"1",1,5,1,"H"
"5903",1959-10-25,1959,"Girondins Bordeaux","US Valenciennes-Anzin","3-7",3,7,"1",1,10,-4,"D"
"5904",1959-10-28,1959,"Stade Reims","Angers SCO","6-0",6,0,"1",1,6,6,"H"
"5905",1959-10-28,1959,"Toulouse FC","Racing Club de France","1-1",1,1,"1",1,2,0,"D"
"5906",1959-10-28,1959,"US Valenciennes-Anzin","RC Strasbourg","2-0",2,0,"1",1,2,2,"H"
"5907",1959-10-29,1959,"Olympique Lyon","Nimes Olympique","1-2",1,2,"1",1,3,-1,"D"
"5908",1959-10-29,1959,"Limoges FC","OGC Nice","2-1",2,1,"1",1,3,1,"H"
"5909",1959-10-29,1959,"Le Havre AC","RC Lens","3-1",3,1,"1",1,4,2,"H"
"5910",1959-10-29,1959,"AS Monaco","Girondins Bordeaux","5-0",5,0,"1",1,5,5,"H"
"5911",1959-10-29,1959,"Stade Francais FC","UA Sedan-Torcy","1-5",1,5,"1",1,6,-4,"D"
"5912",1959-10-29,1959,"Sporting Toulon Var","AS Saint-Etienne","0-1",0,1,"1",1,1,-1,"D"
"5913",1959-10-29,1959,"Stade Rennes","FC Sochaux","0-1",0,1,"1",1,1,-1,"D"
"5914",1959-11-01,1959,"AS Saint-Etienne","Stade Reims","2-5",2,5,"1",1,7,-3,"D"
"5915",1959-11-01,1959,"Nimes Olympique","Toulouse FC","2-2",2,2,"1",1,4,0,"D"
"5916",1959-11-01,1959,"Angers SCO","Limoges FC","1-0",1,0,"1",1,1,1,"H"
"5917",1959-11-01,1959,"Racing Club de France","Olympique Lyon","4-0",4,0,"1",1,4,4,"H"
"5918",1959-11-01,1959,"OGC Nice","Sporting Toulon Var","4-2",4,2,"1",1,6,2,"H"
"5919",1959-11-01,1959,"RC Lens","Stade Rennes","1-0",1,0,"1",1,1,1,"H"
"5920",1959-11-01,1959,"RC Strasbourg","Le Havre AC","1-2",1,2,"1",1,3,-1,"D"
"5921",1959-11-01,1959,"Girondins Bordeaux","Stade Francais FC","3-3",3,3,"1",1,6,0,"D"
"5922",1959-11-01,1959,"FC Sochaux","AS Monaco","1-0",1,0,"1",1,1,1,"H"
"5923",1959-11-01,1959,"UA Sedan-Torcy","US Valenciennes-Anzin","2-2",2,2,"1",1,4,0,"D"
"5924",1959-11-08,1959,"Stade Reims","Nimes Olympique","1-2",1,2,"1",1,3,-1,"D"
"5925",1959-11-08,1959,"Limoges FC","AS Saint-Etienne","2-1",2,1,"1",1,3,1,"H"
"5926",1959-11-08,1959,"Racing Club de France","RC Strasbourg","2-2",2,2,"1",1,4,0,"D"
"5927",1959-11-08,1959,"Sporting Toulon Var","RC Lens","1-1",1,1,"1",1,2,0,"D"
"5928",1959-11-08,1959,"Le Havre AC","OGC Nice","3-1",3,1,"1",1,4,2,"H"
"5929",1959-11-08,1959,"Toulouse FC","Angers SCO","5-1",5,1,"1",1,6,4,"H"
"5930",1959-11-08,1959,"AS Monaco","Stade Francais FC","3-0",3,0,"1",1,3,3,"H"
"5931",1959-11-08,1959,"Olympique Lyon","UA Sedan-Torcy","0-1",0,1,"1",1,1,-1,"D"
"5932",1959-11-08,1959,"US Valenciennes-Anzin","FC Sochaux","1-1",1,1,"1",1,2,0,"D"
"5933",1959-11-08,1959,"Stade Rennes","Girondins Bordeaux","1-0",1,0,"1",1,1,1,"H"
"5934",1959-11-15,1959,"Nimes Olympique","FC Sochaux","2-1",2,1,"1",1,3,1,"H"
"5935",1959-11-15,1959,"Stade Francais FC","Stade Reims","0-3",0,3,"1",1,3,-3,"D"
"5936",1959-11-15,1959,"Sporting Toulon Var","Limoges FC","3-1",3,1,"1",1,4,2,"H"
"5937",1959-11-15,1959,"UA Sedan-Torcy","Racing Club de France","1-4",1,4,"1",1,5,-3,"D"
"5938",1959-11-15,1959,"RC Lens","Toulouse FC","4-0",4,0,"1",1,4,4,"H"
"5939",1959-11-15,1959,"Girondins Bordeaux","Le Havre AC","0-1",0,1,"1",1,1,-1,"D"
"5940",1959-11-15,1959,"OGC Nice","US Valenciennes-Anzin","1-1",1,1,"1",1,2,0,"D"
"5941",1959-11-15,1959,"Angers SCO","AS Monaco","1-1",1,1,"1",1,2,0,"D"
"5942",1959-11-15,1959,"AS Saint-Etienne","Stade Rennes","2-1",2,1,"1",1,3,1,"H"
"5943",1959-11-15,1959,"RC Strasbourg","Olympique Lyon","2-1",2,1,"1",1,3,1,"H"
"5944",1959-11-22,1959,"Stade Rennes","Nimes Olympique","1-1",1,1,"1",1,2,0,"D"
"5945",1959-11-22,1959,"Stade Reims","Racing Club de France","0-0",0,0,"1",1,0,0,"D"
"5946",1959-11-22,1959,"Limoges FC","Le Havre AC","0-0",0,0,"1",1,0,0,"D"
"5947",1959-11-22,1959,"Olympique Lyon","RC Lens","0-1",0,1,"1",1,1,-1,"D"
"5948",1959-11-22,1959,"Girondins Bordeaux","OGC Nice","0-3",0,3,"1",1,3,-3,"D"
"5949",1959-11-22,1959,"AS Monaco","UA Sedan-Torcy","2-1",2,1,"1",1,3,1,"H"
"5950",1959-11-22,1959,"Toulouse FC","RC Strasbourg","2-1",2,1,"1",1,3,1,"H"
"5951",1959-11-22,1959,"Stade Francais FC","AS Saint-Etienne","3-2",3,2,"1",1,5,1,"H"
"5952",1959-11-22,1959,"US Valenciennes-Anzin","Sporting Toulon Var","3-1",3,1,"1",1,4,2,"H"
"5953",1959-11-22,1959,"FC Sochaux","Angers SCO","2-0",2,0,"1",1,2,2,"H"
"5954",1959-11-26,1959,"Sporting Toulon Var","Stade Reims","1-1",1,1,"1",1,2,0,"D"
"5955",1959-11-29,1959,"Nimes Olympique","Girondins Bordeaux","4-0",4,0,"1",1,4,4,"H"
"5956",1959-11-29,1959,"Le Havre AC","Stade Reims","2-2",2,2,"1",1,4,0,"D"
"5957",1959-11-29,1959,"RC Strasbourg","Limoges FC","1-3",1,3,"1",1,4,-2,"D"
"5958",1959-11-29,1959,"Racing Club de France","FC Sochaux","8-0",8,0,"1",1,8,8,"H"
"5959",1959-11-29,1959,"OGC Nice","Stade Rennes","3-1",3,1,"1",1,4,2,"H"
"5960",1959-11-29,1959,"RC Lens","AS Monaco","1-2",1,2,"1",1,3,-1,"D"
"5961",1959-11-29,1959,"UA Sedan-Torcy","Toulouse FC","3-4",3,4,"1",1,7,-1,"D"
"5962",1959-11-29,1959,"AS Saint-Etienne","US Valenciennes-Anzin","3-1",3,1,"1",1,4,2,"H"
"5963",1959-11-29,1959,"Angers SCO","Stade Francais FC","3-0",3,0,"1",1,3,3,"H"
"5964",1959-11-29,1959,"Sporting Toulon Var","Olympique Lyon","1-1",1,1,"1",1,2,0,"D"
"5965",1959-12-06,1959,"Nimes Olympique","RC Strasbourg","2-1",2,1,"1",1,3,1,"H"
"5966",1959-12-06,1959,"Stade Rennes","Stade Reims","0-1",0,1,"1",1,1,-1,"D"
"5967",1959-12-06,1959,"Racing Club de France","RC Lens","3-0",3,0,"1",1,3,3,"H"
"5968",1959-12-06,1959,"US Valenciennes-Anzin","Limoges FC","0-0",0,0,"1",1,0,0,"D"
"5969",1959-12-06,1959,"OGC Nice","Olympique Lyon","2-1",2,1,"1",1,3,1,"H"
"5970",1959-12-06,1959,"Toulouse FC","Sporting Toulon Var","3-0",3,0,"1",1,3,3,"H"
"5971",1959-12-06,1959,"AS Saint-Etienne","Le Havre AC","3-1",3,1,"1",1,4,2,"H"
"5972",1959-12-06,1959,"Girondins Bordeaux","AS Monaco","4-2",4,2,"1",1,6,2,"H"
"5973",1959-12-06,1959,"FC Sochaux","Stade Francais FC","3-2",3,2,"1",1,5,1,"H"
"5974",1959-12-06,1959,"UA Sedan-Torcy","Angers SCO","2-0",2,0,"1",1,2,2,"H"
"5975",1959-12-19,1959,"Limoges FC","Sporting Toulon Var","2-0",2,0,"1",1,2,2,"H"
"5976",1959-12-20,1959,"AS Monaco","Nimes Olympique","0-1",0,1,"1",1,1,-1,"D"
"5977",1959-12-20,1959,"US Valenciennes-Anzin","Stade Reims","3-0",3,0,"1",1,3,3,"H"
"5978",1959-12-20,1959,"Le Havre AC","Racing Club de France","2-2",2,2,"1",1,4,0,"D"
"5979",1959-12-20,1959,"Stade Francais FC","OGC Nice","2-3",2,3,"1",1,5,-1,"D"
"5980",1959-12-20,1959,"Olympique Lyon","Toulouse FC","1-2",1,2,"1",1,3,-1,"D"
"5981",1959-12-20,1959,"RC Lens","UA Sedan-Torcy","1-1",1,1,"1",1,2,0,"D"
"5982",1959-12-20,1959,"RC Strasbourg","AS Saint-Etienne","3-0",3,0,"1",1,3,3,"H"
"5983",1959-12-20,1959,"Angers SCO","Girondins Bordeaux","4-1",4,1,"1",1,5,3,"H"
"5984",1959-12-20,1959,"FC Sochaux","Stade Rennes","2-2",2,2,"1",1,4,0,"D"
"5985",1959-12-27,1959,"Nimes Olympique","Le Havre AC","4-1",4,1,"1",1,5,3,"H"
"5986",1959-12-27,1959,"Stade Reims","Stade Francais FC","4-0",4,0,"1",1,4,4,"H"
"5987",1959-12-27,1959,"Racing Club de France","Angers SCO","4-1",4,1,"1",1,5,3,"H"
"5988",1959-12-27,1959,"UA Sedan-Torcy","Limoges FC","0-0",0,0,"1",1,0,0,"D"
"5989",1959-12-27,1959,"Toulouse FC","FC Sochaux","3-0",3,0,"1",1,3,3,"H"
"5990",1959-12-27,1959,"US Valenciennes-Anzin","OGC Nice","4-3",4,3,"1",1,7,1,"H"
"5991",1959-12-27,1959,"Sporting Toulon Var","AS Monaco","0-3",0,3,"1",1,3,-3,"D"
"5992",1959-12-27,1959,"AS Saint-Etienne","RC Lens","6-0",6,0,"1",1,6,6,"H"
"5993",1959-12-27,1959,"Stade Rennes","RC Strasbourg","4-0",4,0,"1",1,4,4,"H"
"5994",1959-12-27,1959,"Girondins Bordeaux","Olympique Lyon","2-2",2,2,"1",1,4,0,"D"
"5995",1960-01-03,1959,"Girondins Bordeaux","Nimes Olympique","1-3",1,3,"1",1,4,-2,"D"
"5996",1960-01-03,1959,"Angers SCO","Stade Reims","6-1",6,1,"1",1,7,5,"H"
"5997",1960-01-03,1959,"RC Strasbourg","Racing Club de France","2-5",2,5,"1",1,7,-3,"D"
"5998",1960-01-03,1959,"Toulouse FC","AS Saint-Etienne","2-1",2,1,"1",1,3,1,"H"
"5999",1960-01-03,1959,"Limoges FC","Stade Rennes","1-2",1,2,"1",1,3,-1,"D"
"6000",1960-01-03,1959,"RC Lens","OGC Nice","1-0",1,0,"1",1,1,1,"H"
"6001",1960-01-03,1959,"AS Monaco","Le Havre AC","0-1",0,1,"1",1,1,-1,"D"
"6002",1960-01-03,1959,"Stade Francais FC","US Valenciennes-Anzin","1-2",1,2,"1",1,3,-1,"D"
"6003",1960-01-03,1959,"UA Sedan-Torcy","Sporting Toulon Var","1-2",1,2,"1",1,3,-1,"D"
"6004",1960-01-03,1959,"Olympique Lyon","FC Sochaux","3-1",3,1,"1",1,4,2,"H"
"6005",1960-01-10,1959,"Nimes Olympique","RC Lens","0-0",0,0,"1",1,0,0,"D"
"6006",1960-01-10,1959,"Stade Reims","Limoges FC","1-0",1,0,"1",1,1,1,"H"
"6007",1960-01-10,1959,"Racing Club de France","UA Sedan-Torcy","2-3",2,3,"1",1,5,-1,"D"
"6008",1960-01-10,1959,"OGC Nice","Toulouse FC","1-0",1,0,"1",1,1,1,"H"
"6009",1960-01-10,1959,"Le Havre AC","Angers SCO","5-0",5,0,"1",1,5,5,"H"
"6010",1960-01-10,1959,"US Valenciennes-Anzin","AS Monaco","0-2",0,2,"1",1,2,-2,"D"
"6011",1960-01-10,1959,"Stade Rennes","AS Saint-Etienne","0-0",0,0,"1",1,0,0,"D"
"6012",1960-01-10,1959,"Sporting Toulon Var","Stade Francais FC","1-2",1,2,"1",1,3,-1,"D"
"6013",1960-01-10,1959,"FC Sochaux","Girondins Bordeaux","0-0",0,0,"1",1,0,0,"D"
"6014",1960-01-10,1959,"Olympique Lyon","RC Strasbourg","3-2",3,2,"1",1,5,1,"H"
"6015",1960-01-17,1959,"OGC Nice","Nimes Olympique","2-1",2,1,"1",1,3,1,"H"
"6016",1960-01-17,1959,"Toulouse FC","Stade Reims","2-2",2,2,"1",1,4,0,"D"
"6017",1960-01-17,1959,"Racing Club de France","AS Monaco","1-1",1,1,"1",1,2,0,"D"
"6018",1960-01-17,1959,"RC Lens","FC Sochaux","3-1",3,1,"1",1,4,2,"H"
"6019",1960-01-17,1959,"Sporting Toulon Var","US Valenciennes-Anzin","1-2",1,2,"1",1,3,-1,"D"
"6020",1960-01-17,1959,"AS Saint-Etienne","Stade Francais FC","1-1",1,1,"1",1,2,0,"D"
"6021",1960-01-17,1959,"UA Sedan-Torcy","Stade Rennes","2-0",2,0,"1",1,2,2,"H"
"6022",1960-01-27,1959,"Limoges FC","RC Strasbourg","8-0",8,0,"1",1,8,8,"H"
"6023",1960-01-27,1959,"Angers SCO","Olympique Lyon","1-1",1,1,"1",1,2,0,"D"
"6024",1960-01-31,1959,"Nimes Olympique","Olympique Lyon","2-2",2,2,"1",1,4,0,"D"
"6025",1960-01-31,1959,"Stade Reims","RC Lens","5-1",5,1,"1",1,6,4,"H"
"6026",1960-01-31,1959,"Girondins Bordeaux","Racing Club de France","1-5",1,5,"1",1,6,-4,"D"
"6027",1960-01-31,1959,"FC Sochaux","OGC Nice","1-2",1,2,"1",1,3,-1,"D"
"6028",1960-01-31,1959,"AS Saint-Etienne","Limoges FC","2-0",2,0,"1",1,2,2,"H"
"6029",1960-01-31,1959,"Angers SCO","Toulouse FC","2-0",2,0,"1",1,2,2,"H"
"6030",1960-01-31,1959,"US Valenciennes-Anzin","Le Havre AC","2-0",2,0,"1",1,2,2,"H"
"6031",1960-01-31,1959,"Stade Francais FC","AS Monaco","3-2",3,2,"1",1,5,1,"H"
"6032",1960-01-31,1959,"RC Strasbourg","UA Sedan-Torcy","3-3",3,3,"1",1,6,0,"D"
"6033",1960-01-31,1959,"Stade Rennes","Sporting Toulon Var","3-3",3,3,"1",1,6,0,"D"
"6034",1960-02-04,1959,"Le Havre AC","Girondins Bordeaux","2-0",2,0,"1",1,2,2,"H"
"6035",1960-02-06,1959,"AS Monaco","Angers SCO","2-1",2,1,"1",1,3,1,"H"
"6036",1960-02-07,1959,"Nimes Olympique","Stade Rennes","3-0",3,0,"1",1,3,3,"H"
"6037",1960-02-07,1959,"OGC Nice","Stade Reims","1-4",1,4,"1",1,5,-3,"D"
"6038",1960-02-07,1959,"Racing Club de France","Limoges FC","4-0",4,0,"1",1,4,4,"H"
"6039",1960-02-07,1959,"Le Havre AC","Toulouse FC","0-3",0,3,"1",1,3,-3,"D"
"6040",1960-02-07,1959,"RC Lens","Girondins Bordeaux","3-1",3,1,"1",1,4,2,"H"
"6041",1960-02-07,1959,"FC Sochaux","US Valenciennes-Anzin","0-0",0,0,"1",1,0,0,"D"
"6042",1960-02-07,1959,"UA Sedan-Torcy","AS Saint-Etienne","3-1",3,1,"1",1,4,2,"H"
"6043",1960-02-07,1959,"Olympique Lyon","Stade Francais FC","0-0",0,0,"1",1,0,0,"D"
"6044",1960-02-07,1959,"RC Strasbourg","Sporting Toulon Var","3-2",3,2,"1",1,5,1,"H"
"6045",1960-02-21,1959,"AS Saint-Etienne","Nimes Olympique","2-2",2,2,"1",1,4,0,"D"
"6046",1960-02-21,1959,"Stade Reims","RC Strasbourg","5-0",5,0,"1",1,5,5,"H"
"6047",1960-02-21,1959,"Sporting Toulon Var","Racing Club de France","1-3",1,3,"1",1,4,-2,"D"
"6048",1960-02-21,1959,"Toulouse FC","RC Lens","1-0",1,0,"1",1,1,1,"H"
"6049",1960-02-21,1959,"Limoges FC","FC Sochaux","1-0",1,0,"1",1,1,1,"H"
"6050",1960-02-21,1959,"Stade Rennes","OGC Nice","3-1",3,1,"1",1,4,2,"H"
"6051",1960-02-21,1959,"AS Monaco","Olympique Lyon","4-1",4,1,"1",1,5,3,"H"
"6052",1960-02-21,1959,"Le Havre AC","UA Sedan-Torcy","3-3",3,3,"1",1,6,0,"D"
"6053",1960-02-21,1959,"US Valenciennes-Anzin","Angers SCO","3-1",3,1,"1",1,4,2,"H"
"6054",1960-02-21,1959,"Stade Francais FC","Girondins Bordeaux","0-2",0,2,"1",1,2,-2,"D"
"6055",1960-02-27,1959,"RC Strasbourg","Toulouse FC","2-0",2,0,"1",1,2,2,"H"
"6056",1960-02-28,1959,"Sporting Toulon Var","Nimes Olympique","3-2",3,2,"1",1,5,1,"H"
"6057",1960-02-28,1959,"Limoges FC","Stade Francais FC","1-0",1,0,"1",1,1,1,"H"
"6058",1960-02-28,1959,"AS Monaco","Stade Rennes","5-0",5,0,"1",1,5,5,"H"
"6059",1960-02-28,1959,"RC Lens","Le Havre AC","1-1",1,1,"1",1,2,0,"D"
"6060",1960-02-28,1959,"Olympique Lyon","US Valenciennes-Anzin","3-0",3,0,"1",1,3,3,"H"
"6061",1960-02-28,1959,"Girondins Bordeaux","AS Saint-Etienne","0-0",0,0,"1",1,0,0,"D"
"6062",1960-02-28,1959,"Angers SCO","FC Sochaux","1-0",1,0,"1",1,1,1,"H"
"6063",1960-03-13,1959,"Nimes Olympique","UA Sedan-Torcy","2-0",2,0,"1",1,2,2,"H"
"6064",1960-03-13,1959,"Stade Reims","Olympique Lyon","3-0",3,0,"1",1,3,3,"H"
"6065",1960-03-13,1959,"AS Saint-Etienne","Racing Club de France","3-4",3,4,"1",1,7,-1,"D"
"6066",1960-03-13,1959,"Toulouse FC","US Valenciennes-Anzin","2-1",2,1,"1",1,3,1,"H"
"6067",1960-03-13,1959,"RC Strasbourg","AS Monaco","0-2",0,2,"1",1,2,-2,"D"
"6068",1960-03-13,1959,"Le Havre AC","Limoges FC","2-0",2,0,"1",1,2,2,"H"
"6069",1960-03-13,1959,"OGC Nice","Girondins Bordeaux","2-1",2,1,"1",1,3,1,"H"
"6070",1960-03-13,1959,"Stade Rennes","RC Lens","2-0",2,0,"1",1,2,2,"H"
"6071",1960-03-13,1959,"Stade Francais FC","Angers SCO","2-0",2,0,"1",1,2,2,"H"
"6072",1960-03-13,1959,"FC Sochaux","Sporting Toulon Var","1-2",1,2,"1",1,3,-1,"D"
"6073",1960-03-20,1959,"FC Sochaux","Stade Reims","1-2",1,2,"1",1,3,-1,"D"
"6074",1960-03-20,1959,"US Valenciennes-Anzin","Nimes Olympique","3-1",3,1,"1",1,4,2,"H"
"6075",1960-03-20,1959,"Racing Club de France","OGC Nice","1-2",1,2,"1",1,3,-1,"D"
"6076",1960-03-20,1959,"Toulouse FC","Limoges FC","6-0",6,0,"1",1,6,6,"H"
"6077",1960-03-20,1959,"AS Monaco","RC Lens","2-1",2,1,"1",1,3,1,"H"
"6078",1960-03-20,1959,"Le Havre AC","RC Strasbourg","2-1",2,1,"1",1,3,1,"H"
"6079",1960-03-20,1959,"Angers SCO","AS Saint-Etienne","3-3",3,3,"1",1,6,0,"D"
"6080",1960-03-20,1959,"UA Sedan-Torcy","Stade Francais FC","2-1",2,1,"1",1,3,1,"H"
"6081",1960-03-20,1959,"Girondins Bordeaux","Stade Rennes","0-1",0,1,"1",1,1,-1,"D"
"6082",1960-03-20,1959,"Olympique Lyon","Sporting Toulon Var","1-2",1,2,"1",1,3,-1,"D"
"6083",1960-03-26,1959,"RC Lens","RC Strasbourg","2-1",2,1,"1",1,3,1,"H"
"6084",1960-03-27,1959,"Stade Rennes","Toulouse FC","1-0",1,0,"1",1,1,1,"H"
"6085",1960-03-27,1959,"Stade Francais FC","Le Havre AC","0-1",0,1,"1",1,1,-1,"D"
"6086",1960-03-27,1959,"OGC Nice","Angers SCO","1-5",1,5,"1",1,6,-4,"D"
"6087",1960-03-27,1959,"Limoges FC","Olympique Lyon","0-1",0,1,"1",1,1,-1,"D"
"6088",1960-03-27,1959,"US Valenciennes-Anzin","UA Sedan-Torcy","2-1",2,1,"1",1,3,1,"H"
"6089",1960-03-27,1959,"Sporting Toulon Var","Girondins Bordeaux","2-0",2,0,"1",1,2,2,"H"
"6090",1960-04-10,1959,"UA Sedan-Torcy","Stade Reims","1-3",1,3,"1",1,4,-2,"D"
"6091",1960-04-10,1959,"Nimes Olympique","Limoges FC","2-0",2,0,"1",1,2,2,"H"
"6092",1960-04-10,1959,"Racing Club de France","Stade Francais FC","1-1",1,1,"1",1,2,0,"D"
"6093",1960-04-10,1959,"Girondins Bordeaux","Toulouse FC","3-5",3,5,"1",1,8,-2,"D"
"6094",1960-04-10,1959,"AS Monaco","OGC Nice","2-0",2,0,"1",1,2,2,"H"
"6095",1960-04-10,1959,"Sporting Toulon Var","Le Havre AC","3-3",3,3,"1",1,6,0,"D"
"6096",1960-04-10,1959,"RC Lens","US Valenciennes-Anzin","1-0",1,0,"1",1,1,1,"H"
"6097",1960-04-10,1959,"Angers SCO","Stade Rennes","2-0",2,0,"1",1,2,2,"H"
"6098",1960-04-10,1959,"Olympique Lyon","AS Saint-Etienne","0-0",0,0,"1",1,0,0,"D"
"6099",1960-04-10,1959,"RC Strasbourg","FC Sochaux","0-1",0,1,"1",1,1,-1,"D"
"6100",1960-04-13,1959,"Racing Club de France","Stade Reims","3-3",3,3,"1",1,6,0,"D"
"6101",1960-04-13,1959,"AS Saint-Etienne","FC Sochaux","0-3",0,3,"1",1,3,-3,"D"
"6102",1960-04-16,1959,"FC Sochaux","Nimes Olympique","1-1",1,1,"1",1,2,0,"D"
"6103",1960-04-16,1959,"US Valenciennes-Anzin","Girondins Bordeaux","2-2",2,2,"1",1,4,0,"D"
"6104",1960-04-17,1959,"Stade Reims","Sporting Toulon Var","3-0",3,0,"1",1,3,3,"H"
"6105",1960-04-17,1959,"Stade Rennes","Racing Club de France","3-2",3,2,"1",1,5,1,"H"
"6106",1960-04-17,1959,"Toulouse FC","UA Sedan-Torcy","1-1",1,1,"1",1,2,0,"D"
"6107",1960-04-17,1959,"AS Saint-Etienne","AS Monaco","1-0",1,0,"1",1,1,1,"H"
"6108",1960-04-17,1959,"Le Havre AC","Olympique Lyon","1-2",1,2,"1",1,3,-1,"D"
"6109",1960-04-17,1959,"Stade Francais FC","RC Lens","0-1",0,1,"1",1,1,-1,"D"
"6110",1960-04-17,1959,"Limoges FC","Angers SCO","2-0",2,0,"1",1,2,2,"H"
"6111",1960-04-17,1959,"OGC Nice","RC Strasbourg","2-3",2,3,"1",1,5,-1,"D"
"6112",1960-04-24,1959,"Nimes Olympique","Racing Club de France","0-2",0,2,"1",1,2,-2,"D"
"6113",1960-05-01,1959,"Nimes Olympique","Stade Reims","0-3",0,3,"1",1,3,-3,"D"
"6114",1960-05-01,1959,"Racing Club de France","US Valenciennes-Anzin","6-4",6,4,"1",1,10,2,"H"
"6115",1960-05-01,1959,"Toulouse FC","Stade Francais FC","1-3",1,3,"1",1,4,-2,"D"
"6116",1960-05-01,1959,"AS Monaco","FC Sochaux","1-0",1,0,"1",1,1,1,"H"
"6117",1960-05-01,1959,"Stade Rennes","Le Havre AC","2-2",2,2,"1",1,4,0,"D"
"6118",1960-05-01,1959,"RC Lens","Sporting Toulon Var","6-2",6,2,"1",1,8,4,"H"
"6119",1960-05-01,1959,"Girondins Bordeaux","Limoges FC","2-1",2,1,"1",1,3,1,"H"
"6120",1960-05-01,1959,"AS Saint-Etienne","OGC Nice","4-1",4,1,"1",1,5,3,"H"
"6121",1960-05-01,1959,"Angers SCO","RC Strasbourg","3-1",3,1,"1",1,4,2,"H"
"6122",1960-05-01,1959,"UA Sedan-Torcy","Olympique Lyon","0-0",0,0,"1",1,0,0,"D"
"6123",1960-05-04,1959,"UA Sedan-Torcy","OGC Nice","2-0",2,0,"1",1,2,2,"H"
"6124",1960-05-04,1959,"Stade Reims","AS Monaco","2-1",2,1,"1",1,3,1,"H"
"6125",1960-05-07,1959,"Stade Reims","AS Saint-Etienne","3-0",3,0,"1",1,3,3,"H"
"6126",1960-05-08,1959,"Stade Francais FC","Nimes Olympique","0-0",0,0,"1",1,0,0,"D"
"6127",1960-05-08,1959,"Olympique Lyon","Racing Club de France","0-0",0,0,"1",1,0,0,"D"
"6128",1960-05-08,1959,"AS Monaco","Toulouse FC","3-0",3,0,"1",1,3,3,"H"
"6129",1960-05-08,1959,"Limoges FC","RC Lens","1-2",1,2,"1",1,3,-1,"D"
"6130",1960-05-08,1959,"OGC Nice","Le Havre AC","2-2",2,2,"1",1,4,0,"D"
"6131",1960-05-08,1959,"US Valenciennes-Anzin","Stade Rennes","3-0",3,0,"1",1,3,3,"H"
"6132",1960-05-08,1959,"FC Sochaux","UA Sedan-Torcy","0-0",0,0,"1",1,0,0,"D"
"6133",1960-05-08,1959,"Sporting Toulon Var","Angers SCO","1-0",1,0,"1",1,1,1,"H"
"6134",1960-05-08,1959,"RC Strasbourg","Girondins Bordeaux","2-1",2,1,"1",1,3,1,"H"
"6135",1960-05-21,1959,"RC Strasbourg","US Valenciennes-Anzin","0-0",0,0,"1",1,0,0,"D"
"6136",1960-05-22,1959,"Girondins Bordeaux","Stade Reims","2-1",2,1,"1",1,3,1,"H"
"6137",1960-05-22,1959,"Nimes Olympique","Angers SCO","1-1",1,1,"1",1,2,0,"D"
"6138",1960-05-22,1959,"Racing Club de France","Toulouse FC","1-3",1,3,"1",1,4,-2,"D"
"6139",1960-05-22,1959,"RC Lens","Olympique Lyon","1-0",1,0,"1",1,1,1,"H"
"6140",1960-05-22,1959,"UA Sedan-Torcy","AS Monaco","2-1",2,1,"1",1,3,1,"H"
"6141",1960-05-22,1959,"Le Havre AC","FC Sochaux","2-2",2,2,"1",1,4,0,"D"
"6142",1960-05-22,1959,"OGC Nice","Limoges FC","3-3",3,3,"1",1,6,0,"D"
"6143",1960-05-22,1959,"AS Saint-Etienne","Sporting Toulon Var","3-1",3,1,"1",1,4,2,"H"
"6144",1960-05-22,1959,"Stade Rennes","Stade Francais FC","2-3",2,3,"1",1,5,-1,"D"
"6145",1960-05-28,1959,"Stade Reims","Le Havre AC","8-2",8,2,"1",1,10,6,"H"
"6146",1960-05-28,1959,"FC Sochaux","Racing Club de France","3-6",3,6,"1",1,9,-3,"D"
"6147",1960-05-28,1959,"Limoges FC","AS Monaco","0-2",0,2,"1",1,2,-2,"D"
"6148",1960-05-28,1959,"Angers SCO","RC Lens","4-1",4,1,"1",1,5,3,"H"
"6149",1960-05-28,1959,"US Valenciennes-Anzin","AS Saint-Etienne","2-0",2,0,"1",1,2,2,"H"
"6150",1960-05-29,1959,"Toulouse FC","Nimes Olympique","2-3",2,3,"1",1,5,-1,"D"
"6151",1960-05-29,1959,"Sporting Toulon Var","OGC Nice","1-1",1,1,"1",1,2,0,"D"
"6152",1960-05-29,1959,"Girondins Bordeaux","UA Sedan-Torcy","1-4",1,4,"1",1,5,-3,"D"
"6153",1960-05-29,1959,"Stade Francais FC","RC Strasbourg","2-1",2,1,"1",1,3,1,"H"
"6154",1960-05-29,1959,"Olympique Lyon","Stade Rennes","0-0",0,0,"1",1,0,0,"D"
"6155",1960-08-20,1960,"OGC Nice","Grenoble Foot 38","4-2",4,2,"1",1,6,2,"H"
"6156",1960-08-20,1960,"Stade Reims","Olympique Lyon","2-0",2,0,"1",1,2,2,"H"
"6157",1960-08-20,1960,"FC Rouen","Angers SCO","1-0",1,0,"1",1,1,1,"H"
"6158",1960-08-21,1960,"UA Sedan-Torcy","Stade Francais FC","4-0",4,0,"1",1,4,4,"H"
"6159",1960-08-21,1960,"AS Troyes-Savinienne","US Valenciennes-Anzin","0-2",0,2,"1",1,2,-2,"D"
"6160",1960-08-21,1960,"Stade Rennes","Toulouse FC","3-2",3,2,"1",1,5,1,"H"
"6161",1960-08-21,1960,"AS Saint-Etienne","Nimes Olympique","2-1",2,1,"1",1,3,1,"H"
"6162",1960-08-21,1960,"RC Lens","AS Monaco","0-1",0,1,"1",1,1,-1,"D"
"6163",1960-08-21,1960,"Racing Club de France","Le Havre AC","4-4",4,4,"1",1,8,0,"D"
"6164",1960-08-21,1960,"Limoges FC","AS Nancy","0-0",0,0,"1",1,0,0,"D"
"6165",1960-08-24,1960,"Stade Reims","US Valenciennes-Anzin","4-0",4,0,"1",1,4,4,"H"
"6166",1960-08-27,1960,"UA Sedan-Torcy","FC Rouen","4-0",4,0,"1",1,4,4,"H"
"6167",1960-08-27,1960,"AS Monaco","Nimes Olympique","3-0",3,0,"1",1,3,3,"H"
"6168",1960-08-27,1960,"Grenoble Foot 38","Le Havre AC","0-1",0,1,"1",1,1,-1,"D"
"6169",1960-08-27,1960,"Olympique Lyon","Stade Rennes","4-0",4,0,"1",1,4,4,"H"
"6170",1960-08-27,1960,"Stade Francais FC","AS Saint-Etienne","5-0",5,0,"1",1,5,5,"H"
"6171",1960-08-28,1960,"Toulouse FC","Limoges FC","2-1",2,1,"1",1,3,1,"H"
"6172",1960-08-28,1960,"RC Lens","AS Troyes-Savinienne","1-0",1,0,"1",1,1,1,"H"
"6173",1960-08-28,1960,"AS Nancy","OGC Nice","3-3",3,3,"1",1,6,0,"D"
"6174",1960-08-31,1960,"Angers SCO","Racing Club de France","0-3",0,3,"1",1,3,-3,"D"
"6175",1960-09-03,1960,"OGC Nice","RC Lens","1-0",1,0,"1",1,1,1,"H"
"6176",1960-09-03,1960,"FC Rouen","Olympique Lyon","0-1",0,1,"1",1,1,-1,"D"
"6177",1960-09-04,1960,"Limoges FC","AS Monaco","1-5",1,5,"1",1,6,-4,"D"
"6178",1960-09-04,1960,"Racing Club de France","Grenoble Foot 38","6-3",6,3,"1",1,9,3,"H"
"6179",1960-09-04,1960,"Stade Rennes","Stade Reims","2-2",2,2,"1",1,4,0,"D"
"6180",1960-09-04,1960,"Le Havre AC","UA Sedan-Torcy","1-0",1,0,"1",1,1,1,"H"
"6181",1960-09-04,1960,"US Valenciennes-Anzin","Toulouse FC","1-2",1,2,"1",1,3,-1,"D"
"6182",1960-09-04,1960,"AS Saint-Etienne","AS Nancy","1-1",1,1,"1",1,2,0,"D"
"6183",1960-09-04,1960,"Nimes Olympique","Stade Francais FC","4-3",4,3,"1",1,7,1,"H"
"6184",1960-09-04,1960,"AS Troyes-Savinienne","Angers SCO","1-2",1,2,"1",1,3,-1,"D"
"6185",1960-09-10,1960,"AS Monaco","FC Rouen","1-0",1,0,"1",1,1,1,"H"
"6186",1960-09-10,1960,"Olympique Lyon","OGC Nice","4-3",4,3,"1",1,7,1,"H"
"6187",1960-09-10,1960,"UA Sedan-Torcy","AS Saint-Etienne","2-2",2,2,"1",1,4,0,"D"
"6188",1960-09-10,1960,"Angers SCO","Nimes Olympique","4-2",4,2,"1",1,6,2,"H"
"6189",1960-09-11,1960,"Limoges FC","Racing Club de France","0-1",0,1,"1",1,1,-1,"D"
"6190",1960-09-11,1960,"RC Lens","Stade Reims","2-0",2,0,"1",1,2,2,"H"
"6191",1960-09-11,1960,"Toulouse FC","AS Troyes-Savinienne","3-3",3,3,"1",1,6,0,"D"
"6192",1960-09-11,1960,"Le Havre AC","US Valenciennes-Anzin","0-1",0,1,"1",1,1,-1,"D"
"6193",1960-09-11,1960,"Stade Francais FC","Stade Rennes","3-1",3,1,"1",1,4,2,"H"
"6194",1960-09-11,1960,"AS Nancy","Grenoble Foot 38","1-1",1,1,"1",1,2,0,"D"
"6195",1960-09-14,1960,"Stade Reims","Toulouse FC","4-2",4,2,"1",1,6,2,"H"
"6196",1960-09-14,1960,"Angers SCO","UA Sedan-Torcy","0-0",0,0,"1",1,0,0,"D"
"6197",1960-09-14,1960,"OGC Nice","Le Havre AC","3-3",3,3,"1",1,6,0,"D"
"6198",1960-09-14,1960,"Grenoble Foot 38","Stade Francais FC","1-0",1,0,"1",1,1,1,"H"
"6199",1960-09-14,1960,"FC Rouen","AS Nancy","3-1",3,1,"1",1,4,2,"H"
"6200",1960-09-14,1960,"Limoges FC","US Valenciennes-Anzin","2-1",2,1,"1",1,3,1,"H"
"6201",1960-09-15,1960,"AS Saint-Etienne","AS Monaco","0-1",0,1,"1",1,1,-1,"D"
"6202",1960-09-15,1960,"Racing Club de France","Olympique Lyon","3-2",3,2,"1",1,5,1,"H"
"6203",1960-09-15,1960,"Nimes Olympique","RC Lens","1-2",1,2,"1",1,3,-1,"D"
"6204",1960-09-15,1960,"AS Troyes-Savinienne","Stade Rennes","2-3",2,3,"1",1,5,-1,"D"
"6205",1960-09-17,1960,"Stade Francais FC","OGC Nice","1-3",1,3,"1",1,4,-2,"D"
"6206",1960-09-18,1960,"AS Nancy","Racing Club de France","1-1",1,1,"1",1,2,0,"D"
"6207",1960-09-18,1960,"US Valenciennes-Anzin","Olympique Lyon","1-2",1,2,"1",1,3,-1,"D"
"6208",1960-09-18,1960,"Le Havre AC","Stade Reims","2-1",2,1,"1",1,3,1,"H"
"6209",1960-09-18,1960,"Toulouse FC","FC Rouen","2-0",2,0,"1",1,2,2,"H"
"6210",1960-09-18,1960,"Stade Rennes","Limoges FC","3-2",3,2,"1",1,5,1,"H"
"6211",1960-09-18,1960,"UA Sedan-Torcy","Nimes Olympique","1-3",1,3,"1",1,4,-2,"D"
"6212",1960-09-18,1960,"RC Lens","AS Saint-Etienne","1-3",1,3,"1",1,4,-2,"D"
"6213",1960-09-18,1960,"Grenoble Foot 38","AS Troyes-Savinienne","1-0",1,0,"1",1,1,1,"H"
"6214",1960-09-24,1960,"FC Rouen","Nimes Olympique","2-1",2,1,"1",1,3,1,"H"
"6215",1960-09-25,1960,"Stade Rennes","Grenoble Foot 38","1-0",1,0,"1",1,1,1,"H"
"6216",1960-09-25,1960,"US Valenciennes-Anzin","UA Sedan-Torcy","1-3",1,3,"1",1,4,-2,"D"
"6217",1960-09-25,1960,"Limoges FC","Olympique Lyon","3-1",3,1,"1",1,4,2,"H"
"6218",1960-09-25,1960,"Toulouse FC","AS Nancy","2-2",2,2,"1",1,4,0,"D"
"6219",1960-09-25,1960,"AS Troyes-Savinienne","Le Havre AC","4-3",4,3,"1",1,7,1,"H"
"6220",1960-09-25,1960,"Stade Francais FC","RC Lens","0-0",0,0,"1",1,0,0,"D"
"6221",1960-10-02,1960,"AS Monaco","OGC Nice","5-1",5,1,"1",1,6,4,"H"
"6222",1960-10-02,1960,"Racing Club de France","Stade Francais FC","3-1",3,1,"1",1,4,2,"H"
"6223",1960-10-02,1960,"Angers SCO","Stade Rennes","1-1",1,1,"1",1,2,0,"D"
"6224",1960-10-02,1960,"Stade Reims","UA Sedan-Torcy","4-3",4,3,"1",1,7,1,"H"
"6225",1960-10-02,1960,"Olympique Lyon","AS Saint-Etienne","2-2",2,2,"1",1,4,0,"D"
"6226",1960-10-02,1960,"RC Lens","US Valenciennes-Anzin","2-0",2,0,"1",1,2,2,"H"
"6227",1960-10-02,1960,"Le Havre AC","FC Rouen","0-2",0,2,"1",1,2,-2,"D"
"6228",1960-10-02,1960,"Nimes Olympique","Toulouse FC","3-0",3,0,"1",1,3,3,"H"
"6229",1960-10-02,1960,"Grenoble Foot 38","Limoges FC","2-0",2,0,"1",1,2,2,"H"
"6230",1960-10-02,1960,"AS Troyes-Savinienne","AS Nancy","2-1",2,1,"1",1,3,1,"H"
"6231",1960-10-05,1960,"AS Monaco","Angers SCO","2-0",2,0,"1",1,2,2,"H"
"6232",1960-10-09,1960,"Toulouse FC","AS Monaco","3-0",3,0,"1",1,3,3,"H"
"6233",1960-10-09,1960,"US Valenciennes-Anzin","Racing Club de France","1-3",1,3,"1",1,4,-2,"D"
"6234",1960-10-09,1960,"OGC Nice","Stade Reims","1-4",1,4,"1",1,5,-3,"D"
"6235",1960-10-09,1960,"UA Sedan-Torcy","RC Lens","0-0",0,0,"1",1,0,0,"D"
"6236",1960-10-09,1960,"FC Rouen","AS Troyes-Savinienne","1-0",1,0,"1",1,1,1,"H"
"6237",1960-10-09,1960,"Nimes Olympique","Stade Rennes","1-0",1,0,"1",1,1,1,"H"
"6238",1960-10-09,1960,"Angers SCO","Olympique Lyon","3-0",3,0,"1",1,3,3,"H"
"6239",1960-10-09,1960,"AS Nancy","Le Havre AC","0-0",0,0,"1",1,0,0,"D"
"6240",1960-10-09,1960,"AS Saint-Etienne","Grenoble Foot 38","3-1",3,1,"1",1,4,2,"H"
"6241",1960-10-09,1960,"Stade Francais FC","Limoges FC","0-1",0,1,"1",1,1,-1,"D"
"6242",1960-10-15,1960,"AS Monaco","Stade Francais FC","2-4",2,4,"1",1,6,-2,"D"
"6243",1960-10-16,1960,"Racing Club de France","UA Sedan-Torcy","2-0",2,0,"1",1,2,2,"H"
"6244",1960-10-16,1960,"Stade Reims","FC Rouen","3-1",3,1,"1",1,4,2,"H"
"6245",1960-10-16,1960,"Olympique Lyon","RC Lens","1-2",1,2,"1",1,3,-1,"D"
"6246",1960-10-16,1960,"Stade Rennes","AS Nancy","1-0",1,0,"1",1,1,1,"H"
"6247",1960-10-16,1960,"Le Havre AC","AS Saint-Etienne","2-1",2,1,"1",1,3,1,"H"
"6248",1960-10-16,1960,"Limoges FC","Angers SCO","1-3",1,3,"1",1,4,-2,"D"
"6249",1960-10-16,1960,"AS Troyes-Savinienne","Nimes Olympique","0-2",0,2,"1",1,2,-2,"D"
"6250",1960-10-16,1960,"Grenoble Foot 38","Toulouse FC","4-0",4,0,"1",1,4,4,"H"
"6251",1960-10-16,1960,"US Valenciennes-Anzin","OGC Nice","3-1",3,1,"1",1,4,2,"H"
"6252",1960-10-19,1960,"OGC Nice","Racing Club de France","0-1",0,1,"1",1,1,-1,"D"
"6253",1960-10-19,1960,"Stade Reims","AS Monaco","3-0",3,0,"1",1,3,3,"H"
"6254",1960-10-19,1960,"AS Saint-Etienne","Angers SCO","2-2",2,2,"1",1,4,0,"D"
"6255",1960-10-23,1960,"FC Rouen","Racing Club de France","0-3",0,3,"1",1,3,-3,"D"
"6256",1960-10-23,1960,"Stade Francais FC","Stade Reims","0-1",0,1,"1",1,1,-1,"D"
"6257",1960-10-23,1960,"AS Troyes-Savinienne","AS Monaco","0-1",0,1,"1",1,1,-1,"D"
"6258",1960-10-23,1960,"AS Saint-Etienne","Stade Rennes","1-3",1,3,"1",1,4,-2,"D"
"6259",1960-10-23,1960,"Angers SCO","US Valenciennes-Anzin","3-1",3,1,"1",1,4,2,"H"
"6260",1960-10-23,1960,"RC Lens","Grenoble Foot 38","1-1",1,1,"1",1,2,0,"D"
"6261",1960-10-23,1960,"Nimes Olympique","Limoges FC","3-2",3,2,"1",1,5,1,"H"
"6262",1960-10-23,1960,"Toulouse FC","Le Havre AC","4-1",4,1,"1",1,5,3,"H"
"6263",1960-10-23,1960,"UA Sedan-Torcy","OGC Nice","4-3",4,3,"1",1,7,1,"H"
"6264",1960-10-23,1960,"AS Nancy","Olympique Lyon","2-1",2,1,"1",1,3,1,"H"
"6265",1960-10-30,1960,"Grenoble Foot 38","AS Monaco","0-0",0,0,"1",1,0,0,"D"
"6266",1960-10-30,1960,"Stade Rennes","FC Rouen","0-0",0,0,"1",1,0,0,"D"
"6267",1960-10-30,1960,"OGC Nice","Nimes Olympique","0-1",0,1,"1",1,1,-1,"D"
"6268",1960-10-30,1960,"Le Havre AC","Stade Francais FC","0-0",0,0,"1",1,0,0,"D"
"6269",1960-10-30,1960,"AS Troyes-Savinienne","AS Saint-Etienne","4-0",4,0,"1",1,4,4,"H"
"6270",1960-10-30,1960,"US Valenciennes-Anzin","AS Nancy","2-1",2,1,"1",1,3,1,"H"
"6271",1960-11-01,1960,"AS Saint-Etienne","Racing Club de France","1-2",1,2,"1",1,3,-1,"D"
"6272",1960-11-01,1960,"AS Monaco","Le Havre AC","2-2",2,2,"1",1,4,0,"D"
"6273",1960-11-01,1960,"AS Nancy","Stade Reims","2-0",2,0,"1",1,2,2,"H"
"6274",1960-11-01,1960,"Nimes Olympique","Olympique Lyon","3-0",3,0,"1",1,3,3,"H"
"6275",1960-11-01,1960,"Angers SCO","OGC Nice","5-0",5,0,"1",1,5,5,"H"
"6276",1960-11-01,1960,"RC Lens","Stade Rennes","3-1",3,1,"1",1,4,2,"H"
"6277",1960-11-01,1960,"UA Sedan-Torcy","Toulouse FC","1-1",1,1,"1",1,2,0,"D"
"6278",1960-11-01,1960,"FC Rouen","Grenoble Foot 38","2-0",2,0,"1",1,2,2,"H"
"6279",1960-11-01,1960,"Stade Francais FC","US Valenciennes-Anzin","3-0",3,0,"1",1,3,3,"H"
"6280",1960-11-01,1960,"Limoges FC","AS Troyes-Savinienne","1-0",1,0,"1",1,1,1,"H"
"6281",1960-11-06,1960,"Racing Club de France","RC Lens","3-2",3,2,"1",1,5,1,"H"
"6282",1960-11-06,1960,"US Valenciennes-Anzin","AS Monaco","1-3",1,3,"1",1,4,-2,"D"
"6283",1960-11-06,1960,"Stade Reims","Nimes Olympique","5-1",5,1,"1",1,6,4,"H"
"6284",1960-11-06,1960,"AS Nancy","Angers SCO","0-2",0,2,"1",1,2,-2,"D"
"6285",1960-11-06,1960,"Stade Rennes","UA Sedan-Torcy","2-0",2,0,"1",1,2,2,"H"
"6286",1960-11-06,1960,"Le Havre AC","Limoges FC","2-1",2,1,"1",1,3,1,"H"
"6287",1960-11-06,1960,"Toulouse FC","AS Saint-Etienne","0-1",0,1,"1",1,1,-1,"D"
"6288",1960-11-06,1960,"OGC Nice","FC Rouen","3-0",3,0,"1",1,3,3,"H"
"6289",1960-11-06,1960,"Olympique Lyon","Grenoble Foot 38","1-1",1,1,"1",1,2,0,"D"
"6290",1960-11-06,1960,"AS Troyes-Savinienne","Stade Francais FC","5-3",5,3,"1",1,8,2,"H"
"6291",1960-11-11,1960,"AS Troyes-Savinienne","Racing Club de France","1-4",1,4,"1",1,5,-3,"D"
"6292",1960-11-11,1960,"AS Monaco","Stade Rennes","3-0",3,0,"1",1,3,3,"H"
"6293",1960-11-11,1960,"Grenoble Foot 38","Stade Reims","3-2",3,2,"1",1,5,1,"H"
"6294",1960-11-11,1960,"Angers SCO","Le Havre AC","1-0",1,0,"1",1,1,1,"H"
"6295",1960-11-11,1960,"Nimes Olympique","US Valenciennes-Anzin","2-0",2,0,"1",1,2,2,"H"
"6296",1960-11-11,1960,"RC Lens","Toulouse FC","3-1",3,1,"1",1,4,2,"H"
"6297",1960-11-11,1960,"FC Rouen","Limoges FC","3-1",3,1,"1",1,4,2,"H"
"6298",1960-11-11,1960,"UA Sedan-Torcy","AS Nancy","2-1",2,1,"1",1,3,1,"H"
"6299",1960-11-11,1960,"AS Saint-Etienne","OGC Nice","0-0",0,0,"1",1,0,0,"D"
"6300",1960-11-11,1960,"Stade Francais FC","Olympique Lyon","3-1",3,1,"1",1,4,2,"H"
"6301",1960-11-13,1960,"Racing Club de France","Stade Rennes","0-2",0,2,"1",1,2,-2,"D"
"6302",1960-11-13,1960,"Olympique Lyon","AS Monaco","2-0",2,0,"1",1,2,2,"H"
"6303",1960-11-13,1960,"Grenoble Foot 38","Angers SCO","0-0",0,0,"1",1,0,0,"D"
"6304",1960-11-13,1960,"Stade Reims","AS Saint-Etienne","0-1",0,1,"1",1,1,-1,"D"
"6305",1960-11-13,1960,"AS Nancy","RC Lens","2-2",2,2,"1",1,4,0,"D"
"6306",1960-11-13,1960,"Le Havre AC","Nimes Olympique","3-0",3,0,"1",1,3,3,"H"
"6307",1960-11-13,1960,"Limoges FC","UA Sedan-Torcy","1-2",1,2,"1",1,3,-1,"D"
"6308",1960-11-13,1960,"Toulouse FC","Stade Francais FC","1-0",1,0,"1",1,1,1,"H"
"6309",1960-11-13,1960,"US Valenciennes-Anzin","FC Rouen","2-1",2,1,"1",1,3,1,"H"
"6310",1960-11-13,1960,"OGC Nice","AS Troyes-Savinienne","1-1",1,1,"1",1,2,0,"D"
"6311",1960-11-19,1960,"AS Monaco","Racing Club de France","3-0",3,0,"1",1,3,3,"H"
"6312",1960-11-20,1960,"Limoges FC","Stade Reims","0-1",0,1,"1",1,1,-1,"D"
"6313",1960-11-20,1960,"Toulouse FC","Angers SCO","3-1",3,1,"1",1,4,2,"H"
"6314",1960-11-20,1960,"RC Lens","FC Rouen","1-0",1,0,"1",1,1,1,"H"
"6315",1960-11-20,1960,"Nimes Olympique","Grenoble Foot 38","2-2",2,2,"1",1,4,0,"D"
"6316",1960-11-20,1960,"Le Havre AC","Olympique Lyon","3-2",3,2,"1",1,5,1,"H"
"6317",1960-11-20,1960,"Stade Rennes","OGC Nice","1-2",1,2,"1",1,3,-1,"D"
"6318",1960-11-20,1960,"UA Sedan-Torcy","AS Troyes-Savinienne","4-1",4,1,"1",1,5,3,"H"
"6319",1960-11-20,1960,"AS Saint-Etienne","US Valenciennes-Anzin","1-0",1,0,"1",1,1,1,"H"
"6320",1960-11-20,1960,"Stade Francais FC","AS Nancy","0-2",0,2,"1",1,2,-2,"D"
"6321",1960-11-23,1960,"Racing Club de France","Toulouse FC","3-0",3,0,"1",1,3,3,"H"
"6322",1960-11-27,1960,"Racing Club de France","Nimes Olympique","3-2",3,2,"1",1,5,1,"H"
"6323",1960-11-27,1960,"AS Nancy","AS Monaco","0-4",0,4,"1",1,4,-4,"D"
"6324",1960-11-27,1960,"AS Troyes-Savinienne","Stade Reims","1-4",1,4,"1",1,5,-3,"D"
"6325",1960-11-27,1960,"Angers SCO","Stade Francais FC","1-0",1,0,"1",1,1,1,"H"
"6326",1960-11-27,1960,"RC Lens","Le Havre AC","2-1",2,1,"1",1,3,1,"H"
"6327",1960-11-27,1960,"UA Sedan-Torcy","Grenoble Foot 38","3-0",3,0,"1",1,3,3,"H"
"6328",1960-11-27,1960,"US Valenciennes-Anzin","Stade Rennes","1-0",1,0,"1",1,1,1,"H"
"6329",1960-11-27,1960,"Olympique Lyon","Toulouse FC","1-0",1,0,"1",1,1,1,"H"
"6330",1960-11-27,1960,"FC Rouen","AS Saint-Etienne","1-0",1,0,"1",1,1,1,"H"
"6331",1960-11-27,1960,"OGC Nice","Limoges FC","2-1",2,1,"1",1,3,1,"H"
"6332",1960-12-04,1960,"Stade Reims","Racing Club de France","5-3",5,3,"1",1,8,2,"H"
"6333",1960-12-04,1960,"AS Monaco","UA Sedan-Torcy","2-0",2,0,"1",1,2,2,"H"
"6334",1960-12-04,1960,"Angers SCO","RC Lens","3-2",3,2,"1",1,5,1,"H"
"6335",1960-12-04,1960,"Stade Rennes","Le Havre AC","3-2",3,2,"1",1,5,1,"H"
"6336",1960-12-04,1960,"AS Nancy","Nimes Olympique","2-2",2,2,"1",1,4,0,"D"
"6337",1960-12-04,1960,"Stade Francais FC","FC Rouen","0-1",0,1,"1",1,1,-1,"D"
"6338",1960-12-04,1960,"Toulouse FC","OGC Nice","0-0",0,0,"1",1,0,0,"D"
"6339",1960-12-04,1960,"Limoges FC","AS Saint-Etienne","1-1",1,1,"1",1,2,0,"D"
"6340",1960-12-04,1960,"Grenoble Foot 38","US Valenciennes-Anzin","0-0",0,0,"1",1,0,0,"D"
"6341",1960-12-04,1960,"Olympique Lyon","AS Troyes-Savinienne","5-2",5,2,"1",1,7,3,"H"
"6342",1960-12-14,1960,"Stade Reims","Angers SCO","1-0",1,0,"1",1,1,1,"H"
"6343",1960-12-14,1960,"Limoges FC","RC Lens","5-2",5,2,"1",1,7,3,"H"
"6344",1960-12-14,1960,"Olympique Lyon","UA Sedan-Torcy","1-1",1,1,"1",1,2,0,"D"
"6345",1960-12-18,1960,"Racing Club de France","Angers SCO","5-3",5,3,"1",1,8,2,"H"
"6346",1960-12-18,1960,"UA Sedan-Torcy","AS Monaco","4-1",4,1,"1",1,5,3,"H"
"6347",1960-12-18,1960,"RC Lens","Limoges FC","1-1",1,1,"1",1,2,0,"D"
"6348",1960-12-18,1960,"Stade Rennes","AS Troyes-Savinienne","2-2",2,2,"1",1,4,0,"D"
"6349",1960-12-18,1960,"Le Havre AC","Toulouse FC","3-0",3,0,"1",1,3,3,"H"
"6350",1960-12-18,1960,"OGC Nice","US Valenciennes-Anzin","2-0",2,0,"1",1,2,2,"H"
"6351",1960-12-18,1960,"Grenoble Foot 38","Olympique Lyon","2-2",2,2,"1",1,4,0,"D"
"6352",1960-12-18,1960,"AS Nancy","Stade Francais FC","5-1",5,1,"1",1,6,4,"H"
"6353",1960-12-24,1960,"Olympique Lyon","Racing Club de France","4-2",4,2,"1",1,6,2,"H"
"6354",1960-12-24,1960,"AS Monaco","RC Lens","2-1",2,1,"1",1,3,1,"H"
"6355",1960-12-25,1960,"Stade Reims","Grenoble Foot 38","1-0",1,0,"1",1,1,1,"H"
"6356",1960-12-25,1960,"Toulouse FC","UA Sedan-Torcy","0-2",0,2,"1",1,2,-2,"D"
"6357",1960-12-25,1960,"Angers SCO","AS Nancy","1-2",1,2,"1",1,3,-1,"D"
"6358",1960-12-25,1960,"Stade Francais FC","Nimes Olympique","2-1",2,1,"1",1,3,1,"H"
"6359",1960-12-25,1960,"FC Rouen","Stade Rennes","1-0",1,0,"1",1,1,1,"H"
"6360",1960-12-25,1960,"Limoges FC","Le Havre AC","2-1",2,1,"1",1,3,1,"H"
"6361",1960-12-25,1960,"AS Troyes-Savinienne","OGC Nice","0-5",0,5,"1",1,5,-5,"D"
"6362",1960-12-25,1960,"US Valenciennes-Anzin","AS Saint-Etienne","3-1",3,1,"1",1,4,2,"H"
"6363",1961-01-01,1960,"Racing Club de France","US Valenciennes-Anzin","1-1",1,1,"1",1,2,0,"D"
"6364",1961-01-01,1960,"Stade Rennes","AS Monaco","1-3",1,3,"1",1,4,-2,"D"
"6365",1961-01-01,1960,"Stade Reims","Limoges FC","2-2",2,2,"1",1,4,0,"D"
"6366",1961-01-01,1960,"OGC Nice","UA Sedan-Torcy","3-1",3,1,"1",1,4,2,"H"
"6367",1961-01-01,1960,"Grenoble Foot 38","Nimes Olympique","1-2",1,2,"1",1,3,-1,"D"
"6368",1961-01-01,1960,"AS Troyes-Savinienne","FC Rouen","0-2",0,2,"1",1,2,-2,"D"
"6369",1961-01-01,1960,"Le Havre AC","AS Nancy","1-1",1,1,"1",1,2,0,"D"
"6370",1961-01-01,1960,"Toulouse FC","Olympique Lyon","2-0",2,0,"1",1,2,2,"H"
"6371",1961-01-01,1960,"AS Saint-Etienne","Stade Francais FC","2-0",2,0,"1",1,2,2,"H"
"6372",1961-01-02,1960,"RC Lens","Angers SCO","2-2",2,2,"1",1,4,0,"D"
"6373",1961-01-08,1960,"AS Monaco","Grenoble Foot 38","1-0",1,0,"1",1,1,1,"H"
"6374",1961-01-08,1960,"Stade Rennes","Racing Club de France","1-1",1,1,"1",1,2,0,"D"
"6375",1961-01-08,1960,"Angers SCO","Stade Reims","3-2",3,2,"1",1,5,1,"H"
"6376",1961-01-08,1960,"UA Sedan-Torcy","Le Havre AC","2-1",2,1,"1",1,3,1,"H"
"6377",1961-01-08,1960,"Nimes Olympique","AS Troyes-Savinienne","2-0",2,0,"1",1,2,2,"H"
"6378",1961-01-08,1960,"FC Rouen","OGC Nice","1-0",1,0,"1",1,1,1,"H"
"6379",1961-01-08,1960,"AS Saint-Etienne","RC Lens","1-0",1,0,"1",1,1,1,"H"
"6380",1961-01-08,1960,"Stade Francais FC","Toulouse FC","1-3",1,3,"1",1,4,-2,"D"
"6381",1961-01-08,1960,"AS Nancy","Limoges FC","0-0",0,0,"1",1,0,0,"D"
"6382",1961-01-08,1960,"Olympique Lyon","US Valenciennes-Anzin","0-0",0,0,"1",1,0,0,"D"
"6383",1961-01-19,1960,"AS Saint-Etienne","FC Rouen","1-1",1,1,"1",1,2,0,"D"
"6384",1961-01-22,1960,"AS Monaco","AS Troyes-Savinienne","5-0",5,0,"1",1,5,5,"H"
"6385",1961-01-22,1960,"Racing Club de France","AS Nancy","2-0",2,0,"1",1,2,2,"H"
"6386",1961-01-22,1960,"Stade Reims","RC Lens","1-0",1,0,"1",1,1,1,"H"
"6387",1961-01-22,1960,"Olympique Lyon","Angers SCO","1-1",1,1,"1",1,2,0,"D"
"6388",1961-01-22,1960,"FC Rouen","UA Sedan-Torcy","1-0",1,0,"1",1,1,1,"H"
"6389",1961-01-22,1960,"US Valenciennes-Anzin","Nimes Olympique","2-2",2,2,"1",1,4,0,"D"
"6390",1961-01-22,1960,"Le Havre AC","Stade Rennes","3-2",3,2,"1",1,5,1,"H"
"6391",1961-01-22,1960,"OGC Nice","Toulouse FC","1-1",1,1,"1",1,2,0,"D"
"6392",1961-01-22,1960,"Grenoble Foot 38","AS Saint-Etienne","1-1",1,1,"1",1,2,0,"D"
"6393",1961-01-22,1960,"Limoges FC","Stade Francais FC","4-3",4,3,"1",1,7,1,"H"
"6394",1961-01-29,1960,"AS Monaco","Olympique Lyon","3-1",3,1,"1",1,4,2,"H"
"6395",1961-01-29,1960,"Racing Club de France","FC Rouen","0-1",0,1,"1",1,1,-1,"D"
"6396",1961-01-29,1960,"Toulouse FC","Stade Reims","3-1",3,1,"1",1,4,2,"H"
"6397",1961-01-29,1960,"Angers SCO","Limoges FC","4-0",4,0,"1",1,4,4,"H"
"6398",1961-01-29,1960,"UA Sedan-Torcy","Stade Rennes","2-1",2,1,"1",1,3,1,"H"
"6399",1961-01-29,1960,"Nimes Olympique","OGC Nice","4-1",4,1,"1",1,5,3,"H"
"6400",1961-01-29,1960,"AS Saint-Etienne","AS Troyes-Savinienne","7-1",7,1,"1",1,8,6,"H"
"6401",1961-01-29,1960,"Le Havre AC","Grenoble Foot 38","1-1",1,1,"1",1,2,0,"D"
"6402",1961-01-29,1960,"RC Lens","Stade Francais FC","2-2",2,2,"1",1,4,0,"D"
"6403",1961-01-29,1960,"AS Nancy","US Valenciennes-Anzin","4-0",4,0,"1",1,4,4,"H"
"6404",1961-02-05,1960,"AS Monaco","AS Nancy","2-0",2,0,"1",1,2,2,"H"
"6405",1961-02-05,1960,"Nimes Olympique","Racing Club de France","2-2",2,2,"1",1,4,0,"D"
"6406",1961-02-05,1960,"Olympique Lyon","Stade Reims","0-2",0,2,"1",1,2,-2,"D"
"6407",1961-02-05,1960,"US Valenciennes-Anzin","Angers SCO","0-1",0,1,"1",1,1,-1,"D"
"6408",1961-02-05,1960,"FC Rouen","Toulouse FC","7-0",7,0,"1",1,7,7,"H"
"6409",1961-02-05,1960,"AS Troyes-Savinienne","UA Sedan-Torcy","3-7",3,7,"1",1,10,-4,"D"
"6410",1961-02-05,1960,"Stade Rennes","AS Saint-Etienne","2-2",2,2,"1",1,4,0,"D"
"6411",1961-02-05,1960,"Stade Francais FC","Le Havre AC","3-1",3,1,"1",1,4,2,"H"
"6412",1961-02-05,1960,"Limoges FC","OGC Nice","4-2",4,2,"1",1,6,2,"H"
"6413",1961-02-15,1960,"Nimes Olympique","Stade Reims","2-0",2,0,"1",1,2,2,"H"
"6414",1961-02-19,1960,"Stade Francais FC","AS Monaco","1-1",1,1,"1",1,2,0,"D"
"6415",1961-02-19,1960,"RC Lens","Racing Club de France","1-3",1,3,"1",1,4,-2,"D"
"6416",1961-02-19,1960,"Stade Reims","AS Nancy","3-0",3,0,"1",1,3,3,"H"
"6417",1961-02-19,1960,"Le Havre AC","Angers SCO","0-0",0,0,"1",1,0,0,"D"
"6418",1961-02-19,1960,"Grenoble Foot 38","FC Rouen","0-0",0,0,"1",1,0,0,"D"
"6419",1961-02-19,1960,"UA Sedan-Torcy","Limoges FC","1-1",1,1,"1",1,2,0,"D"
"6420",1961-02-19,1960,"Olympique Lyon","Nimes Olympique","2-2",2,2,"1",1,4,0,"D"
"6421",1961-02-19,1960,"OGC Nice","AS Saint-Etienne","1-0",1,0,"1",1,1,1,"H"
"6422",1961-02-19,1960,"AS Troyes-Savinienne","Toulouse FC","0-3",0,3,"1",1,3,-3,"D"
"6423",1961-02-19,1960,"Stade Rennes","US Valenciennes-Anzin","1-2",1,2,"1",1,3,-1,"D"
"6424",1961-02-26,1960,"Nimes Olympique","AS Monaco","1-1",1,1,"1",1,2,0,"D"
"6425",1961-02-26,1960,"Racing Club de France","AS Troyes-Savinienne","3-3",3,3,"1",1,6,0,"D"
"6426",1961-02-26,1960,"AS Saint-Etienne","Stade Reims","3-1",3,1,"1",1,4,2,"H"
"6427",1961-02-26,1960,"Angers SCO","Grenoble Foot 38","2-2",2,2,"1",1,4,0,"D"
"6428",1961-02-26,1960,"FC Rouen","Stade Francais FC","0-0",0,0,"1",1,0,0,"D"
"6429",1961-02-26,1960,"AS Nancy","UA Sedan-Torcy","2-1",2,1,"1",1,3,1,"H"
"6430",1961-02-26,1960,"Toulouse FC","RC Lens","0-0",0,0,"1",1,0,0,"D"
"6431",1961-02-26,1960,"OGC Nice","Olympique Lyon","2-2",2,2,"1",1,4,0,"D"
"6432",1961-02-26,1960,"US Valenciennes-Anzin","Le Havre AC","1-0",1,0,"1",1,1,1,"H"
"6433",1961-02-26,1960,"Limoges FC","Stade Rennes","0-0",0,0,"1",1,0,0,"D"
"6434",1961-03-11,1960,"UA Sedan-Torcy","Olympique Lyon","2-1",2,1,"1",1,3,1,"H"
"6435",1961-03-11,1960,"AS Nancy","Toulouse FC","1-0",1,0,"1",1,1,1,"H"
"6436",1961-03-12,1960,"AS Monaco","Stade Reims","2-0",2,0,"1",1,2,2,"H"
"6437",1961-03-12,1960,"Grenoble Foot 38","Racing Club de France","0-2",0,2,"1",1,2,-2,"D"
"6438",1961-03-12,1960,"Stade Francais FC","Angers SCO","1-0",1,0,"1",1,1,1,"H"
"6439",1961-03-12,1960,"Nimes Olympique","FC Rouen","3-1",3,1,"1",1,4,2,"H"
"6440",1961-03-12,1960,"AS Saint-Etienne","Limoges FC","3-1",3,1,"1",1,4,2,"H"
"6441",1961-03-12,1960,"Le Havre AC","OGC Nice","3-2",3,2,"1",1,5,1,"H"
"6442",1961-03-12,1960,"Stade Rennes","RC Lens","4-2",4,2,"1",1,6,2,"H"
"6443",1961-03-12,1960,"US Valenciennes-Anzin","AS Troyes-Savinienne","1-0",1,0,"1",1,1,1,"H"
"6444",1961-03-19,1960,"AS Monaco","Toulouse FC","3-1",3,1,"1",1,4,2,"H"
"6445",1961-03-19,1960,"Racing Club de France","Limoges FC","3-1",3,1,"1",1,4,2,"H"
"6446",1961-03-19,1960,"Stade Reims","Stade Francais FC","2-0",2,0,"1",1,2,2,"H"
"6447",1961-03-19,1960,"Nimes Olympique","Le Havre AC","2-1",2,1,"1",1,3,1,"H"
"6448",1961-03-19,1960,"FC Rouen","US Valenciennes-Anzin","3-0",3,0,"1",1,3,3,"H"
"6449",1961-03-19,1960,"RC Lens","UA Sedan-Torcy","0-0",0,0,"1",1,0,0,"D"
"6450",1961-03-19,1960,"Angers SCO","AS Saint-Etienne","2-4",2,4,"1",1,6,-2,"D"
"6451",1961-03-19,1960,"Olympique Lyon","AS Nancy","0-1",0,1,"1",1,1,-1,"D"
"6452",1961-03-19,1960,"OGC Nice","Stade Rennes","3-1",3,1,"1",1,4,2,"H"
"6453",1961-03-19,1960,"AS Troyes-Savinienne","Grenoble Foot 38","3-3",3,3,"1",1,6,0,"D"
"6454",1961-03-22,1960,"Grenoble Foot 38","RC Lens","2-1",2,1,"1",1,3,1,"H"
"6455",1961-04-08,1960,"AS Nancy","AS Troyes-Savinienne","3-2",3,2,"1",1,5,1,"H"
"6456",1961-04-08,1960,"FC Rouen","Le Havre AC","3-1",3,1,"1",1,4,2,"H"
"6457",1961-04-09,1960,"OGC Nice","AS Monaco","6-0",6,0,"1",1,6,6,"H"
"6458",1961-04-09,1960,"Stade Francais FC","Racing Club de France","3-3",3,3,"1",1,6,0,"D"
"6459",1961-04-09,1960,"UA Sedan-Torcy","Stade Reims","0-4",0,4,"1",1,4,-4,"D"
"6460",1961-04-09,1960,"Toulouse FC","Nimes Olympique","0-0",0,0,"1",1,0,0,"D"
"6461",1961-04-09,1960,"AS Saint-Etienne","Olympique Lyon","4-2",4,2,"1",1,6,2,"H"
"6462",1961-04-09,1960,"Stade Rennes","Angers SCO","2-0",2,0,"1",1,2,2,"H"
"6463",1961-04-09,1960,"US Valenciennes-Anzin","RC Lens","0-1",0,1,"1",1,1,-1,"D"
"6464",1961-04-09,1960,"Limoges FC","Grenoble Foot 38","1-0",1,0,"1",1,1,1,"H"
"6465",1961-04-22,1960,"Olympique Lyon","FC Rouen","4-1",4,1,"1",1,5,3,"H"
"6466",1961-04-22,1960,"Stade Reims","AS Troyes-Savinienne","3-1",3,1,"1",1,4,2,"H"
"6467",1961-04-22,1960,"Grenoble Foot 38","Stade Rennes","1-1",1,1,"1",1,2,0,"D"
"6468",1961-04-23,1960,"Racing Club de France","OGC Nice","4-2",4,2,"1",1,6,2,"H"
"6469",1961-04-23,1960,"Angers SCO","Toulouse FC","1-0",1,0,"1",1,1,1,"H"
"6470",1961-04-23,1960,"Le Havre AC","RC Lens","3-2",3,2,"1",1,5,1,"H"
"6471",1961-04-23,1960,"US Valenciennes-Anzin","Stade Francais FC","0-0",0,0,"1",1,0,0,"D"
"6472",1961-04-23,1960,"AS Saint-Etienne","UA Sedan-Torcy","0-0",0,0,"1",1,0,0,"D"
"6473",1961-04-29,1960,"UA Sedan-Torcy","Racing Club de France","1-3",1,3,"1",1,4,-2,"D"
"6474",1961-04-29,1960,"FC Rouen","AS Monaco","2-3",2,3,"1",1,5,-1,"D"
"6475",1961-04-29,1960,"Stade Reims","Le Havre AC","2-0",2,0,"1",1,2,2,"H"
"6476",1961-04-29,1960,"OGC Nice","Angers SCO","3-2",3,2,"1",1,5,1,"H"
"6477",1961-04-30,1960,"Stade Rennes","Nimes Olympique","0-0",0,0,"1",1,0,0,"D"
"6478",1961-04-30,1960,"AS Nancy","AS Saint-Etienne","2-2",2,2,"1",1,4,0,"D"
"6479",1961-04-30,1960,"Toulouse FC","US Valenciennes-Anzin","2-2",2,2,"1",1,4,0,"D"
"6480",1961-04-30,1960,"RC Lens","Olympique Lyon","0-1",0,1,"1",1,1,-1,"D"
"6481",1961-04-30,1960,"Stade Francais FC","Grenoble Foot 38","1-0",1,0,"1",1,1,1,"H"
"6482",1961-04-30,1960,"AS Troyes-Savinienne","Limoges FC","3-2",3,2,"1",1,5,1,"H"
"6483",1961-05-03,1960,"AS Monaco","Limoges FC","3-2",3,2,"1",1,5,1,"H"
"6484",1961-05-10,1960,"Racing Club de France","AS Saint-Etienne","4-2",4,2,"1",1,6,2,"H"
"6485",1961-05-11,1960,"Angers SCO","AS Monaco","1-4",1,4,"1",1,5,-3,"D"
"6486",1961-05-11,1960,"US Valenciennes-Anzin","Stade Reims","0-2",0,2,"1",1,2,-2,"D"
"6487",1961-05-11,1960,"Nimes Olympique","UA Sedan-Torcy","5-0",5,0,"1",1,5,5,"H"
"6488",1961-05-11,1960,"Limoges FC","FC Rouen","3-2",3,2,"1",1,5,1,"H"
"6489",1961-05-11,1960,"AS Nancy","Stade Rennes","2-0",2,0,"1",1,2,2,"H"
"6490",1961-05-11,1960,"RC Lens","OGC Nice","1-0",1,0,"1",1,1,1,"H"
"6491",1961-05-11,1960,"Le Havre AC","AS Troyes-Savinienne","5-2",5,2,"1",1,7,3,"H"
"6492",1961-05-11,1960,"Toulouse FC","Grenoble Foot 38","2-1",2,1,"1",1,3,1,"H"
"6493",1961-05-13,1960,"FC Rouen","Stade Reims","2-1",2,1,"1",1,3,1,"H"
"6494",1961-05-13,1960,"UA Sedan-Torcy","US Valenciennes-Anzin","2-1",2,1,"1",1,3,1,"H"
"6495",1961-05-13,1960,"Grenoble Foot 38","AS Nancy","2-2",2,2,"1",1,4,0,"D"
"6496",1961-05-14,1960,"Racing Club de France","AS Monaco","3-0",3,0,"1",1,3,3,"H"
"6497",1961-05-14,1960,"Nimes Olympique","Angers SCO","3-2",3,2,"1",1,5,1,"H"
"6498",1961-05-14,1960,"AS Saint-Etienne","Le Havre AC","2-1",2,1,"1",1,3,1,"H"
"6499",1961-05-14,1960,"OGC Nice","Stade Francais FC","0-0",0,0,"1",1,0,0,"D"
"6500",1961-05-14,1960,"AS Troyes-Savinienne","RC Lens","1-3",1,3,"1",1,4,-2,"D"
"6501",1961-05-14,1960,"Stade Rennes","Olympique Lyon","6-1",6,1,"1",1,7,5,"H"
"6502",1961-05-14,1960,"Limoges FC","Toulouse FC","1-1",1,1,"1",1,2,0,"D"
"6503",1961-05-18,1960,"Angers SCO","AS Troyes-Savinienne","5-1",5,1,"1",1,6,4,"H"
"6504",1961-05-19,1960,"Toulouse FC","Racing Club de France","1-1",1,1,"1",1,2,0,"D"
"6505",1961-05-20,1960,"AS Monaco","AS Saint-Etienne","3-0",3,0,"1",1,3,3,"H"
"6506",1961-05-20,1960,"Stade Reims","Stade Rennes","1-1",1,1,"1",1,2,0,"D"
"6507",1961-05-20,1960,"RC Lens","Nimes Olympique","2-1",2,1,"1",1,3,1,"H"
"6508",1961-05-20,1960,"Grenoble Foot 38","OGC Nice","3-1",3,1,"1",1,4,2,"H"
"6509",1961-05-20,1960,"Olympique Lyon","Le Havre AC","1-3",1,3,"1",1,4,-2,"D"
"6510",1961-05-20,1960,"US Valenciennes-Anzin","Limoges FC","3-1",3,1,"1",1,4,2,"H"
"6511",1961-05-21,1960,"AS Nancy","FC Rouen","0-1",0,1,"1",1,1,-1,"D"
"6512",1961-05-21,1960,"Stade Francais FC","UA Sedan-Torcy","3-1",3,1,"1",1,4,2,"H"
"6513",1961-05-27,1960,"UA Sedan-Torcy","Angers SCO","1-2",1,2,"1",1,3,-1,"D"
"6514",1961-05-27,1960,"OGC Nice","AS Nancy","1-4",1,4,"1",1,5,-3,"D"
"6515",1961-05-27,1960,"US Valenciennes-Anzin","Grenoble Foot 38","1-0",1,0,"1",1,1,1,"H"
"6516",1961-05-28,1960,"Racing Club de France","Stade Reims","1-1",1,1,"1",1,2,0,"D"
"6517",1961-05-28,1960,"Le Havre AC","AS Monaco","1-1",1,1,"1",1,2,0,"D"
"6518",1961-05-28,1960,"FC Rouen","RC Lens","6-2",6,2,"1",1,8,4,"H"
"6519",1961-05-28,1960,"Limoges FC","Nimes Olympique","4-1",4,1,"1",1,5,3,"H"
"6520",1961-05-28,1960,"AS Saint-Etienne","Toulouse FC","1-0",1,0,"1",1,1,1,"H"
"6521",1961-05-28,1960,"Stade Rennes","Stade Francais FC","0-2",0,2,"1",1,2,-2,"D"
"6522",1961-05-28,1960,"AS Troyes-Savinienne","Olympique Lyon","2-3",2,3,"1",1,5,-1,"D"
"6523",1961-05-31,1960,"Olympique Lyon","Stade Francais FC","2-1",2,1,"1",1,3,1,"H"
"6524",1961-06-01,1960,"Nimes Olympique","AS Nancy","3-4",3,4,"1",1,7,-1,"D"
"6525",1961-06-03,1960,"Stade Reims","OGC Nice","3-0",3,0,"1",1,3,3,"H"
"6526",1961-06-03,1960,"Angers SCO","FC Rouen","1-3",1,3,"1",1,4,-2,"D"
"6527",1961-06-03,1960,"Nimes Olympique","AS Saint-Etienne","0-2",0,2,"1",1,2,-2,"D"
"6528",1961-06-04,1960,"AS Monaco","US Valenciennes-Anzin","1-0",1,0,"1",1,1,1,"H"
"6529",1961-06-04,1960,"Le Havre AC","Racing Club de France","2-2",2,2,"1",1,4,0,"D"
"6530",1961-06-04,1960,"RC Lens","AS Nancy","1-0",1,0,"1",1,1,1,"H"
"6531",1961-06-04,1960,"Grenoble Foot 38","UA Sedan-Torcy","6-3",6,3,"1",1,9,3,"H"
"6532",1961-06-04,1960,"Toulouse FC","Stade Rennes","2-0",2,0,"1",1,2,2,"H"
"6533",1961-06-04,1960,"Olympique Lyon","Limoges FC","2-1",2,1,"1",1,3,1,"H"
"6534",1961-06-04,1960,"Stade Francais FC","AS Troyes-Savinienne","2-1",2,1,"1",1,3,1,"H"
"6535",1961-08-19,1961,"OGC Nice","Le Havre AC","4-0",4,0,"1",1,4,4,"H"
"6536",1961-08-19,1961,"Stade Reims","FC Metz","5-3",5,3,"1",1,8,2,"H"
"6537",1961-08-19,1961,"Olympique Lyon","Toulouse FC","1-3",1,3,"1",1,4,-2,"D"
"6538",1961-08-19,1961,"RC Strasbourg","Angers SCO","2-1",2,1,"1",1,3,1,"H"
"6539",1961-08-19,1961,"FC Rouen","Nimes Olympique","1-2",1,2,"1",1,3,-1,"D"
"6540",1961-08-20,1961,"Stade Olympique Montpellierain","UA Sedan-Torcy","5-0",5,0,"1",1,5,5,"H"
"6541",1961-08-20,1961,"RC Lens","FC Sochaux","3-1",3,1,"1",1,4,2,"H"
"6542",1961-08-20,1961,"AS Monaco","AS Saint-Etienne","1-0",1,0,"1",1,1,1,"H"
"6543",1961-08-20,1961,"Stade Francais FC","Stade Rennes","2-2",2,2,"1",1,4,0,"D"
"6544",1961-08-20,1961,"AS Nancy","Racing Club de France","0-0",0,0,"1",1,0,0,"D"
"6545",1961-08-26,1961,"OGC Nice","AS Nancy","3-1",3,1,"1",1,4,2,"H"
"6546",1961-08-26,1961,"UA Sedan-Torcy","Stade Francais FC","1-1",1,1,"1",1,2,0,"D"
"6547",1961-08-26,1961,"FC Metz","FC Rouen","0-1",0,1,"1",1,1,-1,"D"
"6548",1961-08-27,1961,"Stade Olympique Montpellierain","Olympique Lyon","4-2",4,2,"1",1,6,2,"H"
"6549",1961-08-27,1961,"Stade Reims","Toulouse FC","5-1",5,1,"1",1,6,4,"H"
"6550",1961-08-27,1961,"FC Sochaux","AS Monaco","1-4",1,4,"1",1,5,-3,"D"
"6551",1961-08-27,1961,"Le Havre AC","RC Strasbourg","0-2",0,2,"1",1,2,-2,"D"
"6552",1961-08-27,1961,"Stade Rennes","RC Lens","2-1",2,1,"1",1,3,1,"H"
"6553",1961-08-27,1961,"Racing Club de France","Angers SCO","4-3",4,3,"1",1,7,1,"H"
"6554",1961-08-27,1961,"AS Saint-Etienne","Nimes Olympique","5-0",5,0,"1",1,5,5,"H"
"6555",1961-08-30,1961,"AS Monaco","Stade Rennes","4-2",4,2,"1",1,6,2,"H"
"6556",1961-09-02,1961,"AS Monaco","AS Nancy","1-1",1,1,"1",1,2,0,"D"
"6557",1961-09-02,1961,"Stade Reims","RC Lens","4-1",4,1,"1",1,5,3,"H"
"6558",1961-09-02,1961,"AS Saint-Etienne","Stade Olympique Montpellierain","1-1",1,1,"1",1,2,0,"D"
"6559",1961-09-02,1961,"FC Metz","Stade Rennes","0-1",0,1,"1",1,1,-1,"D"
"6560",1961-09-02,1961,"Stade Francais FC","FC Sochaux","1-1",1,1,"1",1,2,0,"D"
"6561",1961-09-02,1961,"FC Rouen","Olympique Lyon","3-4",3,4,"1",1,7,-1,"D"
"6562",1961-09-03,1961,"RC Strasbourg","Racing Club de France","1-3",1,3,"1",1,4,-2,"D"
"6563",1961-09-03,1961,"Toulouse FC","OGC Nice","3-1",3,1,"1",1,4,2,"H"
"6564",1961-09-03,1961,"Nimes Olympique","Le Havre AC","3-2",3,2,"1",1,5,1,"H"
"6565",1961-09-03,1961,"Angers SCO","UA Sedan-Torcy","2-2",2,2,"1",1,4,0,"D"
"6566",1961-09-06,1961,"Stade Reims","AS Saint-Etienne","1-1",1,1,"1",1,2,0,"D"
"6567",1961-09-06,1961,"Stade Olympique Montpellierain","FC Metz","2-0",2,0,"1",1,2,2,"H"
"6568",1961-09-06,1961,"Stade Francais FC","RC Strasbourg","0-1",0,1,"1",1,1,-1,"D"
"6569",1961-09-06,1961,"OGC Nice","Nimes Olympique","1-3",1,3,"1",1,4,-2,"D"
"6570",1961-09-06,1961,"FC Sochaux","Racing Club de France","4-3",4,3,"1",1,7,1,"H"
"6571",1961-09-06,1961,"Olympique Lyon","Angers SCO","2-0",2,0,"1",1,2,2,"H"
"6572",1961-09-06,1961,"AS Nancy","Toulouse FC","2-1",2,1,"1",1,3,1,"H"
"6573",1961-09-06,1961,"RC Lens","FC Rouen","1-0",1,0,"1",1,1,1,"H"
"6574",1961-09-06,1961,"Le Havre AC","UA Sedan-Torcy","1-1",1,1,"1",1,2,0,"D"
"6575",1961-09-09,1961,"AS Monaco","Stade Francais FC","2-0",2,0,"1",1,2,2,"H"
"6576",1961-09-09,1961,"FC Rouen","Stade Olympique Montpellierain","3-2",3,2,"1",1,5,1,"H"
"6577",1961-09-09,1961,"UA Sedan-Torcy","Olympique Lyon","3-1",3,1,"1",1,4,2,"H"
"6578",1961-09-09,1961,"FC Metz","OGC Nice","2-1",2,1,"1",1,3,1,"H"
"6579",1961-09-10,1961,"Nimes Olympique","Stade Reims","2-1",2,1,"1",1,3,1,"H"
"6580",1961-09-10,1961,"Racing Club de France","Le Havre AC","4-1",4,1,"1",1,5,3,"H"
"6581",1961-09-10,1961,"RC Strasbourg","AS Nancy","2-2",2,2,"1",1,4,0,"D"
"6582",1961-09-10,1961,"AS Saint-Etienne","RC Lens","3-4",3,4,"1",1,7,-1,"D"
"6583",1961-09-10,1961,"Toulouse FC","Stade Rennes","3-3",3,3,"1",1,6,0,"D"
"6584",1961-09-10,1961,"Angers SCO","FC Sochaux","3-1",3,1,"1",1,4,2,"H"
"6585",1961-09-16,1961,"Stade Francais FC","Stade Reims","2-4",2,4,"1",1,6,-2,"D"
"6586",1961-09-16,1961,"Olympique Lyon","Racing Club de France","2-0",2,0,"1",1,2,2,"H"
"6587",1961-09-16,1961,"OGC Nice","AS Saint-Etienne","3-1",3,1,"1",1,4,2,"H"
"6588",1961-09-16,1961,"FC Sochaux","FC Rouen","1-1",1,1,"1",1,2,0,"D"
"6589",1961-09-17,1961,"UA Sedan-Torcy","AS Monaco","2-0",2,0,"1",1,2,2,"H"
"6590",1961-09-17,1961,"Stade Olympique Montpellierain","Toulouse FC","3-3",3,3,"1",1,6,0,"D"
"6591",1961-09-17,1961,"Stade Rennes","Nimes Olympique","4-2",4,2,"1",1,6,2,"H"
"6592",1961-09-17,1961,"RC Lens","RC Strasbourg","0-0",0,0,"1",1,0,0,"D"
"6593",1961-09-17,1961,"AS Nancy","Angers SCO","3-2",3,2,"1",1,5,1,"H"
"6594",1961-09-17,1961,"Le Havre AC","FC Metz","2-1",2,1,"1",1,3,1,"H"
"6595",1961-09-20,1961,"Stade Reims","OGC Nice","5-0",5,0,"1",1,5,5,"H"
"6596",1961-09-20,1961,"AS Monaco","Le Havre AC","2-2",2,2,"1",1,4,0,"D"
"6597",1961-09-20,1961,"Racing Club de France","Stade Olympique Montpellierain","2-1",2,1,"1",1,3,1,"H"
"6598",1961-09-20,1961,"RC Strasbourg","Stade Rennes","1-1",1,1,"1",1,2,0,"D"
"6599",1961-09-20,1961,"Toulouse FC","UA Sedan-Torcy","1-4",1,4,"1",1,5,-3,"D"
"6600",1961-09-20,1961,"Angers SCO","RC Lens","0-2",0,2,"1",1,2,-2,"D"
"6601",1961-09-20,1961,"Nimes Olympique","AS Nancy","1-1",1,1,"1",1,2,0,"D"
"6602",1961-09-20,1961,"FC Rouen","Stade Francais FC","2-1",2,1,"1",1,3,1,"H"
"6603",1961-09-20,1961,"FC Metz","Olympique Lyon","2-1",2,1,"1",1,3,1,"H"
"6604",1961-09-20,1961,"AS Saint-Etienne","FC Sochaux","2-2",2,2,"1",1,4,0,"D"
"6605",1961-09-24,1961,"FC Sochaux","Toulouse FC","2-0",2,0,"1",1,2,2,"H"
"6606",1961-09-24,1961,"Olympique Lyon","RC Strasbourg","2-1",2,1,"1",1,3,1,"H"
"6607",1961-09-25,1961,"Stade Olympique Montpellierain","Stade Reims","1-3",1,3,"1",1,4,-2,"D"
"6608",1961-09-25,1961,"RC Lens","AS Monaco","5-0",5,0,"1",1,5,5,"H"
"6609",1961-09-25,1961,"Stade Rennes","FC Rouen","3-2",3,2,"1",1,5,1,"H"
"6610",1961-09-25,1961,"OGC Nice","Racing Club de France","1-0",1,0,"1",1,1,1,"H"
"6611",1961-09-25,1961,"Stade Francais FC","AS Nancy","1-0",1,0,"1",1,1,1,"H"
"6612",1961-09-25,1961,"Le Havre AC","AS Saint-Etienne","1-0",1,0,"1",1,1,1,"H"
"6613",1961-09-25,1961,"FC Metz","Angers SCO","1-2",1,2,"1",1,3,-1,"D"
"6614",1961-09-30,1961,"Stade Reims","FC Sochaux","2-1",2,1,"1",1,3,1,"H"
"6615",1961-09-30,1961,"Angers SCO","Toulouse FC","1-2",1,2,"1",1,3,-1,"D"
"6616",1961-10-01,1961,"RC Lens","OGC Nice","4-2",4,2,"1",1,6,2,"H"
"6617",1961-10-01,1961,"AS Nancy","Stade Rennes","2-2",2,2,"1",1,4,0,"D"
"6618",1961-10-01,1961,"AS Monaco","Stade Olympique Montpellierain","5-3",5,3,"1",1,8,2,"H"
"6619",1961-10-01,1961,"Nimes Olympique","Stade Francais FC","4-0",4,0,"1",1,4,4,"H"
"6620",1961-10-01,1961,"Racing Club de France","UA Sedan-Torcy","2-2",2,2,"1",1,4,0,"D"
"6621",1961-10-01,1961,"Le Havre AC","Olympique Lyon","1-2",1,2,"1",1,3,-1,"D"
"6622",1961-10-01,1961,"RC Strasbourg","FC Metz","0-1",0,1,"1",1,1,-1,"D"
"6623",1961-10-01,1961,"AS Saint-Etienne","FC Rouen","2-0",2,0,"1",1,2,2,"H"
"6624",1961-10-04,1961,"FC Rouen","Stade Reims","2-2",2,2,"1",1,4,0,"D"
"6625",1961-10-04,1961,"UA Sedan-Torcy","RC Lens","1-1",1,1,"1",1,2,0,"D"
"6626",1961-10-04,1961,"Stade Rennes","Le Havre AC","1-0",1,0,"1",1,1,1,"H"
"6627",1961-10-04,1961,"FC Metz","AS Monaco","1-1",1,1,"1",1,2,0,"D"
"6628",1961-10-04,1961,"Toulouse FC","Racing Club de France","1-1",1,1,"1",1,2,0,"D"
"6629",1961-10-04,1961,"FC Sochaux","AS Nancy","0-1",0,1,"1",1,1,-1,"D"
"6630",1961-10-04,1961,"OGC Nice","RC Strasbourg","3-2",3,2,"1",1,5,1,"H"
"6631",1961-10-04,1961,"Stade Olympique Montpellierain","Angers SCO","0-0",0,0,"1",1,0,0,"D"
"6632",1961-10-04,1961,"Stade Francais FC","AS Saint-Etienne","1-1",1,1,"1",1,2,0,"D"
"6633",1961-10-08,1961,"Angers SCO","Stade Reims","2-0",2,0,"1",1,2,2,"H"
"6634",1961-10-08,1961,"RC Lens","Stade Francais FC","2-1",2,1,"1",1,3,1,"H"
"6635",1961-10-08,1961,"AS Monaco","FC Rouen","0-0",0,0,"1",1,0,0,"D"
"6636",1961-10-08,1961,"Racing Club de France","Stade Rennes","3-1",3,1,"1",1,4,2,"H"
"6637",1961-10-08,1961,"AS Nancy","Olympique Lyon","5-1",5,1,"1",1,6,4,"H"
"6638",1961-10-08,1961,"Nimes Olympique","FC Sochaux","2-1",2,1,"1",1,3,1,"H"
"6639",1961-10-08,1961,"UA Sedan-Torcy","OGC Nice","2-2",2,2,"1",1,4,0,"D"
"6640",1961-10-08,1961,"RC Strasbourg","Toulouse FC","0-1",0,1,"1",1,1,-1,"D"
"6641",1961-10-08,1961,"Le Havre AC","Stade Olympique Montpellierain","2-2",2,2,"1",1,4,0,"D"
"6642",1961-10-08,1961,"AS Saint-Etienne","FC Metz","2-2",2,2,"1",1,4,0,"D"
"6643",1961-10-11,1961,"Olympique Lyon","Nimes Olympique","0-0",0,0,"1",1,0,0,"D"
"6644",1961-10-14,1961,"FC Sochaux","RC Strasbourg","0-0",0,0,"1",1,0,0,"D"
"6645",1961-10-14,1961,"FC Rouen","Le Havre AC","0-0",0,0,"1",1,0,0,"D"
"6646",1961-10-15,1961,"Stade Reims","UA Sedan-Torcy","1-3",1,3,"1",1,4,-2,"D"
"6647",1961-10-15,1961,"Toulouse FC","RC Lens","2-0",2,0,"1",1,2,2,"H"
"6648",1961-10-15,1961,"Nimes Olympique","Stade Olympique Montpellierain","3-1",3,1,"1",1,4,2,"H"
"6649",1961-10-15,1961,"Stade Rennes","Angers SCO","2-1",2,1,"1",1,3,1,"H"
"6650",1961-10-15,1961,"AS Nancy","FC Metz","3-0",3,0,"1",1,3,3,"H"
"6651",1961-10-15,1961,"AS Monaco","OGC Nice","1-2",1,2,"1",1,3,-1,"D"
"6652",1961-10-15,1961,"Stade Francais FC","Racing Club de France","2-0",2,0,"1",1,2,2,"H"
"6653",1961-10-15,1961,"AS Saint-Etienne","Olympique Lyon","2-0",2,0,"1",1,2,2,"H"
"6654",1961-10-21,1961,"FC Metz","RC Lens","1-0",1,0,"1",1,1,1,"H"
"6655",1961-10-22,1961,"Olympique Lyon","Stade Reims","1-3",1,3,"1",1,4,-2,"D"
"6656",1961-10-22,1961,"Racing Club de France","Nimes Olympique","0-4",0,4,"1",1,4,-4,"D"
"6657",1961-10-22,1961,"Stade Rennes","AS Saint-Etienne","1-1",1,1,"1",1,2,0,"D"
"6658",1961-10-22,1961,"UA Sedan-Torcy","FC Sochaux","4-1",4,1,"1",1,5,3,"H"
"6659",1961-10-22,1961,"RC Strasbourg","AS Monaco","0-1",0,1,"1",1,1,-1,"D"
"6660",1961-10-22,1961,"Stade Olympique Montpellierain","AS Nancy","1-0",1,0,"1",1,1,1,"H"
"6661",1961-10-22,1961,"Toulouse FC","FC Rouen","1-0",1,0,"1",1,1,1,"H"
"6662",1961-10-22,1961,"OGC Nice","Angers SCO","0-2",0,2,"1",1,2,-2,"D"
"6663",1961-10-22,1961,"Le Havre AC","Stade Francais FC","1-0",1,0,"1",1,1,1,"H"
"6664",1961-10-25,1961,"Nimes Olympique","FC Metz","3-1",3,1,"1",1,4,2,"H"
"6665",1961-10-25,1961,"Stade Reims","Stade Rennes","2-3",2,3,"1",1,5,-1,"D"
"6666",1961-10-25,1961,"AS Nancy","UA Sedan-Torcy","0-3",0,3,"1",1,3,-3,"D"
"6667",1961-10-25,1961,"AS Monaco","Olympique Lyon","3-1",3,1,"1",1,4,2,"H"
"6668",1961-10-25,1961,"RC Lens","Racing Club de France","2-3",2,3,"1",1,5,-1,"D"
"6669",1961-10-25,1961,"AS Saint-Etienne","Toulouse FC","4-1",4,1,"1",1,5,3,"H"
"6670",1961-10-25,1961,"FC Sochaux","Stade Olympique Montpellierain","1-1",1,1,"1",1,2,0,"D"
"6671",1961-10-25,1961,"Stade Francais FC","OGC Nice","4-0",4,0,"1",1,4,4,"H"
"6672",1961-10-25,1961,"FC Rouen","RC Strasbourg","1-0",1,0,"1",1,1,1,"H"
"6673",1961-10-25,1961,"Angers SCO","Le Havre AC","0-0",0,0,"1",1,0,0,"D"
"6674",1961-10-28,1961,"FC Metz","Stade Francais FC","0-2",0,2,"1",1,2,-2,"D"
"6675",1961-10-29,1961,"Toulouse FC","Nimes Olympique","0-1",0,1,"1",1,1,-1,"D"
"6676",1961-10-29,1961,"UA Sedan-Torcy","AS Saint-Etienne","1-0",1,0,"1",1,1,1,"H"
"6677",1961-10-29,1961,"RC Strasbourg","Stade Reims","1-1",1,1,"1",1,2,0,"D"
"6678",1961-10-29,1961,"Stade Olympique Montpellierain","Stade Rennes","3-1",3,1,"1",1,4,2,"H"
"6679",1961-10-29,1961,"Angers SCO","AS Monaco","2-0",2,0,"1",1,2,2,"H"
"6680",1961-10-29,1961,"Olympique Lyon","RC Lens","3-0",3,0,"1",1,3,3,"H"
"6681",1961-10-29,1961,"Le Havre AC","AS Nancy","1-1",1,1,"1",1,2,0,"D"
"6682",1961-10-29,1961,"Racing Club de France","FC Rouen","0-2",0,2,"1",1,2,-2,"D"
"6683",1961-10-29,1961,"OGC Nice","FC Sochaux","1-1",1,1,"1",1,2,0,"D"
"6684",1961-10-31,1961,"FC Metz","UA Sedan-Torcy","2-2",2,2,"1",1,4,0,"D"
"6685",1961-11-01,1961,"Nimes Olympique","RC Strasbourg","1-0",1,0,"1",1,1,1,"H"
"6686",1961-11-01,1961,"Stade Reims","AS Nancy","2-0",2,0,"1",1,2,2,"H"
"6687",1961-11-01,1961,"Stade Rennes","Olympique Lyon","2-0",2,0,"1",1,2,2,"H"
"6688",1961-11-01,1961,"AS Monaco","Toulouse FC","4-3",4,3,"1",1,7,1,"H"
"6689",1961-11-01,1961,"RC Lens","Stade Olympique Montpellierain","5-1",5,1,"1",1,6,4,"H"
"6690",1961-11-01,1961,"FC Rouen","OGC Nice","2-1",2,1,"1",1,3,1,"H"
"6691",1961-11-01,1961,"AS Saint-Etienne","Racing Club de France","1-1",1,1,"1",1,2,0,"D"
"6692",1961-11-01,1961,"Stade Francais FC","Angers SCO","1-1",1,1,"1",1,2,0,"D"
"6693",1961-11-01,1961,"FC Sochaux","Le Havre AC","6-1",6,1,"1",1,7,5,"H"
"6694",1961-11-10,1961,"FC Metz","FC Sochaux","1-1",1,1,"1",1,2,0,"D"
"6695",1961-11-11,1961,"RC Lens","Le Havre AC","2-0",2,0,"1",1,2,2,"H"
"6696",1961-11-11,1961,"FC Rouen","Angers SCO","2-1",2,1,"1",1,3,1,"H"
"6697",1961-11-11,1961,"RC Strasbourg","Stade Olympique Montpellierain","1-2",1,2,"1",1,3,-1,"D"
"6698",1961-11-11,1961,"Stade Francais FC","Toulouse FC","3-4",3,4,"1",1,7,-1,"D"
"6699",1961-11-11,1961,"OGC Nice","Olympique Lyon","0-2",0,2,"1",1,2,-2,"D"
"6700",1961-11-15,1961,"UA Sedan-Torcy","Nimes Olympique","5-1",5,1,"1",1,6,4,"H"
"6701",1961-11-19,1961,"UA Sedan-Torcy","RC Strasbourg","5-0",5,0,"1",1,5,5,"H"
"6702",1961-11-19,1961,"RC Lens","Nimes Olympique","3-1",3,1,"1",1,4,2,"H"
"6703",1961-11-19,1961,"AS Monaco","Stade Reims","0-1",0,1,"1",1,1,-1,"D"
"6704",1961-11-19,1961,"FC Sochaux","Stade Rennes","1-2",1,2,"1",1,3,-1,"D"
"6705",1961-11-19,1961,"Stade Olympique Montpellierain","OGC Nice","3-2",3,2,"1",1,5,1,"H"
"6706",1961-11-19,1961,"Racing Club de France","FC Metz","11-2",11,2,"1",1,13,9,"H"
"6707",1961-11-19,1961,"AS Nancy","FC Rouen","2-1",2,1,"1",1,3,1,"H"
"6708",1961-11-19,1961,"Le Havre AC","Toulouse FC","2-0",2,0,"1",1,2,2,"H"
"6709",1961-11-19,1961,"Angers SCO","AS Saint-Etienne","2-1",2,1,"1",1,3,1,"H"
"6710",1961-11-19,1961,"Olympique Lyon","Stade Francais FC","1-2",1,2,"1",1,3,-1,"D"
"6711",1961-11-22,1961,"AS Saint-Etienne","AS Nancy","1-1",1,1,"1",1,2,0,"D"
"6712",1961-11-22,1961,"Stade Reims","Racing Club de France","1-4",1,4,"1",1,5,-3,"D"
"6713",1961-11-23,1961,"Stade Rennes","UA Sedan-Torcy","1-0",1,0,"1",1,1,1,"H"
"6714",1961-11-26,1961,"Stade Reims","Le Havre AC","3-0",3,0,"1",1,3,3,"H"
"6715",1961-11-26,1961,"Stade Francais FC","UA Sedan-Torcy","4-2",4,2,"1",1,6,2,"H"
"6716",1961-11-26,1961,"Stade Rennes","FC Metz","1-2",1,2,"1",1,3,-1,"D"
"6717",1961-11-26,1961,"FC Sochaux","Nimes Olympique","3-1",3,1,"1",1,4,2,"H"
"6718",1961-11-26,1961,"OGC Nice","RC Lens","2-0",2,0,"1",1,2,2,"H"
"6719",1961-11-26,1961,"Olympique Lyon","AS Monaco","2-4",2,4,"1",1,6,-2,"D"
"6720",1961-11-26,1961,"AS Nancy","RC Strasbourg","3-1",3,1,"1",1,4,2,"H"
"6721",1961-11-26,1961,"Stade Olympique Montpellierain","Racing Club de France","2-1",2,1,"1",1,3,1,"H"
"6722",1961-11-26,1961,"FC Rouen","AS Saint-Etienne","3-1",3,1,"1",1,4,2,"H"
"6723",1961-11-26,1961,"Toulouse FC","Angers SCO","2-0",2,0,"1",1,2,2,"H"
"6724",1961-11-30,1961,"Nimes Olympique","AS Monaco","1-1",1,1,"1",1,2,0,"D"
"6725",1961-12-03,1961,"Nimes Olympique","FC Rouen","3-2",3,2,"1",1,5,1,"H"
"6726",1961-12-03,1961,"UA Sedan-Torcy","Stade Rennes","0-0",0,0,"1",1,0,0,"D"
"6727",1961-12-03,1961,"AS Saint-Etienne","Stade Reims","2-0",2,0,"1",1,2,2,"H"
"6728",1961-12-03,1961,"RC Lens","Olympique Lyon","1-0",1,0,"1",1,1,1,"H"
"6729",1961-12-03,1961,"Toulouse FC","AS Monaco","2-0",2,0,"1",1,2,2,"H"
"6730",1961-12-03,1961,"Racing Club de France","AS Nancy","2-0",2,0,"1",1,2,2,"H"
"6731",1961-12-03,1961,"FC Metz","Stade Olympique Montpellierain","1-1",1,1,"1",1,2,0,"D"
"6732",1961-12-03,1961,"Angers SCO","Stade Francais FC","2-2",2,2,"1",1,4,0,"D"
"6733",1961-12-03,1961,"RC Strasbourg","OGC Nice","2-0",2,0,"1",1,2,2,"H"
"6734",1961-12-03,1961,"Le Havre AC","FC Sochaux","3-1",3,1,"1",1,4,2,"H"
"6735",1961-12-24,1961,"Nimes Olympique","Stade Rennes","3-0",3,0,"1",1,3,3,"H"
"6736",1961-12-24,1961,"UA Sedan-Torcy","Stade Olympique Montpellierain","1-0",1,0,"1",1,1,1,"H"
"6737",1961-12-24,1961,"OGC Nice","Stade Reims","4-1",4,1,"1",1,5,3,"H"
"6738",1961-12-24,1961,"Le Havre AC","RC Lens","0-0",0,0,"1",1,0,0,"D"
"6739",1961-12-24,1961,"Racing Club de France","FC Sochaux","2-2",2,2,"1",1,4,0,"D"
"6740",1961-12-24,1961,"AS Nancy","Stade Francais FC","2-1",2,1,"1",1,3,1,"H"
"6741",1961-12-24,1961,"AS Saint-Etienne","AS Monaco","5-1",5,1,"1",1,6,4,"H"
"6742",1961-12-24,1961,"Toulouse FC","Olympique Lyon","1-1",1,1,"1",1,2,0,"D"
"6743",1961-12-24,1961,"RC Strasbourg","FC Rouen","1-0",1,0,"1",1,1,1,"H"
"6744",1961-12-24,1961,"Angers SCO","FC Metz","3-1",3,1,"1",1,4,2,"H"
"6745",1961-12-31,1961,"Olympique Lyon","UA Sedan-Torcy","2-2",2,2,"1",1,4,0,"D"
"6746",1961-12-31,1961,"Stade Reims","Nimes Olympique","2-0",2,0,"1",1,2,2,"H"
"6747",1961-12-31,1961,"RC Lens","Angers SCO","2-1",2,1,"1",1,3,1,"H"
"6748",1961-12-31,1961,"Stade Rennes","Toulouse FC","1-1",1,1,"1",1,2,0,"D"
"6749",1961-12-31,1961,"Racing Club de France","OGC Nice","3-1",3,1,"1",1,4,2,"H"
"6750",1961-12-31,1961,"FC Rouen","AS Nancy","0-2",0,2,"1",1,2,-2,"D"
"6751",1961-12-31,1961,"Stade Olympique Montpellierain","Le Havre AC","1-1",1,1,"1",1,2,0,"D"
"6752",1961-12-31,1961,"AS Monaco","RC Strasbourg","0-2",0,2,"1",1,2,-2,"D"
"6753",1961-12-31,1961,"FC Metz","AS Saint-Etienne","6-0",6,0,"1",1,6,6,"H"
"6754",1962-01-14,1961,"Nimes Olympique","OGC Nice","3-0",3,0,"1",1,3,3,"H"
"6755",1962-01-14,1961,"UA Sedan-Torcy","Racing Club de France","0-1",0,1,"1",1,1,-1,"D"
"6756",1962-01-14,1961,"AS Nancy","Stade Reims","1-1",1,1,"1",1,2,0,"D"
"6757",1962-01-14,1961,"Stade Francais FC","RC Lens","2-2",2,2,"1",1,4,0,"D"
"6758",1962-01-14,1961,"Stade Rennes","AS Monaco","4-6",4,6,"1",1,10,-2,"D"
"6759",1962-01-14,1961,"Toulouse FC","AS Saint-Etienne","2-1",2,1,"1",1,3,1,"H"
"6760",1962-01-14,1961,"Angers SCO","Stade Olympique Montpellierain","1-0",1,0,"1",1,1,1,"H"
"6761",1962-01-14,1961,"FC Rouen","FC Sochaux","2-2",2,2,"1",1,4,0,"D"
"6762",1962-01-14,1961,"RC Strasbourg","Le Havre AC","3-1",3,1,"1",1,4,2,"H"
"6763",1962-01-14,1961,"Olympique Lyon","FC Metz","1-0",1,0,"1",1,1,1,"H"
"6764",1962-01-21,1961,"Le Havre AC","Nimes Olympique","1-2",1,2,"1",1,3,-1,"D"
"6765",1962-01-21,1961,"RC Lens","AS Nancy","4-1",4,1,"1",1,5,3,"H"
"6766",1962-01-21,1961,"FC Sochaux","UA Sedan-Torcy","2-0",2,0,"1",1,2,2,"H"
"6767",1962-01-21,1961,"Stade Rennes","RC Strasbourg","1-0",1,0,"1",1,1,1,"H"
"6768",1962-01-21,1961,"Stade Reims","Stade Francais FC","0-4",0,4,"1",1,4,-4,"D"
"6769",1962-01-21,1961,"Racing Club de France","Olympique Lyon","0-4",0,4,"1",1,4,-4,"D"
"6770",1962-01-21,1961,"Stade Olympique Montpellierain","AS Monaco","0-2",0,2,"1",1,2,-2,"D"
"6771",1962-01-21,1961,"FC Metz","Toulouse FC","1-1",1,1,"1",1,2,0,"D"
"6772",1962-01-21,1961,"AS Saint-Etienne","Angers SCO","2-3",2,3,"1",1,5,-1,"D"
"6773",1962-01-21,1961,"OGC Nice","FC Rouen","1-1",1,1,"1",1,2,0,"D"
"6774",1962-02-04,1961,"Nimes Olympique","Angers SCO","2-0",2,0,"1",1,2,2,"H"
"6775",1962-02-04,1961,"RC Strasbourg","RC Lens","3-1",3,1,"1",1,4,2,"H"
"6776",1962-02-04,1961,"Stade Rennes","Stade Reims","2-2",2,2,"1",1,4,0,"D"
"6777",1962-02-04,1961,"AS Nancy","AS Saint-Etienne","2-1",2,1,"1",1,3,1,"H"
"6778",1962-02-04,1961,"AS Monaco","FC Sochaux","1-1",1,1,"1",1,2,0,"D"
"6779",1962-02-04,1961,"Toulouse FC","Le Havre AC","1-0",1,0,"1",1,1,1,"H"
"6780",1962-02-04,1961,"FC Rouen","Racing Club de France","2-1",2,1,"1",1,3,1,"H"
"6781",1962-02-04,1961,"Stade Francais FC","Stade Olympique Montpellierain","3-0",3,0,"1",1,3,3,"H"
"6782",1962-02-04,1961,"Olympique Lyon","OGC Nice","1-2",1,2,"1",1,3,-1,"D"
"6783",1962-02-11,1961,"FC Metz","Nimes Olympique","3-1",3,1,"1",1,4,2,"H"
"6784",1962-02-11,1961,"Stade Reims","AS Monaco","1-0",1,0,"1",1,1,1,"H"
"6785",1962-02-11,1961,"Stade Olympique Montpellierain","RC Lens","2-0",2,0,"1",1,2,2,"H"
"6786",1962-02-11,1961,"Toulouse FC","AS Nancy","2-0",2,0,"1",1,2,2,"H"
"6787",1962-02-11,1961,"Le Havre AC","Stade Rennes","2-0",2,0,"1",1,2,2,"H"
"6788",1962-02-11,1961,"AS Saint-Etienne","UA Sedan-Torcy","1-0",1,0,"1",1,1,1,"H"
"6789",1962-02-11,1961,"Racing Club de France","RC Strasbourg","3-3",3,3,"1",1,6,0,"D"
"6790",1962-02-11,1961,"Angers SCO","FC Rouen","1-0",1,0,"1",1,1,1,"H"
"6791",1962-02-11,1961,"OGC Nice","Stade Francais FC","1-0",1,0,"1",1,1,1,"H"
"6792",1962-02-11,1961,"FC Sochaux","Olympique Lyon","1-2",1,2,"1",1,3,-1,"D"
"6793",1962-02-25,1961,"Nimes Olympique","Racing Club de France","2-4",2,4,"1",1,6,-2,"D"
"6794",1962-02-25,1961,"Toulouse FC","Stade Reims","1-2",1,2,"1",1,3,-1,"D"
"6795",1962-02-25,1961,"RC Lens","FC Metz","5-2",5,2,"1",1,7,3,"H"
"6796",1962-02-25,1961,"FC Rouen","UA Sedan-Torcy","2-3",2,3,"1",1,5,-1,"D"
"6797",1962-02-25,1961,"Stade Rennes","Stade Olympique Montpellierain","1-1",1,1,"1",1,2,0,"D"
"6798",1962-02-25,1961,"AS Monaco","Angers SCO","5-0",5,0,"1",1,5,5,"H"
"6799",1962-02-25,1961,"AS Nancy","FC Sochaux","1-0",1,0,"1",1,1,1,"H"
"6800",1962-02-25,1961,"AS Saint-Etienne","OGC Nice","1-2",1,2,"1",1,3,-1,"D"
"6801",1962-02-25,1961,"Stade Francais FC","Le Havre AC","1-1",1,1,"1",1,2,0,"D"
"6802",1962-02-25,1961,"RC Strasbourg","Olympique Lyon","5-2",5,2,"1",1,7,3,"H"
"6803",1962-03-01,1961,"FC Sochaux","Stade Francais FC","2-3",2,3,"1",1,5,-1,"D"
"6804",1962-03-04,1961,"Nimes Olympique","Toulouse FC","2-0",2,0,"1",1,2,2,"H"
"6805",1962-03-04,1961,"FC Metz","Stade Reims","2-1",2,1,"1",1,3,1,"H"
"6806",1962-03-04,1961,"UA Sedan-Torcy","AS Nancy","1-1",1,1,"1",1,2,0,"D"
"6807",1962-03-04,1961,"Racing Club de France","RC Lens","1-0",1,0,"1",1,1,1,"H"
"6808",1962-03-04,1961,"Le Havre AC","AS Monaco","0-1",0,1,"1",1,1,-1,"D"
"6809",1962-03-04,1961,"Olympique Lyon","Stade Rennes","0-0",0,0,"1",1,0,0,"D"
"6810",1962-03-04,1961,"Stade Olympique Montpellierain","FC Rouen","4-1",4,1,"1",1,5,3,"H"
"6811",1962-03-04,1961,"Angers SCO","OGC Nice","0-0",0,0,"1",1,0,0,"D"
"6812",1962-03-14,1961,"UA Sedan-Torcy","FC Metz","2-0",2,0,"1",1,2,2,"H"
"6813",1962-03-17,1961,"FC Rouen","RC Lens","2-1",2,1,"1",1,3,1,"H"
"6814",1962-03-17,1961,"AS Nancy","Le Havre AC","1-1",1,1,"1",1,2,0,"D"
"6815",1962-03-17,1961,"FC Sochaux","FC Metz","1-1",1,1,"1",1,2,0,"D"
"6816",1962-03-18,1961,"AS Monaco","Nimes Olympique","1-1",1,1,"1",1,2,0,"D"
"6817",1962-03-18,1961,"Stade Reims","Angers SCO","2-0",2,0,"1",1,2,2,"H"
"6818",1962-03-18,1961,"OGC Nice","UA Sedan-Torcy","3-2",3,2,"1",1,5,1,"H"
"6819",1962-03-18,1961,"Stade Rennes","Racing Club de France","2-3",2,3,"1",1,5,-1,"D"
"6820",1962-03-18,1961,"Toulouse FC","Stade Olympique Montpellierain","1-2",1,2,"1",1,3,-1,"D"
"6821",1962-03-18,1961,"Stade Francais FC","Olympique Lyon","2-1",2,1,"1",1,3,1,"H"
"6822",1962-03-18,1961,"AS Saint-Etienne","RC Strasbourg","0-1",0,1,"1",1,1,-1,"D"
"6823",1962-03-21,1961,"FC Sochaux","AS Saint-Etienne","0-2",0,2,"1",1,2,-2,"D"
"6824",1962-03-21,1961,"RC Strasbourg","Stade Francais FC","0-0",0,0,"1",1,0,0,"D"
"6825",1962-03-25,1961,"Stade Olympique Montpellierain","Nimes Olympique","3-5",3,5,"1",1,8,-2,"D"
"6826",1962-03-25,1961,"UA Sedan-Torcy","Stade Reims","0-3",0,3,"1",1,3,-3,"D"
"6827",1962-03-25,1961,"Racing Club de France","Stade Francais FC","3-1",3,1,"1",1,4,2,"H"
"6828",1962-03-25,1961,"RC Lens","Toulouse FC","4-0",4,0,"1",1,4,4,"H"
"6829",1962-03-25,1961,"OGC Nice","AS Monaco","1-1",1,1,"1",1,2,0,"D"
"6830",1962-03-25,1961,"FC Metz","AS Nancy","0-1",0,1,"1",1,1,-1,"D"
"6831",1962-03-25,1961,"Angers SCO","Stade Rennes","1-1",1,1,"1",1,2,0,"D"
"6832",1962-03-25,1961,"RC Strasbourg","FC Sochaux","1-1",1,1,"1",1,2,0,"D"
"6833",1962-03-25,1961,"Le Havre AC","FC Rouen","1-1",1,1,"1",1,2,0,"D"
"6834",1962-03-25,1961,"Olympique Lyon","AS Saint-Etienne","4-0",4,0,"1",1,4,4,"H"
"6835",1962-03-28,1961,"Angers SCO","Racing Club de France","2-3",2,3,"1",1,5,-1,"D"
"6836",1962-03-28,1961,"Stade Reims","Olympique Lyon","0-4",0,4,"1",1,4,-4,"D"
"6837",1962-03-28,1961,"AS Monaco","UA Sedan-Torcy","2-1",2,1,"1",1,3,1,"H"
"6838",1962-03-28,1961,"FC Rouen","Stade Rennes","4-1",4,1,"1",1,5,3,"H"
"6839",1962-03-28,1961,"FC Sochaux","OGC Nice","2-0",2,0,"1",1,2,2,"H"
"6840",1962-03-29,1961,"AS Nancy","Stade Olympique Montpellierain","3-1",3,1,"1",1,4,2,"H"
"6841",1962-03-29,1961,"Stade Francais FC","FC Metz","2-2",2,2,"1",1,4,0,"D"
"6842",1962-03-29,1961,"AS Saint-Etienne","Le Havre AC","1-1",1,1,"1",1,2,0,"D"
"6843",1962-03-31,1961,"Olympique Lyon","FC Sochaux","1-0",1,0,"1",1,1,1,"H"
"6844",1962-04-01,1961,"Nimes Olympique","RC Lens","2-1",2,1,"1",1,3,1,"H"
"6845",1962-04-01,1961,"Toulouse FC","RC Strasbourg","4-1",4,1,"1",1,5,3,"H"
"6846",1962-04-01,1961,"Le Havre AC","Stade Reims","1-2",1,2,"1",1,3,-1,"D"
"6847",1962-04-01,1961,"UA Sedan-Torcy","FC Rouen","2-2",2,2,"1",1,4,0,"D"
"6848",1962-04-01,1961,"OGC Nice","Stade Rennes","1-0",1,0,"1",1,1,1,"H"
"6849",1962-04-01,1961,"Stade Olympique Montpellierain","Stade Francais FC","4-0",4,0,"1",1,4,4,"H"
"6850",1962-04-07,1961,"UA Sedan-Torcy","Toulouse FC","1-0",1,0,"1",1,1,1,"H"
"6851",1962-04-07,1961,"Olympique Lyon","FC Rouen","1-1",1,1,"1",1,2,0,"D"
"6852",1962-04-08,1961,"RC Strasbourg","Nimes Olympique","2-1",2,1,"1",1,3,1,"H"
"6853",1962-04-08,1961,"RC Lens","Stade Reims","3-4",3,4,"1",1,7,-1,"D"
"6854",1962-04-08,1961,"Racing Club de France","AS Saint-Etienne","1-2",1,2,"1",1,3,-1,"D"
"6855",1962-04-08,1961,"AS Monaco","FC Metz","4-0",4,0,"1",1,4,4,"H"
"6856",1962-04-08,1961,"AS Nancy","OGC Nice","2-0",2,0,"1",1,2,2,"H"
"6857",1962-04-08,1961,"Stade Olympique Montpellierain","FC Sochaux","4-1",4,1,"1",1,5,3,"H"
"6858",1962-04-08,1961,"Stade Rennes","Stade Francais FC","2-3",2,3,"1",1,5,-1,"D"
"6859",1962-04-08,1961,"Le Havre AC","Angers SCO","0-1",0,1,"1",1,1,-1,"D"
"6860",1962-04-14,1961,"Stade Francais FC","AS Monaco","1-1",1,1,"1",1,2,0,"D"
"6861",1962-04-14,1961,"FC Sochaux","RC Lens","1-2",1,2,"1",1,3,-1,"D"
"6862",1962-04-14,1961,"Olympique Lyon","Stade Olympique Montpellierain","1-2",1,2,"1",1,3,-1,"D"
"6863",1962-04-14,1961,"FC Metz","RC Strasbourg","2-0",2,0,"1",1,2,2,"H"
"6864",1962-04-15,1961,"Stade Reims","FC Rouen","2-2",2,2,"1",1,4,0,"D"
"6865",1962-04-15,1961,"Nimes Olympique","UA Sedan-Torcy","0-1",0,1,"1",1,1,-1,"D"
"6866",1962-04-15,1961,"Le Havre AC","Racing Club de France","0-4",0,4,"1",1,4,-4,"D"
"6867",1962-04-15,1961,"Angers SCO","AS Nancy","2-2",2,2,"1",1,4,0,"D"
"6868",1962-04-15,1961,"AS Saint-Etienne","Stade Rennes","2-1",2,1,"1",1,3,1,"H"
"6869",1962-04-15,1961,"OGC Nice","Toulouse FC","3-1",3,1,"1",1,4,2,"H"
"6870",1962-04-18,1961,"Racing Club de France","Stade Reims","2-6",2,6,"1",1,8,-4,"D"
"6871",1962-04-18,1961,"AS Nancy","Nimes Olympique","0-0",0,0,"1",1,0,0,"D"
"6872",1962-04-18,1961,"UA Sedan-Torcy","Angers SCO","0-2",0,2,"1",1,2,-2,"D"
"6873",1962-04-18,1961,"FC Rouen","AS Monaco","2-1",2,1,"1",1,3,1,"H"
"6874",1962-04-18,1961,"RC Lens","AS Saint-Etienne","2-1",2,1,"1",1,3,1,"H"
"6875",1962-04-18,1961,"Stade Olympique Montpellierain","RC Strasbourg","1-1",1,1,"1",1,2,0,"D"
"6876",1962-04-18,1961,"Toulouse FC","Stade Francais FC","0-1",0,1,"1",1,1,-1,"D"
"6877",1962-04-18,1961,"OGC Nice","FC Metz","2-1",2,1,"1",1,3,1,"H"
"6878",1962-04-18,1961,"Olympique Lyon","Le Havre AC","1-1",1,1,"1",1,2,0,"D"
"6879",1962-04-19,1961,"Stade Rennes","FC Sochaux","2-1",2,1,"1",1,3,1,"H"
"6880",1962-04-21,1961,"Stade Reims","Stade Olympique Montpellierain","2-1",2,1,"1",1,3,1,"H"
"6881",1962-04-21,1961,"FC Metz","Racing Club de France","2-4",2,4,"1",1,6,-2,"D"
"6882",1962-04-21,1961,"AS Monaco","RC Lens","2-1",2,1,"1",1,3,1,"H"
"6883",1962-04-21,1961,"Angers SCO","Olympique Lyon","1-1",1,1,"1",1,2,0,"D"
"6884",1962-04-22,1961,"Nimes Olympique","AS Saint-Etienne","1-0",1,0,"1",1,1,1,"H"
"6885",1962-04-22,1961,"RC Strasbourg","UA Sedan-Torcy","1-2",1,2,"1",1,3,-1,"D"
"6886",1962-04-22,1961,"Stade Rennes","AS Nancy","3-0",3,0,"1",1,3,3,"H"
"6887",1962-04-22,1961,"Stade Francais FC","FC Rouen","2-4",2,4,"1",1,6,-2,"D"
"6888",1962-04-22,1961,"Le Havre AC","OGC Nice","3-0",3,0,"1",1,3,3,"H"
"6889",1962-04-22,1961,"Toulouse FC","FC Sochaux","6-1",6,1,"1",1,7,5,"H"
"6890",1962-04-24,1961,"Angers SCO","Nimes Olympique","8-3",8,3,"1",1,11,5,"H"
"6891",1962-04-24,1961,"Racing Club de France","AS Monaco","3-0",3,0,"1",1,3,3,"H"
"6892",1962-04-24,1961,"AS Nancy","RC Lens","1-0",1,0,"1",1,1,1,"H"
"6893",1962-04-24,1961,"Toulouse FC","FC Metz","6-1",6,1,"1",1,7,5,"H"
"6894",1962-04-24,1961,"RC Strasbourg","AS Saint-Etienne","2-1",2,1,"1",1,3,1,"H"
"6895",1962-04-28,1961,"UA Sedan-Torcy","Le Havre AC","2-0",2,0,"1",1,2,2,"H"
"6896",1962-04-28,1961,"RC Lens","Stade Rennes","1-0",1,0,"1",1,1,1,"H"
"6897",1962-04-28,1961,"FC Rouen","FC Metz","3-2",3,2,"1",1,5,1,"H"
"6898",1962-04-28,1961,"OGC Nice","Stade Olympique Montpellierain","1-0",1,0,"1",1,1,1,"H"
"6899",1962-04-29,1961,"Nimes Olympique","Olympique Lyon","2-1",2,1,"1",1,3,1,"H"
"6900",1962-04-29,1961,"Racing Club de France","Toulouse FC","2-0",2,0,"1",1,2,2,"H"
"6901",1962-04-29,1961,"FC Sochaux","Stade Reims","2-1",2,1,"1",1,3,1,"H"
"6902",1962-04-29,1961,"AS Nancy","AS Monaco","1-2",1,2,"1",1,3,-1,"D"
"6903",1962-04-29,1961,"AS Saint-Etienne","Stade Francais FC","1-1",1,1,"1",1,2,0,"D"
"6904",1962-04-29,1961,"Angers SCO","RC Strasbourg","1-1",1,1,"1",1,2,0,"D"
"6905",1962-05-19,1961,"Olympique Lyon","AS Nancy","1-3",1,3,"1",1,4,-2,"D"
"6906",1962-05-19,1961,"RC Lens","UA Sedan-Torcy","1-0",1,0,"1",1,1,1,"H"
"6907",1962-05-19,1961,"FC Rouen","Toulouse FC","0-1",0,1,"1",1,1,-1,"D"
"6908",1962-05-19,1961,"FC Sochaux","Angers SCO","5-2",5,2,"1",1,7,3,"H"
"6909",1962-05-19,1961,"FC Metz","Le Havre AC","0-0",0,0,"1",1,0,0,"D"
"6910",1962-05-20,1961,"AS Monaco","Racing Club de France","1-2",1,2,"1",1,3,-1,"D"
"6911",1962-05-20,1961,"Stade Reims","RC Strasbourg","5-1",5,1,"1",1,6,4,"H"
"6912",1962-05-20,1961,"Stade Francais FC","Nimes Olympique","1-0",1,0,"1",1,1,1,"H"
"6913",1962-05-20,1961,"Stade Olympique Montpellierain","AS Saint-Etienne","4-3",4,3,"1",1,7,1,"H"
"6914",1962-05-20,1961,"Stade Rennes","OGC Nice","2-2",2,2,"1",1,4,0,"D"
"6915",1962-08-18,1962,"OGC Nice","RC Strasbourg","3-1",3,1,"1",1,4,2,"H"
"6916",1962-08-18,1962,"Nimes Olympique","Girondins Bordeaux","1-2",1,2,"1",1,3,-1,"D"
"6917",1962-08-18,1962,"Olympique Lyon","Olympique Marseille","1-1",1,1,"1",1,2,0,"D"
"6918",1962-08-18,1962,"Grenoble Foot 38","US Valenciennes-Anzin","1-1",1,1,"1",1,2,0,"D"
"6919",1962-08-18,1962,"UA Sedan-Torcy","Racing Club de France","0-0",0,0,"1",1,0,0,"D"
"6920",1962-08-18,1962,"AS Nancy","Stade Rennes","2-2",2,2,"1",1,4,0,"D"
"6921",1962-08-19,1962,"Stade Reims","Angers SCO","4-0",4,0,"1",1,4,4,"H"
"6922",1962-08-19,1962,"FC Rouen","AS Monaco","3-3",3,3,"1",1,6,0,"D"
"6923",1962-08-19,1962,"Stade Francais FC","Stade Olympique Montpellierain","5-2",5,2,"1",1,7,3,"H"
"6924",1962-08-22,1962,"RC Lens","Toulouse FC","1-1",1,1,"1",1,2,0,"D"
"6925",1962-08-25,1962,"AS Monaco","Stade Francais FC","1-1",1,1,"1",1,2,0,"D"
"6926",1962-08-25,1962,"US Valenciennes-Anzin","OGC Nice","2-2",2,2,"1",1,4,0,"D"
"6927",1962-08-25,1962,"Nimes Olympique","Angers SCO","5-0",5,0,"1",1,5,5,"H"
"6928",1962-08-25,1962,"RC Strasbourg","Toulouse FC","3-1",3,1,"1",1,4,2,"H"
"6929",1962-08-25,1962,"Grenoble Foot 38","FC Rouen","1-1",1,1,"1",1,2,0,"D"
"6930",1962-08-26,1962,"Stade Rennes","Stade Olympique Montpellierain","3-1",3,1,"1",1,4,2,"H"
"6931",1962-08-26,1962,"Girondins Bordeaux","UA Sedan-Torcy","4-4",4,4,"1",1,8,0,"D"
"6932",1962-08-26,1962,"Olympique Marseille","AS Nancy","2-1",2,1,"1",1,3,1,"H"
"6933",1962-08-26,1962,"Racing Club de France","RC Lens","2-1",2,1,"1",1,3,1,"H"
"6934",1962-08-29,1962,"Stade Reims","Olympique Lyon","5-1",5,1,"1",1,6,4,"H"
"6935",1962-09-01,1962,"UA Sedan-Torcy","OGC Nice","0-0",0,0,"1",1,0,0,"D"
"6936",1962-09-01,1962,"US Valenciennes-Anzin","Stade Rennes","0-0",0,0,"1",1,0,0,"D"
"6937",1962-09-01,1962,"AS Nancy","Girondins Bordeaux","2-2",2,2,"1",1,4,0,"D"
"6938",1962-09-01,1962,"Olympique Lyon","Nimes Olympique","0-0",0,0,"1",1,0,0,"D"
"6939",1962-09-01,1962,"FC Rouen","RC Strasbourg","0-0",0,0,"1",1,0,0,"D"
"6940",1962-09-02,1962,"Stade Olympique Montpellierain","Stade Reims","3-0",3,0,"1",1,3,3,"H"
"6941",1962-09-02,1962,"Stade Francais FC","Olympique Marseille","2-2",2,2,"1",1,4,0,"D"
"6942",1962-09-02,1962,"AS Monaco","RC Lens","2-0",2,0,"1",1,2,2,"H"
"6943",1962-09-02,1962,"Toulouse FC","Grenoble Foot 38","4-2",4,2,"1",1,6,2,"H"
"6944",1962-09-02,1962,"Angers SCO","Racing Club de France","2-1",2,1,"1",1,3,1,"H"
"6945",1962-09-05,1962,"Stade Rennes","Toulouse FC","3-1",3,1,"1",1,4,2,"H"
"6946",1962-09-05,1962,"OGC Nice","FC Rouen","1-0",1,0,"1",1,1,1,"H"
"6947",1962-09-05,1962,"Girondins Bordeaux","Stade Francais FC","1-0",1,0,"1",1,1,1,"H"
"6948",1962-09-05,1962,"Olympique Marseille","Stade Olympique Montpellierain","3-2",3,2,"1",1,5,1,"H"
"6949",1962-09-05,1962,"Stade Reims","US Valenciennes-Anzin","2-2",2,2,"1",1,4,0,"D"
"6950",1962-09-05,1962,"RC Strasbourg","AS Monaco","2-2",2,2,"1",1,4,0,"D"
"6951",1962-09-05,1962,"Racing Club de France","Grenoble Foot 38","2-0",2,0,"1",1,2,2,"H"
"6952",1962-09-05,1962,"Nimes Olympique","UA Sedan-Torcy","1-2",1,2,"1",1,3,-1,"D"
"6953",1962-09-05,1962,"RC Lens","AS Nancy","0-1",0,1,"1",1,1,-1,"D"
"6954",1962-09-05,1962,"Olympique Lyon","Angers SCO","3-0",3,0,"1",1,3,3,"H"
"6955",1962-09-08,1962,"Stade Reims","Olympique Marseille","1-0",1,0,"1",1,1,1,"H"
"6956",1962-09-08,1962,"Grenoble Foot 38","Stade Rennes","1-1",1,1,"1",1,2,0,"D"
"6957",1962-09-09,1962,"AS Monaco","Girondins Bordeaux","0-2",0,2,"1",1,2,-2,"D"
"6958",1962-09-09,1962,"Stade Francais FC","Nimes Olympique","4-2",4,2,"1",1,6,2,"H"
"6959",1962-09-09,1962,"US Valenciennes-Anzin","RC Strasbourg","4-0",4,0,"1",1,4,4,"H"
"6960",1962-09-09,1962,"AS Nancy","UA Sedan-Torcy","2-0",2,0,"1",1,2,2,"H"
"6961",1962-09-09,1962,"FC Rouen","Olympique Lyon","0-1",0,1,"1",1,1,-1,"D"
"6962",1962-09-09,1962,"Toulouse FC","OGC Nice","4-0",4,0,"1",1,4,4,"H"
"6963",1962-09-09,1962,"Stade Olympique Montpellierain","Racing Club de France","4-1",4,1,"1",1,5,3,"H"
"6964",1962-09-09,1962,"Angers SCO","RC Lens","2-2",2,2,"1",1,4,0,"D"
"6965",1962-09-15,1962,"OGC Nice","Grenoble Foot 38","3-2",3,2,"1",1,5,1,"H"
"6966",1962-09-15,1962,"AS Nancy","Angers SCO","0-0",0,0,"1",1,0,0,"D"
"6967",1962-09-15,1962,"Olympique Lyon","Stade Olympique Montpellierain","1-1",1,1,"1",1,2,0,"D"
"6968",1962-09-15,1962,"RC Lens","Stade Francais FC","2-1",2,1,"1",1,3,1,"H"
"6969",1962-09-15,1962,"Nimes Olympique","Toulouse FC","3-1",3,1,"1",1,4,2,"H"
"6970",1962-09-16,1962,"Girondins Bordeaux","FC Rouen","4-1",4,1,"1",1,5,3,"H"
"6971",1962-09-16,1962,"Stade Rennes","Stade Reims","2-0",2,0,"1",1,2,2,"H"
"6972",1962-09-16,1962,"Olympique Marseille","US Valenciennes-Anzin","1-3",1,3,"1",1,4,-2,"D"
"6973",1962-09-16,1962,"UA Sedan-Torcy","AS Monaco","3-0",3,0,"1",1,3,3,"H"
"6974",1962-09-16,1962,"Racing Club de France","RC Strasbourg","1-1",1,1,"1",1,2,0,"D"
"6975",1962-09-19,1962,"Stade Rennes","Olympique Lyon","2-1",2,1,"1",1,3,1,"H"
"6976",1962-09-19,1962,"Girondins Bordeaux","OGC Nice","0-2",0,2,"1",1,2,-2,"D"
"6977",1962-09-19,1962,"Stade Reims","AS Nancy","5-1",5,1,"1",1,6,4,"H"
"6978",1962-09-19,1962,"FC Rouen","US Valenciennes-Anzin","3-2",3,2,"1",1,5,1,"H"
"6979",1962-09-19,1962,"Grenoble Foot 38","Olympique Marseille","0-3",0,3,"1",1,3,-3,"D"
"6980",1962-09-19,1962,"Stade Olympique Montpellierain","UA Sedan-Torcy","1-0",1,0,"1",1,1,1,"H"
"6981",1962-09-19,1962,"Stade Francais FC","Toulouse FC","1-2",1,2,"1",1,3,-1,"D"
"6982",1962-09-19,1962,"AS Monaco","Racing Club de France","1-1",1,1,"1",1,2,0,"D"
"6983",1962-09-19,1962,"RC Strasbourg","Angers SCO","3-1",3,1,"1",1,4,2,"H"
"6984",1962-09-19,1962,"RC Lens","Nimes Olympique","2-1",2,1,"1",1,3,1,"H"
"6985",1962-09-22,1962,"OGC Nice","Stade Olympique Montpellierain","3-1",3,1,"1",1,4,2,"H"
"6986",1962-09-22,1962,"Nimes Olympique","Stade Reims","0-0",0,0,"1",1,0,0,"D"
"6987",1962-09-22,1962,"RC Strasbourg","Grenoble Foot 38","4-0",4,0,"1",1,4,4,"H"
"6988",1962-09-22,1962,"Olympique Lyon","AS Monaco","1-1",1,1,"1",1,2,0,"D"
"6989",1962-09-23,1962,"Angers SCO","Girondins Bordeaux","0-3",0,3,"1",1,3,-3,"D"
"6990",1962-09-23,1962,"Racing Club de France","Stade Rennes","2-1",2,1,"1",1,3,1,"H"
"6991",1962-09-23,1962,"US Valenciennes-Anzin","Stade Francais FC","0-0",0,0,"1",1,0,0,"D"
"6992",1962-09-23,1962,"Toulouse FC","Olympique Marseille","3-1",3,1,"1",1,4,2,"H"
"6993",1962-09-23,1962,"UA Sedan-Torcy","RC Lens","2-1",2,1,"1",1,3,1,"H"
"6994",1962-09-23,1962,"AS Nancy","FC Rouen","1-3",1,3,"1",1,4,-2,"D"
"6995",1962-10-06,1962,"AS Monaco","US Valenciennes-Anzin","3-1",3,1,"1",1,4,2,"H"
"6996",1962-10-06,1962,"Nimes Olympique","AS Nancy","3-0",3,0,"1",1,3,3,"H"
"6997",1962-10-07,1962,"Stade Rennes","RC Strasbourg","4-1",4,1,"1",1,5,3,"H"
"6998",1962-10-07,1962,"RC Lens","OGC Nice","2-2",2,2,"1",1,4,0,"D"
"6999",1962-10-07,1962,"Grenoble Foot 38","Stade Reims","0-3",0,3,"1",1,3,-3,"D"
"7000",1962-10-07,1962,"Girondins Bordeaux","Olympique Lyon","1-2",1,2,"1",1,3,-1,"D"
"7001",1962-10-07,1962,"Toulouse FC","Stade Olympique Montpellierain","2-1",2,1,"1",1,3,1,"H"
"7002",1962-10-07,1962,"Angers SCO","UA Sedan-Torcy","0-1",0,1,"1",1,1,-1,"D"
"7003",1962-10-07,1962,"Olympique Marseille","Racing Club de France","1-3",1,3,"1",1,4,-2,"D"
"7004",1962-10-07,1962,"Stade Francais FC","FC Rouen","1-2",1,2,"1",1,3,-1,"D"
"7005",1962-10-10,1962,"OGC Nice","Nimes Olympique","1-0",1,0,"1",1,1,1,"H"
"7006",1962-10-10,1962,"Stade Reims","RC Strasbourg","1-1",1,1,"1",1,2,0,"D"
"7007",1962-10-10,1962,"US Valenciennes-Anzin","Toulouse FC","1-2",1,2,"1",1,3,-1,"D"
"7008",1962-10-10,1962,"Olympique Lyon","AS Nancy","3-0",3,0,"1",1,3,3,"H"
"7009",1962-10-10,1962,"FC Rouen","Angers SCO","3-1",3,1,"1",1,4,2,"H"
"7010",1962-10-10,1962,"Olympique Marseille","RC Lens","3-3",3,3,"1",1,6,0,"D"
"7011",1962-10-10,1962,"Grenoble Foot 38","Stade Francais FC","1-1",1,1,"1",1,2,0,"D"
"7012",1962-10-11,1962,"Stade Rennes","UA Sedan-Torcy","3-1",3,1,"1",1,4,2,"H"
"7013",1962-10-11,1962,"Racing Club de France","Girondins Bordeaux","1-3",1,3,"1",1,4,-2,"D"
"7014",1962-10-11,1962,"Stade Olympique Montpellierain","AS Monaco","0-1",0,1,"1",1,1,-1,"D"
"7015",1962-10-13,1962,"FC Rouen","Stade Reims","1-2",1,2,"1",1,3,-1,"D"
"7016",1962-10-13,1962,"Nimes Olympique","Stade Rennes","2-1",2,1,"1",1,3,1,"H"
"7017",1962-10-14,1962,"RC Lens","Girondins Bordeaux","3-3",3,3,"1",1,6,0,"D"
"7018",1962-10-14,1962,"Stade Francais FC","OGC Nice","2-0",2,0,"1",1,2,2,"H"
"7019",1962-10-14,1962,"Toulouse FC","Racing Club de France","1-1",1,1,"1",1,2,0,"D"
"7020",1962-10-14,1962,"UA Sedan-Torcy","Olympique Lyon","1-3",1,3,"1",1,4,-2,"D"
"7021",1962-10-14,1962,"AS Monaco","Grenoble Foot 38","4-0",4,0,"1",1,4,4,"H"
"7022",1962-10-14,1962,"RC Strasbourg","Stade Olympique Montpellierain","1-1",1,1,"1",1,2,0,"D"
"7023",1962-10-14,1962,"AS Nancy","US Valenciennes-Anzin","2-0",2,0,"1",1,2,2,"H"
"7024",1962-10-14,1962,"Angers SCO","Olympique Marseille","3-0",3,0,"1",1,3,3,"H"
"7025",1962-10-21,1962,"Stade Rennes","Angers SCO","1-1",1,1,"1",1,2,0,"D"
"7026",1962-10-21,1962,"Girondins Bordeaux","Toulouse FC","0-0",0,0,"1",1,0,0,"D"
"7027",1962-10-21,1962,"Grenoble Foot 38","Olympique Lyon","1-2",1,2,"1",1,3,-1,"D"
"7028",1962-10-21,1962,"OGC Nice","AS Monaco","2-2",2,2,"1",1,4,0,"D"
"7029",1962-10-21,1962,"Stade Reims","UA Sedan-Torcy","2-3",2,3,"1",1,5,-1,"D"
"7030",1962-10-21,1962,"Olympique Marseille","FC Rouen","0-1",0,1,"1",1,1,-1,"D"
"7031",1962-10-21,1962,"RC Strasbourg","AS Nancy","1-0",1,0,"1",1,1,1,"H"
"7032",1962-10-21,1962,"Racing Club de France","Stade Francais FC","0-2",0,2,"1",1,2,-2,"D"
"7033",1962-10-21,1962,"Stade Olympique Montpellierain","Nimes Olympique","1-1",1,1,"1",1,2,0,"D"
"7034",1962-10-21,1962,"US Valenciennes-Anzin","RC Lens","1-1",1,1,"1",1,2,0,"D"
"7035",1962-10-28,1962,"Girondins Bordeaux","Stade Reims","2-3",2,3,"1",1,5,-1,"D"
"7036",1962-10-28,1962,"OGC Nice","Racing Club de France","3-3",3,3,"1",1,6,0,"D"
"7037",1962-10-28,1962,"FC Rouen","Stade Rennes","2-0",2,0,"1",1,2,2,"H"
"7038",1962-10-28,1962,"RC Lens","Olympique Lyon","2-1",2,1,"1",1,3,1,"H"
"7039",1962-10-28,1962,"UA Sedan-Torcy","Toulouse FC","2-1",2,1,"1",1,3,1,"H"
"7040",1962-10-28,1962,"Stade Francais FC","RC Strasbourg","2-1",2,1,"1",1,3,1,"H"
"7041",1962-10-28,1962,"AS Nancy","AS Monaco","2-1",2,1,"1",1,3,1,"H"
"7042",1962-10-28,1962,"Nimes Olympique","Olympique Marseille","3-0",3,0,"1",1,3,3,"H"
"7043",1962-10-28,1962,"Angers SCO","US Valenciennes-Anzin","0-0",0,0,"1",1,0,0,"D"
"7044",1962-10-28,1962,"Grenoble Foot 38","Stade Olympique Montpellierain","3-1",3,1,"1",1,4,2,"H"
"7045",1962-10-31,1962,"Stade Reims","Stade Francais FC","6-2",6,2,"1",1,8,4,"H"
"7046",1962-10-31,1962,"Toulouse FC","Angers SCO","4-0",4,0,"1",1,4,4,"H"
"7047",1962-10-31,1962,"AS Monaco","Nimes Olympique","4-1",4,1,"1",1,5,3,"H"
"7048",1962-11-01,1962,"Stade Rennes","Girondins Bordeaux","1-3",1,3,"1",1,4,-2,"D"
"7049",1962-11-01,1962,"Olympique Marseille","OGC Nice","1-1",1,1,"1",1,2,0,"D"
"7050",1962-11-01,1962,"US Valenciennes-Anzin","Olympique Lyon","0-0",0,0,"1",1,0,0,"D"
"7051",1962-11-01,1962,"Grenoble Foot 38","UA Sedan-Torcy","1-1",1,1,"1",1,2,0,"D"
"7052",1962-11-01,1962,"Stade Olympique Montpellierain","FC Rouen","3-1",3,1,"1",1,4,2,"H"
"7053",1962-11-01,1962,"Racing Club de France","AS Nancy","4-2",4,2,"1",1,6,2,"H"
"7054",1962-11-01,1962,"RC Strasbourg","RC Lens","1-3",1,3,"1",1,4,-2,"D"
"7055",1962-11-04,1962,"OGC Nice","Stade Reims","4-0",4,0,"1",1,4,4,"H"
"7056",1962-11-04,1962,"Girondins Bordeaux","US Valenciennes-Anzin","2-2",2,2,"1",1,4,0,"D"
"7057",1962-11-04,1962,"FC Rouen","Toulouse FC","2-2",2,2,"1",1,4,0,"D"
"7058",1962-11-04,1962,"UA Sedan-Torcy","Olympique Marseille","4-0",4,0,"1",1,4,4,"H"
"7059",1962-11-04,1962,"Olympique Lyon","Racing Club de France","1-1",1,1,"1",1,2,0,"D"
"7060",1962-11-04,1962,"Stade Francais FC","Stade Rennes","3-3",3,3,"1",1,6,0,"D"
"7061",1962-11-04,1962,"Angers SCO","AS Monaco","4-2",4,2,"1",1,6,2,"H"
"7062",1962-11-04,1962,"RC Lens","Grenoble Foot 38","2-0",2,0,"1",1,2,2,"H"
"7063",1962-11-04,1962,"Nimes Olympique","RC Strasbourg","5-1",5,1,"1",1,6,4,"H"
"7064",1962-11-04,1962,"AS Nancy","Stade Olympique Montpellierain","2-1",2,1,"1",1,3,1,"H"
"7065",1962-11-18,1962,"Stade Reims","RC Lens","3-1",3,1,"1",1,4,2,"H"
"7066",1962-11-18,1962,"Stade Olympique Montpellierain","Girondins Bordeaux","0-3",0,3,"1",1,3,-3,"D"
"7067",1962-11-18,1962,"Toulouse FC","AS Nancy","2-0",2,0,"1",1,2,2,"H"
"7068",1962-11-18,1962,"RC Strasbourg","Olympique Lyon","0-3",0,3,"1",1,3,-3,"D"
"7069",1962-11-18,1962,"Stade Rennes","OGC Nice","3-1",3,1,"1",1,4,2,"H"
"7070",1962-11-18,1962,"FC Rouen","UA Sedan-Torcy","2-1",2,1,"1",1,3,1,"H"
"7071",1962-11-18,1962,"Grenoble Foot 38","Nimes Olympique","0-0",0,0,"1",1,0,0,"D"
"7072",1962-11-18,1962,"US Valenciennes-Anzin","Racing Club de France","4-0",4,0,"1",1,4,4,"H"
"7073",1962-11-18,1962,"Stade Francais FC","Angers SCO","0-3",0,3,"1",1,3,-3,"D"
"7074",1962-11-19,1962,"AS Monaco","Olympique Marseille","2-1",2,1,"1",1,3,1,"H"
"7075",1962-11-21,1962,"Racing Club de France","Stade Reims","3-3",3,3,"1",1,6,0,"D"
"7076",1962-11-21,1962,"Girondins Bordeaux","Grenoble Foot 38","1-1",1,1,"1",1,2,0,"D"
"7077",1962-11-21,1962,"AS Monaco","Toulouse FC","0-0",0,0,"1",1,0,0,"D"
"7078",1962-11-21,1962,"Nimes Olympique","FC Rouen","2-1",2,1,"1",1,3,1,"H"
"7079",1962-11-21,1962,"AS Nancy","Stade Francais FC","0-0",0,0,"1",1,0,0,"D"
"7080",1962-11-22,1962,"Olympique Lyon","OGC Nice","3-1",3,1,"1",1,4,2,"H"
"7081",1962-11-22,1962,"Olympique Marseille","RC Strasbourg","1-3",1,3,"1",1,4,-2,"D"
"7082",1962-11-22,1962,"Angers SCO","Stade Olympique Montpellierain","2-1",2,1,"1",1,3,1,"H"
"7083",1962-11-25,1962,"Toulouse FC","Olympique Lyon","0-1",0,1,"1",1,1,-1,"D"
"7084",1962-11-25,1962,"Stade Reims","AS Monaco","1-1",1,1,"1",1,2,0,"D"
"7085",1962-11-25,1962,"RC Strasbourg","Girondins Bordeaux","0-0",0,0,"1",1,0,0,"D"
"7086",1962-11-25,1962,"Stade Rennes","Olympique Marseille","3-2",3,2,"1",1,5,1,"H"
"7087",1962-11-25,1962,"OGC Nice","Angers SCO","1-1",1,1,"1",1,2,0,"D"
"7088",1962-11-25,1962,"US Valenciennes-Anzin","Nimes Olympique","1-1",1,1,"1",1,2,0,"D"
"7089",1962-11-25,1962,"FC Rouen","Racing Club de France","0-2",0,2,"1",1,2,-2,"D"
"7090",1962-11-25,1962,"Stade Francais FC","UA Sedan-Torcy","4-2",4,2,"1",1,6,2,"H"
"7091",1962-11-25,1962,"Stade Olympique Montpellierain","RC Lens","2-1",2,1,"1",1,3,1,"H"
"7092",1962-11-25,1962,"Grenoble Foot 38","AS Nancy","1-1",1,1,"1",1,2,0,"D"
"7093",1962-11-28,1962,"RC Lens","Stade Rennes","2-2",2,2,"1",1,4,0,"D"
"7094",1962-11-28,1962,"UA Sedan-Torcy","US Valenciennes-Anzin","4-2",4,2,"1",1,6,2,"H"
"7095",1962-12-02,1962,"Olympique Lyon","Stade Francais FC","1-0",1,0,"1",1,1,1,"H"
"7096",1962-12-02,1962,"Olympique Marseille","Girondins Bordeaux","1-1",1,1,"1",1,2,0,"D"
"7097",1962-12-02,1962,"Toulouse FC","Stade Reims","3-2",3,2,"1",1,5,1,"H"
"7098",1962-12-02,1962,"AS Monaco","Stade Rennes","5-0",5,0,"1",1,5,5,"H"
"7099",1962-12-02,1962,"UA Sedan-Torcy","RC Strasbourg","2-1",2,1,"1",1,3,1,"H"
"7100",1962-12-02,1962,"AS Nancy","OGC Nice","1-1",1,1,"1",1,2,0,"D"
"7101",1962-12-02,1962,"Racing Club de France","Nimes Olympique","2-2",2,2,"1",1,4,0,"D"
"7102",1962-12-02,1962,"RC Lens","FC Rouen","1-4",1,4,"1",1,5,-3,"D"
"7103",1962-12-02,1962,"Stade Olympique Montpellierain","US Valenciennes-Anzin","0-4",0,4,"1",1,4,-4,"D"
"7104",1962-12-02,1962,"Angers SCO","Grenoble Foot 38","2-1",2,1,"1",1,3,1,"H"
"7105",1962-12-09,1962,"Nimes Olympique","Olympique Lyon","1-0",1,0,"1",1,1,1,"H"
"7106",1962-12-09,1962,"Girondins Bordeaux","Angers SCO","0-0",0,0,"1",1,0,0,"D"
"7107",1962-12-09,1962,"UA Sedan-Torcy","AS Nancy","2-0",2,0,"1",1,2,2,"H"
"7108",1962-12-09,1962,"OGC Nice","Olympique Marseille","1-0",1,0,"1",1,1,1,"H"
"7109",1962-12-09,1962,"RC Strasbourg","Stade Reims","3-2",3,2,"1",1,5,1,"H"
"7110",1962-12-09,1962,"US Valenciennes-Anzin","AS Monaco","0-0",0,0,"1",1,0,0,"D"
"7111",1962-12-09,1962,"Grenoble Foot 38","Toulouse FC","1-0",1,0,"1",1,1,1,"H"
"7112",1962-12-09,1962,"FC Rouen","Stade Olympique Montpellierain","3-1",3,1,"1",1,4,2,"H"
"7113",1962-12-09,1962,"Stade Rennes","Racing Club de France","3-5",3,5,"1",1,8,-2,"D"
"7114",1962-12-09,1962,"Stade Francais FC","RC Lens","2-0",2,0,"1",1,2,2,"H"
"7115",1962-12-16,1962,"Stade Reims","Girondins Bordeaux","1-3",1,3,"1",1,4,-2,"D"
"7116",1962-12-16,1962,"Olympique Lyon","UA Sedan-Torcy","0-2",0,2,"1",1,2,-2,"D"
"7117",1962-12-16,1962,"AS Monaco","FC Rouen","3-1",3,1,"1",1,4,2,"H"
"7118",1962-12-16,1962,"Toulouse FC","Stade Rennes","2-1",2,1,"1",1,3,1,"H"
"7119",1962-12-16,1962,"Olympique Marseille","Nimes Olympique","0-3",0,3,"1",1,3,-3,"D"
"7120",1962-12-16,1962,"Stade Olympique Montpellierain","OGC Nice","1-0",1,0,"1",1,1,1,"H"
"7121",1962-12-16,1962,"Racing Club de France","US Valenciennes-Anzin","3-2",3,2,"1",1,5,1,"H"
"7122",1962-12-16,1962,"Angers SCO","Stade Francais FC","2-0",2,0,"1",1,2,2,"H"
"7123",1962-12-16,1962,"RC Lens","RC Strasbourg","0-0",0,0,"1",1,0,0,"D"
"7124",1962-12-16,1962,"AS Nancy","Grenoble Foot 38","1-0",1,0,"1",1,1,1,"H"
"7125",1962-12-23,1962,"FC Rouen","Girondins Bordeaux","1-1",1,1,"1",1,2,0,"D"
"7126",1962-12-23,1962,"UA Sedan-Torcy","Stade Olympique Montpellierain","2-0",2,0,"1",1,2,2,"H"
"7127",1962-12-23,1962,"Olympique Lyon","RC Lens","1-0",1,0,"1",1,1,1,"H"
"7128",1962-12-23,1962,"Nimes Olympique","AS Monaco","1-2",1,2,"1",1,3,-1,"D"
"7129",1962-12-23,1962,"OGC Nice","Toulouse FC","2-1",2,1,"1",1,3,1,"H"
"7130",1962-12-23,1962,"Stade Francais FC","Stade Reims","0-4",0,4,"1",1,4,-4,"D"
"7131",1962-12-23,1962,"Grenoble Foot 38","Racing Club de France","1-1",1,1,"1",1,2,0,"D"
"7132",1962-12-23,1962,"Stade Rennes","AS Nancy","1-1",1,1,"1",1,2,0,"D"
"7133",1962-12-23,1962,"US Valenciennes-Anzin","Angers SCO","4-0",4,0,"1",1,4,4,"H"
"7134",1962-12-23,1962,"RC Strasbourg","Olympique Marseille","0-0",0,0,"1",1,0,0,"D"
"7135",1962-12-30,1962,"Girondins Bordeaux","Stade Rennes","6-0",6,0,"1",1,6,6,"H"
"7136",1962-12-30,1962,"AS Monaco","UA Sedan-Torcy","0-1",0,1,"1",1,1,-1,"D"
"7137",1962-12-30,1962,"Racing Club de France","Olympique Lyon","1-1",1,1,"1",1,2,0,"D"
"7138",1962-12-30,1962,"Toulouse FC","RC Strasbourg","1-1",1,1,"1",1,2,0,"D"
"7139",1962-12-30,1962,"Angers SCO","Nimes Olympique","0-0",0,0,"1",1,0,0,"D"
"7140",1962-12-30,1962,"Olympique Marseille","Stade Francais FC","3-2",3,2,"1",1,5,1,"H"
"7141",1962-12-30,1962,"Stade Olympique Montpellierain","Grenoble Foot 38","2-0",2,0,"1",1,2,2,"H"
"7142",1963-01-05,1962,"Girondins Bordeaux","Olympique Marseille","1-3",1,3,"1",1,4,-2,"D"
"7143",1963-01-06,1962,"UA Sedan-Torcy","Nimes Olympique","3-0",3,0,"1",1,3,3,"H"
"7144",1963-01-06,1962,"Stade Olympique Montpellierain","Olympique Lyon","1-1",1,1,"1",1,2,0,"D"
"7145",1963-01-06,1962,"AS Monaco","Stade Reims","5-2",5,2,"1",1,7,3,"H"
"7146",1963-01-06,1962,"Racing Club de France","Toulouse FC","2-2",2,2,"1",1,4,0,"D"
"7147",1963-01-06,1962,"Grenoble Foot 38","OGC Nice","3-1",3,1,"1",1,4,2,"H"
"7148",1963-01-06,1962,"FC Rouen","AS Nancy","2-1",2,1,"1",1,3,1,"H"
"7149",1963-01-06,1962,"Stade Rennes","Stade Francais FC","2-0",2,0,"1",1,2,2,"H"
"7150",1963-01-13,1962,"Toulouse FC","UA Sedan-Torcy","0-2",0,2,"1",1,2,-2,"D"
"7151",1963-01-13,1962,"Stade Rennes","AS Monaco","2-0",2,0,"1",1,2,2,"H"
"7152",1963-01-13,1962,"Stade Reims","FC Rouen","4-0",4,0,"1",1,4,4,"H"
"7153",1963-01-13,1962,"Nimes Olympique","RC Lens","4-2",4,2,"1",1,6,2,"H"
"7154",1963-01-13,1962,"Stade Francais FC","Grenoble Foot 38","1-1",1,1,"1",1,2,0,"D"
"7155",1963-01-27,1962,"UA Sedan-Torcy","Grenoble Foot 38","3-1",3,1,"1",1,4,2,"H"
"7156",1963-01-27,1962,"Girondins Bordeaux","Nimes Olympique","0-0",0,0,"1",1,0,0,"D"
"7157",1963-01-27,1962,"AS Monaco","Olympique Lyon","1-0",1,0,"1",1,1,1,"H"
"7158",1963-01-27,1962,"Angers SCO","Stade Reims","0-1",0,1,"1",1,1,-1,"D"
"7159",1963-01-27,1962,"Racing Club de France","Olympique Marseille","3-0",3,0,"1",1,3,3,"H"
"7160",1963-01-27,1962,"Stade Olympique Montpellierain","Stade Rennes","1-1",1,1,"1",1,2,0,"D"
"7161",1963-01-27,1962,"Toulouse FC","RC Lens","1-2",1,2,"1",1,3,-1,"D"
"7162",1963-01-27,1962,"FC Rouen","Stade Francais FC","3-1",3,1,"1",1,4,2,"H"
"7163",1963-01-27,1962,"RC Strasbourg","OGC Nice","7-0",7,0,"1",1,7,7,"H"
"7164",1963-01-27,1962,"US Valenciennes-Anzin","AS Nancy","2-0",2,0,"1",1,2,2,"H"
"7165",1963-02-03,1962,"OGC Nice","UA Sedan-Torcy","2-1",2,1,"1",1,3,1,"H"
"7166",1963-02-03,1962,"Olympique Marseille","AS Monaco","2-4",2,4,"1",1,6,-2,"D"
"7167",1963-02-03,1962,"Olympique Lyon","Girondins Bordeaux","1-0",1,0,"1",1,1,1,"H"
"7168",1963-02-03,1962,"Stade Reims","Toulouse FC","1-0",1,0,"1",1,1,1,"H"
"7169",1963-02-03,1962,"RC Strasbourg","FC Rouen","3-0",3,0,"1",1,3,3,"H"
"7170",1963-02-03,1962,"Stade Francais FC","AS Nancy","2-0",2,0,"1",1,2,2,"H"
"7171",1963-02-10,1962,"AS Monaco","RC Strasbourg","1-0",1,0,"1",1,1,1,"H"
"7172",1963-02-10,1962,"Girondins Bordeaux","RC Lens","3-0",3,0,"1",1,3,3,"H"
"7173",1963-02-10,1962,"Angers SCO","Olympique Lyon","2-2",2,2,"1",1,4,0,"D"
"7174",1963-02-10,1962,"US Valenciennes-Anzin","Stade Reims","2-0",2,0,"1",1,2,2,"H"
"7175",1963-02-10,1962,"Racing Club de France","OGC Nice","3-4",3,4,"1",1,7,-1,"D"
"7176",1963-02-10,1962,"Toulouse FC","Nimes Olympique","2-0",2,0,"1",1,2,2,"H"
"7177",1963-02-10,1962,"Stade Olympique Montpellierain","Stade Francais FC","4-5",4,5,"1",1,9,-1,"D"
"7178",1963-02-10,1962,"AS Nancy","Olympique Marseille","1-0",1,0,"1",1,1,1,"H"
"7179",1963-03-03,1962,"Racing Club de France","AS Monaco","2-3",2,3,"1",1,5,-1,"D"
"7180",1963-03-03,1962,"Girondins Bordeaux","RC Strasbourg","3-0",3,0,"1",1,3,3,"H"
"7181",1963-03-03,1962,"OGC Nice","RC Lens","3-1",3,1,"1",1,4,2,"H"
"7182",1963-03-03,1962,"Olympique Marseille","Stade Reims","1-0",1,0,"1",1,1,1,"H"
"7183",1963-03-03,1962,"Stade Rennes","Nimes Olympique","1-1",1,1,"1",1,2,0,"D"
"7184",1963-03-03,1962,"Toulouse FC","FC Rouen","1-2",1,2,"1",1,3,-1,"D"
"7185",1963-03-03,1962,"US Valenciennes-Anzin","Grenoble Foot 38","1-1",1,1,"1",1,2,0,"D"
"7186",1963-03-03,1962,"Stade Olympique Montpellierain","Angers SCO","1-2",1,2,"1",1,3,-1,"D"
"7187",1963-03-10,1962,"US Valenciennes-Anzin","Stade Olympique Montpellierain","2-0",2,0,"1",1,2,2,"H"
"7188",1963-03-17,1962,"Grenoble Foot 38","AS Monaco","0-1",0,1,"1",1,1,-1,"D"
"7189",1963-03-17,1962,"RC Strasbourg","UA Sedan-Torcy","1-5",1,5,"1",1,6,-4,"D"
"7190",1963-03-17,1962,"Stade Francais FC","Girondins Bordeaux","0-0",0,0,"1",1,0,0,"D"
"7191",1963-03-17,1962,"Olympique Lyon","Stade Rennes","1-1",1,1,"1",1,2,0,"D"
"7192",1963-03-17,1962,"OGC Nice","AS Nancy","2-0",2,0,"1",1,2,2,"H"
"7193",1963-03-17,1962,"Stade Reims","Stade Olympique Montpellierain","1-1",1,1,"1",1,2,0,"D"
"7194",1963-03-17,1962,"Olympique Marseille","Toulouse FC","0-1",0,1,"1",1,1,-1,"D"
"7195",1963-03-17,1962,"RC Lens","Racing Club de France","1-2",1,2,"1",1,3,-1,"D"
"7196",1963-03-17,1962,"Nimes Olympique","US Valenciennes-Anzin","1-3",1,3,"1",1,4,-2,"D"
"7197",1963-03-17,1962,"Angers SCO","FC Rouen","3-1",3,1,"1",1,4,2,"H"
"7198",1963-03-23,1962,"AS Nancy","RC Strasbourg","1-1",1,1,"1",1,2,0,"D"
"7199",1963-03-23,1962,"FC Rouen","Olympique Marseille","3-0",3,0,"1",1,3,3,"H"
"7200",1963-03-24,1962,"AS Monaco","OGC Nice","6-2",6,2,"1",1,8,4,"H"
"7201",1963-03-24,1962,"UA Sedan-Torcy","Stade Reims","1-2",1,2,"1",1,3,-1,"D"
"7202",1963-03-24,1962,"Toulouse FC","Girondins Bordeaux","0-0",0,0,"1",1,0,0,"D"
"7203",1963-03-24,1962,"Olympique Lyon","Grenoble Foot 38","0-1",0,1,"1",1,1,-1,"D"
"7204",1963-03-24,1962,"Stade Francais FC","Racing Club de France","1-2",1,2,"1",1,3,-1,"D"
"7205",1963-03-24,1962,"RC Lens","US Valenciennes-Anzin","1-2",1,2,"1",1,3,-1,"D"
"7206",1963-03-24,1962,"Angers SCO","Stade Rennes","2-3",2,3,"1",1,5,-1,"D"
"7207",1963-03-24,1962,"Nimes Olympique","Stade Olympique Montpellierain","1-1",1,1,"1",1,2,0,"D"
"7208",1963-03-30,1962,"AS Nancy","RC Lens","1-3",1,3,"1",1,4,-2,"D"
"7209",1963-03-30,1962,"AS Nancy","Racing Club de France","2-2",2,2,"1",1,4,0,"D"
"7210",1963-03-31,1962,"US Valenciennes-Anzin","FC Rouen","1-1",1,1,"1",1,2,0,"D"
"7211",1963-03-31,1962,"Grenoble Foot 38","Angers SCO","0-2",0,2,"1",1,2,-2,"D"
"7212",1963-03-31,1962,"RC Lens","Stade Olympique Montpellierain","3-0",3,0,"1",1,3,3,"H"
"7213",1963-04-03,1962,"RC Lens","AS Monaco","1-0",1,0,"1",1,1,1,"H"
"7214",1963-04-03,1962,"Girondins Bordeaux","AS Nancy","2-0",2,0,"1",1,2,2,"H"
"7215",1963-04-03,1962,"Racing Club de France","UA Sedan-Torcy","4-3",4,3,"1",1,7,1,"H"
"7216",1963-04-03,1962,"Stade Reims","Grenoble Foot 38","1-1",1,1,"1",1,2,0,"D"
"7217",1963-04-03,1962,"Olympique Lyon","US Valenciennes-Anzin","1-1",1,1,"1",1,2,0,"D"
"7218",1963-04-03,1962,"Angers SCO","Toulouse FC","1-3",1,3,"1",1,4,-2,"D"
"7219",1963-04-03,1962,"OGC Nice","Stade Francais FC","0-2",0,2,"1",1,2,-2,"D"
"7220",1963-04-03,1962,"RC Strasbourg","Stade Rennes","1-1",1,1,"1",1,2,0,"D"
"7221",1963-04-03,1962,"FC Rouen","Nimes Olympique","0-1",0,1,"1",1,1,-1,"D"
"7222",1963-04-03,1962,"Stade Olympique Montpellierain","Olympique Marseille","2-0",2,0,"1",1,2,2,"H"
"7223",1963-04-06,1962,"UA Sedan-Torcy","FC Rouen","0-1",0,1,"1",1,1,-1,"D"
"7224",1963-04-06,1962,"Grenoble Foot 38","RC Strasbourg","3-3",3,3,"1",1,6,0,"D"
"7225",1963-04-06,1962,"AS Monaco","Stade Olympique Montpellierain","3-1",3,1,"1",1,4,2,"H"
"7226",1963-04-06,1962,"US Valenciennes-Anzin","Girondins Bordeaux","2-0",2,0,"1",1,2,2,"H"
"7227",1963-04-06,1962,"AS Nancy","Stade Reims","0-2",0,2,"1",1,2,-2,"D"
"7228",1963-04-06,1962,"Olympique Marseille","Olympique Lyon","1-2",1,2,"1",1,3,-1,"D"
"7229",1963-04-06,1962,"Toulouse FC","Stade Francais FC","5-2",5,2,"1",1,7,3,"H"
"7230",1963-04-06,1962,"Racing Club de France","Angers SCO","2-4",2,4,"1",1,6,-2,"D"
"7231",1963-04-06,1962,"Stade Rennes","RC Lens","4-2",4,2,"1",1,6,2,"H"
"7232",1963-04-06,1962,"Nimes Olympique","OGC Nice","6-3",6,3,"1",1,9,3,"H"
"7233",1963-04-12,1962,"Olympique Lyon","Stade Reims","0-0",0,0,"1",1,0,0,"D"
"7234",1963-04-12,1962,"RC Strasbourg","Racing Club de France","2-2",2,2,"1",1,4,0,"D"
"7235",1963-04-12,1962,"AS Nancy","Nimes Olympique","0-4",0,4,"1",1,4,-4,"D"
"7236",1963-04-12,1962,"FC Rouen","OGC Nice","4-2",4,2,"1",1,6,2,"H"
"7237",1963-04-13,1962,"Girondins Bordeaux","Stade Olympique Montpellierain","2-0",2,0,"1",1,2,2,"H"
"7238",1963-04-13,1962,"UA Sedan-Torcy","Angers SCO","0-1",0,1,"1",1,1,-1,"D"
"7239",1963-04-13,1962,"Stade Rennes","Grenoble Foot 38","3-0",3,0,"1",1,3,3,"H"
"7240",1963-04-13,1962,"RC Lens","Olympique Marseille","8-1",8,1,"1",1,9,7,"H"
"7241",1963-04-14,1962,"Toulouse FC","AS Monaco","0-5",0,5,"1",1,5,-5,"D"
"7242",1963-04-14,1962,"Stade Francais FC","US Valenciennes-Anzin","1-3",1,3,"1",1,4,-2,"D"
"7243",1963-04-20,1962,"RC Lens","Angers SCO","3-3",3,3,"1",1,6,0,"D"
"7244",1963-04-20,1962,"Stade Rennes","US Valenciennes-Anzin","3-1",3,1,"1",1,4,2,"H"
"7245",1963-04-20,1962,"Nimes Olympique","Racing Club de France","4-1",4,1,"1",1,5,3,"H"
"7246",1963-04-20,1962,"FC Rouen","Grenoble Foot 38","0-2",0,2,"1",1,2,-2,"D"
"7247",1963-04-20,1962,"UA Sedan-Torcy","Stade Francais FC","3-0",3,0,"1",1,3,3,"H"
"7248",1963-04-21,1962,"OGC Nice","Girondins Bordeaux","1-1",1,1,"1",1,2,0,"D"
"7249",1963-04-30,1962,"Nimes Olympique","Stade Francais FC","4-0",4,0,"1",1,4,4,"H"
"7250",1963-04-30,1962,"Olympique Lyon","Toulouse FC","3-3",3,3,"1",1,6,0,"D"
"7251",1963-04-30,1962,"OGC Nice","US Valenciennes-Anzin","2-0",2,0,"1",1,2,2,"H"
"7252",1963-05-01,1962,"Girondins Bordeaux","AS Monaco","0-1",0,1,"1",1,1,-1,"D"
"7253",1963-05-01,1962,"RC Lens","UA Sedan-Torcy","1-2",1,2,"1",1,3,-1,"D"
"7254",1963-05-01,1962,"Stade Reims","Stade Rennes","4-0",4,0,"1",1,4,4,"H"
"7255",1963-05-01,1962,"Racing Club de France","FC Rouen","3-0",3,0,"1",1,3,3,"H"
"7256",1963-05-01,1962,"Angers SCO","AS Nancy","1-1",1,1,"1",1,2,0,"D"
"7257",1963-05-01,1962,"Stade Olympique Montpellierain","RC Strasbourg","1-1",1,1,"1",1,2,0,"D"
"7258",1963-05-01,1962,"Olympique Marseille","Grenoble Foot 38","2-2",2,2,"1",1,4,0,"D"
"7259",1963-05-04,1962,"FC Rouen","RC Lens","3-2",3,2,"1",1,5,1,"H"
"7260",1963-05-05,1962,"AS Monaco","AS Nancy","0-1",0,1,"1",1,1,-1,"D"
"7261",1963-05-05,1962,"US Valenciennes-Anzin","UA Sedan-Torcy","1-1",1,1,"1",1,2,0,"D"
"7262",1963-05-05,1962,"Grenoble Foot 38","Girondins Bordeaux","2-1",2,1,"1",1,3,1,"H"
"7263",1963-05-05,1962,"Stade Reims","Racing Club de France","3-2",3,2,"1",1,5,1,"H"
"7264",1963-05-05,1962,"RC Strasbourg","Nimes Olympique","2-1",2,1,"1",1,3,1,"H"
"7265",1963-05-05,1962,"Stade Francais FC","Olympique Lyon","1-0",1,0,"1",1,1,1,"H"
"7266",1963-05-05,1962,"Olympique Marseille","Stade Rennes","4-2",4,2,"1",1,6,2,"H"
"7267",1963-05-05,1962,"Stade Olympique Montpellierain","Toulouse FC","1-1",1,1,"1",1,2,0,"D"
"7268",1963-05-05,1962,"Angers SCO","OGC Nice","3-0",3,0,"1",1,3,3,"H"
"7269",1963-05-11,1962,"RC Strasbourg","US Valenciennes-Anzin","0-2",0,2,"1",1,2,-2,"D"
"7270",1963-05-11,1962,"Olympique Marseille","Angers SCO","1-0",1,0,"1",1,1,1,"H"
"7271",1963-05-11,1962,"UA Sedan-Torcy","Stade Rennes","3-3",3,3,"1",1,6,0,"D"
"7272",1963-05-15,1962,"Stade Reims","OGC Nice","4-2",4,2,"1",1,6,2,"H"
"7273",1963-05-15,1962,"AS Nancy","Olympique Lyon","3-2",3,2,"1",1,5,1,"H"
"7274",1963-05-18,1962,"OGC Nice","Olympique Lyon","3-5",3,5,"1",1,8,-2,"D"
"7275",1963-05-18,1962,"US Valenciennes-Anzin","Olympique Marseille","0-1",0,1,"1",1,1,-1,"D"
"7276",1963-05-19,1962,"AS Monaco","Angers SCO","5-1",5,1,"1",1,6,4,"H"
"7277",1963-05-19,1962,"RC Lens","Stade Reims","0-0",0,0,"1",1,0,0,"D"
"7278",1963-05-19,1962,"UA Sedan-Torcy","Girondins Bordeaux","1-1",1,1,"1",1,2,0,"D"
"7279",1963-05-19,1962,"Nimes Olympique","Grenoble Foot 38","1-0",1,0,"1",1,1,1,"H"
"7280",1963-05-19,1962,"Racing Club de France","Stade Olympique Montpellierain","9-1",9,1,"1",1,10,8,"H"
"7281",1963-05-19,1962,"AS Nancy","Toulouse FC","1-2",1,2,"1",1,3,-1,"D"
"7282",1963-05-19,1962,"Stade Rennes","FC Rouen","0-3",0,3,"1",1,3,-3,"D"
"7283",1963-05-19,1962,"RC Strasbourg","Stade Francais FC","1-1",1,1,"1",1,2,0,"D"
"7284",1963-05-25,1962,"Stade Reims","Nimes Olympique","4-1",4,1,"1",1,5,3,"H"
"7285",1963-05-25,1962,"Girondins Bordeaux","Racing Club de France","2-1",2,1,"1",1,3,1,"H"
"7286",1963-05-25,1962,"Toulouse FC","US Valenciennes-Anzin","5-1",5,1,"1",1,6,4,"H"
"7287",1963-05-25,1962,"Angers SCO","RC Strasbourg","2-2",2,2,"1",1,4,0,"D"
"7288",1963-05-26,1962,"Stade Francais FC","AS Monaco","2-2",2,2,"1",1,4,0,"D"
"7289",1963-05-26,1962,"Olympique Marseille","UA Sedan-Torcy","0-0",0,0,"1",1,0,0,"D"
"7290",1963-05-26,1962,"Olympique Lyon","FC Rouen","0-1",0,1,"1",1,1,-1,"D"
"7291",1963-05-26,1962,"OGC Nice","Stade Rennes","3-3",3,3,"1",1,6,0,"D"
"7292",1963-05-26,1962,"Grenoble Foot 38","RC Lens","1-0",1,0,"1",1,1,1,"H"
"7293",1963-05-26,1962,"Stade Olympique Montpellierain","AS Nancy","5-3",5,3,"1",1,8,2,"H"
"7294",1963-05-30,1962,"Olympique Lyon","RC Strasbourg","3-1",3,1,"1",1,4,2,"H"
"7295",1963-09-01,1963,"OGC Nice","Toulouse FC","2-4",2,4,"1",1,6,-2,"D"
"7296",1963-09-01,1963,"RC Strasbourg","Girondins Bordeaux","3-1",3,1,"1",1,4,2,"H"
"7297",1963-09-01,1963,"RC Lens","Olympique Lyon","1-2",1,2,"1",1,3,-1,"D"
"7298",1963-09-01,1963,"AS Monaco","FC Rouen","2-1",2,1,"1",1,3,1,"H"
"7299",1963-09-01,1963,"FC Nantes","UA Sedan-Torcy","2-2",2,2,"1",1,4,0,"D"
"7300",1963-09-01,1963,"Stade Francais FC","Angers SCO","2-2",2,2,"1",1,4,0,"D"
"7301",1963-09-01,1963,"Stade Rennes","Racing Club de France","2-2",2,2,"1",1,4,0,"D"
"7302",1963-09-01,1963,"AS Saint-Etienne","US Valenciennes-Anzin","1-1",1,1,"1",1,2,0,"D"
"7303",1963-09-01,1963,"Stade Reims","Nimes Olympique","0-0",0,0,"1",1,0,0,"D"
"7304",1963-09-07,1963,"Toulouse FC","AS Saint-Etienne","4-0",4,0,"1",1,4,4,"H"
"7305",1963-09-07,1963,"Nimes Olympique","Stade Francais FC","3-0",3,0,"1",1,3,3,"H"
"7306",1963-09-07,1963,"UA Sedan-Torcy","RC Strasbourg","2-1",2,1,"1",1,3,1,"H"
"7307",1963-09-07,1963,"AS Monaco","OGC Nice","0-0",0,0,"1",1,0,0,"D"
"7308",1963-09-07,1963,"Girondins Bordeaux","Stade Reims","4-2",4,2,"1",1,6,2,"H"
"7309",1963-09-07,1963,"Olympique Lyon","FC Rouen","0-1",0,1,"1",1,1,-1,"D"
"7310",1963-09-07,1963,"US Valenciennes-Anzin","Stade Rennes","0-0",0,0,"1",1,0,0,"D"
"7311",1963-09-08,1963,"Racing Club de France","FC Nantes","3-0",3,0,"1",1,3,3,"H"
"7312",1963-09-08,1963,"Angers SCO","RC Lens","1-2",1,2,"1",1,3,-1,"D"
"7313",1963-09-13,1963,"RC Strasbourg","Racing Club de France","2-1",2,1,"1",1,3,1,"H"
"7314",1963-09-13,1963,"OGC Nice","Olympique Lyon","1-2",1,2,"1",1,3,-1,"D"
"7315",1963-09-13,1963,"FC Rouen","Angers SCO","0-0",0,0,"1",1,0,0,"D"
"7316",1963-09-13,1963,"FC Nantes","US Valenciennes-Anzin","3-1",3,1,"1",1,4,2,"H"
"7317",1963-09-13,1963,"AS Saint-Etienne","AS Monaco","4-1",4,1,"1",1,5,3,"H"
"7318",1963-09-14,1963,"Stade Rennes","Toulouse FC","4-2",4,2,"1",1,6,2,"H"
"7319",1963-09-14,1963,"UA Sedan-Torcy","Girondins Bordeaux","2-4",2,4,"1",1,6,-2,"D"
"7320",1963-09-14,1963,"RC Lens","Nimes Olympique","4-2",4,2,"1",1,6,2,"H"
"7321",1963-09-14,1963,"Stade Francais FC","Stade Reims","0-2",0,2,"1",1,2,-2,"D"
"7322",1963-09-21,1963,"Toulouse FC","FC Nantes","1-0",1,0,"1",1,1,1,"H"
"7323",1963-09-21,1963,"Nimes Olympique","FC Rouen","0-2",0,2,"1",1,2,-2,"D"
"7324",1963-09-21,1963,"Stade Reims","RC Lens","1-0",1,0,"1",1,1,1,"H"
"7325",1963-09-21,1963,"Racing Club de France","UA Sedan-Torcy","2-2",2,2,"1",1,4,0,"D"
"7326",1963-09-21,1963,"US Valenciennes-Anzin","RC Strasbourg","1-0",1,0,"1",1,1,1,"H"
"7327",1963-09-22,1963,"Angers SCO","OGC Nice","0-3",0,3,"1",1,3,-3,"D"
"7328",1963-09-22,1963,"Girondins Bordeaux","Stade Francais FC","4-1",4,1,"1",1,5,3,"H"
"7329",1963-09-22,1963,"Olympique Lyon","AS Saint-Etienne","4-5",4,5,"1",1,9,-1,"D"
"7330",1963-09-22,1963,"AS Monaco","Stade Rennes","3-2",3,2,"1",1,5,1,"H"
"7331",1963-10-05,1963,"RC Strasbourg","Toulouse FC","1-1",1,1,"1",1,2,0,"D"
"7332",1963-10-06,1963,"FC Rouen","Stade Reims","3-4",3,4,"1",1,7,-1,"D"
"7333",1963-10-06,1963,"FC Nantes","AS Monaco","1-3",1,3,"1",1,4,-2,"D"
"7334",1963-10-06,1963,"Racing Club de France","Girondins Bordeaux","3-1",3,1,"1",1,4,2,"H"
"7335",1963-10-06,1963,"RC Lens","Stade Francais FC","3-0",3,0,"1",1,3,3,"H"
"7336",1963-10-06,1963,"Stade Rennes","Olympique Lyon","2-3",2,3,"1",1,5,-1,"D"
"7337",1963-10-06,1963,"UA Sedan-Torcy","US Valenciennes-Anzin","0-2",0,2,"1",1,2,-2,"D"
"7338",1963-10-06,1963,"AS Saint-Etienne","Angers SCO","2-2",2,2,"1",1,4,0,"D"
"7339",1963-10-06,1963,"OGC Nice","Nimes Olympique","3-2",3,2,"1",1,5,1,"H"
"7340",1963-10-12,1963,"Toulouse FC","UA Sedan-Torcy","2-0",2,0,"1",1,2,2,"H"
"7341",1963-10-12,1963,"FC Nantes","Olympique Lyon","3-1",3,1,"1",1,4,2,"H"
"7342",1963-10-13,1963,"AS Monaco","RC Strasbourg","4-2",4,2,"1",1,6,2,"H"
"7343",1963-10-13,1963,"US Valenciennes-Anzin","Racing Club de France","1-3",1,3,"1",1,4,-2,"D"
"7344",1963-10-13,1963,"Nimes Olympique","AS Saint-Etienne","0-2",0,2,"1",1,2,-2,"D"
"7345",1963-10-13,1963,"Girondins Bordeaux","RC Lens","1-1",1,1,"1",1,2,0,"D"
"7346",1963-10-13,1963,"Angers SCO","Stade Rennes","1-1",1,1,"1",1,2,0,"D"
"7347",1963-10-13,1963,"Stade Francais FC","FC Rouen","5-2",5,2,"1",1,7,3,"H"
"7348",1963-10-19,1963,"FC Rouen","RC Lens","3-0",3,0,"1",1,3,3,"H"
"7349",1963-10-19,1963,"FC Nantes","Angers SCO","1-0",1,0,"1",1,1,1,"H"
"7350",1963-10-20,1963,"Racing Club de France","Toulouse FC","1-1",1,1,"1",1,2,0,"D"
"7351",1963-10-20,1963,"AS Saint-Etienne","Stade Reims","1-1",1,1,"1",1,2,0,"D"
"7352",1963-10-20,1963,"UA Sedan-Torcy","AS Monaco","4-0",4,0,"1",1,4,4,"H"
"7353",1963-10-20,1963,"US Valenciennes-Anzin","Girondins Bordeaux","1-0",1,0,"1",1,1,1,"H"
"7354",1963-10-20,1963,"RC Strasbourg","Olympique Lyon","5-0",5,0,"1",1,5,5,"H"
"7355",1963-10-20,1963,"OGC Nice","Stade Francais FC","3-1",3,1,"1",1,4,2,"H"
"7356",1963-10-20,1963,"Stade Rennes","Nimes Olympique","3-1",3,1,"1",1,4,2,"H"
"7357",1963-10-31,1963,"Toulouse FC","US Valenciennes-Anzin","2-1",2,1,"1",1,3,1,"H"
"7358",1963-10-31,1963,"AS Monaco","Racing Club de France","5-3",5,3,"1",1,8,2,"H"
"7359",1963-10-31,1963,"RC Lens","OGC Nice","2-1",2,1,"1",1,3,1,"H"
"7360",1963-10-31,1963,"Stade Reims","Stade Rennes","3-3",3,3,"1",1,6,0,"D"
"7361",1963-10-31,1963,"Olympique Lyon","UA Sedan-Torcy","2-0",2,0,"1",1,2,2,"H"
"7362",1963-11-01,1963,"Stade Francais FC","AS Saint-Etienne","1-3",1,3,"1",1,4,-2,"D"
"7363",1963-11-01,1963,"Girondins Bordeaux","FC Rouen","2-0",2,0,"1",1,2,2,"H"
"7364",1963-11-01,1963,"Angers SCO","RC Strasbourg","1-1",1,1,"1",1,2,0,"D"
"7365",1963-11-01,1963,"Nimes Olympique","FC Nantes","3-0",3,0,"1",1,3,3,"H"
"7366",1963-11-03,1963,"AS Saint-Etienne","RC Lens","1-0",1,0,"1",1,1,1,"H"
"7367",1963-11-03,1963,"Toulouse FC","Girondins Bordeaux","0-1",0,1,"1",1,1,-1,"D"
"7368",1963-11-03,1963,"US Valenciennes-Anzin","AS Monaco","0-0",0,0,"1",1,0,0,"D"
"7369",1963-11-03,1963,"RC Strasbourg","Nimes Olympique","3-0",3,0,"1",1,3,3,"H"
"7370",1963-11-03,1963,"Stade Rennes","Stade Francais FC","4-3",4,3,"1",1,7,1,"H"
"7371",1963-11-03,1963,"FC Nantes","Stade Reims","0-0",0,0,"1",1,0,0,"D"
"7372",1963-11-03,1963,"Racing Club de France","Olympique Lyon","1-3",1,3,"1",1,4,-2,"D"
"7373",1963-11-03,1963,"OGC Nice","FC Rouen","2-0",2,0,"1",1,2,2,"H"
"7374",1963-11-03,1963,"UA Sedan-Torcy","Angers SCO","2-1",2,1,"1",1,3,1,"H"
"7375",1963-11-10,1963,"Girondins Bordeaux","OGC Nice","6-2",6,2,"1",1,8,4,"H"
"7376",1963-11-10,1963,"Stade Reims","RC Strasbourg","0-0",0,0,"1",1,0,0,"D"
"7377",1963-11-10,1963,"Angers SCO","Racing Club de France","2-1",2,1,"1",1,3,1,"H"
"7378",1963-11-13,1963,"RC Lens","Stade Rennes","5-0",5,0,"1",1,5,5,"H"
"7379",1963-11-13,1963,"Olympique Lyon","US Valenciennes-Anzin","1-1",1,1,"1",1,2,0,"D"
"7380",1963-11-13,1963,"Nimes Olympique","UA Sedan-Torcy","4-2",4,2,"1",1,6,2,"H"
"7381",1963-11-13,1963,"Stade Francais FC","FC Nantes","4-0",4,0,"1",1,4,4,"H"
"7382",1963-11-14,1963,"AS Monaco","Toulouse FC","5-0",5,0,"1",1,5,5,"H"
"7383",1963-11-17,1963,"AS Saint-Etienne","OGC Nice","2-2",2,2,"1",1,4,0,"D"
"7384",1963-11-17,1963,"Toulouse FC","Olympique Lyon","1-0",1,0,"1",1,1,1,"H"
"7385",1963-11-17,1963,"RC Strasbourg","Stade Francais FC","1-1",1,1,"1",1,2,0,"D"
"7386",1963-11-17,1963,"Stade Rennes","FC Rouen","2-1",2,1,"1",1,3,1,"H"
"7387",1963-11-17,1963,"Racing Club de France","Nimes Olympique","5-0",5,0,"1",1,5,5,"H"
"7388",1963-11-17,1963,"FC Nantes","RC Lens","2-1",2,1,"1",1,3,1,"H"
"7389",1963-11-17,1963,"UA Sedan-Torcy","Stade Reims","2-0",2,0,"1",1,2,2,"H"
"7390",1963-11-17,1963,"US Valenciennes-Anzin","Angers SCO","1-3",1,3,"1",1,4,-2,"D"
"7391",1963-11-19,1963,"AS Monaco","Girondins Bordeaux","2-0",2,0,"1",1,2,2,"H"
"7392",1963-11-24,1963,"Girondins Bordeaux","AS Saint-Etienne","2-3",2,3,"1",1,5,-1,"D"
"7393",1963-11-24,1963,"Olympique Lyon","AS Monaco","5-1",5,1,"1",1,6,4,"H"
"7394",1963-11-24,1963,"Angers SCO","Toulouse FC","4-3",4,3,"1",1,7,1,"H"
"7395",1963-11-24,1963,"OGC Nice","Stade Rennes","0-2",0,2,"1",1,2,-2,"D"
"7396",1963-11-24,1963,"Stade Reims","Racing Club de France","1-4",1,4,"1",1,5,-3,"D"
"7397",1963-11-24,1963,"RC Lens","RC Strasbourg","2-1",2,1,"1",1,3,1,"H"
"7398",1963-11-24,1963,"Stade Francais FC","UA Sedan-Torcy","3-2",3,2,"1",1,5,1,"H"
"7399",1963-11-24,1963,"Nimes Olympique","US Valenciennes-Anzin","2-0",2,0,"1",1,2,2,"H"
"7400",1963-11-24,1963,"FC Rouen","FC Nantes","5-2",5,2,"1",1,7,3,"H"
"7401",1963-11-27,1963,"Stade Reims","OGC Nice","2-0",2,0,"1",1,2,2,"H"
"7402",1963-12-01,1963,"Stade Rennes","AS Saint-Etienne","1-1",1,1,"1",1,2,0,"D"
"7403",1963-12-01,1963,"AS Monaco","Angers SCO","0-1",0,1,"1",1,1,-1,"D"
"7404",1963-12-01,1963,"Racing Club de France","Stade Francais FC","3-2",3,2,"1",1,5,1,"H"
"7405",1963-12-01,1963,"UA Sedan-Torcy","RC Lens","2-3",2,3,"1",1,5,-1,"D"
"7406",1963-12-01,1963,"Olympique Lyon","Girondins Bordeaux","3-1",3,1,"1",1,4,2,"H"
"7407",1963-12-01,1963,"Toulouse FC","Nimes Olympique","1-1",1,1,"1",1,2,0,"D"
"7408",1963-12-01,1963,"RC Strasbourg","FC Rouen","1-0",1,0,"1",1,1,1,"H"
"7409",1963-12-01,1963,"US Valenciennes-Anzin","Stade Reims","2-1",2,1,"1",1,3,1,"H"
"7410",1963-12-01,1963,"FC Nantes","OGC Nice","3-0",3,0,"1",1,3,3,"H"
"7411",1963-12-07,1963,"Girondins Bordeaux","Stade Rennes","3-1",3,1,"1",1,4,2,"H"
"7412",1963-12-08,1963,"AS Saint-Etienne","FC Nantes","6-1",6,1,"1",1,7,5,"H"
"7413",1963-12-08,1963,"RC Lens","Racing Club de France","10-2",10,2,"1",1,12,8,"H"
"7414",1963-12-08,1963,"Stade Reims","Toulouse FC","1-3",1,3,"1",1,4,-2,"D"
"7415",1963-12-08,1963,"Angers SCO","Olympique Lyon","1-1",1,1,"1",1,2,0,"D"
"7416",1963-12-08,1963,"Nimes Olympique","AS Monaco","1-0",1,0,"1",1,1,1,"H"
"7417",1963-12-08,1963,"OGC Nice","RC Strasbourg","1-1",1,1,"1",1,2,0,"D"
"7418",1963-12-08,1963,"Stade Francais FC","US Valenciennes-Anzin","0-2",0,2,"1",1,2,-2,"D"
"7419",1963-12-08,1963,"FC Rouen","UA Sedan-Torcy","2-2",2,2,"1",1,4,0,"D"
"7420",1963-12-14,1963,"Toulouse FC","Stade Francais FC","0-2",0,2,"1",1,2,-2,"D"
"7421",1963-12-15,1963,"RC Strasbourg","AS Saint-Etienne","2-0",2,0,"1",1,2,2,"H"
"7422",1963-12-15,1963,"US Valenciennes-Anzin","RC Lens","0-0",0,0,"1",1,0,0,"D"
"7423",1963-12-15,1963,"Olympique Lyon","Nimes Olympique","2-1",2,1,"1",1,3,1,"H"
"7424",1963-12-15,1963,"AS Monaco","Stade Reims","1-0",1,0,"1",1,1,1,"H"
"7425",1963-12-15,1963,"Angers SCO","Girondins Bordeaux","1-1",1,1,"1",1,2,0,"D"
"7426",1963-12-15,1963,"Racing Club de France","FC Rouen","2-2",2,2,"1",1,4,0,"D"
"7427",1963-12-15,1963,"FC Nantes","Stade Rennes","2-1",2,1,"1",1,3,1,"H"
"7428",1963-12-15,1963,"UA Sedan-Torcy","OGC Nice","8-1",8,1,"1",1,9,7,"H"
"7429",1963-12-22,1963,"RC Lens","Toulouse FC","2-1",2,1,"1",1,3,1,"H"
"7430",1963-12-22,1963,"Stade Rennes","RC Strasbourg","0-0",0,0,"1",1,0,0,"D"
"7431",1963-12-22,1963,"Girondins Bordeaux","FC Nantes","2-0",2,0,"1",1,2,2,"H"
"7432",1963-12-22,1963,"Stade Francais FC","AS Monaco","1-0",1,0,"1",1,1,1,"H"
"7433",1963-12-22,1963,"OGC Nice","Racing Club de France","1-1",1,1,"1",1,2,0,"D"
"7434",1963-12-22,1963,"FC Rouen","US Valenciennes-Anzin","0-4",0,4,"1",1,4,-4,"D"
"7435",1963-12-22,1963,"Nimes Olympique","Angers SCO","2-0",2,0,"1",1,2,2,"H"
"7436",1963-12-29,1963,"Racing Club de France","AS Saint-Etienne","1-3",1,3,"1",1,4,-2,"D"
"7437",1963-12-29,1963,"AS Monaco","RC Lens","5-0",5,0,"1",1,5,5,"H"
"7438",1963-12-29,1963,"Olympique Lyon","Stade Francais FC","2-0",2,0,"1",1,2,2,"H"
"7439",1963-12-29,1963,"RC Strasbourg","FC Nantes","0-0",0,0,"1",1,0,0,"D"
"7440",1963-12-29,1963,"Nimes Olympique","Girondins Bordeaux","0-0",0,0,"1",1,0,0,"D"
"7441",1963-12-29,1963,"US Valenciennes-Anzin","OGC Nice","7-2",7,2,"1",1,9,5,"H"
"7442",1963-12-29,1963,"Toulouse FC","FC Rouen","2-2",2,2,"1",1,4,0,"D"
"7443",1963-12-29,1963,"Angers SCO","Stade Reims","3-1",3,1,"1",1,4,2,"H"
"7444",1963-12-29,1963,"UA Sedan-Torcy","Stade Rennes","5-0",5,0,"1",1,5,5,"H"
"7445",1964-01-05,1963,"AS Saint-Etienne","Racing Club de France","2-1",2,1,"1",1,3,1,"H"
"7446",1964-01-05,1963,"Stade Francais FC","Olympique Lyon","1-2",1,2,"1",1,3,-1,"D"
"7447",1964-01-05,1963,"RC Lens","AS Monaco","0-0",0,0,"1",1,0,0,"D"
"7448",1964-01-05,1963,"OGC Nice","US Valenciennes-Anzin","1-3",1,3,"1",1,4,-2,"D"
"7449",1964-01-05,1963,"Girondins Bordeaux","Nimes Olympique","2-2",2,2,"1",1,4,0,"D"
"7450",1964-01-05,1963,"FC Nantes","RC Strasbourg","2-1",2,1,"1",1,3,1,"H"
"7451",1964-01-05,1963,"FC Rouen","Toulouse FC","2-1",2,1,"1",1,3,1,"H"
"7452",1964-01-05,1963,"Stade Reims","Angers SCO","1-1",1,1,"1",1,2,0,"D"
"7453",1964-01-05,1963,"Stade Rennes","UA Sedan-Torcy","1-0",1,0,"1",1,1,1,"H"
"7454",1964-01-19,1963,"US Valenciennes-Anzin","AS Saint-Etienne","1-2",1,2,"1",1,3,-1,"D"
"7455",1964-01-19,1963,"Girondins Bordeaux","RC Strasbourg","2-0",2,0,"1",1,2,2,"H"
"7456",1964-01-19,1963,"Olympique Lyon","RC Lens","1-1",1,1,"1",1,2,0,"D"
"7457",1964-01-19,1963,"FC Rouen","AS Monaco","4-0",4,0,"1",1,4,4,"H"
"7458",1964-01-19,1963,"Toulouse FC","OGC Nice","2-1",2,1,"1",1,3,1,"H"
"7459",1964-01-19,1963,"Racing Club de France","Stade Rennes","0-2",0,2,"1",1,2,-2,"D"
"7460",1964-01-19,1963,"Nimes Olympique","Stade Reims","4-0",4,0,"1",1,4,4,"H"
"7461",1964-01-19,1963,"Angers SCO","Stade Francais FC","1-3",1,3,"1",1,4,-2,"D"
"7462",1964-01-19,1963,"UA Sedan-Torcy","FC Nantes","2-0",2,0,"1",1,2,2,"H"
"7463",1964-01-26,1963,"AS Saint-Etienne","Toulouse FC","7-1",7,1,"1",1,8,6,"H"
"7464",1964-01-26,1963,"RC Lens","Angers SCO","4-0",4,0,"1",1,4,4,"H"
"7465",1964-01-26,1963,"FC Rouen","Olympique Lyon","2-2",2,2,"1",1,4,0,"D"
"7466",1964-01-26,1963,"OGC Nice","AS Monaco","0-2",0,2,"1",1,2,-2,"D"
"7467",1964-01-26,1963,"Stade Reims","Girondins Bordeaux","1-0",1,0,"1",1,1,1,"H"
"7468",1964-01-26,1963,"Stade Rennes","US Valenciennes-Anzin","2-1",2,1,"1",1,3,1,"H"
"7469",1964-01-26,1963,"Stade Francais FC","Nimes Olympique","0-0",0,0,"1",1,0,0,"D"
"7470",1964-01-26,1963,"FC Nantes","Racing Club de France","1-0",1,0,"1",1,1,1,"H"
"7471",1964-02-02,1963,"AS Monaco","AS Saint-Etienne","2-1",2,1,"1",1,3,1,"H"
"7472",1964-02-02,1963,"Nimes Olympique","RC Lens","1-1",1,1,"1",1,2,0,"D"
"7473",1964-02-02,1963,"Olympique Lyon","OGC Nice","0-0",0,0,"1",1,0,0,"D"
"7474",1964-02-02,1963,"Girondins Bordeaux","UA Sedan-Torcy","3-2",3,2,"1",1,5,1,"H"
"7475",1964-02-02,1963,"Toulouse FC","Stade Rennes","1-1",1,1,"1",1,2,0,"D"
"7476",1964-02-02,1963,"US Valenciennes-Anzin","FC Nantes","0-0",0,0,"1",1,0,0,"D"
"7477",1964-02-02,1963,"Angers SCO","FC Rouen","3-0",3,0,"1",1,3,3,"H"
"7478",1964-02-02,1963,"Racing Club de France","RC Strasbourg","3-0",3,0,"1",1,3,3,"H"
"7479",1964-02-02,1963,"Stade Reims","Stade Francais FC","0-3",0,3,"1",1,3,-3,"D"
"7480",1964-02-16,1963,"AS Saint-Etienne","Olympique Lyon","2-1",2,1,"1",1,3,1,"H"
"7481",1964-02-16,1963,"RC Lens","Stade Reims","2-1",2,1,"1",1,3,1,"H"
"7482",1964-02-16,1963,"Stade Rennes","AS Monaco","2-1",2,1,"1",1,3,1,"H"
"7483",1964-02-16,1963,"Stade Francais FC","Girondins Bordeaux","2-0",2,0,"1",1,2,2,"H"
"7484",1964-02-16,1963,"RC Strasbourg","US Valenciennes-Anzin","1-0",1,0,"1",1,1,1,"H"
"7485",1964-02-16,1963,"FC Nantes","Toulouse FC","2-2",2,2,"1",1,4,0,"D"
"7486",1964-02-16,1963,"FC Rouen","Nimes Olympique","1-0",1,0,"1",1,1,1,"H"
"7487",1964-02-16,1963,"OGC Nice","Angers SCO","3-1",3,1,"1",1,4,2,"H"
"7488",1964-02-16,1963,"UA Sedan-Torcy","Racing Club de France","1-0",1,0,"1",1,1,1,"H"
"7489",1964-02-23,1963,"Angers SCO","AS Saint-Etienne","3-1",3,1,"1",1,4,2,"H"
"7490",1964-02-23,1963,"Stade Francais FC","RC Lens","1-0",1,0,"1",1,1,1,"H"
"7491",1964-02-23,1963,"Olympique Lyon","Stade Rennes","4-1",4,1,"1",1,5,3,"H"
"7492",1964-02-23,1963,"AS Monaco","FC Nantes","3-1",3,1,"1",1,4,2,"H"
"7493",1964-02-23,1963,"Girondins Bordeaux","Racing Club de France","2-2",2,2,"1",1,4,0,"D"
"7494",1964-02-23,1963,"US Valenciennes-Anzin","UA Sedan-Torcy","2-0",2,0,"1",1,2,2,"H"
"7495",1964-02-23,1963,"Toulouse FC","RC Strasbourg","3-2",3,2,"1",1,5,1,"H"
"7496",1964-02-23,1963,"Nimes Olympique","OGC Nice","0-0",0,0,"1",1,0,0,"D"
"7497",1964-02-23,1963,"Stade Reims","FC Rouen","0-0",0,0,"1",1,0,0,"D"
"7498",1964-02-26,1963,"FC Rouen","AS Saint-Etienne","0-0",0,0,"1",1,0,0,"D"
"7499",1964-03-08,1963,"AS Saint-Etienne","Nimes Olympique","3-0",3,0,"1",1,3,3,"H"
"7500",1964-03-08,1963,"RC Lens","Girondins Bordeaux","8-1",8,1,"1",1,9,7,"H"
"7501",1964-03-08,1963,"Olympique Lyon","FC Nantes","1-1",1,1,"1",1,2,0,"D"
"7502",1964-03-08,1963,"RC Strasbourg","AS Monaco","1-1",1,1,"1",1,2,0,"D"
"7503",1964-03-08,1963,"Racing Club de France","US Valenciennes-Anzin","1-3",1,3,"1",1,4,-2,"D"
"7504",1964-03-08,1963,"UA Sedan-Torcy","Toulouse FC","1-1",1,1,"1",1,2,0,"D"
"7505",1964-03-08,1963,"Stade Rennes","Angers SCO","2-4",2,4,"1",1,6,-2,"D"
"7506",1964-03-08,1963,"FC Rouen","Stade Francais FC","2-0",2,0,"1",1,2,2,"H"
"7507",1964-03-13,1963,"Olympique Lyon","RC Strasbourg","1-1",1,1,"1",1,2,0,"D"
"7508",1964-03-14,1963,"Girondins Bordeaux","US Valenciennes-Anzin","0-3",0,3,"1",1,3,-3,"D"
"7509",1964-03-14,1963,"Stade Reims","AS Saint-Etienne","3-1",3,1,"1",1,4,2,"H"
"7510",1964-03-15,1963,"AS Monaco","UA Sedan-Torcy","3-1",3,1,"1",1,4,2,"H"
"7511",1964-03-15,1963,"RC Lens","FC Rouen","0-2",0,2,"1",1,2,-2,"D"
"7512",1964-03-15,1963,"Toulouse FC","Racing Club de France","2-2",2,2,"1",1,4,0,"D"
"7513",1964-03-15,1963,"Angers SCO","FC Nantes","3-3",3,3,"1",1,6,0,"D"
"7514",1964-03-15,1963,"Nimes Olympique","Stade Rennes","3-1",3,1,"1",1,4,2,"H"
"7515",1964-03-15,1963,"Stade Francais FC","OGC Nice","2-2",2,2,"1",1,4,0,"D"
"7516",1964-03-18,1963,"AS Saint-Etienne","UA Sedan-Torcy","2-1",2,1,"1",1,3,1,"H"
"7517",1964-03-25,1963,"Stade Reims","Olympique Lyon","2-2",2,2,"1",1,4,0,"D"
"7518",1964-03-26,1963,"Racing Club de France","AS Monaco","1-5",1,5,"1",1,6,-4,"D"
"7519",1964-03-27,1963,"US Valenciennes-Anzin","Toulouse FC","2-3",2,3,"1",1,5,-1,"D"
"7520",1964-03-27,1963,"RC Strasbourg","Angers SCO","2-1",2,1,"1",1,3,1,"H"
"7521",1964-03-28,1963,"AS Saint-Etienne","Stade Francais FC","0-1",0,1,"1",1,1,-1,"D"
"7522",1964-03-28,1963,"Stade Rennes","Stade Reims","2-0",2,0,"1",1,2,2,"H"
"7523",1964-03-28,1963,"FC Nantes","Nimes Olympique","2-1",2,1,"1",1,3,1,"H"
"7524",1964-03-29,1963,"UA Sedan-Torcy","Olympique Lyon","2-0",2,0,"1",1,2,2,"H"
"7525",1964-03-29,1963,"OGC Nice","RC Lens","3-2",3,2,"1",1,5,1,"H"
"7526",1964-03-29,1963,"FC Rouen","Girondins Bordeaux","0-0",0,0,"1",1,0,0,"D"
"7527",1964-04-01,1963,"OGC Nice","AS Saint-Etienne","1-1",1,1,"1",1,2,0,"D"
"7528",1964-04-01,1963,"Girondins Bordeaux","AS Monaco","0-0",0,0,"1",1,0,0,"D"
"7529",1964-04-01,1963,"RC Lens","FC Nantes","2-0",2,0,"1",1,2,2,"H"
"7530",1964-04-01,1963,"Olympique Lyon","Toulouse FC","1-2",1,2,"1",1,3,-1,"D"
"7531",1964-04-01,1963,"Angers SCO","US Valenciennes-Anzin","3-2",3,2,"1",1,5,1,"H"
"7532",1964-04-01,1963,"FC Rouen","Stade Rennes","3-1",3,1,"1",1,4,2,"H"
"7533",1964-04-01,1963,"Stade Francais FC","RC Strasbourg","1-0",1,0,"1",1,1,1,"H"
"7534",1964-04-01,1963,"Stade Reims","UA Sedan-Torcy","1-0",1,0,"1",1,1,1,"H"
"7535",1964-04-04,1963,"Girondins Bordeaux","Toulouse FC","2-1",2,1,"1",1,3,1,"H"
"7536",1964-04-04,1963,"Stade Reims","FC Nantes","1-1",1,1,"1",1,2,0,"D"
"7537",1964-04-05,1963,"RC Lens","AS Saint-Etienne","4-2",4,2,"1",1,6,2,"H"
"7538",1964-04-05,1963,"AS Monaco","US Valenciennes-Anzin","3-0",3,0,"1",1,3,3,"H"
"7539",1964-04-05,1963,"FC Rouen","OGC Nice","3-0",3,0,"1",1,3,3,"H"
"7540",1964-04-05,1963,"Angers SCO","UA Sedan-Torcy","1-0",1,0,"1",1,1,1,"H"
"7541",1964-04-05,1963,"Stade Francais FC","Stade Rennes","4-2",4,2,"1",1,6,2,"H"
"7542",1964-04-05,1963,"Nimes Olympique","RC Strasbourg","1-1",1,1,"1",1,2,0,"D"
"7543",1964-04-11,1963,"UA Sedan-Torcy","Nimes Olympique","3-1",3,1,"1",1,4,2,"H"
"7544",1964-04-11,1963,"FC Nantes","Stade Francais FC","3-1",3,1,"1",1,4,2,"H"
"7545",1964-04-12,1963,"AS Saint-Etienne","FC Rouen","1-0",1,0,"1",1,1,1,"H"
"7546",1964-04-12,1963,"Toulouse FC","AS Monaco","1-1",1,1,"1",1,2,0,"D"
"7547",1964-04-12,1963,"Stade Rennes","RC Lens","0-0",0,0,"1",1,0,0,"D"
"7548",1964-04-12,1963,"US Valenciennes-Anzin","Olympique Lyon","0-1",0,1,"1",1,1,-1,"D"
"7549",1964-04-12,1963,"Racing Club de France","Angers SCO","3-4",3,4,"1",1,7,-1,"D"
"7550",1964-04-12,1963,"OGC Nice","Girondins Bordeaux","2-0",2,0,"1",1,2,2,"H"
"7551",1964-04-12,1963,"RC Strasbourg","Stade Reims","1-2",1,2,"1",1,3,-1,"D"
"7552",1964-04-15,1963,"RC Strasbourg","UA Sedan-Torcy","2-0",2,0,"1",1,2,2,"H"
"7553",1964-04-18,1963,"Nimes Olympique","Racing Club de France","3-1",3,1,"1",1,4,2,"H"
"7554",1964-04-19,1963,"OGC Nice","Stade Reims","1-1",1,1,"1",1,2,0,"D"
"7555",1964-04-29,1963,"AS Saint-Etienne","Girondins Bordeaux","4-0",4,0,"1",1,4,4,"H"
"7556",1964-04-29,1963,"AS Monaco","Olympique Lyon","0-1",0,1,"1",1,1,-1,"D"
"7557",1964-04-29,1963,"FC Nantes","FC Rouen","7-1",7,1,"1",1,8,6,"H"
"7558",1964-04-29,1963,"Racing Club de France","Stade Reims","2-1",2,1,"1",1,3,1,"H"
"7559",1964-04-30,1963,"RC Strasbourg","RC Lens","1-2",1,2,"1",1,3,-1,"D"
"7560",1964-04-30,1963,"Toulouse FC","Angers SCO","4-0",4,0,"1",1,4,4,"H"
"7561",1964-04-30,1963,"US Valenciennes-Anzin","Nimes Olympique","1-0",1,0,"1",1,1,1,"H"
"7562",1964-04-30,1963,"UA Sedan-Torcy","Stade Francais FC","2-0",2,0,"1",1,2,2,"H"
"7563",1964-05-01,1963,"Stade Rennes","OGC Nice","3-1",3,1,"1",1,4,2,"H"
"7564",1964-05-03,1963,"AS Saint-Etienne","Stade Rennes","3-0",3,0,"1",1,3,3,"H"
"7565",1964-05-03,1963,"RC Lens","UA Sedan-Torcy","3-1",3,1,"1",1,4,2,"H"
"7566",1964-05-03,1963,"Angers SCO","AS Monaco","4-4",4,4,"1",1,8,0,"D"
"7567",1964-05-03,1963,"Nimes Olympique","Toulouse FC","1-0",1,0,"1",1,1,1,"H"
"7568",1964-05-03,1963,"Stade Reims","US Valenciennes-Anzin","1-4",1,4,"1",1,5,-3,"D"
"7569",1964-05-03,1963,"FC Rouen","RC Strasbourg","3-0",3,0,"1",1,3,3,"H"
"7570",1964-05-03,1963,"OGC Nice","FC Nantes","1-2",1,2,"1",1,3,-1,"D"
"7571",1964-05-03,1963,"Stade Francais FC","Racing Club de France","2-3",2,3,"1",1,5,-1,"D"
"7572",1964-05-13,1963,"Olympique Lyon","Racing Club de France","5-1",5,1,"1",1,6,4,"H"
"7573",1964-05-17,1963,"FC Nantes","AS Saint-Etienne","1-3",1,3,"1",1,4,-2,"D"
"7574",1964-05-17,1963,"AS Monaco","Nimes Olympique","2-0",2,0,"1",1,2,2,"H"
"7575",1964-05-17,1963,"Racing Club de France","RC Lens","3-2",3,2,"1",1,5,1,"H"
"7576",1964-05-17,1963,"Olympique Lyon","Angers SCO","2-2",2,2,"1",1,4,0,"D"
"7577",1964-05-17,1963,"Toulouse FC","Stade Reims","0-0",0,0,"1",1,0,0,"D"
"7578",1964-05-17,1963,"US Valenciennes-Anzin","Stade Francais FC","0-0",0,0,"1",1,0,0,"D"
"7579",1964-05-17,1963,"UA Sedan-Torcy","FC Rouen","2-1",2,1,"1",1,3,1,"H"
"7580",1964-05-17,1963,"Stade Rennes","Girondins Bordeaux","2-2",2,2,"1",1,4,0,"D"
"7581",1964-05-17,1963,"RC Strasbourg","OGC Nice","2-1",2,1,"1",1,3,1,"H"
"7582",1964-05-26,1963,"Girondins Bordeaux","Olympique Lyon","4-0",4,0,"1",1,4,4,"H"
"7583",1964-05-30,1963,"US Valenciennes-Anzin","FC Rouen","2-1",2,1,"1",1,3,1,"H"
"7584",1964-05-31,1963,"UA Sedan-Torcy","AS Saint-Etienne","3-0",3,0,"1",1,3,3,"H"
"7585",1964-05-31,1963,"AS Monaco","Stade Francais FC","0-1",0,1,"1",1,1,-1,"D"
"7586",1964-05-31,1963,"Olympique Lyon","Stade Reims","3-1",3,1,"1",1,4,2,"H"
"7587",1964-05-31,1963,"Toulouse FC","RC Lens","4-2",4,2,"1",1,6,2,"H"
"7588",1964-05-31,1963,"FC Nantes","Girondins Bordeaux","4-1",4,1,"1",1,5,3,"H"
"7589",1964-05-31,1963,"Angers SCO","Nimes Olympique","0-1",0,1,"1",1,1,-1,"D"
"7590",1964-05-31,1963,"RC Strasbourg","Stade Rennes","2-1",2,1,"1",1,3,1,"H"
"7591",1964-05-31,1963,"Racing Club de France","OGC Nice","3-2",3,2,"1",1,5,1,"H"
"7592",1964-06-06,1963,"Stade Reims","AS Monaco","2-3",2,3,"1",1,5,-1,"D"
"7593",1964-06-07,1963,"AS Saint-Etienne","RC Strasbourg","2-2",2,2,"1",1,4,0,"D"
"7594",1964-06-07,1963,"RC Lens","US Valenciennes-Anzin","2-0",2,0,"1",1,2,2,"H"
"7595",1964-06-07,1963,"Nimes Olympique","Olympique Lyon","5-0",5,0,"1",1,5,5,"H"
"7596",1964-06-07,1963,"Stade Francais FC","Toulouse FC","0-0",0,0,"1",1,0,0,"D"
"7597",1964-06-07,1963,"Girondins Bordeaux","Angers SCO","3-0",3,0,"1",1,3,3,"H"
"7598",1964-06-07,1963,"Stade Rennes","FC Nantes","3-1",3,1,"1",1,4,2,"H"
"7599",1964-06-07,1963,"OGC Nice","UA Sedan-Torcy","2-4",2,4,"1",1,6,-2,"D"
"7600",1964-06-07,1963,"FC Rouen","Racing Club de France","1-2",1,2,"1",1,3,-1,"D"
"7601",1964-08-29,1964,"AS Monaco","FC Nantes","4-1",4,1,"1",1,5,3,"H"
"7602",1964-08-29,1964,"FC Sochaux","Stade Francais FC","4-1",4,1,"1",1,5,3,"H"
"7603",1964-08-29,1964,"UA Sedan-Torcy","Nimes Olympique","4-2",4,2,"1",1,6,2,"H"
"7604",1964-08-29,1964,"RC Lens","Olympique Lyon","1-2",1,2,"1",1,3,-1,"D"
"7605",1964-08-29,1964,"AS Saint-Etienne","Girondins Bordeaux","0-1",0,1,"1",1,1,-1,"D"
"7606",1964-08-30,1964,"US Valenciennes-Anzin","FC Rouen","3-0",3,0,"1",1,3,3,"H"
"7607",1964-08-30,1964,"Angers SCO","Toulouse FC","2-4",2,4,"1",1,6,-2,"D"
"7608",1964-08-30,1964,"Sporting Toulon Var","Lille OSC","3-1",3,1,"1",1,4,2,"H"
"7609",1964-08-30,1964,"Stade Rennes","RC Strasbourg","1-2",1,2,"1",1,3,-1,"D"
"7610",1964-09-04,1964,"Olympique Lyon","Angers SCO","5-2",5,2,"1",1,7,3,"H"
"7611",1964-09-05,1964,"FC Rouen","FC Sochaux","0-4",0,4,"1",1,4,-4,"D"
"7612",1964-09-05,1964,"Girondins Bordeaux","UA Sedan-Torcy","5-1",5,1,"1",1,6,4,"H"
"7613",1964-09-05,1964,"RC Strasbourg","US Valenciennes-Anzin","3-3",3,3,"1",1,6,0,"D"
"7614",1964-09-05,1964,"Toulouse FC","RC Lens","2-2",2,2,"1",1,4,0,"D"
"7615",1964-09-05,1964,"FC Nantes","AS Saint-Etienne","4-1",4,1,"1",1,5,3,"H"
"7616",1964-09-05,1964,"Nimes Olympique","Stade Rennes","2-3",2,3,"1",1,5,-1,"D"
"7617",1964-09-06,1964,"Stade Francais FC","Sporting Toulon Var","3-2",3,2,"1",1,5,1,"H"
"7618",1964-09-06,1964,"Lille OSC","AS Monaco","3-0",3,0,"1",1,3,3,"H"
"7619",1964-09-12,1964,"FC Sochaux","Girondins Bordeaux","4-1",4,1,"1",1,5,3,"H"
"7620",1964-09-12,1964,"FC Nantes","FC Rouen","3-0",3,0,"1",1,3,3,"H"
"7621",1964-09-12,1964,"UA Sedan-Torcy","RC Strasbourg","5-2",5,2,"1",1,7,3,"H"
"7622",1964-09-12,1964,"AS Monaco","Stade Francais FC","1-0",1,0,"1",1,1,1,"H"
"7623",1964-09-12,1964,"AS Saint-Etienne","Lille OSC","3-3",3,3,"1",1,6,0,"D"
"7624",1964-09-12,1964,"RC Lens","Angers SCO","1-0",1,0,"1",1,1,1,"H"
"7625",1964-09-13,1964,"Sporting Toulon Var","Olympique Lyon","1-1",1,1,"1",1,2,0,"D"
"7626",1964-09-13,1964,"US Valenciennes-Anzin","Nimes Olympique","1-0",1,0,"1",1,1,1,"H"
"7627",1964-09-13,1964,"Stade Rennes","Toulouse FC","1-1",1,1,"1",1,2,0,"D"
"7628",1964-09-19,1964,"RC Strasbourg","FC Sochaux","0-0",0,0,"1",1,0,0,"D"
"7629",1964-09-19,1964,"Girondins Bordeaux","AS Monaco","2-0",2,0,"1",1,2,2,"H"
"7630",1964-09-19,1964,"Toulouse FC","US Valenciennes-Anzin","1-0",1,0,"1",1,1,1,"H"
"7631",1964-09-19,1964,"Nimes Olympique","RC Lens","2-2",2,2,"1",1,4,0,"D"
"7632",1964-09-19,1964,"FC Rouen","Sporting Toulon Var","1-0",1,0,"1",1,1,1,"H"
"7633",1964-09-20,1964,"Olympique Lyon","UA Sedan-Torcy","2-0",2,0,"1",1,2,2,"H"
"7634",1964-09-20,1964,"Lille OSC","FC Nantes","2-2",2,2,"1",1,4,0,"D"
"7635",1964-09-20,1964,"Angers SCO","Stade Rennes","1-2",1,2,"1",1,3,-1,"D"
"7636",1964-09-20,1964,"Stade Francais FC","AS Saint-Etienne","2-3",2,3,"1",1,5,-1,"D"
"7637",1964-09-26,1964,"FC Sochaux","Olympique Lyon","2-1",2,1,"1",1,3,1,"H"
"7638",1964-09-26,1964,"FC Nantes","Stade Francais FC","4-2",4,2,"1",1,6,2,"H"
"7639",1964-09-26,1964,"UA Sedan-Torcy","Toulouse FC","6-0",6,0,"1",1,6,6,"H"
"7640",1964-09-26,1964,"FC Rouen","AS Monaco","1-1",1,1,"1",1,2,0,"D"
"7641",1964-09-26,1964,"AS Saint-Etienne","Nimes Olympique","1-2",1,2,"1",1,3,-1,"D"
"7642",1964-09-27,1964,"US Valenciennes-Anzin","Angers SCO","0-0",0,0,"1",1,0,0,"D"
"7643",1964-09-27,1964,"Sporting Toulon Var","Girondins Bordeaux","2-0",2,0,"1",1,2,2,"H"
"7644",1964-09-27,1964,"Stade Rennes","RC Lens","3-3",3,3,"1",1,6,0,"D"
"7645",1964-09-27,1964,"Lille OSC","RC Strasbourg","1-1",1,1,"1",1,2,0,"D"
"7646",1964-10-07,1964,"Nimes Olympique","FC Sochaux","3-0",3,0,"1",1,3,3,"H"
"7647",1964-10-07,1964,"Olympique Lyon","Stade Rennes","1-0",1,0,"1",1,1,1,"H"
"7648",1964-10-07,1964,"Girondins Bordeaux","FC Nantes","2-2",2,2,"1",1,4,0,"D"
"7649",1964-10-07,1964,"Toulouse FC","Sporting Toulon Var","0-1",0,1,"1",1,1,-1,"D"
"7650",1964-10-07,1964,"RC Lens","US Valenciennes-Anzin","3-2",3,2,"1",1,5,1,"H"
"7651",1964-10-07,1964,"Angers SCO","UA Sedan-Torcy","3-0",3,0,"1",1,3,3,"H"
"7652",1964-10-07,1964,"Stade Francais FC","Lille OSC","0-0",0,0,"1",1,0,0,"D"
"7653",1964-10-07,1964,"RC Strasbourg","AS Monaco","3-3",3,3,"1",1,6,0,"D"
"7654",1964-10-07,1964,"FC Rouen","AS Saint-Etienne","0-1",0,1,"1",1,1,-1,"D"
"7655",1964-10-10,1964,"FC Sochaux","Toulouse FC","0-2",0,2,"1",1,2,-2,"D"
"7656",1964-10-10,1964,"FC Nantes","Nimes Olympique","0-2",0,2,"1",1,2,-2,"D"
"7657",1964-10-11,1964,"Sporting Toulon Var","Angers SCO","4-0",4,0,"1",1,4,4,"H"
"7658",1964-10-11,1964,"AS Monaco","Olympique Lyon","3-2",3,2,"1",1,5,1,"H"
"7659",1964-10-11,1964,"UA Sedan-Torcy","RC Lens","3-1",3,1,"1",1,4,2,"H"
"7660",1964-10-11,1964,"Lille OSC","Girondins Bordeaux","3-1",3,1,"1",1,4,2,"H"
"7661",1964-10-11,1964,"US Valenciennes-Anzin","Stade Rennes","0-0",0,0,"1",1,0,0,"D"
"7662",1964-10-11,1964,"AS Saint-Etienne","RC Strasbourg","1-1",1,1,"1",1,2,0,"D"
"7663",1964-10-11,1964,"Stade Francais FC","FC Rouen","2-0",2,0,"1",1,2,2,"H"
"7664",1964-10-17,1964,"Olympique Lyon","US Valenciennes-Anzin","1-0",1,0,"1",1,1,1,"H"
"7665",1964-10-17,1964,"Nimes Olympique","AS Monaco","1-0",1,0,"1",1,1,1,"H"
"7666",1964-10-17,1964,"Toulouse FC","AS Saint-Etienne","2-2",2,2,"1",1,4,0,"D"
"7667",1964-10-18,1964,"RC Strasbourg","Sporting Toulon Var","0-0",0,0,"1",1,0,0,"D"
"7668",1964-10-18,1964,"RC Lens","FC Nantes","0-3",0,3,"1",1,3,-3,"D"
"7669",1964-10-18,1964,"Angers SCO","FC Sochaux","1-0",1,0,"1",1,1,1,"H"
"7670",1964-10-18,1964,"Girondins Bordeaux","Stade Francais FC","2-1",2,1,"1",1,3,1,"H"
"7671",1964-10-18,1964,"Stade Rennes","UA Sedan-Torcy","3-2",3,2,"1",1,5,1,"H"
"7672",1964-10-18,1964,"FC Rouen","Lille OSC","2-1",2,1,"1",1,3,1,"H"
"7673",1964-10-24,1964,"FC Nantes","Angers SCO","2-1",2,1,"1",1,3,1,"H"
"7674",1964-10-24,1964,"FC Sochaux","Stade Rennes","3-0",3,0,"1",1,3,3,"H"
"7675",1964-10-24,1964,"Girondins Bordeaux","FC Rouen","1-2",1,2,"1",1,3,-1,"D"
"7676",1964-10-25,1964,"Sporting Toulon Var","Nimes Olympique","1-2",1,2,"1",1,3,-1,"D"
"7677",1964-10-25,1964,"AS Saint-Etienne","Olympique Lyon","6-0",6,0,"1",1,6,6,"H"
"7678",1964-10-25,1964,"Lille OSC","RC Lens","4-0",4,0,"1",1,4,4,"H"
"7679",1964-10-25,1964,"AS Monaco","Toulouse FC","2-1",2,1,"1",1,3,1,"H"
"7680",1964-10-25,1964,"UA Sedan-Torcy","US Valenciennes-Anzin","1-3",1,3,"1",1,4,-2,"D"
"7681",1964-10-25,1964,"Stade Francais FC","RC Strasbourg","2-2",2,2,"1",1,4,0,"D"
"7682",1964-10-30,1964,"Toulouse FC","FC Nantes","3-0",3,0,"1",1,3,3,"H"
"7683",1964-10-31,1964,"US Valenciennes-Anzin","FC Sochaux","1-0",1,0,"1",1,1,1,"H"
"7684",1964-10-31,1964,"RC Strasbourg","Girondins Bordeaux","0-0",0,0,"1",1,0,0,"D"
"7685",1964-11-01,1964,"Nimes Olympique","Stade Francais FC","3-0",3,0,"1",1,3,3,"H"
"7686",1964-11-01,1964,"Olympique Lyon","Lille OSC","1-0",1,0,"1",1,1,1,"H"
"7687",1964-11-01,1964,"Angers SCO","AS Saint-Etienne","0-1",0,1,"1",1,1,-1,"D"
"7688",1964-11-01,1964,"Stade Rennes","Sporting Toulon Var","4-1",4,1,"1",1,5,3,"H"
"7689",1964-11-01,1964,"FC Rouen","UA Sedan-Torcy","2-0",2,0,"1",1,2,2,"H"
"7690",1964-11-02,1964,"RC Lens","AS Monaco","2-0",2,0,"1",1,2,2,"H"
"7691",1964-11-08,1964,"FC Nantes","RC Strasbourg","3-2",3,2,"1",1,5,1,"H"
"7692",1964-11-08,1964,"FC Rouen","Olympique Lyon","1-1",1,1,"1",1,2,0,"D"
"7693",1964-11-08,1964,"Girondins Bordeaux","Nimes Olympique","2-1",2,1,"1",1,3,1,"H"
"7694",1964-11-08,1964,"Sporting Toulon Var","US Valenciennes-Anzin","1-3",1,3,"1",1,4,-2,"D"
"7695",1964-11-08,1964,"Lille OSC","Toulouse FC","0-2",0,2,"1",1,2,-2,"D"
"7696",1964-11-08,1964,"FC Sochaux","UA Sedan-Torcy","2-2",2,2,"1",1,4,0,"D"
"7697",1964-11-08,1964,"AS Saint-Etienne","RC Lens","2-2",2,2,"1",1,4,0,"D"
"7698",1964-11-08,1964,"AS Monaco","Stade Rennes","2-1",2,1,"1",1,3,1,"H"
"7699",1964-11-08,1964,"Stade Francais FC","Angers SCO","2-0",2,0,"1",1,2,2,"H"
"7700",1964-11-15,1964,"Nimes Olympique","Lille OSC","2-1",2,1,"1",1,3,1,"H"
"7701",1964-11-15,1964,"US Valenciennes-Anzin","FC Nantes","2-1",2,1,"1",1,3,1,"H"
"7702",1964-11-15,1964,"Olympique Lyon","Girondins Bordeaux","0-0",0,0,"1",1,0,0,"D"
"7703",1964-11-15,1964,"RC Lens","FC Sochaux","2-3",2,3,"1",1,5,-1,"D"
"7704",1964-11-15,1964,"Toulouse FC","Stade Francais FC","1-1",1,1,"1",1,2,0,"D"
"7705",1964-11-15,1964,"Stade Rennes","AS Saint-Etienne","2-1",2,1,"1",1,3,1,"H"
"7706",1964-11-15,1964,"Angers SCO","AS Monaco","0-0",0,0,"1",1,0,0,"D"
"7707",1964-11-15,1964,"RC Strasbourg","FC Rouen","3-0",3,0,"1",1,3,3,"H"
"7708",1964-11-15,1964,"UA Sedan-Torcy","Sporting Toulon Var","3-2",3,2,"1",1,5,1,"H"
"7709",1964-11-22,1964,"AS Saint-Etienne","US Valenciennes-Anzin","0-1",0,1,"1",1,1,-1,"D"
"7710",1964-11-22,1964,"Sporting Toulon Var","FC Sochaux","0-1",0,1,"1",1,1,-1,"D"
"7711",1964-11-22,1964,"RC Strasbourg","Olympique Lyon","3-3",3,3,"1",1,6,0,"D"
"7712",1964-11-22,1964,"FC Rouen","Nimes Olympique","1-0",1,0,"1",1,1,1,"H"
"7713",1964-11-22,1964,"Girondins Bordeaux","Toulouse FC","4-2",4,2,"1",1,6,2,"H"
"7714",1964-11-22,1964,"FC Nantes","Stade Rennes","2-3",2,3,"1",1,5,-1,"D"
"7715",1964-11-22,1964,"AS Monaco","UA Sedan-Torcy","0-4",0,4,"1",1,4,-4,"D"
"7716",1964-11-22,1964,"Stade Francais FC","RC Lens","0-0",0,0,"1",1,0,0,"D"
"7717",1964-11-22,1964,"Lille OSC","Angers SCO","3-4",3,4,"1",1,7,-1,"D"
"7718",1964-11-29,1964,"US Valenciennes-Anzin","AS Monaco","3-0",3,0,"1",1,3,3,"H"
"7719",1964-11-29,1964,"Olympique Lyon","Stade Francais FC","4-0",4,0,"1",1,4,4,"H"
"7720",1964-11-29,1964,"FC Sochaux","FC Nantes","1-1",1,1,"1",1,2,0,"D"
"7721",1964-11-29,1964,"Nimes Olympique","RC Strasbourg","2-1",2,1,"1",1,3,1,"H"
"7722",1964-11-29,1964,"Stade Rennes","Lille OSC","3-3",3,3,"1",1,6,0,"D"
"7723",1964-11-29,1964,"UA Sedan-Torcy","AS Saint-Etienne","1-0",1,0,"1",1,1,1,"H"
"7724",1964-11-29,1964,"Angers SCO","Girondins Bordeaux","2-1",2,1,"1",1,3,1,"H"
"7725",1964-11-29,1964,"Toulouse FC","FC Rouen","0-1",0,1,"1",1,1,-1,"D"
"7726",1964-11-29,1964,"RC Lens","Sporting Toulon Var","2-1",2,1,"1",1,3,1,"H"
"7727",1964-12-06,1964,"Lille OSC","US Valenciennes-Anzin","1-1",1,1,"1",1,2,0,"D"
"7728",1964-12-06,1964,"Nimes Olympique","Olympique Lyon","1-2",1,2,"1",1,3,-1,"D"
"7729",1964-12-06,1964,"FC Nantes","UA Sedan-Torcy","2-2",2,2,"1",1,4,0,"D"
"7730",1964-12-06,1964,"Girondins Bordeaux","RC Lens","0-0",0,0,"1",1,0,0,"D"
"7731",1964-12-06,1964,"Stade Francais FC","Stade Rennes","2-1",2,1,"1",1,3,1,"H"
"7732",1964-12-06,1964,"RC Strasbourg","Toulouse FC","5-3",5,3,"1",1,8,2,"H"
"7733",1964-12-06,1964,"AS Monaco","Sporting Toulon Var","1-0",1,0,"1",1,1,1,"H"
"7734",1964-12-06,1964,"FC Rouen","Angers SCO","0-1",0,1,"1",1,1,-1,"D"
"7735",1964-12-12,1964,"FC Sochaux","AS Monaco","3-0",3,0,"1",1,3,3,"H"
"7736",1964-12-13,1964,"US Valenciennes-Anzin","Stade Francais FC","0-0",0,0,"1",1,0,0,"D"
"7737",1964-12-13,1964,"Olympique Lyon","FC Nantes","1-1",1,1,"1",1,2,0,"D"
"7738",1964-12-13,1964,"Stade Rennes","Girondins Bordeaux","1-2",1,2,"1",1,3,-1,"D"
"7739",1964-12-13,1964,"UA Sedan-Torcy","Lille OSC","0-0",0,0,"1",1,0,0,"D"
"7740",1964-12-13,1964,"Toulouse FC","Nimes Olympique","1-0",1,0,"1",1,1,1,"H"
"7741",1964-12-13,1964,"Angers SCO","RC Strasbourg","0-0",0,0,"1",1,0,0,"D"
"7742",1964-12-13,1964,"RC Lens","FC Rouen","2-2",2,2,"1",1,4,0,"D"
"7743",1964-12-13,1964,"Sporting Toulon Var","AS Saint-Etienne","1-3",1,3,"1",1,4,-2,"D"
"7744",1964-12-16,1964,"AS Saint-Etienne","FC Sochaux","0-0",0,0,"1",1,0,0,"D"
"7745",1964-12-20,1964,"Girondins Bordeaux","US Valenciennes-Anzin","1-0",1,0,"1",1,1,1,"H"
"7746",1964-12-20,1964,"Toulouse FC","Olympique Lyon","3-2",3,2,"1",1,5,1,"H"
"7747",1964-12-20,1964,"Lille OSC","FC Sochaux","3-0",3,0,"1",1,3,3,"H"
"7748",1964-12-20,1964,"FC Nantes","Sporting Toulon Var","5-1",5,1,"1",1,6,4,"H"
"7749",1964-12-20,1964,"Nimes Olympique","Angers SCO","2-1",2,1,"1",1,3,1,"H"
"7750",1964-12-20,1964,"RC Strasbourg","RC Lens","3-0",3,0,"1",1,3,3,"H"
"7751",1964-12-20,1964,"AS Saint-Etienne","AS Monaco","2-0",2,0,"1",1,2,2,"H"
"7752",1964-12-20,1964,"Stade Francais FC","UA Sedan-Torcy","1-0",1,0,"1",1,1,1,"H"
"7753",1964-12-20,1964,"FC Rouen","Stade Rennes","1-0",1,0,"1",1,1,1,"H"
"7754",1965-01-03,1964,"US Valenciennes-Anzin","RC Strasbourg","3-0",3,0,"1",1,3,3,"H"
"7755",1965-01-03,1964,"UA Sedan-Torcy","Girondins Bordeaux","0-1",0,1,"1",1,1,-1,"D"
"7756",1965-01-03,1964,"Angers SCO","Olympique Lyon","2-1",2,1,"1",1,3,1,"H"
"7757",1965-01-03,1964,"FC Sochaux","FC Rouen","2-3",2,3,"1",1,5,-1,"D"
"7758",1965-01-03,1964,"AS Saint-Etienne","FC Nantes","2-0",2,0,"1",1,2,2,"H"
"7759",1965-01-03,1964,"Stade Rennes","Nimes Olympique","4-0",4,0,"1",1,4,4,"H"
"7760",1965-01-03,1964,"RC Lens","Toulouse FC","1-1",1,1,"1",1,2,0,"D"
"7761",1965-01-03,1964,"AS Monaco","Lille OSC","1-1",1,1,"1",1,2,0,"D"
"7762",1965-01-03,1964,"Sporting Toulon Var","Stade Francais FC","2-1",2,1,"1",1,3,1,"H"
"7763",1965-01-10,1964,"Girondins Bordeaux","FC Sochaux","1-0",1,0,"1",1,1,1,"H"
"7764",1965-01-10,1964,"Nimes Olympique","US Valenciennes-Anzin","2-1",2,1,"1",1,3,1,"H"
"7765",1965-01-10,1964,"Olympique Lyon","Sporting Toulon Var","1-0",1,0,"1",1,1,1,"H"
"7766",1965-01-10,1964,"FC Rouen","FC Nantes","1-3",1,3,"1",1,4,-2,"D"
"7767",1965-01-10,1964,"Lille OSC","AS Saint-Etienne","3-3",3,3,"1",1,6,0,"D"
"7768",1965-01-10,1964,"RC Strasbourg","UA Sedan-Torcy","2-0",2,0,"1",1,2,2,"H"
"7769",1965-01-10,1964,"Toulouse FC","Stade Rennes","1-1",1,1,"1",1,2,0,"D"
"7770",1965-01-10,1964,"Angers SCO","RC Lens","3-1",3,1,"1",1,4,2,"H"
"7771",1965-01-10,1964,"Stade Francais FC","AS Monaco","3-2",3,2,"1",1,5,1,"H"
"7772",1965-01-24,1964,"AS Monaco","Girondins Bordeaux","0-0",0,0,"1",1,0,0,"D"
"7773",1965-01-24,1964,"US Valenciennes-Anzin","Toulouse FC","1-1",1,1,"1",1,2,0,"D"
"7774",1965-01-24,1964,"FC Nantes","Lille OSC","1-1",1,1,"1",1,2,0,"D"
"7775",1965-01-24,1964,"Stade Rennes","Angers SCO","6-0",6,0,"1",1,6,6,"H"
"7776",1965-01-24,1964,"AS Saint-Etienne","Stade Francais FC","0-0",0,0,"1",1,0,0,"D"
"7777",1965-01-24,1964,"RC Lens","Nimes Olympique","3-1",3,1,"1",1,4,2,"H"
"7778",1965-01-24,1964,"Sporting Toulon Var","FC Rouen","1-0",1,0,"1",1,1,1,"H"
"7779",1965-01-30,1964,"Girondins Bordeaux","Sporting Toulon Var","3-0",3,0,"1",1,3,3,"H"
"7780",1965-01-31,1964,"Angers SCO","US Valenciennes-Anzin","2-2",2,2,"1",1,4,0,"D"
"7781",1965-01-31,1964,"Olympique Lyon","FC Sochaux","2-1",2,1,"1",1,3,1,"H"
"7782",1965-01-31,1964,"Toulouse FC","UA Sedan-Torcy","5-0",5,0,"1",1,5,5,"H"
"7783",1965-01-31,1964,"Nimes Olympique","AS Saint-Etienne","1-0",1,0,"1",1,1,1,"H"
"7784",1965-01-31,1964,"RC Lens","Stade Rennes","1-1",1,1,"1",1,2,0,"D"
"7785",1965-01-31,1964,"RC Strasbourg","Lille OSC","3-2",3,2,"1",1,5,1,"H"
"7786",1965-01-31,1964,"AS Monaco","FC Rouen","1-0",1,0,"1",1,1,1,"H"
"7787",1965-02-03,1964,"Stade Francais FC","FC Nantes","1-1",1,1,"1",1,2,0,"D"
"7788",1965-02-06,1964,"Sporting Toulon Var","Toulouse FC","0-2",0,2,"1",1,2,-2,"D"
"7789",1965-02-07,1964,"US Valenciennes-Anzin","RC Lens","6-1",6,1,"1",1,7,5,"H"
"7790",1965-02-07,1964,"FC Nantes","Girondins Bordeaux","2-0",2,0,"1",1,2,2,"H"
"7791",1965-02-07,1964,"Stade Rennes","Olympique Lyon","3-0",3,0,"1",1,3,3,"H"
"7792",1965-02-07,1964,"AS Monaco","RC Strasbourg","0-1",0,1,"1",1,1,-1,"D"
"7793",1965-02-07,1964,"FC Sochaux","Nimes Olympique","1-1",1,1,"1",1,2,0,"D"
"7794",1965-02-07,1964,"AS Saint-Etienne","FC Rouen","1-3",1,3,"1",1,4,-2,"D"
"7795",1965-02-07,1964,"Lille OSC","Stade Francais FC","1-1",1,1,"1",1,2,0,"D"
"7796",1965-02-07,1964,"UA Sedan-Torcy","Angers SCO","1-0",1,0,"1",1,1,1,"H"
"7797",1965-02-20,1964,"Nimes Olympique","FC Nantes","0-3",0,3,"1",1,3,-3,"D"
"7798",1965-02-21,1964,"Girondins Bordeaux","Lille OSC","2-0",2,0,"1",1,2,2,"H"
"7799",1965-02-21,1964,"Stade Rennes","US Valenciennes-Anzin","3-1",3,1,"1",1,4,2,"H"
"7800",1965-02-21,1964,"Toulouse FC","FC Sochaux","1-0",1,0,"1",1,1,1,"H"
"7801",1965-02-21,1964,"RC Strasbourg","AS Saint-Etienne","1-0",1,0,"1",1,1,1,"H"
"7802",1965-02-21,1964,"Olympique Lyon","AS Monaco","0-1",0,1,"1",1,1,-1,"D"
"7803",1965-02-21,1964,"FC Rouen","Stade Francais FC","1-1",1,1,"1",1,2,0,"D"
"7804",1965-02-21,1964,"RC Lens","UA Sedan-Torcy","3-1",3,1,"1",1,4,2,"H"
"7805",1965-02-21,1964,"Angers SCO","Sporting Toulon Var","0-0",0,0,"1",1,0,0,"D"
"7806",1965-02-27,1964,"FC Sochaux","Angers SCO","2-0",2,0,"1",1,2,2,"H"
"7807",1965-02-28,1964,"Stade Francais FC","Girondins Bordeaux","0-0",0,0,"1",1,0,0,"D"
"7808",1965-02-28,1964,"US Valenciennes-Anzin","Olympique Lyon","1-1",1,1,"1",1,2,0,"D"
"7809",1965-02-28,1964,"FC Nantes","RC Lens","1-1",1,1,"1",1,2,0,"D"
"7810",1965-02-28,1964,"UA Sedan-Torcy","Stade Rennes","2-2",2,2,"1",1,4,0,"D"
"7811",1965-02-28,1964,"AS Saint-Etienne","Toulouse FC","1-0",1,0,"1",1,1,1,"H"
"7812",1965-02-28,1964,"Sporting Toulon Var","RC Strasbourg","0-0",0,0,"1",1,0,0,"D"
"7813",1965-02-28,1964,"AS Monaco","Nimes Olympique","1-1",1,1,"1",1,2,0,"D"
"7814",1965-02-28,1964,"Lille OSC","FC Rouen","1-0",1,0,"1",1,1,1,"H"
"7815",1965-03-14,1964,"FC Rouen","Girondins Bordeaux","1-0",1,0,"1",1,1,1,"H"
"7816",1965-03-14,1964,"US Valenciennes-Anzin","UA Sedan-Torcy","1-1",1,1,"1",1,2,0,"D"
"7817",1965-03-14,1964,"Angers SCO","FC Nantes","2-2",2,2,"1",1,4,0,"D"
"7818",1965-03-14,1964,"RC Strasbourg","Stade Francais FC","2-0",2,0,"1",1,2,2,"H"
"7819",1965-03-14,1964,"Stade Rennes","FC Sochaux","1-1",1,1,"1",1,2,0,"D"
"7820",1965-03-14,1964,"Toulouse FC","AS Monaco","0-2",0,2,"1",1,2,-2,"D"
"7821",1965-03-14,1964,"Olympique Lyon","AS Saint-Etienne","0-1",0,1,"1",1,1,-1,"D"
"7822",1965-03-14,1964,"Nimes Olympique","Sporting Toulon Var","0-1",0,1,"1",1,1,-1,"D"
"7823",1965-03-14,1964,"RC Lens","Lille OSC","0-1",0,1,"1",1,1,-1,"D"
"7824",1965-03-18,1964,"UA Sedan-Torcy","Olympique Lyon","4-1",4,1,"1",1,5,3,"H"
"7825",1965-03-20,1964,"Girondins Bordeaux","RC Strasbourg","1-0",1,0,"1",1,1,1,"H"
"7826",1965-03-21,1964,"FC Nantes","Toulouse FC","4-0",4,0,"1",1,4,4,"H"
"7827",1965-03-21,1964,"FC Sochaux","US Valenciennes-Anzin","3-2",3,2,"1",1,5,1,"H"
"7828",1965-03-21,1964,"Sporting Toulon Var","Stade Rennes","4-1",4,1,"1",1,5,3,"H"
"7829",1965-03-21,1964,"AS Saint-Etienne","Angers SCO","2-1",2,1,"1",1,3,1,"H"
"7830",1965-03-21,1964,"Lille OSC","Olympique Lyon","2-2",2,2,"1",1,4,0,"D"
"7831",1965-03-21,1964,"UA Sedan-Torcy","FC Rouen","0-2",0,2,"1",1,2,-2,"D"
"7832",1965-03-21,1964,"AS Monaco","RC Lens","2-1",2,1,"1",1,3,1,"H"
"7833",1965-03-21,1964,"Stade Francais FC","Nimes Olympique","3-1",3,1,"1",1,4,2,"H"
"7834",1965-03-27,1964,"FC Nantes","US Valenciennes-Anzin","1-0",1,0,"1",1,1,1,"H"
"7835",1965-03-27,1964,"Girondins Bordeaux","Olympique Lyon","0-2",0,2,"1",1,2,-2,"D"
"7836",1965-03-27,1964,"FC Sochaux","RC Lens","2-3",2,3,"1",1,5,-1,"D"
"7837",1965-03-28,1964,"FC Rouen","RC Strasbourg","1-3",1,3,"1",1,4,-2,"D"
"7838",1965-03-28,1964,"AS Saint-Etienne","Stade Rennes","3-1",3,1,"1",1,4,2,"H"
"7839",1965-03-28,1964,"AS Monaco","Angers SCO","3-1",3,1,"1",1,4,2,"H"
"7840",1965-03-28,1964,"Stade Francais FC","Toulouse FC","2-0",2,0,"1",1,2,2,"H"
"7841",1965-03-28,1964,"Lille OSC","Nimes Olympique","2-1",2,1,"1",1,3,1,"H"
"7842",1965-03-28,1964,"Sporting Toulon Var","UA Sedan-Torcy","1-0",1,0,"1",1,1,1,"H"
"7843",1965-03-31,1964,"FC Sochaux","RC Strasbourg","0-2",0,2,"1",1,2,-2,"D"
"7844",1965-04-09,1964,"Olympique Lyon","RC Strasbourg","2-1",2,1,"1",1,3,1,"H"
"7845",1965-04-10,1964,"Stade Rennes","FC Nantes","4-0",4,0,"1",1,4,4,"H"
"7846",1965-04-10,1964,"US Valenciennes-Anzin","AS Saint-Etienne","2-0",2,0,"1",1,2,2,"H"
"7847",1965-04-10,1964,"FC Sochaux","Sporting Toulon Var","2-0",2,0,"1",1,2,2,"H"
"7848",1965-04-10,1964,"UA Sedan-Torcy","AS Monaco","2-1",2,1,"1",1,3,1,"H"
"7849",1965-04-10,1964,"Nimes Olympique","FC Rouen","2-0",2,0,"1",1,2,2,"H"
"7850",1965-04-10,1964,"RC Lens","Stade Francais FC","5-2",5,2,"1",1,7,3,"H"
"7851",1965-04-11,1964,"Toulouse FC","Girondins Bordeaux","1-1",1,1,"1",1,2,0,"D"
"7852",1965-04-11,1964,"Angers SCO","Lille OSC","1-1",1,1,"1",1,2,0,"D"
"7853",1965-04-21,1964,"FC Nantes","FC Sochaux","3-0",3,0,"1",1,3,3,"H"
"7854",1965-04-21,1964,"RC Strasbourg","Nimes Olympique","3-2",3,2,"1",1,5,1,"H"
"7855",1965-04-21,1964,"Girondins Bordeaux","Angers SCO","2-1",2,1,"1",1,3,1,"H"
"7856",1965-04-21,1964,"AS Monaco","US Valenciennes-Anzin","1-1",1,1,"1",1,2,0,"D"
"7857",1965-04-21,1964,"Stade Francais FC","Olympique Lyon","1-1",1,1,"1",1,2,0,"D"
"7858",1965-04-21,1964,"Lille OSC","Stade Rennes","3-2",3,2,"1",1,5,1,"H"
"7859",1965-04-21,1964,"AS Saint-Etienne","UA Sedan-Torcy","1-1",1,1,"1",1,2,0,"D"
"7860",1965-04-21,1964,"FC Rouen","Toulouse FC","3-0",3,0,"1",1,3,3,"H"
"7861",1965-04-21,1964,"Sporting Toulon Var","RC Lens","1-3",1,3,"1",1,4,-2,"D"
"7862",1965-04-24,1964,"UA Sedan-Torcy","FC Nantes","2-2",2,2,"1",1,4,0,"D"
"7863",1965-04-24,1964,"RC Lens","Girondins Bordeaux","3-2",3,2,"1",1,5,1,"H"
"7864",1965-04-24,1964,"Olympique Lyon","Nimes Olympique","0-3",0,3,"1",1,3,-3,"D"
"7865",1965-04-24,1964,"FC Sochaux","AS Saint-Etienne","3-2",3,2,"1",1,5,1,"H"
"7866",1965-04-24,1964,"Angers SCO","FC Rouen","3-0",3,0,"1",1,3,3,"H"
"7867",1965-04-25,1964,"Toulouse FC","RC Strasbourg","3-1",3,1,"1",1,4,2,"H"
"7868",1965-04-25,1964,"US Valenciennes-Anzin","Lille OSC","3-0",3,0,"1",1,3,3,"H"
"7869",1965-04-25,1964,"Stade Rennes","Stade Francais FC","2-0",2,0,"1",1,2,2,"H"
"7870",1965-04-25,1964,"Sporting Toulon Var","AS Monaco","0-6",0,6,"1",1,6,-6,"D"
"7871",1965-05-05,1964,"RC Strasbourg","FC Nantes","1-1",1,1,"1",1,2,0,"D"
"7872",1965-05-05,1964,"Nimes Olympique","Girondins Bordeaux","0-3",0,3,"1",1,3,-3,"D"
"7873",1965-05-05,1964,"US Valenciennes-Anzin","Sporting Toulon Var","1-0",1,0,"1",1,1,1,"H"
"7874",1965-05-05,1964,"Stade Rennes","AS Monaco","1-0",1,0,"1",1,1,1,"H"
"7875",1965-05-05,1964,"Olympique Lyon","FC Rouen","1-1",1,1,"1",1,2,0,"D"
"7876",1965-05-05,1964,"RC Lens","AS Saint-Etienne","4-1",4,1,"1",1,5,3,"H"
"7877",1965-05-05,1964,"UA Sedan-Torcy","FC Sochaux","0-0",0,0,"1",1,0,0,"D"
"7878",1965-05-05,1964,"Toulouse FC","Lille OSC","1-1",1,1,"1",1,2,0,"D"
"7879",1965-05-05,1964,"Angers SCO","Stade Francais FC","1-0",1,0,"1",1,1,1,"H"
"7880",1965-05-08,1964,"FC Nantes","Olympique Lyon","3-0",3,0,"1",1,3,3,"H"
"7881",1965-05-08,1964,"Girondins Bordeaux","Stade Rennes","1-0",1,0,"1",1,1,1,"H"
"7882",1965-05-08,1964,"RC Strasbourg","Angers SCO","0-1",0,1,"1",1,1,-1,"D"
"7883",1965-05-08,1964,"FC Rouen","RC Lens","0-1",0,1,"1",1,1,-1,"D"
"7884",1965-05-08,1964,"Nimes Olympique","Toulouse FC","0-4",0,4,"1",1,4,-4,"D"
"7885",1965-05-08,1964,"Lille OSC","UA Sedan-Torcy","3-0",3,0,"1",1,3,3,"H"
"7886",1965-05-09,1964,"AS Saint-Etienne","Sporting Toulon Var","1-0",1,0,"1",1,1,1,"H"
"7887",1965-05-09,1964,"Stade Francais FC","US Valenciennes-Anzin","0-3",0,3,"1",1,3,-3,"D"
"7888",1965-05-09,1964,"AS Monaco","FC Sochaux","2-0",2,0,"1",1,2,2,"H"
"7889",1965-05-14,1964,"Olympique Lyon","Toulouse FC","2-1",2,1,"1",1,3,1,"H"
"7890",1965-05-15,1964,"RC Lens","RC Strasbourg","0-3",0,3,"1",1,3,-3,"D"
"7891",1965-05-15,1964,"AS Monaco","AS Saint-Etienne","0-2",0,2,"1",1,2,-2,"D"
"7892",1965-05-15,1964,"FC Sochaux","Lille OSC","2-1",2,1,"1",1,3,1,"H"
"7893",1965-05-16,1964,"Sporting Toulon Var","FC Nantes","0-1",0,1,"1",1,1,-1,"D"
"7894",1965-05-16,1964,"US Valenciennes-Anzin","Girondins Bordeaux","0-0",0,0,"1",1,0,0,"D"
"7895",1965-05-16,1964,"Stade Rennes","FC Rouen","4-0",4,0,"1",1,4,4,"H"
"7896",1965-05-16,1964,"Angers SCO","Nimes Olympique","5-0",5,0,"1",1,5,5,"H"
"7897",1965-05-16,1964,"UA Sedan-Torcy","Stade Francais FC","0-3",0,3,"1",1,3,-3,"D"
"7898",1965-05-29,1964,"RC Strasbourg","Stade Rennes","2-3",2,3,"1",1,5,-1,"D"
"7899",1965-05-29,1964,"Olympique Lyon","RC Lens","1-1",1,1,"1",1,2,0,"D"
"7900",1965-05-29,1964,"Lille OSC","Sporting Toulon Var","5-0",5,0,"1",1,5,5,"H"
"7901",1965-05-30,1964,"FC Nantes","AS Monaco","2-1",2,1,"1",1,3,1,"H"
"7902",1965-05-30,1964,"Girondins Bordeaux","AS Saint-Etienne","1-1",1,1,"1",1,2,0,"D"
"7903",1965-05-30,1964,"FC Rouen","US Valenciennes-Anzin","1-1",1,1,"1",1,2,0,"D"
"7904",1965-05-30,1964,"Stade Francais FC","FC Sochaux","3-3",3,3,"1",1,6,0,"D"
"7905",1965-05-30,1964,"Toulouse FC","Angers SCO","1-3",1,3,"1",1,4,-2,"D"
"7906",1965-05-30,1964,"Nimes Olympique","UA Sedan-Torcy","0-3",0,3,"1",1,3,-3,"D"
"7907",1965-08-21,1965,"Toulouse FC","Angers SCO","1-0",1,0,"1",1,1,1,"H"
"7908",1965-08-22,1965,"UA Sedan-Torcy","Stade Rennes","3-1",3,1,"1",1,4,2,"H"
"7909",1965-08-22,1965,"FC Nantes","Olympique Lyon","2-0",2,0,"1",1,2,2,"H"
"7910",1965-08-22,1965,"Red Star FC","US Valenciennes-Anzin","2-0",2,0,"1",1,2,2,"H"
"7911",1965-08-22,1965,"AS Monaco","Lille OSC","2-0",2,0,"1",1,2,2,"H"
"7912",1965-08-22,1965,"AS Saint-Etienne","Nimes Olympique","2-1",2,1,"1",1,3,1,"H"
"7913",1965-08-22,1965,"AS Cannes","Girondins Bordeaux","2-1",2,1,"1",1,3,1,"H"
"7914",1965-08-22,1965,"RC Lens","Stade Francais FC","1-0",1,0,"1",1,1,1,"H"
"7915",1965-08-22,1965,"FC Sochaux","OGC Nice","1-0",1,0,"1",1,1,1,"H"
"7916",1965-08-22,1965,"RC Strasbourg","FC Rouen","0-0",0,0,"1",1,0,0,"D"
"7917",1965-08-28,1965,"UA Sedan-Torcy","FC Sochaux","3-0",3,0,"1",1,3,3,"H"
"7918",1965-08-28,1965,"FC Nantes","RC Lens","4-2",4,2,"1",1,6,2,"H"
"7919",1965-08-28,1965,"AS Saint-Etienne","AS Monaco","1-3",1,3,"1",1,4,-2,"D"
"7920",1965-08-28,1965,"OGC Nice","RC Strasbourg","0-2",0,2,"1",1,2,-2,"D"
"7921",1965-08-28,1965,"FC Rouen","AS Cannes","1-0",1,0,"1",1,1,1,"H"
"7922",1965-08-28,1965,"Nimes Olympique","Red Star FC","3-1",3,1,"1",1,4,2,"H"
"7923",1965-08-28,1965,"Lille OSC","Toulouse FC","1-0",1,0,"1",1,1,1,"H"
"7924",1965-08-28,1965,"US Valenciennes-Anzin","Stade Rennes","2-1",2,1,"1",1,3,1,"H"
"7925",1965-08-28,1965,"Girondins Bordeaux","Olympique Lyon","2-2",2,2,"1",1,4,0,"D"
"7926",1965-08-29,1965,"Angers SCO","Stade Francais FC","0-0",0,0,"1",1,0,0,"D"
"7927",1965-09-01,1965,"AS Monaco","FC Rouen","3-0",3,0,"1",1,3,3,"H"
"7928",1965-09-01,1965,"Stade Francais FC","FC Nantes","0-1",0,1,"1",1,1,-1,"D"
"7929",1965-09-01,1965,"RC Strasbourg","UA Sedan-Torcy","3-3",3,3,"1",1,6,0,"D"
"7930",1965-09-01,1965,"AS Cannes","Lille OSC","2-0",2,0,"1",1,2,2,"H"
"7931",1965-09-01,1965,"FC Sochaux","AS Saint-Etienne","2-3",2,3,"1",1,5,-1,"D"
"7932",1965-09-01,1965,"Nimes Olympique","US Valenciennes-Anzin","2-2",2,2,"1",1,4,0,"D"
"7933",1965-09-01,1965,"Olympique Lyon","OGC Nice","2-0",2,0,"1",1,2,2,"H"
"7934",1965-09-01,1965,"Toulouse FC","Girondins Bordeaux","0-0",0,0,"1",1,0,0,"D"
"7935",1965-09-01,1965,"RC Lens","Angers SCO","2-2",2,2,"1",1,4,0,"D"
"7936",1965-09-01,1965,"Stade Rennes","Red Star FC","2-1",2,1,"1",1,3,1,"H"
"7937",1965-09-04,1965,"FC Nantes","Angers SCO","5-3",5,3,"1",1,8,2,"H"
"7938",1965-09-04,1965,"UA Sedan-Torcy","Nimes Olympique","2-0",2,0,"1",1,2,2,"H"
"7939",1965-09-04,1965,"AS Saint-Etienne","Toulouse FC","3-0",3,0,"1",1,3,3,"H"
"7940",1965-09-04,1965,"US Valenciennes-Anzin","RC Strasbourg","3-2",3,2,"1",1,5,1,"H"
"7941",1965-09-04,1965,"Girondins Bordeaux","Stade Francais FC","10-0",10,0,"1",1,10,10,"H"
"7942",1965-09-04,1965,"FC Rouen","Olympique Lyon","0-0",0,0,"1",1,0,0,"D"
"7943",1965-09-05,1965,"OGC Nice","AS Monaco","1-2",1,2,"1",1,3,-1,"D"
"7944",1965-09-05,1965,"Stade Rennes","AS Cannes","2-2",2,2,"1",1,4,0,"D"
"7945",1965-09-05,1965,"Lille OSC","RC Lens","1-1",1,1,"1",1,2,0,"D"
"7946",1965-09-05,1965,"Red Star FC","FC Sochaux","1-1",1,1,"1",1,2,0,"D"
"7947",1965-09-09,1965,"AS Monaco","UA Sedan-Torcy","3-3",3,3,"1",1,6,0,"D"
"7948",1965-09-09,1965,"RC Lens","FC Rouen","0-0",0,0,"1",1,0,0,"D"
"7949",1965-09-10,1965,"Toulouse FC","FC Nantes","0-0",0,0,"1",1,0,0,"D"
"7950",1965-09-10,1965,"AS Cannes","AS Saint-Etienne","2-8",2,8,"1",1,10,-6,"D"
"7951",1965-09-10,1965,"RC Strasbourg","Red Star FC","7-1",7,1,"1",1,8,6,"H"
"7952",1965-09-10,1965,"Olympique Lyon","Lille OSC","6-3",6,3,"1",1,9,3,"H"
"7953",1965-09-10,1965,"FC Sochaux","US Valenciennes-Anzin","1-1",1,1,"1",1,2,0,"D"
"7954",1965-09-10,1965,"Angers SCO","Girondins Bordeaux","0-0",0,0,"1",1,0,0,"D"
"7955",1965-09-10,1965,"Nimes Olympique","Stade Rennes","2-2",2,2,"1",1,4,0,"D"
"7956",1965-09-10,1965,"Stade Francais FC","OGC Nice","2-1",2,1,"1",1,3,1,"H"
"7957",1965-09-17,1965,"OGC Nice","Toulouse FC","2-1",2,1,"1",1,3,1,"H"
"7958",1965-09-18,1965,"Girondins Bordeaux","FC Nantes","1-2",1,2,"1",1,3,-1,"D"
"7959",1965-09-18,1965,"AS Saint-Etienne","RC Strasbourg","5-1",5,1,"1",1,6,4,"H"
"7960",1965-09-18,1965,"UA Sedan-Torcy","AS Cannes","3-1",3,1,"1",1,4,2,"H"
"7961",1965-09-18,1965,"FC Rouen","Stade Francais FC","2-1",2,1,"1",1,3,1,"H"
"7962",1965-09-18,1965,"Stade Rennes","FC Sochaux","4-3",4,3,"1",1,7,1,"H"
"7963",1965-09-19,1965,"US Valenciennes-Anzin","AS Monaco","1-0",1,0,"1",1,1,1,"H"
"7964",1965-09-19,1965,"Red Star FC","Olympique Lyon","2-2",2,2,"1",1,4,0,"D"
"7965",1965-09-19,1965,"Lille OSC","Angers SCO","1-0",1,0,"1",1,1,1,"H"
"7966",1965-09-24,1965,"Olympique Lyon","UA Sedan-Torcy","2-1",2,1,"1",1,3,1,"H"
"7967",1965-09-24,1965,"AS Cannes","US Valenciennes-Anzin","0-1",0,1,"1",1,1,-1,"D"
"7968",1965-09-25,1965,"FC Nantes","OGC Nice","2-1",2,1,"1",1,3,1,"H"
"7969",1965-09-25,1965,"Angers SCO","AS Saint-Etienne","1-1",1,1,"1",1,2,0,"D"
"7970",1965-09-25,1965,"AS Monaco","Red Star FC","2-1",2,1,"1",1,3,1,"H"
"7971",1965-09-25,1965,"RC Strasbourg","Stade Rennes","3-1",3,1,"1",1,4,2,"H"
"7972",1965-09-25,1965,"RC Lens","Girondins Bordeaux","0-1",0,1,"1",1,1,-1,"D"
"7973",1965-09-25,1965,"Toulouse FC","FC Rouen","6-5",6,5,"1",1,11,1,"H"
"7974",1965-09-25,1965,"FC Sochaux","Nimes Olympique","3-1",3,1,"1",1,4,2,"H"
"7975",1965-09-26,1965,"Stade Francais FC","Lille OSC","1-1",1,1,"1",1,2,0,"D"
"7976",1965-09-28,1965,"US Valenciennes-Anzin","Olympique Lyon","1-0",1,0,"1",1,1,1,"H"
"7977",1965-09-29,1965,"FC Rouen","FC Nantes","0-0",0,0,"1",1,0,0,"D"
"7978",1965-09-29,1965,"AS Saint-Etienne","Stade Francais FC","0-0",0,0,"1",1,0,0,"D"
"7979",1965-09-29,1965,"UA Sedan-Torcy","Angers SCO","3-1",3,1,"1",1,4,2,"H"
"7980",1965-09-29,1965,"Lille OSC","Girondins Bordeaux","0-0",0,0,"1",1,0,0,"D"
"7981",1965-09-29,1965,"Nimes Olympique","RC Strasbourg","4-1",4,1,"1",1,5,3,"H"
"7982",1965-09-29,1965,"FC Sochaux","Toulouse FC","0-1",0,1,"1",1,1,-1,"D"
"7983",1965-09-29,1965,"OGC Nice","RC Lens","0-3",0,3,"1",1,3,-3,"D"
"7984",1965-09-29,1965,"Red Star FC","AS Cannes","3-2",3,2,"1",1,5,1,"H"
"7985",1965-10-02,1965,"FC Nantes","Lille OSC","3-1",3,1,"1",1,4,2,"H"
"7986",1965-10-02,1965,"AS Monaco","Nimes Olympique","4-0",4,0,"1",1,4,4,"H"
"7987",1965-10-02,1965,"RC Strasbourg","FC Sochaux","5-1",5,1,"1",1,6,4,"H"
"7988",1965-10-03,1965,"Olympique Lyon","AS Saint-Etienne","1-1",1,1,"1",1,2,0,"D"
"7989",1965-10-03,1965,"Toulouse FC","UA Sedan-Torcy","2-2",2,2,"1",1,4,0,"D"
"7990",1965-10-03,1965,"RC Lens","US Valenciennes-Anzin","1-1",1,1,"1",1,2,0,"D"
"7991",1965-10-03,1965,"Girondins Bordeaux","FC Rouen","4-1",4,1,"1",1,5,3,"H"
"7992",1965-10-03,1965,"Stade Francais FC","Red Star FC","1-1",1,1,"1",1,2,0,"D"
"7993",1965-10-03,1965,"Angers SCO","Stade Rennes","5-3",5,3,"1",1,8,2,"H"
"7994",1965-10-03,1965,"AS Cannes","OGC Nice","1-3",1,3,"1",1,4,-2,"D"
"7995",1965-10-06,1965,"Nimes Olympique","RC Lens","4-5",4,5,"1",1,9,-1,"D"
"7996",1965-10-12,1965,"Stade Rennes","AS Monaco","0-1",0,1,"1",1,1,-1,"D"
"7997",1965-10-13,1965,"Stade Francais FC","UA Sedan-Torcy","1-1",1,1,"1",1,2,0,"D"
"7998",1965-10-13,1965,"RC Lens","AS Saint-Etienne","2-1",2,1,"1",1,3,1,"H"
"7999",1965-10-16,1965,"FC Rouen","Lille OSC","1-1",1,1,"1",1,2,0,"D"
"8000",1965-10-17,1965,"AS Saint-Etienne","FC Nantes","0-3",0,3,"1",1,3,-3,"D"
"8001",1965-10-17,1965,"FC Sochaux","AS Monaco","2-1",2,1,"1",1,3,1,"H"
"8002",1965-10-17,1965,"US Valenciennes-Anzin","Stade Francais FC","1-0",1,0,"1",1,1,1,"H"
"8003",1965-10-17,1965,"UA Sedan-Torcy","RC Lens","1-3",1,3,"1",1,4,-2,"D"
"8004",1965-10-17,1965,"OGC Nice","Girondins Bordeaux","1-2",1,2,"1",1,3,-1,"D"
"8005",1965-10-17,1965,"RC Strasbourg","Angers SCO","1-1",1,1,"1",1,2,0,"D"
"8006",1965-10-17,1965,"Stade Rennes","Olympique Lyon","5-2",5,2,"1",1,7,3,"H"
"8007",1965-10-17,1965,"Red Star FC","Toulouse FC","1-1",1,1,"1",1,2,0,"D"
"8008",1965-10-17,1965,"Nimes Olympique","AS Cannes","1-1",1,1,"1",1,2,0,"D"
"8009",1965-10-20,1965,"FC Nantes","Red Star FC","7-2",7,2,"1",1,9,5,"H"
"8010",1965-10-20,1965,"Toulouse FC","US Valenciennes-Anzin","1-2",1,2,"1",1,3,-1,"D"
"8011",1965-10-20,1965,"AS Monaco","RC Strasbourg","0-0",0,0,"1",1,0,0,"D"
"8012",1965-10-20,1965,"Girondins Bordeaux","Stade Rennes","2-1",2,1,"1",1,3,1,"H"
"8013",1965-10-20,1965,"Olympique Lyon","Nimes Olympique","3-1",3,1,"1",1,4,2,"H"
"8014",1965-10-20,1965,"Lille OSC","OGC Nice","2-1",2,1,"1",1,3,1,"H"
"8015",1965-10-20,1965,"Angers SCO","FC Rouen","6-0",6,0,"1",1,6,6,"H"
"8016",1965-10-20,1965,"AS Cannes","FC Sochaux","1-1",1,1,"1",1,2,0,"D"
"8017",1965-10-24,1965,"US Valenciennes-Anzin","FC Nantes","2-2",2,2,"1",1,4,0,"D"
"8018",1965-10-24,1965,"AS Monaco","AS Cannes","0-0",0,0,"1",1,0,0,"D"
"8019",1965-10-24,1965,"UA Sedan-Torcy","Girondins Bordeaux","1-1",1,1,"1",1,2,0,"D"
"8020",1965-10-24,1965,"AS Saint-Etienne","Lille OSC","7-4",7,4,"1",1,11,3,"H"
"8021",1965-10-24,1965,"RC Strasbourg","RC Lens","1-0",1,0,"1",1,1,1,"H"
"8022",1965-10-24,1965,"FC Sochaux","Olympique Lyon","7-2",7,2,"1",1,9,5,"H"
"8023",1965-10-24,1965,"Red Star FC","Angers SCO","0-2",0,2,"1",1,2,-2,"D"
"8024",1965-10-24,1965,"Stade Rennes","Stade Francais FC","4-3",4,3,"1",1,7,1,"H"
"8025",1965-10-24,1965,"Nimes Olympique","Toulouse FC","2-0",2,0,"1",1,2,2,"H"
"8026",1965-10-24,1965,"OGC Nice","FC Rouen","6-0",6,0,"1",1,6,6,"H"
"8027",1965-10-29,1965,"Toulouse FC","Stade Rennes","4-1",4,1,"1",1,5,3,"H"
"8028",1965-10-29,1965,"Olympique Lyon","AS Monaco","1-0",1,0,"1",1,1,1,"H"
"8029",1965-10-30,1965,"Lille OSC","Red Star FC","3-0",3,0,"1",1,3,3,"H"
"8030",1965-10-30,1965,"FC Nantes","UA Sedan-Torcy","4-2",4,2,"1",1,6,2,"H"
"8031",1965-10-30,1965,"FC Rouen","AS Saint-Etienne","2-0",2,0,"1",1,2,2,"H"
"8032",1965-10-31,1965,"Girondins Bordeaux","US Valenciennes-Anzin","2-0",2,0,"1",1,2,2,"H"
"8033",1965-10-31,1965,"AS Cannes","RC Strasbourg","2-1",2,1,"1",1,3,1,"H"
"8034",1965-10-31,1965,"RC Lens","FC Sochaux","0-1",0,1,"1",1,1,-1,"D"
"8035",1965-10-31,1965,"Angers SCO","OGC Nice","1-0",1,0,"1",1,1,1,"H"
"8036",1965-10-31,1965,"Stade Francais FC","Nimes Olympique","2-1",2,1,"1",1,3,1,"H"
"8037",1965-11-10,1965,"UA Sedan-Torcy","FC Rouen","4-4",4,4,"1",1,8,0,"D"
"8038",1965-11-10,1965,"AS Monaco","RC Lens","3-0",3,0,"1",1,3,3,"H"
"8039",1965-11-11,1965,"Stade Rennes","FC Nantes","2-0",2,0,"1",1,2,2,"H"
"8040",1965-11-11,1965,"US Valenciennes-Anzin","Lille OSC","2-0",2,0,"1",1,2,2,"H"
"8041",1965-11-11,1965,"AS Saint-Etienne","OGC Nice","5-1",5,1,"1",1,6,4,"H"
"8042",1965-11-11,1965,"Red Star FC","Girondins Bordeaux","2-0",2,0,"1",1,2,2,"H"
"8043",1965-11-11,1965,"RC Strasbourg","Olympique Lyon","0-0",0,0,"1",1,0,0,"D"
"8044",1965-11-11,1965,"FC Sochaux","Stade Francais FC","1-0",1,0,"1",1,1,1,"H"
"8045",1965-11-11,1965,"Nimes Olympique","Angers SCO","1-0",1,0,"1",1,1,1,"H"
"8046",1965-11-11,1965,"AS Cannes","Toulouse FC","5-3",5,3,"1",1,8,2,"H"
"8047",1965-11-13,1965,"FC Nantes","Nimes Olympique","4-1",4,1,"1",1,5,3,"H"
"8048",1965-11-14,1965,"FC Rouen","US Valenciennes-Anzin","1-3",1,3,"1",1,4,-2,"D"
"8049",1965-11-14,1965,"Girondins Bordeaux","AS Saint-Etienne","4-0",4,0,"1",1,4,4,"H"
"8050",1965-11-14,1965,"Toulouse FC","AS Monaco","5-1",5,1,"1",1,6,4,"H"
"8051",1965-11-14,1965,"Stade Francais FC","RC Strasbourg","0-2",0,2,"1",1,2,-2,"D"
"8052",1965-11-14,1965,"Lille OSC","UA Sedan-Torcy","1-1",1,1,"1",1,2,0,"D"
"8053",1965-11-14,1965,"Olympique Lyon","AS Cannes","2-0",2,0,"1",1,2,2,"H"
"8054",1965-11-14,1965,"RC Lens","Stade Rennes","4-1",4,1,"1",1,5,3,"H"
"8055",1965-11-14,1965,"Angers SCO","FC Sochaux","2-2",2,2,"1",1,4,0,"D"
"8056",1965-11-14,1965,"OGC Nice","Red Star FC","4-0",4,0,"1",1,4,4,"H"
"8057",1965-11-19,1965,"AS Monaco","Stade Francais FC","3-1",3,1,"1",1,4,2,"H"
"8058",1965-11-20,1965,"FC Sochaux","FC Nantes","3-1",3,1,"1",1,4,2,"H"
"8059",1965-11-21,1965,"US Valenciennes-Anzin","OGC Nice","4-2",4,2,"1",1,6,2,"H"
"8060",1965-11-21,1965,"Nimes Olympique","Girondins Bordeaux","1-1",1,1,"1",1,2,0,"D"
"8061",1965-11-21,1965,"UA Sedan-Torcy","AS Saint-Etienne","4-1",4,1,"1",1,5,3,"H"
"8062",1965-11-21,1965,"Olympique Lyon","Angers SCO","2-1",2,1,"1",1,3,1,"H"
"8063",1965-11-21,1965,"RC Strasbourg","Toulouse FC","2-2",2,2,"1",1,4,0,"D"
"8064",1965-11-21,1965,"AS Cannes","RC Lens","1-1",1,1,"1",1,2,0,"D"
"8065",1965-11-21,1965,"Stade Rennes","Lille OSC","4-0",4,0,"1",1,4,4,"H"
"8066",1965-11-21,1965,"Red Star FC","FC Rouen","0-1",0,1,"1",1,1,-1,"D"
"8067",1965-11-28,1965,"FC Nantes","RC Strasbourg","2-0",2,0,"1",1,2,2,"H"
"8068",1965-11-28,1965,"AS Saint-Etienne","US Valenciennes-Anzin","5-1",5,1,"1",1,6,4,"H"
"8069",1965-11-28,1965,"Girondins Bordeaux","FC Sochaux","4-2",4,2,"1",1,6,2,"H"
"8070",1965-11-28,1965,"Angers SCO","AS Monaco","1-1",1,1,"1",1,2,0,"D"
"8071",1965-11-28,1965,"OGC Nice","UA Sedan-Torcy","1-0",1,0,"1",1,1,1,"H"
"8072",1965-11-28,1965,"RC Lens","Red Star FC","3-0",3,0,"1",1,3,3,"H"
"8073",1965-11-28,1965,"Toulouse FC","Olympique Lyon","1-0",1,0,"1",1,1,1,"H"
"8074",1965-11-28,1965,"FC Rouen","Stade Rennes","2-2",2,2,"1",1,4,0,"D"
"8075",1965-11-28,1965,"Lille OSC","Nimes Olympique","1-2",1,2,"1",1,3,-1,"D"
"8076",1965-11-28,1965,"Stade Francais FC","AS Cannes","3-1",3,1,"1",1,4,2,"H"
"8077",1965-12-05,1965,"AS Monaco","FC Nantes","1-3",1,3,"1",1,4,-2,"D"
"8078",1965-12-05,1965,"US Valenciennes-Anzin","UA Sedan-Torcy","0-4",0,4,"1",1,4,-4,"D"
"8079",1965-12-05,1965,"RC Strasbourg","Girondins Bordeaux","3-0",3,0,"1",1,3,3,"H"
"8080",1965-12-05,1965,"Red Star FC","AS Saint-Etienne","1-5",1,5,"1",1,6,-4,"D"
"8081",1965-12-05,1965,"Olympique Lyon","Stade Francais FC","2-0",2,0,"1",1,2,2,"H"
"8082",1965-12-05,1965,"FC Sochaux","Lille OSC","1-0",1,0,"1",1,1,1,"H"
"8083",1965-12-05,1965,"Toulouse FC","RC Lens","4-1",4,1,"1",1,5,3,"H"
"8084",1965-12-05,1965,"AS Cannes","Angers SCO","2-5",2,5,"1",1,7,-3,"D"
"8085",1965-12-05,1965,"Stade Rennes","OGC Nice","3-0",3,0,"1",1,3,3,"H"
"8086",1965-12-05,1965,"Nimes Olympique","FC Rouen","2-1",2,1,"1",1,3,1,"H"
"8087",1965-12-12,1965,"FC Nantes","AS Cannes","1-0",1,0,"1",1,1,1,"H"
"8088",1965-12-12,1965,"Angers SCO","US Valenciennes-Anzin","0-1",0,1,"1",1,1,-1,"D"
"8089",1965-12-12,1965,"Girondins Bordeaux","AS Monaco","5-0",5,0,"1",1,5,5,"H"
"8090",1965-12-12,1965,"AS Saint-Etienne","Stade Rennes","4-0",4,0,"1",1,4,4,"H"
"8091",1965-12-12,1965,"UA Sedan-Torcy","Red Star FC","5-2",5,2,"1",1,7,3,"H"
"8092",1965-12-12,1965,"RC Lens","Olympique Lyon","2-1",2,1,"1",1,3,1,"H"
"8093",1965-12-12,1965,"FC Rouen","FC Sochaux","1-1",1,1,"1",1,2,0,"D"
"8094",1965-12-12,1965,"Lille OSC","RC Strasbourg","2-1",2,1,"1",1,3,1,"H"
"8095",1965-12-12,1965,"Stade Francais FC","Toulouse FC","2-0",2,0,"1",1,2,2,"H"
"8096",1965-12-12,1965,"OGC Nice","Nimes Olympique","4-1",4,1,"1",1,5,3,"H"
"8097",1965-12-19,1965,"Olympique Lyon","FC Nantes","0-2",0,2,"1",1,2,-2,"D"
"8098",1965-12-19,1965,"US Valenciennes-Anzin","Red Star FC","1-0",1,0,"1",1,1,1,"H"
"8099",1965-12-19,1965,"Girondins Bordeaux","AS Cannes","1-0",1,0,"1",1,1,1,"H"
"8100",1965-12-19,1965,"Nimes Olympique","AS Saint-Etienne","1-1",1,1,"1",1,2,0,"D"
"8101",1965-12-19,1965,"Stade Rennes","UA Sedan-Torcy","4-2",4,2,"1",1,6,2,"H"
"8102",1965-12-19,1965,"Lille OSC","AS Monaco","2-1",2,1,"1",1,3,1,"H"
"8103",1965-12-19,1965,"FC Rouen","RC Strasbourg","0-0",0,0,"1",1,0,0,"D"
"8104",1965-12-19,1965,"Stade Francais FC","RC Lens","3-1",3,1,"1",1,4,2,"H"
"8105",1965-12-19,1965,"OGC Nice","FC Sochaux","3-1",3,1,"1",1,4,2,"H"
"8106",1965-12-19,1965,"Angers SCO","Toulouse FC","2-0",2,0,"1",1,2,2,"H"
"8107",1966-01-08,1965,"Toulouse FC","Lille OSC","2-0",2,0,"1",1,2,2,"H"
"8108",1966-01-09,1965,"RC Lens","FC Nantes","1-1",1,1,"1",1,2,0,"D"
"8109",1966-01-09,1965,"Stade Rennes","US Valenciennes-Anzin","1-1",1,1,"1",1,2,0,"D"
"8110",1966-01-09,1965,"Olympique Lyon","Girondins Bordeaux","1-4",1,4,"1",1,5,-3,"D"
"8111",1966-01-09,1965,"AS Monaco","AS Saint-Etienne","1-1",1,1,"1",1,2,0,"D"
"8112",1966-01-09,1965,"FC Sochaux","UA Sedan-Torcy","0-1",0,1,"1",1,1,-1,"D"
"8113",1966-01-09,1965,"RC Strasbourg","OGC Nice","1-3",1,3,"1",1,4,-2,"D"
"8114",1966-01-09,1965,"Stade Francais FC","Angers SCO","2-1",2,1,"1",1,3,1,"H"
"8115",1966-01-09,1965,"AS Cannes","FC Rouen","1-2",1,2,"1",1,3,-1,"D"
"8116",1966-01-09,1965,"Red Star FC","Nimes Olympique","3-3",3,3,"1",1,6,0,"D"
"8117",1966-01-23,1965,"FC Nantes","Stade Francais FC","2-1",2,1,"1",1,3,1,"H"
"8118",1966-01-23,1965,"US Valenciennes-Anzin","Nimes Olympique","3-0",3,0,"1",1,3,3,"H"
"8119",1966-01-23,1965,"Girondins Bordeaux","Toulouse FC","3-0",3,0,"1",1,3,3,"H"
"8120",1966-01-23,1965,"AS Saint-Etienne","FC Sochaux","3-1",3,1,"1",1,4,2,"H"
"8121",1966-01-23,1965,"OGC Nice","Olympique Lyon","4-2",4,2,"1",1,6,2,"H"
"8122",1966-01-23,1965,"Lille OSC","AS Cannes","2-0",2,0,"1",1,2,2,"H"
"8123",1966-01-30,1965,"Angers SCO","FC Nantes","1-1",1,1,"1",1,2,0,"D"
"8124",1966-01-30,1965,"Stade Francais FC","Girondins Bordeaux","2-4",2,4,"1",1,6,-2,"D"
"8125",1966-01-30,1965,"RC Strasbourg","US Valenciennes-Anzin","0-0",0,0,"1",1,0,0,"D"
"8126",1966-01-30,1965,"Toulouse FC","AS Saint-Etienne","2-0",2,0,"1",1,2,2,"H"
"8127",1966-01-30,1965,"Nimes Olympique","UA Sedan-Torcy","1-0",1,0,"1",1,1,1,"H"
"8128",1966-01-30,1965,"RC Lens","Lille OSC","2-0",2,0,"1",1,2,2,"H"
"8129",1966-01-30,1965,"AS Monaco","OGC Nice","0-3",0,3,"1",1,3,-3,"D"
"8130",1966-01-30,1965,"FC Sochaux","Red Star FC","3-0",3,0,"1",1,3,3,"H"
"8131",1966-01-30,1965,"Olympique Lyon","FC Rouen","0-0",0,0,"1",1,0,0,"D"
"8132",1966-01-30,1965,"AS Cannes","Stade Rennes","1-0",1,0,"1",1,1,1,"H"
"8133",1966-02-06,1965,"FC Nantes","Toulouse FC","2-0",2,0,"1",1,2,2,"H"
"8134",1966-02-06,1965,"Girondins Bordeaux","Angers SCO","2-0",2,0,"1",1,2,2,"H"
"8135",1966-02-06,1965,"US Valenciennes-Anzin","FC Sochaux","0-0",0,0,"1",1,0,0,"D"
"8136",1966-02-06,1965,"AS Saint-Etienne","AS Cannes","1-1",1,1,"1",1,2,0,"D"
"8137",1966-02-06,1965,"FC Rouen","RC Lens","1-3",1,3,"1",1,4,-2,"D"
"8138",1966-02-06,1965,"UA Sedan-Torcy","AS Monaco","0-2",0,2,"1",1,2,-2,"D"
"8139",1966-02-06,1965,"Red Star FC","RC Strasbourg","2-2",2,2,"1",1,4,0,"D"
"8140",1966-02-06,1965,"Stade Rennes","Nimes Olympique","3-1",3,1,"1",1,4,2,"H"
"8141",1966-02-06,1965,"Lille OSC","Olympique Lyon","1-0",1,0,"1",1,1,1,"H"
"8142",1966-02-06,1965,"OGC Nice","Stade Francais FC","1-1",1,1,"1",1,2,0,"D"
"8143",1966-02-13,1965,"FC Rouen","AS Monaco","1-2",1,2,"1",1,3,-1,"D"
"8144",1966-02-16,1965,"UA Sedan-Torcy","RC Strasbourg","0-0",0,0,"1",1,0,0,"D"
"8145",1966-02-20,1965,"FC Nantes","Girondins Bordeaux","2-2",2,2,"1",1,4,0,"D"
"8146",1966-02-20,1965,"AS Monaco","US Valenciennes-Anzin","0-2",0,2,"1",1,2,-2,"D"
"8147",1966-02-20,1965,"RC Strasbourg","AS Saint-Etienne","0-1",0,1,"1",1,1,-1,"D"
"8148",1966-02-20,1965,"RC Lens","Nimes Olympique","1-1",1,1,"1",1,2,0,"D"
"8149",1966-02-20,1965,"FC Sochaux","Stade Rennes","3-2",3,2,"1",1,5,1,"H"
"8150",1966-02-20,1965,"Toulouse FC","OGC Nice","2-1",2,1,"1",1,3,1,"H"
"8151",1966-02-20,1965,"Olympique Lyon","Red Star FC","0-0",0,0,"1",1,0,0,"D"
"8152",1966-02-20,1965,"Angers SCO","Lille OSC","3-1",3,1,"1",1,4,2,"H"
"8153",1966-02-20,1965,"Stade Francais FC","FC Rouen","0-0",0,0,"1",1,0,0,"D"
"8154",1966-02-27,1965,"OGC Nice","FC Nantes","0-0",0,0,"1",1,0,0,"D"
"8155",1966-02-27,1965,"Girondins Bordeaux","RC Lens","2-1",2,1,"1",1,3,1,"H"
"8156",1966-02-27,1965,"US Valenciennes-Anzin","AS Cannes","3-0",3,0,"1",1,3,3,"H"
"8157",1966-02-27,1965,"AS Saint-Etienne","Angers SCO","4-0",4,0,"1",1,4,4,"H"
"8158",1966-02-27,1965,"UA Sedan-Torcy","Olympique Lyon","2-0",2,0,"1",1,2,2,"H"
"8159",1966-02-27,1965,"FC Rouen","Toulouse FC","0-1",0,1,"1",1,1,-1,"D"
"8160",1966-02-27,1965,"Red Star FC","AS Monaco","2-0",2,0,"1",1,2,2,"H"
"8161",1966-02-27,1965,"Nimes Olympique","FC Sochaux","1-0",1,0,"1",1,1,1,"H"
"8162",1966-02-27,1965,"Stade Rennes","RC Strasbourg","2-1",2,1,"1",1,3,1,"H"
"8163",1966-02-27,1965,"Lille OSC","Stade Francais FC","3-3",3,3,"1",1,6,0,"D"
"8164",1966-03-02,1965,"FC Nantes","FC Rouen","2-1",2,1,"1",1,3,1,"H"
"8165",1966-03-02,1965,"Girondins Bordeaux","Lille OSC","1-0",1,0,"1",1,1,1,"H"
"8166",1966-03-02,1965,"Stade Francais FC","AS Saint-Etienne","1-2",1,2,"1",1,3,-1,"D"
"8167",1966-03-02,1965,"RC Lens","OGC Nice","4-2",4,2,"1",1,6,2,"H"
"8168",1966-03-02,1965,"Angers SCO","UA Sedan-Torcy","2-0",2,0,"1",1,2,2,"H"
"8169",1966-03-02,1965,"Toulouse FC","FC Sochaux","1-1",1,1,"1",1,2,0,"D"
"8170",1966-03-02,1965,"AS Monaco","Stade Rennes","1-1",1,1,"1",1,2,0,"D"
"8171",1966-03-02,1965,"RC Strasbourg","Nimes Olympique","1-0",1,0,"1",1,1,1,"H"
"8172",1966-03-02,1965,"AS Cannes","Red Star FC","1-1",1,1,"1",1,2,0,"D"
"8173",1966-03-06,1965,"Lille OSC","FC Nantes","0-1",0,1,"1",1,1,-1,"D"
"8174",1966-03-06,1965,"FC Rouen","Girondins Bordeaux","0-0",0,0,"1",1,0,0,"D"
"8175",1966-03-06,1965,"US Valenciennes-Anzin","RC Lens","2-0",2,0,"1",1,2,2,"H"
"8176",1966-03-06,1965,"AS Saint-Etienne","Olympique Lyon","2-1",2,1,"1",1,3,1,"H"
"8177",1966-03-06,1965,"UA Sedan-Torcy","Toulouse FC","0-1",0,1,"1",1,1,-1,"D"
"8178",1966-03-06,1965,"FC Sochaux","RC Strasbourg","2-1",2,1,"1",1,3,1,"H"
"8179",1966-03-06,1965,"Nimes Olympique","AS Monaco","4-0",4,0,"1",1,4,4,"H"
"8180",1966-03-06,1965,"Stade Rennes","Angers SCO","4-4",4,4,"1",1,8,0,"D"
"8181",1966-03-06,1965,"OGC Nice","AS Cannes","1-1",1,1,"1",1,2,0,"D"
"8182",1966-03-06,1965,"Red Star FC","Stade Francais FC","1-5",1,5,"1",1,6,-4,"D"
"8183",1966-03-23,1965,"Angers SCO","RC Lens","3-2",3,2,"1",1,5,1,"H"
"8184",1966-03-26,1965,"FC Nantes","AS Saint-Etienne","5-0",5,0,"1",1,5,5,"H"
"8185",1966-03-26,1965,"Girondins Bordeaux","OGC Nice","0-2",0,2,"1",1,2,-2,"D"
"8186",1966-03-26,1965,"AS Monaco","FC Sochaux","1-1",1,1,"1",1,2,0,"D"
"8187",1966-03-26,1965,"Olympique Lyon","Stade Rennes","1-2",1,2,"1",1,3,-1,"D"
"8188",1966-03-26,1965,"Lille OSC","FC Rouen","2-1",2,1,"1",1,3,1,"H"
"8189",1966-03-27,1965,"Stade Francais FC","US Valenciennes-Anzin","1-1",1,1,"1",1,2,0,"D"
"8190",1966-03-27,1965,"Toulouse FC","Red Star FC","1-0",1,0,"1",1,1,1,"H"
"8191",1966-03-27,1965,"RC Lens","UA Sedan-Torcy","1-1",1,1,"1",1,2,0,"D"
"8192",1966-03-27,1965,"Angers SCO","RC Strasbourg","0-3",0,3,"1",1,3,-3,"D"
"8193",1966-03-27,1965,"AS Cannes","Nimes Olympique","1-2",1,2,"1",1,3,-1,"D"
"8194",1966-04-03,1965,"AS Cannes","UA Sedan-Torcy","2-1",2,1,"1",1,3,1,"H"
"8195",1966-04-08,1965,"Red Star FC","FC Nantes","0-3",0,3,"1",1,3,-3,"D"
"8196",1966-04-08,1965,"US Valenciennes-Anzin","Toulouse FC","1-1",1,1,"1",1,2,0,"D"
"8197",1966-04-08,1965,"AS Saint-Etienne","RC Lens","2-0",2,0,"1",1,2,2,"H"
"8198",1966-04-08,1965,"FC Sochaux","AS Cannes","3-1",3,1,"1",1,4,2,"H"
"8199",1966-04-08,1965,"RC Strasbourg","AS Monaco","1-1",1,1,"1",1,2,0,"D"
"8200",1966-04-08,1965,"Nimes Olympique","Olympique Lyon","0-0",0,0,"1",1,0,0,"D"
"8201",1966-04-08,1965,"FC Rouen","Angers SCO","4-0",4,0,"1",1,4,4,"H"
"8202",1966-04-09,1965,"Stade Rennes","Girondins Bordeaux","2-0",2,0,"1",1,2,2,"H"
"8203",1966-04-09,1965,"UA Sedan-Torcy","Stade Francais FC","0-0",0,0,"1",1,0,0,"D"
"8204",1966-04-10,1965,"OGC Nice","Lille OSC","2-0",2,0,"1",1,2,2,"H"
"8205",1966-04-13,1965,"FC Nantes","US Valenciennes-Anzin","1-1",1,1,"1",1,2,0,"D"
"8206",1966-04-13,1965,"Girondins Bordeaux","UA Sedan-Torcy","4-2",4,2,"1",1,6,2,"H"
"8207",1966-04-13,1965,"Lille OSC","AS Saint-Etienne","3-0",3,0,"1",1,3,3,"H"
"8208",1966-04-13,1965,"Toulouse FC","Nimes Olympique","3-0",3,0,"1",1,3,3,"H"
"8209",1966-04-13,1965,"Olympique Lyon","FC Sochaux","1-0",1,0,"1",1,1,1,"H"
"8210",1966-04-13,1965,"AS Cannes","AS Monaco","0-3",0,3,"1",1,3,-3,"D"
"8211",1966-04-13,1965,"RC Lens","RC Strasbourg","0-0",0,0,"1",1,0,0,"D"
"8212",1966-04-13,1965,"Stade Francais FC","Stade Rennes","2-1",2,1,"1",1,3,1,"H"
"8213",1966-04-13,1965,"Angers SCO","Red Star FC","2-2",2,2,"1",1,4,0,"D"
"8214",1966-04-13,1965,"FC Rouen","OGC Nice","1-0",1,0,"1",1,1,1,"H"
"8215",1966-04-17,1965,"UA Sedan-Torcy","FC Nantes","3-0",3,0,"1",1,3,3,"H"
"8216",1966-04-17,1965,"US Valenciennes-Anzin","Girondins Bordeaux","2-2",2,2,"1",1,4,0,"D"
"8217",1966-04-17,1965,"AS Saint-Etienne","FC Rouen","2-2",2,2,"1",1,4,0,"D"
"8218",1966-04-17,1965,"Stade Rennes","Toulouse FC","2-1",2,1,"1",1,3,1,"H"
"8219",1966-04-17,1965,"FC Sochaux","RC Lens","3-2",3,2,"1",1,5,1,"H"
"8220",1966-04-17,1965,"AS Monaco","Olympique Lyon","2-0",2,0,"1",1,2,2,"H"
"8221",1966-04-17,1965,"RC Strasbourg","AS Cannes","5-0",5,0,"1",1,5,5,"H"
"8222",1966-04-17,1965,"OGC Nice","Angers SCO","5-2",5,2,"1",1,7,3,"H"
"8223",1966-04-17,1965,"Nimes Olympique","Stade Francais FC","0-0",0,0,"1",1,0,0,"D"
"8224",1966-04-17,1965,"Red Star FC","Lille OSC","6-4",6,4,"1",1,10,2,"H"
"8225",1966-04-22,1965,"Toulouse FC","AS Cannes","6-1",6,1,"1",1,7,5,"H"
"8226",1966-04-23,1965,"FC Nantes","Stade Rennes","4-0",4,0,"1",1,4,4,"H"
"8227",1966-04-23,1965,"Girondins Bordeaux","Red Star FC","6-0",6,0,"1",1,6,6,"H"
"8228",1966-04-23,1965,"Lille OSC","US Valenciennes-Anzin","6-1",6,1,"1",1,7,5,"H"
"8229",1966-04-23,1965,"Stade Francais FC","FC Sochaux","1-1",1,1,"1",1,2,0,"D"
"8230",1966-04-23,1965,"RC Lens","AS Monaco","0-0",0,0,"1",1,0,0,"D"
"8231",1966-04-23,1965,"Olympique Lyon","RC Strasbourg","2-0",2,0,"1",1,2,2,"H"
"8232",1966-04-23,1965,"FC Rouen","UA Sedan-Torcy","3-1",3,1,"1",1,4,2,"H"
"8233",1966-04-23,1965,"Angers SCO","Nimes Olympique","3-0",3,0,"1",1,3,3,"H"
"8234",1966-04-24,1965,"OGC Nice","AS Saint-Etienne","4-2",4,2,"1",1,6,2,"H"
"8235",1966-04-28,1965,"Olympique Lyon","US Valenciennes-Anzin","0-1",0,1,"1",1,1,-1,"D"
"8236",1966-04-29,1965,"Red Star FC","Stade Rennes","0-2",0,2,"1",1,2,-2,"D"
"8237",1966-05-07,1965,"Nimes Olympique","FC Nantes","1-2",1,2,"1",1,3,-1,"D"
"8238",1966-05-07,1965,"US Valenciennes-Anzin","FC Rouen","1-1",1,1,"1",1,2,0,"D"
"8239",1966-05-07,1965,"AS Saint-Etienne","Girondins Bordeaux","2-1",2,1,"1",1,3,1,"H"
"8240",1966-05-07,1965,"FC Sochaux","Angers SCO","3-2",3,2,"1",1,5,1,"H"
"8241",1966-05-07,1965,"Stade Rennes","RC Lens","4-1",4,1,"1",1,5,3,"H"
"8242",1966-05-07,1965,"RC Strasbourg","Stade Francais FC","4-0",4,0,"1",1,4,4,"H"
"8243",1966-05-07,1965,"UA Sedan-Torcy","Lille OSC","1-0",1,0,"1",1,1,1,"H"
"8244",1966-05-07,1965,"AS Cannes","Olympique Lyon","0-0",0,0,"1",1,0,0,"D"
"8245",1966-05-08,1965,"Red Star FC","OGC Nice","2-3",2,3,"1",1,5,-1,"D"
"8246",1966-05-10,1965,"AS Monaco","Toulouse FC","2-3",2,3,"1",1,5,-1,"D"
"8247",1966-05-14,1965,"FC Nantes","FC Sochaux","2-1",2,1,"1",1,3,1,"H"
"8248",1966-05-14,1965,"Girondins Bordeaux","Nimes Olympique","5-2",5,2,"1",1,7,3,"H"
"8249",1966-05-14,1965,"AS Saint-Etienne","UA Sedan-Torcy","2-1",2,1,"1",1,3,1,"H"
"8250",1966-05-14,1965,"Lille OSC","Stade Rennes","1-3",1,3,"1",1,4,-2,"D"
"8251",1966-05-14,1965,"RC Lens","AS Cannes","1-0",1,0,"1",1,1,1,"H"
"8252",1966-05-14,1965,"Angers SCO","Olympique Lyon","4-1",4,1,"1",1,5,3,"H"
"8253",1966-05-14,1965,"FC Rouen","Red Star FC","1-0",1,0,"1",1,1,1,"H"
"8254",1966-05-15,1965,"OGC Nice","US Valenciennes-Anzin","1-1",1,1,"1",1,2,0,"D"
"8255",1966-05-15,1965,"Toulouse FC","RC Strasbourg","2-0",2,0,"1",1,2,2,"H"
"8256",1966-05-15,1965,"Stade Francais FC","AS Monaco","1-0",1,0,"1",1,1,1,"H"
"8257",1966-05-18,1965,"FC Sochaux","Girondins Bordeaux","0-1",0,1,"1",1,1,-1,"D"
"8258",1966-05-18,1965,"US Valenciennes-Anzin","AS Saint-Etienne","3-1",3,1,"1",1,4,2,"H"
"8259",1966-05-18,1965,"Olympique Lyon","Toulouse FC","0-1",0,1,"1",1,1,-1,"D"
"8260",1966-05-18,1965,"UA Sedan-Torcy","OGC Nice","2-0",2,0,"1",1,2,2,"H"
"8261",1966-05-18,1965,"AS Monaco","Angers SCO","1-3",1,3,"1",1,4,-2,"D"
"8262",1966-05-18,1965,"Nimes Olympique","Lille OSC","4-1",4,1,"1",1,5,3,"H"
"8263",1966-05-19,1965,"Red Star FC","RC Lens","1-2",1,2,"1",1,3,-1,"D"
"8264",1966-05-19,1965,"AS Cannes","Stade Francais FC","0-4",0,4,"1",1,4,-4,"D"
"8265",1966-05-21,1965,"Stade Rennes","FC Rouen","4-0",4,0,"1",1,4,4,"H"
"8266",1966-05-25,1965,"RC Strasbourg","FC Nantes","1-0",1,0,"1",1,1,1,"H"
"8267",1966-05-27,1965,"AS Saint-Etienne","Red Star FC","7-0",7,0,"1",1,7,7,"H"
"8268",1966-05-27,1965,"Lille OSC","FC Sochaux","2-1",2,1,"1",1,3,1,"H"
"8269",1966-05-27,1965,"Angers SCO","AS Cannes","4-1",4,1,"1",1,5,3,"H"
"8270",1966-05-27,1965,"FC Rouen","Nimes Olympique","1-0",1,0,"1",1,1,1,"H"
"8271",1966-05-27,1965,"Stade Francais FC","Olympique Lyon","0-1",0,1,"1",1,1,-1,"D"
"8272",1966-05-28,1965,"FC Nantes","AS Monaco","2-1",2,1,"1",1,3,1,"H"
"8273",1966-05-28,1965,"Girondins Bordeaux","RC Strasbourg","4-0",4,0,"1",1,4,4,"H"
"8274",1966-05-28,1965,"UA Sedan-Torcy","US Valenciennes-Anzin","2-2",2,2,"1",1,4,0,"D"
"8275",1966-05-28,1965,"RC Lens","Toulouse FC","0-1",0,1,"1",1,1,-1,"D"
"8276",1966-06-10,1965,"US Valenciennes-Anzin","Angers SCO","4-1",4,1,"1",1,5,3,"H"
"8277",1966-06-10,1965,"FC Sochaux","FC Rouen","4-0",4,0,"1",1,4,4,"H"
"8278",1966-06-10,1965,"Red Star FC","UA Sedan-Torcy","3-3",3,3,"1",1,6,0,"D"
"8279",1966-06-11,1965,"AS Cannes","FC Nantes","1-6",1,6,"1",1,7,-5,"D"
"8280",1966-06-11,1965,"Toulouse FC","Stade Francais FC","1-1",1,1,"1",1,2,0,"D"
"8281",1966-06-11,1965,"Stade Rennes","AS Saint-Etienne","2-0",2,0,"1",1,2,2,"H"
"8282",1966-06-11,1965,"RC Strasbourg","Lille OSC","4-1",4,1,"1",1,5,3,"H"
"8283",1966-06-11,1965,"Olympique Lyon","RC Lens","3-2",3,2,"1",1,5,1,"H"
"8284",1966-06-11,1965,"Nimes Olympique","OGC Nice","1-0",1,0,"1",1,1,1,"H"
"8285",1966-06-12,1965,"AS Monaco","Girondins Bordeaux","0-2",0,2,"1",1,2,-2,"D"
"8286",1966-06-15,1965,"OGC Nice","Stade Rennes","3-2",3,2,"1",1,5,1,"H"
"8287",1966-08-18,1966,"Girondins Bordeaux","Stade Rennes","2-0",2,0,"1",1,2,2,"H"
"8288",1966-08-19,1966,"Toulouse FC","AS Saint-Etienne","0-2",0,2,"1",1,2,-2,"D"
"8289",1966-08-19,1966,"Olympique Marseille","US Valenciennes-Anzin","2-1",2,1,"1",1,3,1,"H"
"8290",1966-08-20,1966,"FC Nantes","Olympique Lyon","5-2",5,2,"1",1,7,3,"H"
"8291",1966-08-20,1966,"RC Strasbourg","AS Monaco","4-2",4,2,"1",1,6,2,"H"
"8292",1966-08-20,1966,"Stade Reims","Lille OSC","0-1",0,1,"1",1,1,-1,"D"
"8293",1966-08-20,1966,"FC Rouen","Stade de Paris FC","0-1",0,1,"1",1,1,-1,"D"
"8294",1966-08-20,1966,"RC Lens","CS Sedan","2-2",2,2,"1",1,4,0,"D"
"8295",1966-08-21,1966,"OGC Nice","FC Sochaux","1-4",1,4,"1",1,5,-3,"D"
"8296",1966-08-21,1966,"Angers SCO","Nimes Olympique","1-2",1,2,"1",1,3,-1,"D"
"8297",1966-08-24,1966,"CS Sedan","FC Nantes","3-3",3,3,"1",1,6,0,"D"
"8298",1966-08-26,1966,"US Valenciennes-Anzin","Girondins Bordeaux","0-1",0,1,"1",1,1,-1,"D"
"8299",1966-08-26,1966,"Nimes Olympique","OGC Nice","1-1",1,1,"1",1,2,0,"D"
"8300",1966-08-27,1966,"FC Nantes","RC Lens","3-1",3,1,"1",1,4,2,"H"
"8301",1966-08-27,1966,"FC Sochaux","FC Rouen","3-0",3,0,"1",1,3,3,"H"
"8302",1966-08-27,1966,"AS Saint-Etienne","Olympique Marseille","2-0",2,0,"1",1,2,2,"H"
"8303",1966-08-27,1966,"Stade de Paris FC","RC Strasbourg","0-0",0,0,"1",1,0,0,"D"
"8304",1966-08-27,1966,"Lille OSC","Angers SCO","0-0",0,0,"1",1,0,0,"D"
"8305",1966-08-27,1966,"Stade Rennes","CS Sedan","5-0",5,0,"1",1,5,5,"H"
"8306",1966-08-27,1966,"AS Monaco","Olympique Lyon","4-0",4,0,"1",1,4,4,"H"
"8307",1966-08-27,1966,"Stade Reims","Toulouse FC","1-3",1,3,"1",1,4,-2,"D"
"8308",1966-08-31,1966,"OGC Nice","AS Saint-Etienne","1-2",1,2,"1",1,3,-1,"D"
"8309",1966-08-31,1966,"Olympique Lyon","FC Sochaux","0-0",0,0,"1",1,0,0,"D"
"8310",1966-08-31,1966,"RC Strasbourg","US Valenciennes-Anzin","4-1",4,1,"1",1,5,3,"H"
"8311",1966-08-31,1966,"Girondins Bordeaux","AS Monaco","1-1",1,1,"1",1,2,0,"D"
"8312",1966-08-31,1966,"Olympique Marseille","Stade de Paris FC","1-2",1,2,"1",1,3,-1,"D"
"8313",1966-08-31,1966,"Toulouse FC","Lille OSC","2-1",2,1,"1",1,3,1,"H"
"8314",1966-08-31,1966,"RC Lens","Stade Rennes","2-1",2,1,"1",1,3,1,"H"
"8315",1966-08-31,1966,"FC Rouen","Nimes Olympique","2-0",2,0,"1",1,2,2,"H"
"8316",1966-08-31,1966,"Angers SCO","Stade Reims","2-2",2,2,"1",1,4,0,"D"
"8317",1966-09-03,1966,"FC Nantes","Stade Rennes","1-0",1,0,"1",1,1,1,"H"
"8318",1966-09-03,1966,"AS Saint-Etienne","Girondins Bordeaux","1-1",1,1,"1",1,2,0,"D"
"8319",1966-09-03,1966,"FC Sochaux","Olympique Marseille","0-1",0,1,"1",1,1,-1,"D"
"8320",1966-09-03,1966,"Angers SCO","RC Strasbourg","3-1",3,1,"1",1,4,2,"H"
"8321",1966-09-03,1966,"Nimes Olympique","Toulouse FC","2-0",2,0,"1",1,2,2,"H"
"8322",1966-09-03,1966,"Stade de Paris FC","Olympique Lyon","0-1",0,1,"1",1,1,-1,"D"
"8323",1966-09-03,1966,"Stade Reims","OGC Nice","2-0",2,0,"1",1,2,2,"H"
"8324",1966-09-04,1966,"AS Monaco","CS Sedan","4-2",4,2,"1",1,6,2,"H"
"8325",1966-09-04,1966,"US Valenciennes-Anzin","RC Lens","1-3",1,3,"1",1,4,-2,"D"
"8326",1966-09-04,1966,"Lille OSC","FC Rouen","1-0",1,0,"1",1,1,1,"H"
"8327",1966-09-09,1966,"OGC Nice","Lille OSC","1-2",1,2,"1",1,3,-1,"D"
"8328",1966-09-09,1966,"Toulouse FC","Angers SCO","1-1",1,1,"1",1,2,0,"D"
"8329",1966-09-09,1966,"Olympique Lyon","US Valenciennes-Anzin","0-0",0,0,"1",1,0,0,"D"
"8330",1966-09-10,1966,"Girondins Bordeaux","FC Nantes","0-1",0,1,"1",1,1,-1,"D"
"8331",1966-09-10,1966,"RC Lens","Stade de Paris FC","4-1",4,1,"1",1,5,3,"H"
"8332",1966-09-10,1966,"RC Strasbourg","AS Saint-Etienne","2-1",2,1,"1",1,3,1,"H"
"8333",1966-09-10,1966,"CS Sedan","FC Sochaux","1-1",1,1,"1",1,2,0,"D"
"8334",1966-09-10,1966,"Olympique Marseille","Nimes Olympique","4-0",4,0,"1",1,4,4,"H"
"8335",1966-09-10,1966,"FC Rouen","Stade Reims","2-0",2,0,"1",1,2,2,"H"
"8336",1966-09-11,1966,"Stade Rennes","AS Monaco","3-1",3,1,"1",1,4,2,"H"
"8337",1966-09-14,1966,"AS Monaco","FC Nantes","0-0",0,0,"1",1,0,0,"D"
"8338",1966-09-14,1966,"AS Saint-Etienne","FC Rouen","3-0",3,0,"1",1,3,3,"H"
"8339",1966-09-14,1966,"Lille OSC","Olympique Marseille","0-0",0,0,"1",1,0,0,"D"
"8340",1966-09-14,1966,"FC Sochaux","Girondins Bordeaux","1-1",1,1,"1",1,2,0,"D"
"8341",1966-09-14,1966,"Toulouse FC","RC Lens","3-2",3,2,"1",1,5,1,"H"
"8342",1966-09-14,1966,"Nimes Olympique","RC Strasbourg","1-0",1,0,"1",1,1,1,"H"
"8343",1966-09-14,1966,"Angers SCO","OGC Nice","1-0",1,0,"1",1,1,1,"H"
"8344",1966-09-14,1966,"Stade de Paris FC","CS Sedan","1-1",1,1,"1",1,2,0,"D"
"8345",1966-09-14,1966,"Stade Reims","Olympique Lyon","2-0",2,0,"1",1,2,2,"H"
"8346",1966-09-14,1966,"US Valenciennes-Anzin","Stade Rennes","3-1",3,1,"1",1,4,2,"H"
"8347",1966-09-17,1966,"FC Nantes","FC Sochaux","1-1",1,1,"1",1,2,0,"D"
"8348",1966-09-17,1966,"Olympique Marseille","Stade Reims","0-0",0,0,"1",1,0,0,"D"
"8349",1966-09-17,1966,"Girondins Bordeaux","Stade de Paris FC","0-0",0,0,"1",1,0,0,"D"
"8350",1966-09-17,1966,"FC Rouen","Angers SCO","1-0",1,0,"1",1,1,1,"H"
"8351",1966-09-17,1966,"Olympique Lyon","Nimes Olympique","3-1",3,1,"1",1,4,2,"H"
"8352",1966-09-17,1966,"CS Sedan","US Valenciennes-Anzin","0-0",0,0,"1",1,0,0,"D"
"8353",1966-09-18,1966,"Stade Rennes","AS Saint-Etienne","1-1",1,1,"1",1,2,0,"D"
"8354",1966-09-18,1966,"RC Strasbourg","Lille OSC","3-1",3,1,"1",1,4,2,"H"
"8355",1966-09-18,1966,"RC Lens","AS Monaco","2-1",2,1,"1",1,3,1,"H"
"8356",1966-09-18,1966,"OGC Nice","Toulouse FC","3-1",3,1,"1",1,4,2,"H"
"8357",1966-09-23,1966,"AS Saint-Etienne","CS Sedan","1-0",1,0,"1",1,1,1,"H"
"8358",1966-09-23,1966,"FC Sochaux","RC Lens","2-5",2,5,"1",1,7,-3,"D"
"8359",1966-09-23,1966,"Stade de Paris FC","FC Nantes","1-0",1,0,"1",1,1,1,"H"
"8360",1966-09-23,1966,"Angers SCO","Olympique Marseille","5-0",5,0,"1",1,5,5,"H"
"8361",1966-09-23,1966,"Stade Reims","RC Strasbourg","2-1",2,1,"1",1,3,1,"H"
"8362",1966-09-23,1966,"Toulouse FC","FC Rouen","1-1",1,1,"1",1,2,0,"D"
"8363",1966-09-23,1966,"Nimes Olympique","Stade Rennes","1-2",1,2,"1",1,3,-1,"D"
"8364",1966-09-23,1966,"US Valenciennes-Anzin","AS Monaco","2-0",2,0,"1",1,2,2,"H"
"8365",1966-09-24,1966,"OGC Nice","Girondins Bordeaux","2-1",2,1,"1",1,3,1,"H"
"8366",1966-09-24,1966,"Lille OSC","Olympique Lyon","0-1",0,1,"1",1,1,-1,"D"
"8367",1966-10-01,1966,"FC Nantes","US Valenciennes-Anzin","3-1",3,1,"1",1,4,2,"H"
"8368",1966-10-01,1966,"Girondins Bordeaux","Nimes Olympique","2-0",2,0,"1",1,2,2,"H"
"8369",1966-10-01,1966,"Olympique Marseille","Toulouse FC","2-0",2,0,"1",1,2,2,"H"
"8370",1966-10-01,1966,"FC Rouen","OGC Nice","1-0",1,0,"1",1,1,1,"H"
"8371",1966-10-02,1966,"RC Lens","Lille OSC","1-1",1,1,"1",1,2,0,"D"
"8372",1966-10-02,1966,"Olympique Lyon","AS Saint-Etienne","3-0",3,0,"1",1,3,3,"H"
"8373",1966-10-02,1966,"Stade Rennes","Angers SCO","2-3",2,3,"1",1,5,-1,"D"
"8374",1966-10-02,1966,"RC Strasbourg","FC Sochaux","3-1",3,1,"1",1,4,2,"H"
"8375",1966-10-02,1966,"AS Monaco","Stade de Paris FC","0-1",0,1,"1",1,1,-1,"D"
"8376",1966-10-02,1966,"CS Sedan","Stade Reims","1-0",1,0,"1",1,1,1,"H"
"8377",1966-10-08,1966,"Nimes Olympique","RC Lens","1-2",1,2,"1",1,3,-1,"D"
"8378",1966-10-08,1966,"Toulouse FC","RC Strasbourg","1-1",1,1,"1",1,2,0,"D"
"8379",1966-10-08,1966,"Lille OSC","CS Sedan","2-2",2,2,"1",1,4,0,"D"
"8380",1966-10-08,1966,"Stade Reims","Girondins Bordeaux","4-1",4,1,"1",1,5,3,"H"
"8381",1966-10-08,1966,"FC Sochaux","AS Monaco","0-0",0,0,"1",1,0,0,"D"
"8382",1966-10-08,1966,"FC Rouen","Stade Rennes","1-0",1,0,"1",1,1,1,"H"
"8383",1966-10-09,1966,"AS Saint-Etienne","FC Nantes","3-3",3,3,"1",1,6,0,"D"
"8384",1966-10-09,1966,"Angers SCO","Olympique Lyon","0-2",0,2,"1",1,2,-2,"D"
"8385",1966-10-09,1966,"OGC Nice","Olympique Marseille","0-0",0,0,"1",1,0,0,"D"
"8386",1966-10-09,1966,"Stade de Paris FC","US Valenciennes-Anzin","0-2",0,2,"1",1,2,-2,"D"
"8387",1966-10-12,1966,"FC Nantes","Stade Reims","6-2",6,2,"1",1,8,4,"H"
"8388",1966-10-12,1966,"RC Lens","AS Saint-Etienne","2-0",2,0,"1",1,2,2,"H"
"8389",1966-10-12,1966,"AS Monaco","Angers SCO","1-5",1,5,"1",1,6,-4,"D"
"8390",1966-10-12,1966,"Olympique Lyon","Toulouse FC","1-1",1,1,"1",1,2,0,"D"
"8391",1966-10-12,1966,"Girondins Bordeaux","Lille OSC","1-3",1,3,"1",1,4,-2,"D"
"8392",1966-10-12,1966,"Olympique Marseille","FC Rouen","0-0",0,0,"1",1,0,0,"D"
"8393",1966-10-12,1966,"Stade Rennes","Stade de Paris FC","2-1",2,1,"1",1,3,1,"H"
"8394",1966-10-12,1966,"US Valenciennes-Anzin","FC Sochaux","2-0",2,0,"1",1,2,2,"H"
"8395",1966-10-12,1966,"CS Sedan","Nimes Olympique","2-2",2,2,"1",1,4,0,"D"
"8396",1966-10-15,1966,"FC Rouen","RC Lens","0-2",0,2,"1",1,2,-2,"D"
"8397",1966-10-15,1966,"AS Saint-Etienne","US Valenciennes-Anzin","3-1",3,1,"1",1,4,2,"H"
"8398",1966-10-15,1966,"Stade Reims","Stade Rennes","2-4",2,4,"1",1,6,-2,"D"
"8399",1966-10-15,1966,"FC Sochaux","Stade de Paris FC","3-0",3,0,"1",1,3,3,"H"
"8400",1966-10-16,1966,"Lille OSC","FC Nantes","2-4",2,4,"1",1,6,-2,"D"
"8401",1966-10-16,1966,"Olympique Marseille","RC Strasbourg","0-1",0,1,"1",1,1,-1,"D"
"8402",1966-10-16,1966,"Angers SCO","CS Sedan","2-5",2,5,"1",1,7,-3,"D"
"8403",1966-10-16,1966,"OGC Nice","Olympique Lyon","4-3",4,3,"1",1,7,1,"H"
"8404",1966-10-16,1966,"Toulouse FC","Girondins Bordeaux","2-1",2,1,"1",1,3,1,"H"
"8405",1966-10-16,1966,"Nimes Olympique","AS Monaco","3-2",3,2,"1",1,5,1,"H"
"8406",1966-10-28,1966,"FC Nantes","Nimes Olympique","5-3",5,3,"1",1,8,2,"H"
"8407",1966-10-28,1966,"RC Strasbourg","FC Rouen","1-0",1,0,"1",1,1,1,"H"
"8408",1966-10-30,1966,"RC Lens","OGC Nice","1-3",1,3,"1",1,4,-2,"D"
"8409",1966-10-30,1966,"Stade de Paris FC","AS Saint-Etienne","1-1",1,1,"1",1,2,0,"D"
"8410",1966-10-30,1966,"Girondins Bordeaux","Angers SCO","1-4",1,4,"1",1,5,-3,"D"
"8411",1966-10-30,1966,"Olympique Lyon","Olympique Marseille","2-2",2,2,"1",1,4,0,"D"
"8412",1966-10-30,1966,"CS Sedan","Toulouse FC","1-0",1,0,"1",1,1,1,"H"
"8413",1966-10-30,1966,"Stade Rennes","FC Sochaux","1-1",1,1,"1",1,2,0,"D"
"8414",1966-10-30,1966,"US Valenciennes-Anzin","Stade Reims","2-0",2,0,"1",1,2,2,"H"
"8415",1966-10-30,1966,"AS Monaco","Lille OSC","3-0",3,0,"1",1,3,3,"H"
"8416",1966-11-01,1966,"Angers SCO","FC Nantes","1-1",1,1,"1",1,2,0,"D"
"8417",1966-11-01,1966,"AS Saint-Etienne","FC Sochaux","1-0",1,0,"1",1,1,1,"H"
"8418",1966-11-01,1966,"RC Strasbourg","Girondins Bordeaux","0-3",0,3,"1",1,3,-3,"D"
"8419",1966-11-01,1966,"Nimes Olympique","Stade de Paris FC","0-1",0,1,"1",1,1,-1,"D"
"8420",1966-11-01,1966,"OGC Nice","CS Sedan","5-1",5,1,"1",1,6,4,"H"
"8421",1966-11-01,1966,"Stade Reims","AS Monaco","2-0",2,0,"1",1,2,2,"H"
"8422",1966-11-02,1966,"Olympique Marseille","RC Lens","1-0",1,0,"1",1,1,1,"H"
"8423",1966-11-02,1966,"FC Rouen","Olympique Lyon","3-2",3,2,"1",1,5,1,"H"
"8424",1966-11-02,1966,"Lille OSC","US Valenciennes-Anzin","1-0",1,0,"1",1,1,1,"H"
"8425",1966-11-02,1966,"Toulouse FC","Stade Rennes","1-1",1,1,"1",1,2,0,"D"
"8426",1966-11-06,1966,"FC Nantes","Toulouse FC","2-2",2,2,"1",1,4,0,"D"
"8427",1966-11-06,1966,"RC Lens","Angers SCO","1-1",1,1,"1",1,2,0,"D"
"8428",1966-11-06,1966,"Olympique Lyon","RC Strasbourg","2-1",2,1,"1",1,3,1,"H"
"8429",1966-11-06,1966,"Stade de Paris FC","Lille OSC","0-2",0,2,"1",1,2,-2,"D"
"8430",1966-11-06,1966,"Girondins Bordeaux","Olympique Marseille","2-0",2,0,"1",1,2,2,"H"
"8431",1966-11-06,1966,"CS Sedan","FC Rouen","1-0",1,0,"1",1,1,1,"H"
"8432",1966-11-06,1966,"Stade Rennes","OGC Nice","0-1",0,1,"1",1,1,-1,"D"
"8433",1966-11-06,1966,"US Valenciennes-Anzin","Nimes Olympique","2-0",2,0,"1",1,2,2,"H"
"8434",1966-11-06,1966,"FC Sochaux","Stade Reims","1-1",1,1,"1",1,2,0,"D"
"8435",1966-11-13,1966,"AS Saint-Etienne","Nimes Olympique","3-1",3,1,"1",1,4,2,"H"
"8436",1966-11-13,1966,"Olympique Lyon","Stade Rennes","2-2",2,2,"1",1,4,0,"D"
"8437",1966-11-13,1966,"Toulouse FC","AS Monaco","3-0",3,0,"1",1,3,3,"H"
"8438",1966-11-13,1966,"Olympique Marseille","CS Sedan","1-1",1,1,"1",1,2,0,"D"
"8439",1966-11-13,1966,"Stade Reims","Stade de Paris FC","1-0",1,0,"1",1,1,1,"H"
"8440",1966-11-15,1966,"OGC Nice","FC Nantes","3-1",3,1,"1",1,4,2,"H"
"8441",1966-11-15,1966,"Angers SCO","US Valenciennes-Anzin","3-1",3,1,"1",1,4,2,"H"
"8442",1966-11-15,1966,"RC Strasbourg","RC Lens","1-0",1,0,"1",1,1,1,"H"
"8443",1966-11-15,1966,"Lille OSC","FC Sochaux","6-0",6,0,"1",1,6,6,"H"
"8444",1966-11-15,1966,"FC Rouen","Girondins Bordeaux","1-1",1,1,"1",1,2,0,"D"
"8445",1966-11-19,1966,"AS Monaco","OGC Nice","0-0",0,0,"1",1,0,0,"D"
"8446",1966-11-20,1966,"FC Nantes","FC Rouen","0-0",0,0,"1",1,0,0,"D"
"8447",1966-11-20,1966,"AS Saint-Etienne","Lille OSC","4-1",4,1,"1",1,5,3,"H"
"8448",1966-11-20,1966,"RC Lens","Stade Reims","5-2",5,2,"1",1,7,3,"H"
"8449",1966-11-20,1966,"Stade de Paris FC","Angers SCO","1-1",1,1,"1",1,2,0,"D"
"8450",1966-11-20,1966,"CS Sedan","RC Strasbourg","3-0",3,0,"1",1,3,3,"H"
"8451",1966-11-20,1966,"Girondins Bordeaux","Olympique Lyon","4-1",4,1,"1",1,5,3,"H"
"8452",1966-11-20,1966,"Stade Rennes","Olympique Marseille","2-1",2,1,"1",1,3,1,"H"
"8453",1966-11-20,1966,"US Valenciennes-Anzin","Toulouse FC","2-0",2,0,"1",1,2,2,"H"
"8454",1966-11-20,1966,"FC Sochaux","Nimes Olympique","2-2",2,2,"1",1,4,0,"D"
"8455",1966-11-29,1966,"AS Monaco","AS Saint-Etienne","1-0",1,0,"1",1,1,1,"H"
"8456",1966-12-04,1966,"Stade Reims","AS Saint-Etienne","1-2",1,2,"1",1,3,-1,"D"
"8457",1966-12-04,1966,"Olympique Marseille","FC Nantes","1-0",1,0,"1",1,1,1,"H"
"8458",1966-12-04,1966,"Girondins Bordeaux","RC Lens","1-1",1,1,"1",1,2,0,"D"
"8459",1966-12-04,1966,"Angers SCO","FC Sochaux","1-1",1,1,"1",1,2,0,"D"
"8460",1966-12-04,1966,"Lille OSC","Nimes Olympique","4-0",4,0,"1",1,4,4,"H"
"8461",1966-12-04,1966,"RC Strasbourg","Stade Rennes","5-3",5,3,"1",1,8,2,"H"
"8462",1966-12-04,1966,"Olympique Lyon","CS Sedan","0-3",0,3,"1",1,3,-3,"D"
"8463",1966-12-04,1966,"OGC Nice","US Valenciennes-Anzin","5-2",5,2,"1",1,7,3,"H"
"8464",1966-12-04,1966,"Toulouse FC","Stade de Paris FC","0-0",0,0,"1",1,0,0,"D"
"8465",1966-12-04,1966,"FC Rouen","AS Monaco","0-0",0,0,"1",1,0,0,"D"
"8466",1966-12-11,1966,"AS Saint-Etienne","Angers SCO","4-2",4,2,"1",1,6,2,"H"
"8467",1966-12-11,1966,"FC Nantes","RC Strasbourg","4-0",4,0,"1",1,4,4,"H"
"8468",1966-12-11,1966,"RC Lens","Olympique Lyon","4-1",4,1,"1",1,5,3,"H"
"8469",1966-12-11,1966,"Stade Rennes","Lille OSC","1-2",1,2,"1",1,3,-1,"D"
"8470",1966-12-11,1966,"CS Sedan","Girondins Bordeaux","0-3",0,3,"1",1,3,-3,"D"
"8471",1966-12-11,1966,"AS Monaco","Olympique Marseille","0-1",0,1,"1",1,1,-1,"D"
"8472",1966-12-11,1966,"Stade de Paris FC","OGC Nice","2-0",2,0,"1",1,2,2,"H"
"8473",1966-12-11,1966,"US Valenciennes-Anzin","FC Rouen","3-0",3,0,"1",1,3,3,"H"
"8474",1966-12-11,1966,"FC Sochaux","Toulouse FC","1-0",1,0,"1",1,1,1,"H"
"8475",1966-12-11,1966,"Nimes Olympique","Stade Reims","2-2",2,2,"1",1,4,0,"D"
"8476",1966-12-14,1966,"RC Strasbourg","OGC Nice","3-1",3,1,"1",1,4,2,"H"
"8477",1966-12-18,1966,"AS Saint-Etienne","Toulouse FC","3-0",3,0,"1",1,3,3,"H"
"8478",1966-12-18,1966,"Olympique Lyon","FC Nantes","1-2",1,2,"1",1,3,-1,"D"
"8479",1966-12-18,1966,"CS Sedan","RC Lens","3-0",3,0,"1",1,3,3,"H"
"8480",1966-12-18,1966,"Nimes Olympique","Angers SCO","1-4",1,4,"1",1,5,-3,"D"
"8481",1966-12-18,1966,"Lille OSC","Stade Reims","1-1",1,1,"1",1,2,0,"D"
"8482",1966-12-18,1966,"AS Monaco","RC Strasbourg","1-1",1,1,"1",1,2,0,"D"
"8483",1966-12-18,1966,"Stade Rennes","Girondins Bordeaux","0-1",0,1,"1",1,1,-1,"D"
"8484",1966-12-18,1966,"US Valenciennes-Anzin","Olympique Marseille","2-1",2,1,"1",1,3,1,"H"
"8485",1966-12-18,1966,"FC Sochaux","OGC Nice","4-0",4,0,"1",1,4,4,"H"
"8486",1966-12-18,1966,"Stade de Paris FC","FC Rouen","1-2",1,2,"1",1,3,-1,"D"
"8487",1967-01-08,1966,"Olympique Marseille","AS Saint-Etienne","2-2",2,2,"1",1,4,0,"D"
"8488",1967-01-08,1966,"RC Lens","FC Nantes","4-0",4,0,"1",1,4,4,"H"
"8489",1967-01-08,1966,"Angers SCO","Lille OSC","2-1",2,1,"1",1,3,1,"H"
"8490",1967-01-08,1966,"RC Strasbourg","Stade de Paris FC","1-0",1,0,"1",1,1,1,"H"
"8491",1967-01-08,1966,"CS Sedan","Stade Rennes","4-0",4,0,"1",1,4,4,"H"
"8492",1967-01-08,1966,"Girondins Bordeaux","US Valenciennes-Anzin","0-0",0,0,"1",1,0,0,"D"
"8493",1967-01-08,1966,"OGC Nice","Nimes Olympique","4-1",4,1,"1",1,5,3,"H"
"8494",1967-01-22,1966,"AS Saint-Etienne","OGC Nice","7-0",7,0,"1",1,7,7,"H"
"8495",1967-01-22,1966,"FC Nantes","CS Sedan","3-1",3,1,"1",1,4,2,"H"
"8496",1967-01-22,1966,"Stade Reims","Angers SCO","0-3",0,3,"1",1,3,-3,"D"
"8497",1967-01-22,1966,"Stade Rennes","RC Lens","3-0",3,0,"1",1,3,3,"H"
"8498",1967-01-22,1966,"Lille OSC","Toulouse FC","3-1",3,1,"1",1,4,2,"H"
"8499",1967-01-22,1966,"US Valenciennes-Anzin","RC Strasbourg","1-0",1,0,"1",1,1,1,"H"
"8500",1967-01-22,1966,"AS Monaco","Girondins Bordeaux","1-1",1,1,"1",1,2,0,"D"
"8501",1967-01-22,1966,"FC Sochaux","Olympique Lyon","1-1",1,1,"1",1,2,0,"D"
"8502",1967-01-22,1966,"Nimes Olympique","FC Rouen","1-0",1,0,"1",1,1,1,"H"
"8503",1967-01-28,1966,"OGC Nice","Stade Reims","1-0",1,0,"1",1,1,1,"H"
"8504",1967-01-29,1966,"Girondins Bordeaux","AS Saint-Etienne","1-0",1,0,"1",1,1,1,"H"
"8505",1967-01-29,1966,"Stade Rennes","FC Nantes","2-2",2,2,"1",1,4,0,"D"
"8506",1967-01-29,1966,"RC Strasbourg","Angers SCO","0-0",0,0,"1",1,0,0,"D"
"8507",1967-01-29,1966,"RC Lens","US Valenciennes-Anzin","0-0",0,0,"1",1,0,0,"D"
"8508",1967-01-29,1966,"FC Rouen","Lille OSC","3-0",3,0,"1",1,3,3,"H"
"8509",1967-01-29,1966,"CS Sedan","AS Monaco","1-1",1,1,"1",1,2,0,"D"
"8510",1967-01-29,1966,"Olympique Marseille","FC Sochaux","1-0",1,0,"1",1,1,1,"H"
"8511",1967-01-29,1966,"Olympique Lyon","Stade de Paris FC","0-0",0,0,"1",1,0,0,"D"
"8512",1967-01-29,1966,"Toulouse FC","Nimes Olympique","0-1",0,1,"1",1,1,-1,"D"
"8513",1967-02-05,1966,"AS Saint-Etienne","RC Strasbourg","2-1",2,1,"1",1,3,1,"H"
"8514",1967-02-05,1966,"FC Nantes","Girondins Bordeaux","1-1",1,1,"1",1,2,0,"D"
"8515",1967-02-05,1966,"Angers SCO","Toulouse FC","1-1",1,1,"1",1,2,0,"D"
"8516",1967-02-05,1966,"Stade de Paris FC","RC Lens","0-1",0,1,"1",1,1,-1,"D"
"8517",1967-02-05,1966,"Lille OSC","OGC Nice","3-0",3,0,"1",1,3,3,"H"
"8518",1967-02-05,1966,"US Valenciennes-Anzin","Olympique Lyon","0-0",0,0,"1",1,0,0,"D"
"8519",1967-02-05,1966,"FC Sochaux","CS Sedan","1-0",1,0,"1",1,1,1,"H"
"8520",1967-02-05,1966,"Nimes Olympique","Olympique Marseille","0-1",0,1,"1",1,1,-1,"D"
"8521",1967-02-05,1966,"Stade Reims","FC Rouen","1-0",1,0,"1",1,1,1,"H"
"8522",1967-02-05,1966,"AS Monaco","Stade Rennes","0-0",0,0,"1",1,0,0,"D"
"8523",1967-02-12,1966,"Toulouse FC","Stade Reims","1-0",1,0,"1",1,1,1,"H"
"8524",1967-02-19,1966,"FC Rouen","AS Saint-Etienne","0-1",0,1,"1",1,1,-1,"D"
"8525",1967-02-19,1966,"OGC Nice","Angers SCO","3-1",3,1,"1",1,4,2,"H"
"8526",1967-02-19,1966,"Girondins Bordeaux","FC Sochaux","1-0",1,0,"1",1,1,1,"H"
"8527",1967-02-19,1966,"Olympique Marseille","Lille OSC","2-1",2,1,"1",1,3,1,"H"
"8528",1967-02-19,1966,"CS Sedan","Stade de Paris FC","0-0",0,0,"1",1,0,0,"D"
"8529",1967-02-19,1966,"RC Strasbourg","Nimes Olympique","1-2",1,2,"1",1,3,-1,"D"
"8530",1967-02-19,1966,"Stade Rennes","US Valenciennes-Anzin","1-0",1,0,"1",1,1,1,"H"
"8531",1967-02-19,1966,"Olympique Lyon","Stade Reims","3-1",3,1,"1",1,4,2,"H"
"8532",1967-02-26,1966,"AS Saint-Etienne","Stade Rennes","4-1",4,1,"1",1,5,3,"H"
"8533",1967-02-26,1966,"FC Sochaux","FC Nantes","1-1",1,1,"1",1,2,0,"D"
"8534",1967-02-26,1966,"Angers SCO","FC Rouen","5-2",5,2,"1",1,7,3,"H"
"8535",1967-02-26,1966,"Stade de Paris FC","Girondins Bordeaux","0-0",0,0,"1",1,0,0,"D"
"8536",1967-02-26,1966,"AS Monaco","RC Lens","2-1",2,1,"1",1,3,1,"H"
"8537",1967-02-26,1966,"Lille OSC","RC Strasbourg","2-1",2,1,"1",1,3,1,"H"
"8538",1967-02-26,1966,"US Valenciennes-Anzin","CS Sedan","0-0",0,0,"1",1,0,0,"D"
"8539",1967-02-26,1966,"Stade Reims","Olympique Marseille","1-0",1,0,"1",1,1,1,"H"
"8540",1967-02-26,1966,"Toulouse FC","OGC Nice","3-0",3,0,"1",1,3,3,"H"
"8541",1967-02-26,1966,"Nimes Olympique","Olympique Lyon","1-0",1,0,"1",1,1,1,"H"
"8542",1967-03-04,1966,"CS Sedan","AS Saint-Etienne","1-0",1,0,"1",1,1,1,"H"
"8543",1967-03-04,1966,"FC Nantes","Stade de Paris FC","3-0",3,0,"1",1,3,3,"H"
"8544",1967-03-05,1966,"Olympique Marseille","Angers SCO","1-1",1,1,"1",1,2,0,"D"
"8545",1967-03-05,1966,"Olympique Lyon","Lille OSC","0-1",0,1,"1",1,1,-1,"D"
"8546",1967-03-05,1966,"Girondins Bordeaux","OGC Nice","1-1",1,1,"1",1,2,0,"D"
"8547",1967-03-05,1966,"RC Lens","FC Sochaux","1-1",1,1,"1",1,2,0,"D"
"8548",1967-03-05,1966,"RC Strasbourg","Stade Reims","5-0",5,0,"1",1,5,5,"H"
"8549",1967-03-05,1966,"AS Monaco","US Valenciennes-Anzin","2-2",2,2,"1",1,4,0,"D"
"8550",1967-03-05,1966,"Stade Rennes","Nimes Olympique","3-0",3,0,"1",1,3,3,"H"
"8551",1967-03-05,1966,"FC Rouen","Toulouse FC","0-2",0,2,"1",1,2,-2,"D"
"8552",1967-03-17,1966,"Toulouse FC","Olympique Marseille","1-0",1,0,"1",1,1,1,"H"
"8553",1967-03-18,1966,"FC Sochaux","RC Strasbourg","1-0",1,0,"1",1,1,1,"H"
"8554",1967-03-19,1966,"AS Saint-Etienne","Olympique Lyon","2-1",2,1,"1",1,3,1,"H"
"8555",1967-03-19,1966,"US Valenciennes-Anzin","FC Nantes","0-0",0,0,"1",1,0,0,"D"
"8556",1967-03-19,1966,"Angers SCO","Stade Rennes","0-0",0,0,"1",1,0,0,"D"
"8557",1967-03-19,1966,"Lille OSC","RC Lens","2-1",2,1,"1",1,3,1,"H"
"8558",1967-03-19,1966,"Nimes Olympique","Girondins Bordeaux","1-2",1,2,"1",1,3,-1,"D"
"8559",1967-03-19,1966,"Stade Reims","CS Sedan","1-4",1,4,"1",1,5,-3,"D"
"8560",1967-03-19,1966,"OGC Nice","FC Rouen","2-0",2,0,"1",1,2,2,"H"
"8561",1967-03-19,1966,"Stade de Paris FC","AS Monaco","1-1",1,1,"1",1,2,0,"D"
"8562",1967-03-23,1966,"RC Strasbourg","Toulouse FC","4-0",4,0,"1",1,4,4,"H"
"8563",1967-03-24,1966,"Girondins Bordeaux","Stade Reims","1-0",1,0,"1",1,1,1,"H"
"8564",1967-03-24,1966,"US Valenciennes-Anzin","Stade de Paris FC","2-0",2,0,"1",1,2,2,"H"
"8565",1967-03-25,1966,"FC Nantes","AS Saint-Etienne","4-1",4,1,"1",1,5,3,"H"
"8566",1967-03-25,1966,"Olympique Lyon","Angers SCO","1-1",1,1,"1",1,2,0,"D"
"8567",1967-03-25,1966,"CS Sedan","Lille OSC","4-1",4,1,"1",1,5,3,"H"
"8568",1967-03-25,1966,"RC Lens","Nimes Olympique","2-1",2,1,"1",1,3,1,"H"
"8569",1967-03-25,1966,"Olympique Marseille","OGC Nice","1-1",1,1,"1",1,2,0,"D"
"8570",1967-03-25,1966,"Stade Rennes","FC Rouen","2-1",2,1,"1",1,3,1,"H"
"8571",1967-03-26,1966,"AS Monaco","FC Sochaux","3-0",3,0,"1",1,3,3,"H"
"8572",1967-04-05,1966,"Olympique Lyon","AS Monaco","1-0",1,0,"1",1,1,1,"H"
"8573",1967-04-07,1966,"OGC Nice","RC Strasbourg","2-1",2,1,"1",1,3,1,"H"
"8574",1967-04-08,1966,"AS Saint-Etienne","RC Lens","4-0",4,0,"1",1,4,4,"H"
"8575",1967-04-08,1966,"Stade Reims","FC Nantes","1-1",1,1,"1",1,2,0,"D"
"8576",1967-04-08,1966,"Lille OSC","Girondins Bordeaux","1-2",1,2,"1",1,3,-1,"D"
"8577",1967-04-08,1966,"Nimes Olympique","CS Sedan","2-2",2,2,"1",1,4,0,"D"
"8578",1967-04-08,1966,"FC Sochaux","US Valenciennes-Anzin","0-1",0,1,"1",1,1,-1,"D"
"8579",1967-04-08,1966,"FC Rouen","Olympique Marseille","5-1",5,1,"1",1,6,4,"H"
"8580",1967-04-08,1966,"Toulouse FC","Olympique Lyon","2-2",2,2,"1",1,4,0,"D"
"8581",1967-04-09,1966,"Angers SCO","AS Monaco","0-0",0,0,"1",1,0,0,"D"
"8582",1967-04-09,1966,"Stade de Paris FC","Stade Rennes","0-2",0,2,"1",1,2,-2,"D"
"8583",1967-04-14,1966,"Olympique Lyon","OGC Nice","1-0",1,0,"1",1,1,1,"H"
"8584",1967-04-15,1966,"FC Nantes","Lille OSC","4-0",4,0,"1",1,4,4,"H"
"8585",1967-04-15,1966,"Girondins Bordeaux","Toulouse FC","2-1",2,1,"1",1,3,1,"H"
"8586",1967-04-15,1966,"RC Lens","FC Rouen","1-1",1,1,"1",1,2,0,"D"
"8587",1967-04-15,1966,"Stade Rennes","Stade Reims","3-0",3,0,"1",1,3,3,"H"
"8588",1967-04-15,1966,"AS Monaco","Nimes Olympique","0-1",0,1,"1",1,1,-1,"D"
"8589",1967-04-16,1966,"US Valenciennes-Anzin","AS Saint-Etienne","0-3",0,3,"1",1,3,-3,"D"
"8590",1967-04-16,1966,"CS Sedan","Angers SCO","1-1",1,1,"1",1,2,0,"D"
"8591",1967-04-16,1966,"RC Strasbourg","Olympique Marseille","2-1",2,1,"1",1,3,1,"H"
"8592",1967-04-16,1966,"Stade de Paris FC","FC Sochaux","0-3",0,3,"1",1,3,-3,"D"
"8593",1967-04-22,1966,"RC Lens","Toulouse FC","0-0",0,0,"1",1,0,0,"D"
"8594",1967-04-23,1966,"Stade de Paris FC","Olympique Marseille","0-2",0,2,"1",1,2,-2,"D"
"8595",1967-04-23,1966,"FC Nantes","AS Monaco","2-1",2,1,"1",1,3,1,"H"
"8596",1967-04-25,1966,"FC Rouen","FC Sochaux","3-0",3,0,"1",1,3,3,"H"
"8597",1967-04-28,1966,"AS Saint-Etienne","Stade de Paris FC","7-1",7,1,"1",1,8,6,"H"
"8598",1967-04-28,1966,"Toulouse FC","CS Sedan","2-3",2,3,"1",1,5,-1,"D"
"8599",1967-04-28,1966,"Lille OSC","AS Monaco","2-1",2,1,"1",1,3,1,"H"
"8600",1967-04-28,1966,"OGC Nice","RC Lens","1-0",1,0,"1",1,1,1,"H"
"8601",1967-04-28,1966,"Olympique Marseille","Olympique Lyon","4-1",4,1,"1",1,5,3,"H"
"8602",1967-04-29,1966,"Nimes Olympique","FC Nantes","1-0",1,0,"1",1,1,1,"H"
"8603",1967-04-29,1966,"Angers SCO","Girondins Bordeaux","2-0",2,0,"1",1,2,2,"H"
"8604",1967-04-29,1966,"FC Rouen","RC Strasbourg","0-0",0,0,"1",1,0,0,"D"
"8605",1967-04-29,1966,"Stade Reims","US Valenciennes-Anzin","1-0",1,0,"1",1,1,1,"H"
"8606",1967-05-03,1966,"FC Sochaux","AS Saint-Etienne","0-3",0,3,"1",1,3,-3,"D"
"8607",1967-05-03,1966,"FC Nantes","Angers SCO","2-1",2,1,"1",1,3,1,"H"
"8608",1967-05-03,1966,"Girondins Bordeaux","RC Strasbourg","4-1",4,1,"1",1,5,3,"H"
"8609",1967-05-03,1966,"CS Sedan","OGC Nice","0-1",0,1,"1",1,1,-1,"D"
"8610",1967-05-03,1966,"RC Lens","Olympique Marseille","2-2",2,2,"1",1,4,0,"D"
"8611",1967-05-03,1966,"Stade Rennes","Toulouse FC","1-2",1,2,"1",1,3,-1,"D"
"8612",1967-05-03,1966,"Stade de Paris FC","Nimes Olympique","1-2",1,2,"1",1,3,-1,"D"
"8613",1967-05-03,1966,"AS Monaco","Stade Reims","5-0",5,0,"1",1,5,5,"H"
"8614",1967-05-04,1966,"US Valenciennes-Anzin","Lille OSC","3-0",3,0,"1",1,3,3,"H"
"8615",1967-05-06,1966,"Toulouse FC","FC Nantes","2-2",2,2,"1",1,4,0,"D"
"8616",1967-05-06,1966,"Olympique Marseille","Girondins Bordeaux","3-2",3,2,"1",1,5,1,"H"
"8617",1967-05-06,1966,"Angers SCO","RC Lens","2-0",2,0,"1",1,2,2,"H"
"8618",1967-05-06,1966,"FC Rouen","CS Sedan","3-0",3,0,"1",1,3,3,"H"
"8619",1967-05-06,1966,"Nimes Olympique","US Valenciennes-Anzin","1-2",1,2,"1",1,3,-1,"D"
"8620",1967-05-06,1966,"Lille OSC","Stade de Paris FC","0-0",0,0,"1",1,0,0,"D"
"8621",1967-05-06,1966,"RC Strasbourg","Olympique Lyon","0-0",0,0,"1",1,0,0,"D"
"8622",1967-05-06,1966,"Stade Reims","FC Sochaux","1-1",1,1,"1",1,2,0,"D"
"8623",1967-05-07,1966,"AS Saint-Etienne","AS Monaco","1-3",1,3,"1",1,4,-2,"D"
"8624",1967-05-07,1966,"OGC Nice","Stade Rennes","4-0",4,0,"1",1,4,4,"H"
"8625",1967-05-12,1966,"Girondins Bordeaux","FC Rouen","3-0",3,0,"1",1,3,3,"H"
"8626",1967-05-12,1966,"US Valenciennes-Anzin","Angers SCO","0-0",0,0,"1",1,0,0,"D"
"8627",1967-05-12,1966,"FC Sochaux","Lille OSC","1-0",1,0,"1",1,1,1,"H"
"8628",1967-05-13,1966,"Nimes Olympique","AS Saint-Etienne","1-1",1,1,"1",1,2,0,"D"
"8629",1967-05-13,1966,"FC Nantes","OGC Nice","4-1",4,1,"1",1,5,3,"H"
"8630",1967-05-13,1966,"CS Sedan","Olympique Marseille","0-0",0,0,"1",1,0,0,"D"
"8631",1967-05-13,1966,"RC Lens","RC Strasbourg","2-1",2,1,"1",1,3,1,"H"
"8632",1967-05-13,1966,"Stade Rennes","Olympique Lyon","4-0",4,0,"1",1,4,4,"H"
"8633",1967-05-13,1966,"AS Monaco","Toulouse FC","1-0",1,0,"1",1,1,1,"H"
"8634",1967-05-14,1966,"Stade de Paris FC","Stade Reims","0-1",0,1,"1",1,1,-1,"D"
"8635",1967-05-19,1966,"Toulouse FC","US Valenciennes-Anzin","0-2",0,2,"1",1,2,-2,"D"
"8636",1967-05-19,1966,"Olympique Marseille","Stade Rennes","1-1",1,1,"1",1,2,0,"D"
"8637",1967-05-19,1966,"Stade Reims","RC Lens","4-0",4,0,"1",1,4,4,"H"
"8638",1967-05-20,1966,"Lille OSC","AS Saint-Etienne","0-1",0,1,"1",1,1,-1,"D"
"8639",1967-05-20,1966,"FC Rouen","FC Nantes","3-3",3,3,"1",1,6,0,"D"
"8640",1967-05-20,1966,"Angers SCO","Stade de Paris FC","1-1",1,1,"1",1,2,0,"D"
"8641",1967-05-20,1966,"RC Strasbourg","CS Sedan","0-0",0,0,"1",1,0,0,"D"
"8642",1967-05-21,1966,"OGC Nice","AS Monaco","0-0",0,0,"1",1,0,0,"D"
"8643",1967-05-24,1966,"Nimes Olympique","FC Sochaux","3-0",3,0,"1",1,3,3,"H"
"8644",1967-05-24,1966,"Olympique Lyon","Girondins Bordeaux","1-0",1,0,"1",1,1,1,"H"
"8645",1967-05-27,1966,"RC Lens","Girondins Bordeaux","3-2",3,2,"1",1,5,1,"H"
"8646",1967-05-27,1966,"Stade Rennes","RC Strasbourg","4-3",4,3,"1",1,7,1,"H"
"8647",1967-05-28,1966,"AS Saint-Etienne","Stade Reims","3-0",3,0,"1",1,3,3,"H"
"8648",1967-05-28,1966,"FC Nantes","Olympique Marseille","3-3",3,3,"1",1,6,0,"D"
"8649",1967-05-28,1966,"FC Sochaux","Angers SCO","2-5",2,5,"1",1,7,-3,"D"
"8650",1967-05-28,1966,"CS Sedan","Olympique Lyon","0-0",0,0,"1",1,0,0,"D"
"8651",1967-05-28,1966,"US Valenciennes-Anzin","OGC Nice","0-1",0,1,"1",1,1,-1,"D"
"8652",1967-05-28,1966,"Nimes Olympique","Lille OSC","0-0",0,0,"1",1,0,0,"D"
"8653",1967-05-28,1966,"AS Monaco","FC Rouen","0-0",0,0,"1",1,0,0,"D"
"8654",1967-05-28,1966,"Stade de Paris FC","Toulouse FC","0-0",0,0,"1",1,0,0,"D"
"8655",1967-06-02,1966,"Olympique Lyon","FC Rouen","1-1",1,1,"1",1,2,0,"D"
"8656",1967-06-07,1966,"FC Sochaux","Stade Rennes","3-1",3,1,"1",1,4,2,"H"
"8657",1967-06-09,1966,"OGC Nice","Stade de Paris FC","0-0",0,0,"1",1,0,0,"D"
"8658",1967-06-10,1966,"RC Strasbourg","FC Nantes","1-1",1,1,"1",1,2,0,"D"
"8659",1967-06-10,1966,"Girondins Bordeaux","CS Sedan","2-5",2,5,"1",1,7,-3,"D"
"8660",1967-06-10,1966,"FC Rouen","US Valenciennes-Anzin","1-1",1,1,"1",1,2,0,"D"
"8661",1967-06-10,1966,"Olympique Lyon","RC Lens","0-0",0,0,"1",1,0,0,"D"
"8662",1967-06-10,1966,"Olympique Marseille","AS Monaco","1-2",1,2,"1",1,3,-1,"D"
"8663",1967-06-10,1966,"Lille OSC","Stade Rennes","0-0",0,0,"1",1,0,0,"D"
"8664",1967-06-10,1966,"Toulouse FC","FC Sochaux","1-2",1,2,"1",1,3,-1,"D"
"8665",1967-06-10,1966,"Stade Reims","Nimes Olympique","1-1",1,1,"1",1,2,0,"D"
"8666",1967-06-11,1966,"Angers SCO","AS Saint-Etienne","0-3",0,3,"1",1,3,-3,"D"
"8667",1967-08-17,1967,"Olympique Marseille","FC Nantes","1-0",1,0,"1",1,1,1,"H"
"8668",1967-08-18,1967,"Olympique Lyon","AC Ajaccio","2-1",2,1,"1",1,3,1,"H"
"8669",1967-08-18,1967,"RC Strasbourg","AS Saint-Etienne","0-1",0,1,"1",1,1,-1,"D"
"8670",1967-08-18,1967,"Lille OSC","AS Aixoise","2-1",2,1,"1",1,3,1,"H"
"8671",1967-08-19,1967,"Angers SCO","FC Rouen","3-0",3,0,"1",1,3,3,"H"
"8672",1967-08-19,1967,"FC Sochaux","OGC Nice","0-2",0,2,"1",1,2,-2,"D"
"8673",1967-08-19,1967,"Stade Rennes","RC Lens","1-0",1,0,"1",1,1,1,"H"
"8674",1967-08-19,1967,"CS Sedan","US Valenciennes-Anzin","1-1",1,1,"1",1,2,0,"D"
"8675",1967-08-19,1967,"FC Metz","Red Star FC","1-1",1,1,"1",1,2,0,"D"
"8676",1967-08-20,1967,"AS Monaco","Girondins Bordeaux","1-2",1,2,"1",1,3,-1,"D"
"8677",1967-08-24,1967,"Lille OSC","Olympique Lyon","1-1",1,1,"1",1,2,0,"D"
"8678",1967-08-25,1967,"AS Saint-Etienne","RC Lens","3-0",3,0,"1",1,3,3,"H"
"8679",1967-08-25,1967,"OGC Nice","CS Sedan","1-0",1,0,"1",1,1,1,"H"
"8680",1967-08-25,1967,"Girondins Bordeaux","Olympique Marseille","1-2",1,2,"1",1,3,-1,"D"
"8681",1967-08-25,1967,"AS Aixoise","Angers SCO","1-3",1,3,"1",1,4,-2,"D"
"8682",1967-08-26,1967,"US Valenciennes-Anzin","FC Metz","1-2",1,2,"1",1,3,-1,"D"
"8683",1967-08-26,1967,"FC Nantes","RC Strasbourg","3-0",3,0,"1",1,3,3,"H"
"8684",1967-08-26,1967,"FC Rouen","FC Sochaux","1-0",1,0,"1",1,1,1,"H"
"8685",1967-08-27,1967,"AC Ajaccio","Stade Rennes","2-0",2,0,"1",1,2,2,"H"
"8686",1967-08-27,1967,"Red Star FC","AS Monaco","2-0",2,0,"1",1,2,2,"H"
"8687",1967-08-30,1967,"Angers SCO","AC Ajaccio","3-0",3,0,"1",1,3,3,"H"
"8688",1967-08-30,1967,"AS Saint-Etienne","Girondins Bordeaux","1-0",1,0,"1",1,1,1,"H"
"8689",1967-08-30,1967,"Olympique Marseille","OGC Nice","0-2",0,2,"1",1,2,-2,"D"
"8690",1967-08-30,1967,"RC Lens","FC Nantes","1-3",1,3,"1",1,4,-2,"D"
"8691",1967-08-30,1967,"CS Sedan","Lille OSC","1-1",1,1,"1",1,2,0,"D"
"8692",1967-08-30,1967,"FC Metz","FC Rouen","1-1",1,1,"1",1,2,0,"D"
"8693",1967-08-30,1967,"Stade Rennes","Olympique Lyon","1-0",1,0,"1",1,1,1,"H"
"8694",1967-08-30,1967,"RC Strasbourg","Red Star FC","2-1",2,1,"1",1,3,1,"H"
"8695",1967-08-30,1967,"AS Monaco","US Valenciennes-Anzin","0-1",0,1,"1",1,1,-1,"D"
"8696",1967-08-30,1967,"FC Sochaux","AS Aixoise","1-1",1,1,"1",1,2,0,"D"
"8697",1967-09-02,1967,"FC Nantes","AS Saint-Etienne","1-1",1,1,"1",1,2,0,"D"
"8698",1967-09-02,1967,"Lille OSC","Stade Rennes","2-0",2,0,"1",1,2,2,"H"
"8699",1967-09-02,1967,"Olympique Lyon","Angers SCO","8-0",8,0,"1",1,8,8,"H"
"8700",1967-09-02,1967,"Girondins Bordeaux","RC Lens","6-1",6,1,"1",1,7,5,"H"
"8701",1967-09-02,1967,"US Valenciennes-Anzin","RC Strasbourg","0-1",0,1,"1",1,1,-1,"D"
"8702",1967-09-02,1967,"FC Rouen","CS Sedan","0-0",0,0,"1",1,0,0,"D"
"8703",1967-09-02,1967,"AS Aixoise","AS Monaco","0-0",0,0,"1",1,0,0,"D"
"8704",1967-09-03,1967,"OGC Nice","FC Metz","4-1",4,1,"1",1,5,3,"H"
"8705",1967-09-03,1967,"Red Star FC","Olympique Marseille","2-0",2,0,"1",1,2,2,"H"
"8706",1967-09-03,1967,"AC Ajaccio","FC Sochaux","1-1",1,1,"1",1,2,0,"D"
"8707",1967-09-08,1967,"AS Saint-Etienne","Red Star FC","1-1",1,1,"1",1,2,0,"D"
"8708",1967-09-08,1967,"Olympique Marseille","Lille OSC","0-0",0,0,"1",1,0,0,"D"
"8709",1967-09-08,1967,"RC Strasbourg","Girondins Bordeaux","0-1",0,1,"1",1,1,-1,"D"
"8710",1967-09-09,1967,"FC Nantes","FC Rouen","0-0",0,0,"1",1,0,0,"D"
"8711",1967-09-09,1967,"FC Metz","AS Aixoise","3-1",3,1,"1",1,4,2,"H"
"8712",1967-09-09,1967,"FC Sochaux","Olympique Lyon","3-1",3,1,"1",1,4,2,"H"
"8713",1967-09-09,1967,"CS Sedan","AC Ajaccio","2-0",2,0,"1",1,2,2,"H"
"8714",1967-09-10,1967,"AS Monaco","OGC Nice","2-2",2,2,"1",1,4,0,"D"
"8715",1967-09-10,1967,"Angers SCO","Stade Rennes","1-1",1,1,"1",1,2,0,"D"
"8716",1967-09-10,1967,"RC Lens","US Valenciennes-Anzin","1-0",1,0,"1",1,1,1,"H"
"8717",1967-09-22,1967,"Lille OSC","Angers SCO","2-1",2,1,"1",1,3,1,"H"
"8718",1967-09-23,1967,"Girondins Bordeaux","FC Nantes","6-2",6,2,"1",1,8,4,"H"
"8719",1967-09-23,1967,"FC Rouen","Olympique Marseille","1-2",1,2,"1",1,3,-1,"D"
"8720",1967-09-23,1967,"Stade Rennes","FC Sochaux","1-1",1,1,"1",1,2,0,"D"
"8721",1967-09-23,1967,"Olympique Lyon","AS Monaco","1-2",1,2,"1",1,3,-1,"D"
"8722",1967-09-24,1967,"OGC Nice","RC Strasbourg","2-0",2,0,"1",1,2,2,"H"
"8723",1967-09-24,1967,"US Valenciennes-Anzin","AS Saint-Etienne","1-2",1,2,"1",1,3,-1,"D"
"8724",1967-09-24,1967,"Red Star FC","RC Lens","3-2",3,2,"1",1,5,1,"H"
"8725",1967-09-24,1967,"AC Ajaccio","FC Metz","2-1",2,1,"1",1,3,1,"H"
"8726",1967-09-24,1967,"AS Aixoise","CS Sedan","4-2",4,2,"1",1,6,2,"H"
"8727",1967-09-30,1967,"RC Lens","OGC Nice","0-0",0,0,"1",1,0,0,"D"
"8728",1967-09-30,1967,"AS Saint-Etienne","AS Aixoise","3-1",3,1,"1",1,4,2,"H"
"8729",1967-09-30,1967,"Girondins Bordeaux","Lille OSC","2-1",2,1,"1",1,3,1,"H"
"8730",1967-09-30,1967,"FC Nantes","Red Star FC","4-2",4,2,"1",1,6,2,"H"
"8731",1967-09-30,1967,"FC Metz","Olympique Lyon","3-1",3,1,"1",1,4,2,"H"
"8732",1967-09-30,1967,"CS Sedan","Stade Rennes","3-0",3,0,"1",1,3,3,"H"
"8733",1967-09-30,1967,"FC Sochaux","Angers SCO","2-0",2,0,"1",1,2,2,"H"
"8734",1967-09-30,1967,"AS Monaco","AC Ajaccio","0-1",0,1,"1",1,1,-1,"D"
"8735",1967-10-01,1967,"Olympique Marseille","US Valenciennes-Anzin","2-0",2,0,"1",1,2,2,"H"
"8736",1967-10-04,1967,"Red Star FC","Girondins Bordeaux","1-0",1,0,"1",1,1,1,"H"
"8737",1967-10-04,1967,"AC Ajaccio","Olympique Marseille","2-2",2,2,"1",1,4,0,"D"
"8738",1967-10-04,1967,"Lille OSC","FC Sochaux","0-1",0,1,"1",1,1,-1,"D"
"8739",1967-10-04,1967,"Stade Rennes","FC Metz","0-0",0,0,"1",1,0,0,"D"
"8740",1967-10-04,1967,"Angers SCO","AS Monaco","3-0",3,0,"1",1,3,3,"H"
"8741",1967-10-04,1967,"US Valenciennes-Anzin","FC Nantes","2-1",2,1,"1",1,3,1,"H"
"8742",1967-10-04,1967,"AS Aixoise","RC Strasbourg","0-3",0,3,"1",1,3,-3,"D"
"8743",1967-10-04,1967,"FC Rouen","RC Lens","0-1",0,1,"1",1,1,-1,"D"
"8744",1967-10-07,1967,"FC Nantes","OGC Nice","0-0",0,0,"1",1,0,0,"D"
"8745",1967-10-07,1967,"Olympique Marseille","Olympique Lyon","2-1",2,1,"1",1,3,1,"H"
"8746",1967-10-07,1967,"FC Metz","Angers SCO","1-1",1,1,"1",1,2,0,"D"
"8747",1967-10-07,1967,"RC Strasbourg","Stade Rennes","1-1",1,1,"1",1,2,0,"D"
"8748",1967-10-08,1967,"AS Saint-Etienne","FC Rouen","3-0",3,0,"1",1,3,3,"H"
"8749",1967-10-08,1967,"Red Star FC","AC Ajaccio","4-1",4,1,"1",1,5,3,"H"
"8750",1967-10-08,1967,"Girondins Bordeaux","US Valenciennes-Anzin","0-1",0,1,"1",1,1,-1,"D"
"8751",1967-10-08,1967,"CS Sedan","FC Sochaux","2-0",2,0,"1",1,2,2,"H"
"8752",1967-10-08,1967,"AS Monaco","Lille OSC","3-1",3,1,"1",1,4,2,"H"
"8753",1967-10-08,1967,"RC Lens","AS Aixoise","4-1",4,1,"1",1,5,3,"H"
"8754",1967-10-13,1967,"Lille OSC","RC Lens","0-1",0,1,"1",1,1,-1,"D"
"8755",1967-10-14,1967,"FC Sochaux","FC Metz","3-2",3,2,"1",1,5,1,"H"
"8756",1967-10-14,1967,"FC Rouen","AS Monaco","2-1",2,1,"1",1,3,1,"H"
"8757",1967-10-15,1967,"Olympique Lyon","AS Saint-Etienne","1-1",1,1,"1",1,2,0,"D"
"8758",1967-10-15,1967,"OGC Nice","Girondins Bordeaux","1-1",1,1,"1",1,2,0,"D"
"8759",1967-10-15,1967,"AS Aixoise","Olympique Marseille","1-2",1,2,"1",1,3,-1,"D"
"8760",1967-10-15,1967,"US Valenciennes-Anzin","Red Star FC","1-0",1,0,"1",1,1,1,"H"
"8761",1967-10-15,1967,"Angers SCO","CS Sedan","2-3",2,3,"1",1,5,-1,"D"
"8762",1967-10-15,1967,"Stade Rennes","FC Nantes","1-1",1,1,"1",1,2,0,"D"
"8763",1967-10-15,1967,"AC Ajaccio","RC Strasbourg","1-0",1,0,"1",1,1,1,"H"
"8764",1967-10-21,1967,"FC Rouen","Red Star FC","0-2",0,2,"1",1,2,-2,"D"
"8765",1967-10-21,1967,"Stade Rennes","Olympique Marseille","3-1",3,1,"1",1,4,2,"H"
"8766",1967-10-21,1967,"FC Sochaux","FC Nantes","1-0",1,0,"1",1,1,1,"H"
"8767",1967-10-21,1967,"Lille OSC","FC Metz","0-0",0,0,"1",1,0,0,"D"
"8768",1967-10-22,1967,"OGC Nice","US Valenciennes-Anzin","2-1",2,1,"1",1,3,1,"H"
"8769",1967-10-22,1967,"Angers SCO","AS Saint-Etienne","1-0",1,0,"1",1,1,1,"H"
"8770",1967-10-22,1967,"CS Sedan","AS Monaco","3-0",3,0,"1",1,3,3,"H"
"8771",1967-10-22,1967,"AC Ajaccio","RC Lens","2-0",2,0,"1",1,2,2,"H"
"8772",1967-10-22,1967,"AS Aixoise","Girondins Bordeaux","5-1",5,1,"1",1,6,4,"H"
"8773",1967-10-22,1967,"Olympique Lyon","RC Strasbourg","0-0",0,0,"1",1,0,0,"D"
"8774",1967-10-25,1967,"RC Strasbourg","FC Rouen","2-1",2,1,"1",1,3,1,"H"
"8775",1967-11-01,1967,"OGC Nice","FC Rouen","4-0",4,0,"1",1,4,4,"H"
"8776",1967-11-01,1967,"AS Saint-Etienne","Stade Rennes","3-0",3,0,"1",1,3,3,"H"
"8777",1967-11-01,1967,"Red Star FC","AS Aixoise","2-1",2,1,"1",1,3,1,"H"
"8778",1967-11-01,1967,"Olympique Marseille","CS Sedan","1-0",1,0,"1",1,1,1,"H"
"8779",1967-11-01,1967,"RC Strasbourg","FC Sochaux","1-4",1,4,"1",1,5,-3,"D"
"8780",1967-11-01,1967,"Girondins Bordeaux","AC Ajaccio","3-0",3,0,"1",1,3,3,"H"
"8781",1967-11-01,1967,"FC Nantes","Olympique Lyon","1-0",1,0,"1",1,1,1,"H"
"8782",1967-11-01,1967,"RC Lens","Angers SCO","4-2",4,2,"1",1,6,2,"H"
"8783",1967-11-01,1967,"US Valenciennes-Anzin","Lille OSC","3-0",3,0,"1",1,3,3,"H"
"8784",1967-11-01,1967,"AS Monaco","FC Metz","3-1",3,1,"1",1,4,2,"H"
"8785",1967-11-05,1967,"AS Aixoise","OGC Nice","3-1",3,1,"1",1,4,2,"H"
"8786",1967-11-05,1967,"CS Sedan","AS Saint-Etienne","5-2",5,2,"1",1,7,3,"H"
"8787",1967-11-05,1967,"Lille OSC","Red Star FC","1-1",1,1,"1",1,2,0,"D"
"8788",1967-11-05,1967,"FC Sochaux","RC Lens","4-1",4,1,"1",1,5,3,"H"
"8789",1967-11-05,1967,"FC Metz","Olympique Marseille","3-0",3,0,"1",1,3,3,"H"
"8790",1967-11-05,1967,"Angers SCO","RC Strasbourg","1-0",1,0,"1",1,1,1,"H"
"8791",1967-11-05,1967,"AC Ajaccio","FC Nantes","5-3",5,3,"1",1,8,2,"H"
"8792",1967-11-05,1967,"Olympique Lyon","Girondins Bordeaux","2-0",2,0,"1",1,2,2,"H"
"8793",1967-11-05,1967,"FC Rouen","US Valenciennes-Anzin","1-2",1,2,"1",1,3,-1,"D"
"8794",1967-11-05,1967,"Stade Rennes","AS Monaco","1-1",1,1,"1",1,2,0,"D"
"8795",1967-11-08,1967,"Olympique Lyon","CS Sedan","0-2",0,2,"1",1,2,-2,"D"
"8796",1967-11-11,1967,"AS Saint-Etienne","FC Sochaux","2-0",2,0,"1",1,2,2,"H"
"8797",1967-11-11,1967,"Olympique Marseille","AS Monaco","2-1",2,1,"1",1,3,1,"H"
"8798",1967-11-11,1967,"RC Lens","CS Sedan","3-0",3,0,"1",1,3,3,"H"
"8799",1967-11-11,1967,"FC Nantes","Angers SCO","0-1",0,1,"1",1,1,-1,"D"
"8800",1967-11-11,1967,"RC Strasbourg","FC Metz","0-0",0,0,"1",1,0,0,"D"
"8801",1967-11-12,1967,"OGC Nice","Lille OSC","3-1",3,1,"1",1,4,2,"H"
"8802",1967-11-12,1967,"Red Star FC","Olympique Lyon","1-1",1,1,"1",1,2,0,"D"
"8803",1967-11-12,1967,"Girondins Bordeaux","Stade Rennes","6-2",6,2,"1",1,8,4,"H"
"8804",1967-11-12,1967,"US Valenciennes-Anzin","AS Aixoise","1-0",1,0,"1",1,1,1,"H"
"8805",1967-11-12,1967,"FC Rouen","AC Ajaccio","3-1",3,1,"1",1,4,2,"H"
"8806",1967-11-18,1967,"FC Sochaux","Olympique Marseille","1-1",1,1,"1",1,2,0,"D"
"8807",1967-11-19,1967,"AS Monaco","AS Saint-Etienne","0-3",0,3,"1",1,3,-3,"D"
"8808",1967-11-19,1967,"AC Ajaccio","OGC Nice","2-1",2,1,"1",1,3,1,"H"
"8809",1967-11-19,1967,"CS Sedan","RC Strasbourg","3-1",3,1,"1",1,4,2,"H"
"8810",1967-11-19,1967,"Stade Rennes","Red Star FC","3-0",3,0,"1",1,3,3,"H"
"8811",1967-11-19,1967,"Angers SCO","Girondins Bordeaux","0-0",0,0,"1",1,0,0,"D"
"8812",1967-11-19,1967,"FC Metz","RC Lens","2-1",2,1,"1",1,3,1,"H"
"8813",1967-11-19,1967,"Olympique Lyon","US Valenciennes-Anzin","0-0",0,0,"1",1,0,0,"D"
"8814",1967-11-19,1967,"Lille OSC","FC Nantes","2-0",2,0,"1",1,2,2,"H"
"8815",1967-11-19,1967,"AS Aixoise","FC Rouen","4-1",4,1,"1",1,5,3,"H"
"8816",1967-11-25,1967,"AS Saint-Etienne","FC Metz","4-0",4,0,"1",1,4,4,"H"
"8817",1967-11-26,1967,"FC Nantes","CS Sedan","1-1",1,1,"1",1,2,0,"D"
"8818",1967-11-26,1967,"OGC Nice","Olympique Lyon","0-3",0,3,"1",1,3,-3,"D"
"8819",1967-11-26,1967,"Red Star FC","Angers SCO","3-3",3,3,"1",1,6,0,"D"
"8820",1967-11-26,1967,"RC Strasbourg","Olympique Marseille","1-0",1,0,"1",1,1,1,"H"
"8821",1967-11-26,1967,"Girondins Bordeaux","FC Sochaux","3-0",3,0,"1",1,3,3,"H"
"8822",1967-11-26,1967,"US Valenciennes-Anzin","AC Ajaccio","0-0",0,0,"1",1,0,0,"D"
"8823",1967-11-26,1967,"AS Aixoise","Stade Rennes","2-3",2,3,"1",1,5,-1,"D"
"8824",1967-11-26,1967,"FC Rouen","Lille OSC","1-0",1,0,"1",1,1,1,"H"
"8825",1967-11-26,1967,"RC Lens","AS Monaco","1-3",1,3,"1",1,4,-2,"D"
"8826",1967-12-03,1967,"AS Saint-Etienne","AC Ajaccio","4-0",4,0,"1",1,4,4,"H"
"8827",1967-12-03,1967,"FC Metz","CS Sedan","1-5",1,5,"1",1,6,-4,"D"
"8828",1967-12-03,1967,"Red Star FC","OGC Nice","1-1",1,1,"1",1,2,0,"D"
"8829",1967-12-03,1967,"Olympique Marseille","Angers SCO","3-1",3,1,"1",1,4,2,"H"
"8830",1967-12-03,1967,"Girondins Bordeaux","FC Rouen","1-0",1,0,"1",1,1,1,"H"
"8831",1967-12-03,1967,"US Valenciennes-Anzin","Stade Rennes","2-1",2,1,"1",1,3,1,"H"
"8832",1967-12-03,1967,"AS Monaco","FC Sochaux","1-0",1,0,"1",1,1,1,"H"
"8833",1967-12-03,1967,"FC Nantes","AS Aixoise","5-1",5,1,"1",1,6,4,"H"
"8834",1967-12-03,1967,"RC Strasbourg","Lille OSC","2-0",2,0,"1",1,2,2,"H"
"8835",1967-12-03,1967,"RC Lens","Olympique Lyon","1-0",1,0,"1",1,1,1,"H"
"8836",1967-12-09,1967,"FC Sochaux","Red Star FC","1-0",1,0,"1",1,1,1,"H"
"8837",1967-12-10,1967,"Lille OSC","AS Saint-Etienne","2-2",2,2,"1",1,4,0,"D"
"8838",1967-12-10,1967,"Olympique Marseille","RC Lens","2-0",2,0,"1",1,2,2,"H"
"8839",1967-12-10,1967,"CS Sedan","Girondins Bordeaux","1-2",1,2,"1",1,3,-1,"D"
"8840",1967-12-10,1967,"Stade Rennes","OGC Nice","4-0",4,0,"1",1,4,4,"H"
"8841",1967-12-10,1967,"AC Ajaccio","AS Aixoise","8-2",8,2,"1",1,10,6,"H"
"8842",1967-12-10,1967,"FC Metz","FC Nantes","1-1",1,1,"1",1,2,0,"D"
"8843",1967-12-10,1967,"Olympique Lyon","FC Rouen","2-1",2,1,"1",1,3,1,"H"
"8844",1967-12-10,1967,"AS Monaco","RC Strasbourg","2-1",2,1,"1",1,3,1,"H"
"8845",1967-12-13,1967,"OGC Nice","AS Saint-Etienne","1-2",1,2,"1",1,3,-1,"D"
"8846",1967-12-17,1967,"AS Saint-Etienne","Olympique Marseille","2-0",2,0,"1",1,2,2,"H"
"8847",1967-12-17,1967,"Girondins Bordeaux","FC Metz","1-0",1,0,"1",1,1,1,"H"
"8848",1967-12-17,1967,"OGC Nice","Angers SCO","2-1",2,1,"1",1,3,1,"H"
"8849",1967-12-17,1967,"Red Star FC","CS Sedan","3-0",3,0,"1",1,3,3,"H"
"8850",1967-12-17,1967,"US Valenciennes-Anzin","FC Sochaux","0-0",0,0,"1",1,0,0,"D"
"8851",1967-12-17,1967,"AC Ajaccio","Lille OSC","2-1",2,1,"1",1,3,1,"H"
"8852",1967-12-17,1967,"FC Nantes","AS Monaco","0-0",0,0,"1",1,0,0,"D"
"8853",1967-12-17,1967,"RC Lens","RC Strasbourg","1-0",1,0,"1",1,1,1,"H"
"8854",1967-12-17,1967,"AS Aixoise","Olympique Lyon","2-0",2,0,"1",1,2,2,"H"
"8855",1968-01-07,1967,"Girondins Bordeaux","AS Saint-Etienne","1-2",1,2,"1",1,3,-1,"D"
"8856",1968-01-07,1967,"OGC Nice","Olympique Marseille","1-1",1,1,"1",1,2,0,"D"
"8857",1968-01-07,1967,"AC Ajaccio","Angers SCO","4-0",4,0,"1",1,4,4,"H"
"8858",1968-01-07,1967,"Lille OSC","CS Sedan","2-0",2,0,"1",1,2,2,"H"
"8859",1968-01-07,1967,"Red Star FC","RC Strasbourg","0-1",0,1,"1",1,1,-1,"D"
"8860",1968-01-07,1967,"AS Aixoise","FC Sochaux","0-0",0,0,"1",1,0,0,"D"
"8861",1968-01-07,1967,"FC Nantes","RC Lens","1-0",1,0,"1",1,1,1,"H"
"8862",1968-01-07,1967,"Olympique Lyon","Stade Rennes","2-1",2,1,"1",1,3,1,"H"
"8863",1968-01-07,1967,"FC Rouen","FC Metz","0-0",0,0,"1",1,0,0,"D"
"8864",1968-01-21,1967,"AS Saint-Etienne","FC Nantes","1-2",1,2,"1",1,3,-1,"D"
"8865",1968-01-21,1967,"Olympique Marseille","Red Star FC","2-0",2,0,"1",1,2,2,"H"
"8866",1968-01-21,1967,"CS Sedan","FC Rouen","2-0",2,0,"1",1,2,2,"H"
"8867",1968-01-21,1967,"FC Sochaux","AC Ajaccio","3-1",3,1,"1",1,4,2,"H"
"8868",1968-01-21,1967,"RC Strasbourg","US Valenciennes-Anzin","0-1",0,1,"1",1,1,-1,"D"
"8869",1968-01-21,1967,"Stade Rennes","Lille OSC","4-1",4,1,"1",1,5,3,"H"
"8870",1968-01-21,1967,"Angers SCO","Olympique Lyon","3-1",3,1,"1",1,4,2,"H"
"8871",1968-01-21,1967,"AS Monaco","AS Aixoise","1-1",1,1,"1",1,2,0,"D"
"8872",1968-01-28,1967,"Red Star FC","AS Saint-Etienne","1-1",1,1,"1",1,2,0,"D"
"8873",1968-01-28,1967,"Lille OSC","Olympique Marseille","2-0",2,0,"1",1,2,2,"H"
"8874",1968-01-28,1967,"Olympique Lyon","FC Sochaux","2-2",2,2,"1",1,4,0,"D"
"8875",1968-01-28,1967,"AC Ajaccio","CS Sedan","2-0",2,0,"1",1,2,2,"H"
"8876",1968-01-28,1967,"Girondins Bordeaux","RC Strasbourg","1-2",1,2,"1",1,3,-1,"D"
"8877",1968-01-28,1967,"OGC Nice","AS Monaco","0-2",0,2,"1",1,2,-2,"D"
"8878",1968-01-28,1967,"US Valenciennes-Anzin","RC Lens","1-1",1,1,"1",1,2,0,"D"
"8879",1968-01-28,1967,"FC Rouen","FC Nantes","1-2",1,2,"1",1,3,-1,"D"
"8880",1968-01-28,1967,"Stade Rennes","Angers SCO","1-1",1,1,"1",1,2,0,"D"
"8881",1968-02-03,1967,"FC Sochaux","Stade Rennes","1-2",1,2,"1",1,3,-1,"D"
"8882",1968-02-04,1967,"AS Saint-Etienne","US Valenciennes-Anzin","3-0",3,0,"1",1,3,3,"H"
"8883",1968-02-04,1967,"Olympique Marseille","FC Rouen","2-2",2,2,"1",1,4,0,"D"
"8884",1968-02-04,1967,"CS Sedan","AS Aixoise","3-0",3,0,"1",1,3,3,"H"
"8885",1968-02-04,1967,"FC Nantes","Girondins Bordeaux","1-1",1,1,"1",1,2,0,"D"
"8886",1968-02-04,1967,"RC Lens","Red Star FC","2-4",2,4,"1",1,6,-2,"D"
"8887",1968-02-04,1967,"RC Strasbourg","OGC Nice","0-0",0,0,"1",1,0,0,"D"
"8888",1968-02-04,1967,"FC Metz","AC Ajaccio","3-0",3,0,"1",1,3,3,"H"
"8889",1968-02-04,1967,"AS Monaco","Olympique Lyon","2-1",2,1,"1",1,3,1,"H"
"8890",1968-02-04,1967,"Angers SCO","Lille OSC","1-3",1,3,"1",1,4,-2,"D"
"8891",1968-02-17,1967,"AS Aixoise","AS Saint-Etienne","1-1",1,1,"1",1,2,0,"D"
"8892",1968-02-17,1967,"Lille OSC","Girondins Bordeaux","1-2",1,2,"1",1,3,-1,"D"
"8893",1968-02-17,1967,"Stade Rennes","CS Sedan","1-1",1,1,"1",1,2,0,"D"
"8894",1968-02-17,1967,"US Valenciennes-Anzin","Olympique Marseille","1-0",1,0,"1",1,1,1,"H"
"8895",1968-02-17,1967,"Angers SCO","FC Sochaux","1-1",1,1,"1",1,2,0,"D"
"8896",1968-02-17,1967,"Olympique Lyon","FC Metz","3-1",3,1,"1",1,4,2,"H"
"8897",1968-02-17,1967,"OGC Nice","RC Lens","0-0",0,0,"1",1,0,0,"D"
"8898",1968-02-17,1967,"Red Star FC","FC Nantes","0-1",0,1,"1",1,1,-1,"D"
"8899",1968-02-24,1967,"FC Sochaux","Lille OSC","2-1",2,1,"1",1,3,1,"H"
"8900",1968-02-25,1967,"AS Saint-Etienne","OGC Nice","3-1",3,1,"1",1,4,2,"H"
"8901",1968-02-25,1967,"Girondins Bordeaux","Red Star FC","1-0",1,0,"1",1,1,1,"H"
"8902",1968-02-25,1967,"Olympique Marseille","AC Ajaccio","2-0",2,0,"1",1,2,2,"H"
"8903",1968-02-25,1967,"CS Sedan","Olympique Lyon","2-3",2,3,"1",1,5,-1,"D"
"8904",1968-02-25,1967,"FC Nantes","US Valenciennes-Anzin","0-2",0,2,"1",1,2,-2,"D"
"8905",1968-02-25,1967,"FC Metz","Stade Rennes","6-1",6,1,"1",1,7,5,"H"
"8906",1968-02-25,1967,"AS Monaco","Angers SCO","5-0",5,0,"1",1,5,5,"H"
"8907",1968-02-25,1967,"RC Strasbourg","AS Aixoise","1-0",1,0,"1",1,1,1,"H"
"8908",1968-02-25,1967,"RC Lens","FC Rouen","2-1",2,1,"1",1,3,1,"H"
"8909",1968-03-02,1967,"Olympique Lyon","Olympique Marseille","3-2",3,2,"1",1,5,1,"H"
"8910",1968-03-03,1967,"FC Rouen","AS Saint-Etienne","3-0",3,0,"1",1,3,3,"H"
"8911",1968-03-03,1967,"FC Sochaux","CS Sedan","3-0",3,0,"1",1,3,3,"H"
"8912",1968-03-03,1967,"US Valenciennes-Anzin","Girondins Bordeaux","2-0",2,0,"1",1,2,2,"H"
"8913",1968-03-03,1967,"OGC Nice","FC Nantes","5-1",5,1,"1",1,6,4,"H"
"8914",1968-03-03,1967,"AC Ajaccio","Red Star FC","0-0",0,0,"1",1,0,0,"D"
"8915",1968-03-03,1967,"Stade Rennes","RC Strasbourg","2-1",2,1,"1",1,3,1,"H"
"8916",1968-03-03,1967,"Lille OSC","AS Monaco","0-1",0,1,"1",1,1,-1,"D"
"8917",1968-03-03,1967,"Angers SCO","FC Metz","0-0",0,0,"1",1,0,0,"D"
"8918",1968-03-03,1967,"AS Aixoise","RC Lens","2-2",2,2,"1",1,4,0,"D"
"8919",1968-03-10,1967,"AC Ajaccio","AS Monaco","1-2",1,2,"1",1,3,-1,"D"
"8920",1968-03-16,1967,"FC Metz","FC Sochaux","2-0",2,0,"1",1,2,2,"H"
"8921",1968-03-16,1967,"CS Sedan","Angers SCO","3-1",3,1,"1",1,4,2,"H"
"8922",1968-03-16,1967,"RC Strasbourg","AC Ajaccio","0-0",0,0,"1",1,0,0,"D"
"8923",1968-03-16,1967,"Girondins Bordeaux","OGC Nice","4-0",4,0,"1",1,4,4,"H"
"8924",1968-03-17,1967,"AS Saint-Etienne","Olympique Lyon","1-1",1,1,"1",1,2,0,"D"
"8925",1968-03-17,1967,"Olympique Marseille","AS Aixoise","3-2",3,2,"1",1,5,1,"H"
"8926",1968-03-17,1967,"Red Star FC","US Valenciennes-Anzin","1-0",1,0,"1",1,1,1,"H"
"8927",1968-03-17,1967,"FC Nantes","Stade Rennes","2-0",2,0,"1",1,2,2,"H"
"8928",1968-03-17,1967,"AS Monaco","FC Rouen","1-3",1,3,"1",1,4,-2,"D"
"8929",1968-03-17,1967,"RC Lens","Lille OSC","1-1",1,1,"1",1,2,0,"D"
"8930",1968-03-22,1967,"Lille OSC","RC Strasbourg","0-0",0,0,"1",1,0,0,"D"
"8931",1968-03-23,1967,"Angers SCO","Olympique Marseille","2-2",2,2,"1",1,4,0,"D"
"8932",1968-03-23,1967,"FC Rouen","Girondins Bordeaux","3-0",3,0,"1",1,3,3,"H"
"8933",1968-03-23,1967,"CS Sedan","FC Metz","3-0",3,0,"1",1,3,3,"H"
"8934",1968-03-23,1967,"FC Sochaux","AS Monaco","0-0",0,0,"1",1,0,0,"D"
"8935",1968-03-23,1967,"Stade Rennes","US Valenciennes-Anzin","1-1",1,1,"1",1,2,0,"D"
"8936",1968-03-24,1967,"AC Ajaccio","AS Saint-Etienne","1-1",1,1,"1",1,2,0,"D"
"8937",1968-03-24,1967,"AS Aixoise","FC Nantes","2-6",2,6,"1",1,8,-4,"D"
"8938",1968-03-24,1967,"OGC Nice","Red Star FC","2-1",2,1,"1",1,3,1,"H"
"8939",1968-03-24,1967,"Olympique Lyon","RC Lens","3-0",3,0,"1",1,3,3,"H"
"8940",1968-03-30,1967,"Stade Rennes","FC Rouen","0-1",0,1,"1",1,1,-1,"D"
"8941",1968-03-31,1967,"US Valenciennes-Anzin","AS Monaco","1-1",1,1,"1",1,2,0,"D"
"8942",1968-04-06,1967,"FC Metz","Lille OSC","1-0",1,0,"1",1,1,1,"H"
"8943",1968-04-07,1967,"RC Lens","AC Ajaccio","1-2",1,2,"1",1,3,-1,"D"
"8944",1968-04-07,1967,"Red Star FC","FC Rouen","0-2",0,2,"1",1,2,-2,"D"
"8945",1968-04-09,1967,"AS Saint-Etienne","Angers SCO","3-0",3,0,"1",1,3,3,"H"
"8946",1968-04-09,1967,"Girondins Bordeaux","AS Aixoise","3-0",3,0,"1",1,3,3,"H"
"8947",1968-04-09,1967,"FC Nantes","FC Sochaux","1-1",1,1,"1",1,2,0,"D"
"8948",1968-04-09,1967,"US Valenciennes-Anzin","OGC Nice","0-1",0,1,"1",1,1,-1,"D"
"8949",1968-04-09,1967,"AS Monaco","CS Sedan","2-1",2,1,"1",1,3,1,"H"
"8950",1968-04-09,1967,"RC Strasbourg","Olympique Lyon","0-1",0,1,"1",1,1,-1,"D"
"8951",1968-04-12,1967,"Stade Rennes","AS Saint-Etienne","0-3",0,3,"1",1,3,-3,"D"
"8952",1968-04-12,1967,"Olympique Lyon","FC Nantes","0-3",0,3,"1",1,3,-3,"D"
"8953",1968-04-12,1967,"FC Sochaux","RC Strasbourg","1-1",1,1,"1",1,2,0,"D"
"8954",1968-04-12,1967,"FC Rouen","OGC Nice","1-0",1,0,"1",1,1,1,"H"
"8955",1968-04-13,1967,"Lille OSC","US Valenciennes-Anzin","0-3",0,3,"1",1,3,-3,"D"
"8956",1968-04-13,1967,"CS Sedan","Olympique Marseille","1-1",1,1,"1",1,2,0,"D"
"8957",1968-04-13,1967,"FC Metz","AS Monaco","2-0",2,0,"1",1,2,2,"H"
"8958",1968-04-13,1967,"AS Aixoise","Red Star FC","0-0",0,0,"1",1,0,0,"D"
"8959",1968-04-13,1967,"Angers SCO","RC Lens","1-2",1,2,"1",1,3,-1,"D"
"8960",1968-04-14,1967,"AC Ajaccio","Girondins Bordeaux","3-0",3,0,"1",1,3,3,"H"
"8961",1968-04-20,1967,"Angers SCO","US Valenciennes-Anzin","1-0",1,0,"1",1,1,1,"H"
"8962",1968-04-26,1967,"Olympique Marseille","FC Metz","2-0",2,0,"1",1,2,2,"H"
"8963",1968-04-26,1967,"OGC Nice","AS Aixoise","1-0",1,0,"1",1,1,1,"H"
"8964",1968-04-26,1967,"RC Strasbourg","Angers SCO","5-1",5,1,"1",1,6,4,"H"
"8965",1968-04-27,1967,"AS Saint-Etienne","CS Sedan","2-1",2,1,"1",1,3,1,"H"
"8966",1968-04-27,1967,"FC Nantes","AC Ajaccio","1-0",1,0,"1",1,1,1,"H"
"8967",1968-04-27,1967,"RC Lens","FC Sochaux","0-2",0,2,"1",1,2,-2,"D"
"8968",1968-04-27,1967,"Girondins Bordeaux","Olympique Lyon","0-0",0,0,"1",1,0,0,"D"
"8969",1968-04-27,1967,"US Valenciennes-Anzin","FC Rouen","0-2",0,2,"1",1,2,-2,"D"
"8970",1968-04-27,1967,"AS Monaco","Stade Rennes","2-1",2,1,"1",1,3,1,"H"
"8971",1968-04-28,1967,"Red Star FC","Lille OSC","0-2",0,2,"1",1,2,-2,"D"
"8972",1968-04-30,1967,"Olympique Marseille","Stade Rennes","3-1",3,1,"1",1,4,2,"H"
"8973",1968-05-01,1967,"AS Aixoise","FC Metz","0-1",0,1,"1",1,1,-1,"D"
"8974",1968-05-03,1967,"Lille OSC","OGC Nice","0-2",0,2,"1",1,2,-2,"D"
"8975",1968-05-03,1967,"Olympique Lyon","Red Star FC","0-0",0,0,"1",1,0,0,"D"
"8976",1968-05-04,1967,"FC Sochaux","AS Saint-Etienne","0-4",0,4,"1",1,4,-4,"D"
"8977",1968-05-04,1967,"AS Monaco","Olympique Marseille","1-0",1,0,"1",1,1,1,"H"
"8978",1968-05-04,1967,"Stade Rennes","Girondins Bordeaux","1-0",1,0,"1",1,1,1,"H"
"8979",1968-05-04,1967,"CS Sedan","RC Lens","1-1",1,1,"1",1,2,0,"D"
"8980",1968-05-04,1967,"FC Metz","RC Strasbourg","1-0",1,0,"1",1,1,1,"H"
"8981",1968-05-05,1967,"Angers SCO","FC Nantes","1-3",1,3,"1",1,4,-2,"D"
"8982",1968-05-05,1967,"AS Aixoise","US Valenciennes-Anzin","1-1",1,1,"1",1,2,0,"D"
"8983",1968-05-05,1967,"AC Ajaccio","FC Rouen","5-3",5,3,"1",1,8,2,"H"
"8984",1968-05-11,1967,"FC Metz","OGC Nice","1-2",1,2,"1",1,3,-1,"D"
"8985",1968-05-11,1967,"FC Rouen","RC Strasbourg","3-2",3,2,"1",1,5,1,"H"
"8986",1968-05-17,1967,"AS Saint-Etienne","AS Monaco","1-0",1,0,"1",1,1,1,"H"
"8987",1968-05-17,1967,"OGC Nice","AC Ajaccio","1-0",1,0,"1",1,1,1,"H"
"8988",1968-05-17,1967,"RC Strasbourg","CS Sedan","0-2",0,2,"1",1,2,-2,"D"
"8989",1968-05-17,1967,"Girondins Bordeaux","Angers SCO","1-2",1,2,"1",1,3,-1,"D"
"8990",1968-05-17,1967,"FC Rouen","AS Aixoise","5-0",5,0,"1",1,5,5,"H"
"8991",1968-05-18,1967,"FC Nantes","Lille OSC","2-1",2,1,"1",1,3,1,"H"
"8992",1968-05-18,1967,"Olympique Marseille","FC Sochaux","0-1",0,1,"1",1,1,-1,"D"
"8993",1968-05-18,1967,"US Valenciennes-Anzin","Olympique Lyon","2-0",2,0,"1",1,2,2,"H"
"8994",1968-05-18,1967,"RC Lens","FC Metz","1-1",1,1,"1",1,2,0,"D"
"8995",1968-05-19,1967,"Red Star FC","Stade Rennes","3-1",3,1,"1",1,4,2,"H"
"8996",1968-05-22,1967,"FC Metz","AS Saint-Etienne","1-1",1,1,"1",1,2,0,"D"
"8997",1968-05-22,1967,"CS Sedan","FC Nantes","1-0",1,0,"1",1,1,1,"H"
"8998",1968-05-22,1967,"Lille OSC","FC Rouen","1-0",1,0,"1",1,1,1,"H"
"8999",1968-06-12,1967,"Olympique Lyon","OGC Nice","1-1",1,1,"1",1,2,0,"D"
"9000",1968-06-12,1967,"AC Ajaccio","US Valenciennes-Anzin","1-4",1,4,"1",1,5,-3,"D"
"9001",1968-06-12,1967,"Olympique Marseille","RC Strasbourg","0-0",0,0,"1",1,0,0,"D"
"9002",1968-06-12,1967,"FC Sochaux","Girondins Bordeaux","0-1",0,1,"1",1,1,-1,"D"
"9003",1968-06-12,1967,"AS Monaco","RC Lens","2-3",2,3,"1",1,5,-1,"D"
"9004",1968-06-12,1967,"Angers SCO","Red Star FC","2-2",2,2,"1",1,4,0,"D"
"9005",1968-06-12,1967,"Stade Rennes","AS Aixoise","4-0",4,0,"1",1,4,4,"H"
"9006",1968-06-14,1967,"AS Saint-Etienne","Lille OSC","3-0",3,0,"1",1,3,3,"H"
"9007",1968-06-15,1967,"FC Nantes","FC Metz","1-1",1,1,"1",1,2,0,"D"
"9008",1968-06-15,1967,"US Valenciennes-Anzin","Angers SCO","2-1",2,1,"1",1,3,1,"H"
"9009",1968-06-15,1967,"Girondins Bordeaux","CS Sedan","2-0",2,0,"1",1,2,2,"H"
"9010",1968-06-15,1967,"RC Lens","Olympique Marseille","5-1",5,1,"1",1,6,4,"H"
"9011",1968-06-15,1967,"AS Aixoise","AC Ajaccio","2-4",2,4,"1",1,6,-2,"D"
"9012",1968-06-15,1967,"RC Strasbourg","AS Monaco","2-0",2,0,"1",1,2,2,"H"
"9013",1968-06-15,1967,"FC Rouen","Olympique Lyon","3-1",3,1,"1",1,4,2,"H"
"9014",1968-06-16,1967,"OGC Nice","Stade Rennes","0-3",0,3,"1",1,3,-3,"D"
"9015",1968-06-16,1967,"Red Star FC","FC Sochaux","1-2",1,2,"1",1,3,-1,"D"
"9016",1968-06-19,1967,"RC Lens","Girondins Bordeaux","2-1",2,1,"1",1,3,1,"H"
"9017",1968-06-19,1967,"Olympique Marseille","AS Saint-Etienne","2-1",2,1,"1",1,3,1,"H"
"9018",1968-06-21,1967,"AS Monaco","FC Nantes","3-0",3,0,"1",1,3,3,"H"
"9019",1968-06-21,1967,"Lille OSC","AC Ajaccio","1-2",1,2,"1",1,3,-1,"D"
"9020",1968-06-21,1967,"FC Rouen","Stade Rennes","2-0",2,0,"1",1,2,2,"H"
"9021",1968-06-21,1967,"Olympique Lyon","AS Aixoise","4-3",4,3,"1",1,7,1,"H"
"9022",1968-06-22,1967,"Angers SCO","OGC Nice","1-1",1,1,"1",1,2,0,"D"
"9023",1968-06-22,1967,"FC Metz","Girondins Bordeaux","2-0",2,0,"1",1,2,2,"H"
"9024",1968-06-22,1967,"CS Sedan","Red Star FC","0-0",0,0,"1",1,0,0,"D"
"9025",1968-06-22,1967,"FC Sochaux","US Valenciennes-Anzin","3-1",3,1,"1",1,4,2,"H"
"9026",1968-06-23,1967,"RC Strasbourg","RC Lens","1-0",1,0,"1",1,1,1,"H"
"9027",1968-06-28,1967,"AS Saint-Etienne","RC Strasbourg","4-0",4,0,"1",1,4,4,"H"
"9028",1968-06-28,1967,"OGC Nice","FC Sochaux","1-0",1,0,"1",1,1,1,"H"
"9029",1968-06-28,1967,"US Valenciennes-Anzin","CS Sedan","3-1",3,1,"1",1,4,2,"H"
"9030",1968-06-28,1967,"FC Nantes","Olympique Marseille","1-1",1,1,"1",1,2,0,"D"
"9031",1968-06-28,1967,"Girondins Bordeaux","AS Monaco","3-0",3,0,"1",1,3,3,"H"
"9032",1968-06-28,1967,"Red Star FC","FC Metz","0-1",0,1,"1",1,1,-1,"D"
"9033",1968-06-28,1967,"AC Ajaccio","Olympique Lyon","2-2",2,2,"1",1,4,0,"D"
"9034",1968-06-28,1967,"FC Rouen","Angers SCO","0-1",0,1,"1",1,1,-1,"D"
"9035",1968-06-28,1967,"RC Lens","Stade Rennes","1-1",1,1,"1",1,2,0,"D"
"9036",1968-06-28,1967,"AS Aixoise","Lille OSC","2-1",2,1,"1",1,3,1,"H"
"9037",1968-07-03,1967,"CS Sedan","OGC Nice","0-1",0,1,"1",1,1,-1,"D"
"9038",1968-07-03,1967,"Olympique Marseille","Girondins Bordeaux","2-0",2,0,"1",1,2,2,"H"
"9039",1968-07-05,1967,"RC Lens","AS Saint-Etienne","1-3",1,3,"1",1,4,-2,"D"
"9040",1968-07-05,1967,"FC Sochaux","FC Rouen","3-0",3,0,"1",1,3,3,"H"
"9041",1968-07-05,1967,"FC Metz","US Valenciennes-Anzin","2-0",2,0,"1",1,2,2,"H"
"9042",1968-07-05,1967,"RC Strasbourg","FC Nantes","3-1",3,1,"1",1,4,2,"H"
"9043",1968-07-05,1967,"Stade Rennes","AC Ajaccio","1-0",1,0,"1",1,1,1,"H"
"9044",1968-07-05,1967,"AS Monaco","Red Star FC","0-1",0,1,"1",1,1,-1,"D"
"9045",1968-07-05,1967,"Olympique Lyon","Lille OSC","1-1",1,1,"1",1,2,0,"D"
"9046",1968-07-05,1967,"Angers SCO","AS Aixoise","9-1",9,1,"1",1,10,8,"H"
"9047",1968-09-01,1968,"AC Ajaccio","AS Monaco","4-3",4,3,"1",1,7,1,"H"
"9048",1968-09-01,1968,"FC Nantes","CS Sedan","3-2",3,2,"1",1,5,1,"H"
"9049",1968-09-03,1968,"Stade Rennes","Nimes Olympique","1-0",1,0,"1",1,1,1,"H"
"9050",1968-09-03,1968,"Olympique Marseille","Girondins Bordeaux","3-3",3,3,"1",1,6,0,"D"
"9051",1968-09-03,1968,"OGC Nice","SC Bastia","2-2",2,2,"1",1,4,0,"D"
"9052",1968-09-03,1968,"RC Strasbourg","Olympique Lyon","2-2",2,2,"1",1,4,0,"D"
"9053",1968-09-03,1968,"FC Rouen","Red Star FC","1-1",1,1,"1",1,2,0,"D"
"9054",1968-09-04,1968,"AS Saint-Etienne","FC Sochaux","4-1",4,1,"1",1,5,3,"H"
"9055",1968-09-04,1968,"US Valenciennes-Anzin","FC Metz","1-1",1,1,"1",1,2,0,"D"
"9056",1968-09-06,1968,"Olympique Lyon","Nimes Olympique","1-1",1,1,"1",1,2,0,"D"
"9057",1968-09-07,1968,"FC Sochaux","AC Ajaccio","0-1",0,1,"1",1,1,-1,"D"
"9058",1968-09-07,1968,"FC Metz","FC Rouen","7-3",7,3,"1",1,10,4,"H"
"9059",1968-09-07,1968,"CS Sedan","AS Saint-Etienne","0-0",0,0,"1",1,0,0,"D"
"9060",1968-09-07,1968,"Girondins Bordeaux","US Valenciennes-Anzin","1-0",1,0,"1",1,1,1,"H"
"9061",1968-09-07,1968,"SC Bastia","RC Strasbourg","2-1",2,1,"1",1,3,1,"H"
"9062",1968-09-08,1968,"FC Nantes","Olympique Marseille","2-1",2,1,"1",1,3,1,"H"
"9063",1968-09-08,1968,"Red Star FC","OGC Nice","0-2",0,2,"1",1,2,-2,"D"
"9064",1968-09-08,1968,"AS Monaco","Stade Rennes","2-2",2,2,"1",1,4,0,"D"
"9065",1968-09-13,1968,"AS Saint-Etienne","FC Nantes","3-1",3,1,"1",1,4,2,"H"
"9066",1968-09-13,1968,"OGC Nice","Olympique Lyon","2-1",2,1,"1",1,3,1,"H"
"9067",1968-09-13,1968,"RC Strasbourg","Red Star FC","1-0",1,0,"1",1,1,1,"H"
"9068",1968-09-14,1968,"Stade Rennes","FC Metz","2-0",2,0,"1",1,2,2,"H"
"9069",1968-09-14,1968,"FC Rouen","Girondins Bordeaux","2-1",2,1,"1",1,3,1,"H"
"9070",1968-09-14,1968,"Nimes Olympique","SC Bastia","2-1",2,1,"1",1,3,1,"H"
"9071",1968-09-14,1968,"US Valenciennes-Anzin","FC Sochaux","2-1",2,1,"1",1,3,1,"H"
"9072",1968-09-15,1968,"AC Ajaccio","CS Sedan","2-0",2,0,"1",1,2,2,"H"
"9073",1968-09-15,1968,"Olympique Marseille","AS Monaco","0-1",0,1,"1",1,1,-1,"D"
"9074",1968-09-20,1968,"AS Monaco","US Valenciennes-Anzin","0-0",0,0,"1",1,0,0,"D"
"9075",1968-09-21,1968,"AS Saint-Etienne","FC Rouen","2-0",2,0,"1",1,2,2,"H"
"9076",1968-09-21,1968,"FC Nantes","AC Ajaccio","0-0",0,0,"1",1,0,0,"D"
"9077",1968-09-21,1968,"SC Bastia","Stade Rennes","1-2",1,2,"1",1,3,-1,"D"
"9078",1968-09-21,1968,"FC Metz","RC Strasbourg","2-0",2,0,"1",1,2,2,"H"
"9079",1968-09-21,1968,"CS Sedan","OGC Nice","2-1",2,1,"1",1,3,1,"H"
"9080",1968-09-21,1968,"Girondins Bordeaux","Nimes Olympique","2-1",2,1,"1",1,3,1,"H"
"9081",1968-09-21,1968,"Red Star FC","Olympique Lyon","1-2",1,2,"1",1,3,-1,"D"
"9082",1968-09-23,1968,"FC Sochaux","Olympique Marseille","3-1",3,1,"1",1,4,2,"H"
"9083",1968-09-27,1968,"Olympique Lyon","SC Bastia","8-3",8,3,"1",1,11,5,"H"
"9084",1968-09-27,1968,"RC Strasbourg","AS Monaco","5-0",5,0,"1",1,5,5,"H"
"9085",1968-09-27,1968,"OGC Nice","Girondins Bordeaux","2-2",2,2,"1",1,4,0,"D"
"9086",1968-09-28,1968,"Stade Rennes","Red Star FC","1-1",1,1,"1",1,2,0,"D"
"9087",1968-09-28,1968,"Nimes Olympique","FC Metz","0-0",0,0,"1",1,0,0,"D"
"9088",1968-09-28,1968,"US Valenciennes-Anzin","FC Nantes","0-0",0,0,"1",1,0,0,"D"
"9089",1968-09-28,1968,"FC Rouen","FC Sochaux","2-1",2,1,"1",1,3,1,"H"
"9090",1968-09-28,1968,"Olympique Marseille","CS Sedan","4-1",4,1,"1",1,5,3,"H"
"9091",1968-10-05,1968,"FC Sochaux","Stade Rennes","1-1",1,1,"1",1,2,0,"D"
"9092",1968-10-05,1968,"Girondins Bordeaux","RC Strasbourg","3-0",3,0,"1",1,3,3,"H"
"9093",1968-10-05,1968,"FC Metz","Olympique Lyon","1-1",1,1,"1",1,2,0,"D"
"9094",1968-10-05,1968,"FC Nantes","OGC Nice","0-0",0,0,"1",1,0,0,"D"
"9095",1968-10-05,1968,"CS Sedan","FC Rouen","1-1",1,1,"1",1,2,0,"D"
"9096",1968-10-05,1968,"AS Monaco","Nimes Olympique","0-0",0,0,"1",1,0,0,"D"
"9097",1968-10-06,1968,"Red Star FC","SC Bastia","1-1",1,1,"1",1,2,0,"D"
"9098",1968-10-06,1968,"AC Ajaccio","Olympique Marseille","1-1",1,1,"1",1,2,0,"D"
"9099",1968-10-06,1968,"AS Saint-Etienne","US Valenciennes-Anzin","4-0",4,0,"1",1,4,4,"H"
"9100",1968-10-11,1968,"OGC Nice","FC Sochaux","0-3",0,3,"1",1,3,-3,"D"
"9101",1968-10-11,1968,"RC Strasbourg","CS Sedan","1-2",1,2,"1",1,3,-1,"D"
"9102",1968-10-12,1968,"Stade Rennes","Girondins Bordeaux","0-1",0,1,"1",1,1,-1,"D"
"9103",1968-10-12,1968,"FC Rouen","AS Monaco","3-1",3,1,"1",1,4,2,"H"
"9104",1968-10-12,1968,"Nimes Olympique","Red Star FC","0-0",0,0,"1",1,0,0,"D"
"9105",1968-10-13,1968,"Olympique Marseille","AS Saint-Etienne","0-3",0,3,"1",1,3,-3,"D"
"9106",1968-10-13,1968,"Olympique Lyon","FC Nantes","3-1",3,1,"1",1,4,2,"H"
"9107",1968-10-13,1968,"SC Bastia","FC Metz","1-1",1,1,"1",1,2,0,"D"
"9108",1968-10-13,1968,"US Valenciennes-Anzin","AC Ajaccio","1-0",1,0,"1",1,1,1,"H"
"9109",1968-10-19,1968,"Girondins Bordeaux","SC Bastia","8-1",8,1,"1",1,9,7,"H"
"9110",1968-10-19,1968,"FC Metz","Red Star FC","3-1",3,1,"1",1,4,2,"H"
"9111",1968-10-19,1968,"FC Nantes","Nimes Olympique","3-1",3,1,"1",1,4,2,"H"
"9112",1968-10-19,1968,"FC Sochaux","RC Strasbourg","3-0",3,0,"1",1,3,3,"H"
"9113",1968-10-20,1968,"AS Saint-Etienne","Olympique Lyon","0-1",0,1,"1",1,1,-1,"D"
"9114",1968-10-20,1968,"AC Ajaccio","FC Rouen","0-1",0,1,"1",1,1,-1,"D"
"9115",1968-10-20,1968,"CS Sedan","Stade Rennes","3-0",3,0,"1",1,3,3,"H"
"9116",1968-10-20,1968,"US Valenciennes-Anzin","Olympique Marseille","3-1",3,1,"1",1,4,2,"H"
"9117",1968-10-20,1968,"AS Monaco","OGC Nice","0-0",0,0,"1",1,0,0,"D"
"9118",1968-10-25,1968,"RC Strasbourg","AC Ajaccio","3-0",3,0,"1",1,3,3,"H"
"9119",1968-10-25,1968,"Red Star FC","Girondins Bordeaux","1-2",1,2,"1",1,3,-1,"D"
"9120",1968-10-26,1968,"Olympique Lyon","FC Sochaux","6-3",6,3,"1",1,9,3,"H"
"9121",1968-10-26,1968,"Stade Rennes","FC Nantes","2-1",2,1,"1",1,3,1,"H"
"9122",1968-10-26,1968,"FC Rouen","US Valenciennes-Anzin","2-2",2,2,"1",1,4,0,"D"
"9123",1968-10-27,1968,"OGC Nice","AS Saint-Etienne","2-3",2,3,"1",1,5,-1,"D"
"9124",1968-10-27,1968,"Olympique Marseille","FC Metz","0-1",0,1,"1",1,1,-1,"D"
"9125",1968-10-27,1968,"Nimes Olympique","CS Sedan","1-0",1,0,"1",1,1,1,"H"
"9126",1968-10-27,1968,"SC Bastia","AS Monaco","4-0",4,0,"1",1,4,4,"H"
"9127",1968-10-31,1968,"Girondins Bordeaux","FC Metz","1-0",1,0,"1",1,1,1,"H"
"9128",1968-10-31,1968,"AS Saint-Etienne","RC Strasbourg","2-0",2,0,"1",1,2,2,"H"
"9129",1968-11-01,1968,"CS Sedan","Olympique Lyon","1-0",1,0,"1",1,1,1,"H"
"9130",1968-11-01,1968,"FC Nantes","FC Rouen","0-1",0,1,"1",1,1,-1,"D"
"9131",1968-11-01,1968,"US Valenciennes-Anzin","OGC Nice","3-0",3,0,"1",1,3,3,"H"
"9132",1968-11-01,1968,"Olympique Marseille","Stade Rennes","3-3",3,3,"1",1,6,0,"D"
"9133",1968-11-01,1968,"FC Sochaux","SC Bastia","2-2",2,2,"1",1,4,0,"D"
"9134",1968-11-01,1968,"AS Monaco","Red Star FC","1-1",1,1,"1",1,2,0,"D"
"9135",1968-11-03,1968,"AC Ajaccio","Nimes Olympique","1-0",1,0,"1",1,1,1,"H"
"9136",1968-11-10,1968,"Olympique Lyon","Girondins Bordeaux","0-2",0,2,"1",1,2,-2,"D"
"9137",1968-11-10,1968,"Red Star FC","AS Saint-Etienne","0-0",0,0,"1",1,0,0,"D"
"9138",1968-11-10,1968,"FC Rouen","Olympique Marseille","2-1",2,1,"1",1,3,1,"H"
"9139",1968-11-10,1968,"Stade Rennes","US Valenciennes-Anzin","1-2",1,2,"1",1,3,-1,"D"
"9140",1968-11-10,1968,"FC Metz","AS Monaco","0-0",0,0,"1",1,0,0,"D"
"9141",1968-11-10,1968,"OGC Nice","AC Ajaccio","0-3",0,3,"1",1,3,-3,"D"
"9142",1968-11-10,1968,"Nimes Olympique","FC Sochaux","3-1",3,1,"1",1,4,2,"H"
"9143",1968-11-10,1968,"RC Strasbourg","FC Nantes","1-0",1,0,"1",1,1,1,"H"
"9144",1968-11-11,1968,"SC Bastia","CS Sedan","0-0",0,0,"1",1,0,0,"D"
"9145",1968-11-16,1968,"US Valenciennes-Anzin","RC Strasbourg","1-1",1,1,"1",1,2,0,"D"
"9146",1968-11-16,1968,"AS Saint-Etienne","Nimes Olympique","1-0",1,0,"1",1,1,1,"H"
"9147",1968-11-17,1968,"AC Ajaccio","Olympique Lyon","4-1",4,1,"1",1,5,3,"H"
"9148",1968-11-17,1968,"FC Sochaux","FC Metz","5-2",5,2,"1",1,7,3,"H"
"9149",1968-11-17,1968,"CS Sedan","Red Star FC","0-0",0,0,"1",1,0,0,"D"
"9150",1968-11-17,1968,"FC Nantes","SC Bastia","3-0",3,0,"1",1,3,3,"H"
"9151",1968-11-17,1968,"Olympique Marseille","OGC Nice","3-1",3,1,"1",1,4,2,"H"
"9152",1968-11-19,1968,"AS Monaco","Girondins Bordeaux","2-4",2,4,"1",1,6,-2,"D"
"9153",1968-11-24,1968,"Girondins Bordeaux","FC Nantes","1-1",1,1,"1",1,2,0,"D"
"9154",1968-11-24,1968,"SC Bastia","AS Saint-Etienne","1-1",1,1,"1",1,2,0,"D"
"9155",1968-11-24,1968,"Nimes Olympique","US Valenciennes-Anzin","2-2",2,2,"1",1,4,0,"D"
"9156",1968-11-24,1968,"OGC Nice","FC Rouen","2-2",2,2,"1",1,4,0,"D"
"9157",1968-11-24,1968,"Olympique Lyon","AS Monaco","2-0",2,0,"1",1,2,2,"H"
"9158",1968-11-24,1968,"Stade Rennes","AC Ajaccio","5-0",5,0,"1",1,5,5,"H"
"9159",1968-11-24,1968,"FC Metz","CS Sedan","0-1",0,1,"1",1,1,-1,"D"
"9160",1968-11-24,1968,"Red Star FC","FC Sochaux","2-2",2,2,"1",1,4,0,"D"
"9161",1968-11-24,1968,"RC Strasbourg","Olympique Marseille","1-2",1,2,"1",1,3,-1,"D"
"9162",1968-11-30,1968,"AS Saint-Etienne","FC Metz","4-0",4,0,"1",1,4,4,"H"
"9163",1968-11-30,1968,"FC Sochaux","AS Monaco","0-0",0,0,"1",1,0,0,"D"
"9164",1968-12-01,1968,"CS Sedan","Girondins Bordeaux","0-1",0,1,"1",1,1,-1,"D"
"9165",1968-12-01,1968,"FC Rouen","RC Strasbourg","3-0",3,0,"1",1,3,3,"H"
"9166",1968-12-01,1968,"US Valenciennes-Anzin","Olympique Lyon","0-0",0,0,"1",1,0,0,"D"
"9167",1968-12-01,1968,"AC Ajaccio","SC Bastia","4-0",4,0,"1",1,4,4,"H"
"9168",1968-12-01,1968,"OGC Nice","Stade Rennes","1-1",1,1,"1",1,2,0,"D"
"9169",1968-12-01,1968,"FC Nantes","Red Star FC","0-1",0,1,"1",1,1,-1,"D"
"9170",1968-12-01,1968,"Olympique Marseille","Nimes Olympique","4-0",4,0,"1",1,4,4,"H"
"9171",1968-12-05,1968,"AS Saint-Etienne","AC Ajaccio","2-0",2,0,"1",1,2,2,"H"
"9172",1968-12-07,1968,"RC Strasbourg","OGC Nice","1-0",1,0,"1",1,1,1,"H"
"9173",1968-12-08,1968,"Stade Rennes","AS Saint-Etienne","0-2",0,2,"1",1,2,-2,"D"
"9174",1968-12-08,1968,"Girondins Bordeaux","FC Sochaux","4-0",4,0,"1",1,4,4,"H"
"9175",1968-12-08,1968,"Nimes Olympique","FC Rouen","0-0",0,0,"1",1,0,0,"D"
"9176",1968-12-08,1968,"Olympique Lyon","Olympique Marseille","2-3",2,3,"1",1,5,-1,"D"
"9177",1968-12-08,1968,"Red Star FC","AC Ajaccio","1-0",1,0,"1",1,1,1,"H"
"9178",1968-12-08,1968,"FC Metz","FC Nantes","1-0",1,0,"1",1,1,1,"H"
"9179",1968-12-08,1968,"AS Monaco","CS Sedan","0-0",0,0,"1",1,0,0,"D"
"9180",1968-12-12,1968,"FC Rouen","Stade Rennes","1-0",1,0,"1",1,1,1,"H"
"9181",1968-12-15,1968,"AS Saint-Etienne","Girondins Bordeaux","3-2",3,2,"1",1,5,1,"H"
"9182",1968-12-15,1968,"FC Rouen","Olympique Lyon","2-1",2,1,"1",1,3,1,"H"
"9183",1968-12-15,1968,"US Valenciennes-Anzin","Red Star FC","3-0",3,0,"1",1,3,3,"H"
"9184",1968-12-15,1968,"CS Sedan","FC Sochaux","2-0",2,0,"1",1,2,2,"H"
"9185",1968-12-15,1968,"AC Ajaccio","FC Metz","0-1",0,1,"1",1,1,-1,"D"
"9186",1968-12-15,1968,"RC Strasbourg","Stade Rennes","0-0",0,0,"1",1,0,0,"D"
"9187",1968-12-15,1968,"Olympique Marseille","SC Bastia","1-0",1,0,"1",1,1,1,"H"
"9188",1968-12-15,1968,"FC Nantes","AS Monaco","2-0",2,0,"1",1,2,2,"H"
"9189",1968-12-15,1968,"OGC Nice","Nimes Olympique","3-0",3,0,"1",1,3,3,"H"
"9190",1969-01-05,1968,"AS Monaco","AS Saint-Etienne","1-2",1,2,"1",1,3,-1,"D"
"9191",1969-01-05,1968,"Girondins Bordeaux","AC Ajaccio","5-0",5,0,"1",1,5,5,"H"
"9192",1969-01-05,1968,"SC Bastia","FC Rouen","1-1",1,1,"1",1,2,0,"D"
"9193",1969-01-05,1968,"CS Sedan","US Valenciennes-Anzin","1-0",1,0,"1",1,1,1,"H"
"9194",1969-01-05,1968,"FC Metz","OGC Nice","1-0",1,0,"1",1,1,1,"H"
"9195",1969-01-05,1968,"Olympique Lyon","Stade Rennes","1-0",1,0,"1",1,1,1,"H"
"9196",1969-01-05,1968,"Red Star FC","Olympique Marseille","1-1",1,1,"1",1,2,0,"D"
"9197",1969-01-05,1968,"FC Sochaux","FC Nantes","1-2",1,2,"1",1,3,-1,"D"
"9198",1969-01-05,1968,"Nimes Olympique","RC Strasbourg","0-0",0,0,"1",1,0,0,"D"
"9199",1969-01-18,1968,"Stade Rennes","AS Monaco","3-1",3,1,"1",1,4,2,"H"
"9200",1969-01-19,1968,"AS Saint-Etienne","CS Sedan","4-2",4,2,"1",1,6,2,"H"
"9201",1969-01-19,1968,"US Valenciennes-Anzin","Girondins Bordeaux","1-1",1,1,"1",1,2,0,"D"
"9202",1969-01-19,1968,"FC Rouen","FC Metz","1-0",1,0,"1",1,1,1,"H"
"9203",1969-01-19,1968,"Olympique Marseille","FC Nantes","3-1",3,1,"1",1,4,2,"H"
"9204",1969-01-19,1968,"RC Strasbourg","SC Bastia","4-0",4,0,"1",1,4,4,"H"
"9205",1969-01-19,1968,"AC Ajaccio","FC Sochaux","0-2",0,2,"1",1,2,-2,"D"
"9206",1969-01-19,1968,"OGC Nice","Red Star FC","1-1",1,1,"1",1,2,0,"D"
"9207",1969-01-26,1968,"FC Nantes","AS Saint-Etienne","3-0",3,0,"1",1,3,3,"H"
"9208",1969-01-26,1968,"Girondins Bordeaux","FC Rouen","2-1",2,1,"1",1,3,1,"H"
"9209",1969-01-26,1968,"CS Sedan","AC Ajaccio","4-0",4,0,"1",1,4,4,"H"
"9210",1969-01-26,1968,"FC Metz","Stade Rennes","3-0",3,0,"1",1,3,3,"H"
"9211",1969-01-26,1968,"Olympique Lyon","OGC Nice","3-1",3,1,"1",1,4,2,"H"
"9212",1969-01-26,1968,"FC Sochaux","US Valenciennes-Anzin","2-0",2,0,"1",1,2,2,"H"
"9213",1969-01-26,1968,"AS Monaco","Olympique Marseille","1-0",1,0,"1",1,1,1,"H"
"9214",1969-01-26,1968,"Red Star FC","RC Strasbourg","2-1",2,1,"1",1,3,1,"H"
"9215",1969-01-26,1968,"SC Bastia","Nimes Olympique","2-2",2,2,"1",1,4,0,"D"
"9216",1969-02-01,1968,"Stade Rennes","SC Bastia","3-1",3,1,"1",1,4,2,"H"
"9217",1969-02-02,1968,"FC Rouen","AS Saint-Etienne","1-5",1,5,"1",1,6,-4,"D"
"9218",1969-02-02,1968,"Nimes Olympique","Girondins Bordeaux","1-3",1,3,"1",1,4,-2,"D"
"9219",1969-02-02,1968,"US Valenciennes-Anzin","AS Monaco","4-2",4,2,"1",1,6,2,"H"
"9220",1969-02-02,1968,"RC Strasbourg","FC Metz","1-1",1,1,"1",1,2,0,"D"
"9221",1969-02-02,1968,"Olympique Lyon","Red Star FC","0-0",0,0,"1",1,0,0,"D"
"9222",1969-02-02,1968,"OGC Nice","CS Sedan","2-1",2,1,"1",1,3,1,"H"
"9223",1969-02-02,1968,"Olympique Marseille","FC Sochaux","4-0",4,0,"1",1,4,4,"H"
"9224",1969-02-02,1968,"AC Ajaccio","FC Nantes","1-0",1,0,"1",1,1,1,"H"
"9225",1969-02-16,1968,"AC Ajaccio","AS Saint-Etienne","0-2",0,2,"1",1,2,-2,"D"
"9226",1969-02-16,1968,"FC Nantes","US Valenciennes-Anzin","3-2",3,2,"1",1,5,1,"H"
"9227",1969-02-16,1968,"SC Bastia","Olympique Lyon","4-0",4,0,"1",1,4,4,"H"
"9228",1969-02-16,1968,"AS Monaco","RC Strasbourg","2-1",2,1,"1",1,3,1,"H"
"9229",1969-02-23,1968,"US Valenciennes-Anzin","AS Saint-Etienne","1-1",1,1,"1",1,2,0,"D"
"9230",1969-02-23,1968,"RC Strasbourg","Girondins Bordeaux","1-1",1,1,"1",1,2,0,"D"
"9231",1969-02-23,1968,"FC Rouen","CS Sedan","0-1",0,1,"1",1,1,-1,"D"
"9232",1969-02-23,1968,"Olympique Lyon","FC Metz","0-1",0,1,"1",1,1,-1,"D"
"9233",1969-02-23,1968,"Olympique Marseille","AC Ajaccio","3-0",3,0,"1",1,3,3,"H"
"9234",1969-02-23,1968,"Stade Rennes","FC Sochaux","3-2",3,2,"1",1,5,1,"H"
"9235",1969-02-23,1968,"SC Bastia","Red Star FC","2-1",2,1,"1",1,3,1,"H"
"9236",1969-03-02,1968,"SC Bastia","US Valenciennes-Anzin","3-0",3,0,"1",1,3,3,"H"
"9237",1969-03-02,1968,"FC Sochaux","FC Rouen","2-0",2,0,"1",1,2,2,"H"
"9238",1969-03-02,1968,"Nimes Olympique","AS Monaco","1-1",1,1,"1",1,2,0,"D"
"9239",1969-03-15,1968,"FC Metz","SC Bastia","2-0",2,0,"1",1,2,2,"H"
"9240",1969-03-15,1968,"FC Nantes","Olympique Lyon","2-1",2,1,"1",1,3,1,"H"
"9241",1969-03-15,1968,"FC Sochaux","OGC Nice","3-0",3,0,"1",1,3,3,"H"
"9242",1969-03-16,1968,"AS Saint-Etienne","Olympique Marseille","1-0",1,0,"1",1,1,1,"H"
"9243",1969-03-16,1968,"Girondins Bordeaux","Stade Rennes","3-2",3,2,"1",1,5,1,"H"
"9244",1969-03-16,1968,"AS Monaco","FC Rouen","1-1",1,1,"1",1,2,0,"D"
"9245",1969-03-16,1968,"CS Sedan","RC Strasbourg","1-1",1,1,"1",1,2,0,"D"
"9246",1969-03-16,1968,"AC Ajaccio","US Valenciennes-Anzin","1-1",1,1,"1",1,2,0,"D"
"9247",1969-03-16,1968,"Red Star FC","Nimes Olympique","0-2",0,2,"1",1,2,-2,"D"
"9248",1969-03-21,1968,"FC Rouen","AC Ajaccio","1-1",1,1,"1",1,2,0,"D"
"9249",1969-03-21,1968,"Olympique Marseille","US Valenciennes-Anzin","1-0",1,0,"1",1,1,1,"H"
"9250",1969-03-21,1968,"RC Strasbourg","FC Sochaux","1-0",1,0,"1",1,1,1,"H"
"9251",1969-03-22,1968,"Nimes Olympique","FC Nantes","1-2",1,2,"1",1,3,-1,"D"
"9252",1969-03-22,1968,"Stade Rennes","CS Sedan","1-3",1,3,"1",1,4,-2,"D"
"9253",1969-03-23,1968,"Olympique Lyon","AS Saint-Etienne","1-2",1,2,"1",1,3,-1,"D"
"9254",1969-03-23,1968,"SC Bastia","Girondins Bordeaux","1-0",1,0,"1",1,1,1,"H"
"9255",1969-03-23,1968,"Red Star FC","FC Metz","1-0",1,0,"1",1,1,1,"H"
"9256",1969-03-23,1968,"OGC Nice","AS Monaco","1-0",1,0,"1",1,1,1,"H"
"9257",1969-03-29,1968,"FC Metz","Nimes Olympique","0-0",0,0,"1",1,0,0,"D"
"9258",1969-03-29,1968,"OGC Nice","FC Nantes","0-0",0,0,"1",1,0,0,"D"
"9259",1969-04-04,1968,"AS Saint-Etienne","OGC Nice","2-0",2,0,"1",1,2,2,"H"
"9260",1969-04-04,1968,"US Valenciennes-Anzin","FC Rouen","0-1",0,1,"1",1,1,-1,"D"
"9261",1969-04-04,1968,"FC Sochaux","Olympique Lyon","2-1",2,1,"1",1,3,1,"H"
"9262",1969-04-04,1968,"AS Monaco","SC Bastia","2-0",2,0,"1",1,2,2,"H"
"9263",1969-04-05,1968,"FC Nantes","Stade Rennes","3-2",3,2,"1",1,5,1,"H"
"9264",1969-04-05,1968,"AC Ajaccio","RC Strasbourg","1-1",1,1,"1",1,2,0,"D"
"9265",1969-04-06,1968,"CS Sedan","Nimes Olympique","3-1",3,1,"1",1,4,2,"H"
"9266",1969-04-09,1968,"Girondins Bordeaux","Red Star FC","6-1",6,1,"1",1,7,5,"H"
"9267",1969-04-09,1968,"FC Metz","Olympique Marseille","3-0",3,0,"1",1,3,3,"H"
"9268",1969-04-11,1968,"OGC Nice","US Valenciennes-Anzin","1-1",1,1,"1",1,2,0,"D"
"9269",1969-04-12,1968,"Olympique Lyon","CS Sedan","1-0",1,0,"1",1,1,1,"H"
"9270",1969-04-12,1968,"Stade Rennes","Olympique Marseille","2-1",2,1,"1",1,3,1,"H"
"9271",1969-04-12,1968,"SC Bastia","FC Sochaux","1-0",1,0,"1",1,1,1,"H"
"9272",1969-04-12,1968,"Nimes Olympique","AC Ajaccio","3-2",3,2,"1",1,5,1,"H"
"9273",1969-04-13,1968,"RC Strasbourg","AS Saint-Etienne","0-2",0,2,"1",1,2,-2,"D"
"9274",1969-04-13,1968,"FC Metz","Girondins Bordeaux","1-0",1,0,"1",1,1,1,"H"
"9275",1969-04-13,1968,"FC Rouen","FC Nantes","3-0",3,0,"1",1,3,3,"H"
"9276",1969-04-13,1968,"Red Star FC","AS Monaco","1-0",1,0,"1",1,1,1,"H"
"9277",1969-04-16,1968,"Girondins Bordeaux","OGC Nice","5-0",5,0,"1",1,5,5,"H"
"9278",1969-04-18,1968,"Olympique Marseille","FC Rouen","1-0",1,0,"1",1,1,1,"H"
"9279",1969-04-18,1968,"FC Sochaux","Nimes Olympique","1-1",1,1,"1",1,2,0,"D"
"9280",1969-04-19,1968,"AS Saint-Etienne","Red Star FC","3-1",3,1,"1",1,4,2,"H"
"9281",1969-04-19,1968,"AS Monaco","FC Metz","1-1",1,1,"1",1,2,0,"D"
"9282",1969-04-19,1968,"US Valenciennes-Anzin","Stade Rennes","4-1",4,1,"1",1,5,3,"H"
"9283",1969-04-20,1968,"AC Ajaccio","OGC Nice","1-0",1,0,"1",1,1,1,"H"
"9284",1969-04-20,1968,"Girondins Bordeaux","Olympique Lyon","2-1",2,1,"1",1,3,1,"H"
"9285",1969-04-25,1968,"Nimes Olympique","Olympique Lyon","1-2",1,2,"1",1,3,-1,"D"
"9286",1969-04-27,1968,"Red Star FC","Stade Rennes","2-1",2,1,"1",1,3,1,"H"
"9287",1969-05-02,1968,"RC Strasbourg","US Valenciennes-Anzin","0-1",0,1,"1",1,1,-1,"D"
"9288",1969-05-02,1968,"Olympique Lyon","AC Ajaccio","3-2",3,2,"1",1,5,1,"H"
"9289",1969-05-03,1968,"Nimes Olympique","AS Saint-Etienne","1-0",1,0,"1",1,1,1,"H"
"9290",1969-05-03,1968,"FC Metz","FC Sochaux","3-0",3,0,"1",1,3,3,"H"
"9291",1969-05-03,1968,"Stade Rennes","FC Rouen","0-1",0,1,"1",1,1,-1,"D"
"9292",1969-05-03,1968,"SC Bastia","FC Nantes","3-1",3,1,"1",1,4,2,"H"
"9293",1969-05-07,1968,"Girondins Bordeaux","AS Monaco","2-1",2,1,"1",1,3,1,"H"
"9294",1969-05-07,1968,"OGC Nice","Olympique Marseille","2-3",2,3,"1",1,5,-1,"D"
"9295",1969-05-07,1968,"Red Star FC","CS Sedan","2-1",2,1,"1",1,3,1,"H"
"9296",1969-05-09,1968,"AS Saint-Etienne","SC Bastia","7-2",7,2,"1",1,9,5,"H"
"9297",1969-05-10,1968,"FC Nantes","Girondins Bordeaux","1-2",1,2,"1",1,3,-1,"D"
"9298",1969-05-10,1968,"US Valenciennes-Anzin","Nimes Olympique","0-0",0,0,"1",1,0,0,"D"
"9299",1969-05-10,1968,"Olympique Marseille","RC Strasbourg","0-0",0,0,"1",1,0,0,"D"
"9300",1969-05-10,1968,"FC Sochaux","Red Star FC","3-3",3,3,"1",1,6,0,"D"
"9301",1969-05-10,1968,"AC Ajaccio","Stade Rennes","2-2",2,2,"1",1,4,0,"D"
"9302",1969-05-11,1968,"CS Sedan","FC Metz","0-0",0,0,"1",1,0,0,"D"
"9303",1969-05-11,1968,"AS Monaco","Olympique Lyon","0-2",0,2,"1",1,2,-2,"D"
"9304",1969-05-13,1968,"FC Rouen","OGC Nice","4-0",4,0,"1",1,4,4,"H"
"9305",1969-05-14,1968,"Olympique Lyon","US Valenciennes-Anzin","1-0",1,0,"1",1,1,1,"H"
"9306",1969-05-15,1968,"Red Star FC","FC Nantes","2-3",2,3,"1",1,5,-1,"D"
"9307",1969-05-18,1968,"FC Metz","AS Saint-Etienne","0-1",0,1,"1",1,1,-1,"D"
"9308",1969-05-18,1968,"RC Strasbourg","FC Rouen","2-0",2,0,"1",1,2,2,"H"
"9309",1969-05-18,1968,"Stade Rennes","OGC Nice","4-2",4,2,"1",1,6,2,"H"
"9310",1969-05-18,1968,"SC Bastia","AC Ajaccio","1-0",1,0,"1",1,1,1,"H"
"9311",1969-05-18,1968,"AS Monaco","FC Sochaux","2-1",2,1,"1",1,3,1,"H"
"9312",1969-05-21,1968,"CS Sedan","SC Bastia","5-1",5,1,"1",1,6,4,"H"
"9313",1969-05-22,1968,"Olympique Marseille","Olympique Lyon","2-2",2,2,"1",1,4,0,"D"
"9314",1969-05-23,1968,"AS Saint-Etienne","Stade Rennes","3-1",3,1,"1",1,4,2,"H"
"9315",1969-05-23,1968,"FC Sochaux","Girondins Bordeaux","0-1",0,1,"1",1,1,-1,"D"
"9316",1969-05-23,1968,"FC Rouen","Nimes Olympique","1-0",1,0,"1",1,1,1,"H"
"9317",1969-05-23,1968,"OGC Nice","RC Strasbourg","1-0",1,0,"1",1,1,1,"H"
"9318",1969-05-24,1968,"FC Nantes","FC Metz","1-2",1,2,"1",1,3,-1,"D"
"9319",1969-05-24,1968,"CS Sedan","AS Monaco","2-2",2,2,"1",1,4,0,"D"
"9320",1969-05-24,1968,"US Valenciennes-Anzin","SC Bastia","0-1",0,1,"1",1,1,-1,"D"
"9321",1969-05-24,1968,"AC Ajaccio","Red Star FC","3-1",3,1,"1",1,4,2,"H"
"9322",1969-05-27,1968,"Girondins Bordeaux","CS Sedan","0-2",0,2,"1",1,2,-2,"D"
"9323",1969-05-27,1968,"Nimes Olympique","Olympique Marseille","0-0",0,0,"1",1,0,0,"D"
"9324",1969-05-30,1968,"Olympique Lyon","FC Rouen","0-1",0,1,"1",1,1,-1,"D"
"9325",1969-05-31,1968,"FC Metz","AC Ajaccio","0-0",0,0,"1",1,0,0,"D"
"9326",1969-05-31,1968,"FC Sochaux","CS Sedan","3-1",3,1,"1",1,4,2,"H"
"9327",1969-05-31,1968,"Red Star FC","US Valenciennes-Anzin","1-2",1,2,"1",1,3,-1,"D"
"9328",1969-05-31,1968,"SC Bastia","Olympique Marseille","3-1",3,1,"1",1,4,2,"H"
"9329",1969-05-31,1968,"AS Monaco","FC Nantes","2-0",2,0,"1",1,2,2,"H"
"9330",1969-05-31,1968,"Stade Rennes","RC Strasbourg","1-0",1,0,"1",1,1,1,"H"
"9331",1969-05-31,1968,"Nimes Olympique","OGC Nice","2-0",2,0,"1",1,2,2,"H"
"9332",1969-06-01,1968,"Girondins Bordeaux","AS Saint-Etienne","2-0",2,0,"1",1,2,2,"H"
"9333",1969-06-04,1968,"CS Sedan","Olympique Marseille","3-1",3,1,"1",1,4,2,"H"
"9334",1969-06-04,1968,"FC Nantes","RC Strasbourg","4-0",4,0,"1",1,4,4,"H"
"9335",1969-06-06,1968,"FC Rouen","SC Bastia","1-3",1,3,"1",1,4,-2,"D"
"9336",1969-06-06,1968,"US Valenciennes-Anzin","CS Sedan","1-1",1,1,"1",1,2,0,"D"
"9337",1969-06-07,1968,"AS Saint-Etienne","AS Monaco","1-1",1,1,"1",1,2,0,"D"
"9338",1969-06-07,1968,"AC Ajaccio","Girondins Bordeaux","2-2",2,2,"1",1,4,0,"D"
"9339",1969-06-07,1968,"OGC Nice","FC Metz","1-2",1,2,"1",1,3,-1,"D"
"9340",1969-06-07,1968,"Stade Rennes","Olympique Lyon","2-1",2,1,"1",1,3,1,"H"
"9341",1969-06-07,1968,"Olympique Marseille","Red Star FC","0-0",0,0,"1",1,0,0,"D"
"9342",1969-06-07,1968,"FC Nantes","FC Sochaux","0-0",0,0,"1",1,0,0,"D"
"9343",1969-06-07,1968,"RC Strasbourg","Nimes Olympique","1-0",1,0,"1",1,1,1,"H"
"9344",1969-06-13,1968,"Girondins Bordeaux","Olympique Marseille","2-2",2,2,"1",1,4,0,"D"
"9345",1969-06-13,1968,"Nimes Olympique","Stade Rennes","5-1",5,1,"1",1,6,4,"H"
"9346",1969-06-14,1968,"FC Sochaux","AS Saint-Etienne","1-0",1,0,"1",1,1,1,"H"
"9347",1969-06-14,1968,"FC Metz","US Valenciennes-Anzin","1-0",1,0,"1",1,1,1,"H"
"9348",1969-06-14,1968,"Red Star FC","FC Rouen","4-0",4,0,"1",1,4,4,"H"
"9349",1969-06-14,1968,"CS Sedan","FC Nantes","3-1",3,1,"1",1,4,2,"H"
"9350",1969-06-14,1968,"SC Bastia","OGC Nice","2-0",2,0,"1",1,2,2,"H"
"9351",1969-06-14,1968,"Olympique Lyon","RC Strasbourg","2-3",2,3,"1",1,5,-1,"D"
"9352",1969-06-14,1968,"AS Monaco","AC Ajaccio","3-0",3,0,"1",1,3,3,"H"
"9353",1969-08-05,1969,"AS Saint-Etienne","AC Ajaccio","3-1",3,1,"1",1,4,2,"H"
"9354",1969-08-05,1969,"Olympique Marseille","FC Sochaux","0-0",0,0,"1",1,0,0,"D"
"9355",1969-08-06,1969,"SC Bastia","Olympique Lyon","2-4",2,4,"1",1,6,-2,"D"
"9356",1969-08-06,1969,"Red Star FC","Angers SCO","3-4",3,4,"1",1,7,-1,"D"
"9357",1969-08-06,1969,"RC Strasbourg","FC Rouen","3-2",3,2,"1",1,5,1,"H"
"9358",1969-08-06,1969,"FC Nantes","FC Metz","1-0",1,0,"1",1,1,1,"H"
"9359",1969-08-06,1969,"AS Angouleme","Nimes Olympique","1-0",1,0,"1",1,1,1,"H"
"9360",1969-08-06,1969,"Stade Rennes","US Valenciennes-Anzin","1-1",1,1,"1",1,2,0,"D"
"9361",1969-08-06,1969,"CS Sedan","Girondins Bordeaux","1-1",1,1,"1",1,2,0,"D"
"9362",1969-08-09,1969,"Olympique Lyon","CS Sedan","4-2",4,2,"1",1,6,2,"H"
"9363",1969-08-09,1969,"AS Saint-Etienne","FC Metz","2-0",2,0,"1",1,2,2,"H"
"9364",1969-08-09,1969,"US Valenciennes-Anzin","AS Angouleme","0-1",0,1,"1",1,1,-1,"D"
"9365",1969-08-09,1969,"Girondins Bordeaux","RC Strasbourg","4-2",4,2,"1",1,6,2,"H"
"9366",1969-08-09,1969,"FC Rouen","Stade Rennes","4-0",4,0,"1",1,4,4,"H"
"9367",1969-08-09,1969,"FC Sochaux","Red Star FC","0-3",0,3,"1",1,3,-3,"D"
"9368",1969-08-09,1969,"AC Ajaccio","FC Nantes","2-1",2,1,"1",1,3,1,"H"
"9369",1969-08-09,1969,"Nimes Olympique","Olympique Marseille","1-1",1,1,"1",1,2,0,"D"
"9370",1969-08-13,1969,"Olympique Lyon","Nimes Olympique","3-0",3,0,"1",1,3,3,"H"
"9371",1969-08-13,1969,"FC Nantes","AS Saint-Etienne","2-2",2,2,"1",1,4,0,"D"
"9372",1969-08-13,1969,"AS Angouleme","FC Rouen","1-1",1,1,"1",1,2,0,"D"
"9373",1969-08-13,1969,"Red Star FC","FC Metz","3-1",3,1,"1",1,4,2,"H"
"9374",1969-08-13,1969,"Olympique Marseille","Girondins Bordeaux","3-1",3,1,"1",1,4,2,"H"
"9375",1969-08-13,1969,"RC Strasbourg","US Valenciennes-Anzin","4-2",4,2,"1",1,6,2,"H"
"9376",1969-08-13,1969,"Stade Rennes","AC Ajaccio","0-1",0,1,"1",1,1,-1,"D"
"9377",1969-08-13,1969,"CS Sedan","Angers SCO","2-2",2,2,"1",1,4,0,"D"
"9378",1969-08-13,1969,"SC Bastia","FC Sochaux","2-0",2,0,"1",1,2,2,"H"
"9379",1969-08-17,1969,"Angers SCO","SC Bastia","5-0",5,0,"1",1,5,5,"H"
"9380",1969-08-20,1969,"AS Saint-Etienne","Stade Rennes","8-2",8,2,"1",1,10,6,"H"
"9381",1969-08-20,1969,"Angers SCO","Olympique Lyon","3-2",3,2,"1",1,5,1,"H"
"9382",1969-08-20,1969,"Nimes Olympique","Red Star FC","1-3",1,3,"1",1,4,-2,"D"
"9383",1969-08-20,1969,"US Valenciennes-Anzin","Olympique Marseille","0-2",0,2,"1",1,2,-2,"D"
"9384",1969-08-20,1969,"AC Ajaccio","AS Angouleme","0-0",0,0,"1",1,0,0,"D"
"9385",1969-08-20,1969,"FC Rouen","FC Nantes","1-0",1,0,"1",1,1,1,"H"
"9386",1969-08-20,1969,"FC Sochaux","CS Sedan","1-0",1,0,"1",1,1,1,"H"
"9387",1969-08-20,1969,"Girondins Bordeaux","SC Bastia","1-0",1,0,"1",1,1,1,"H"
"9388",1969-08-21,1969,"FC Metz","RC Strasbourg","2-2",2,2,"1",1,4,0,"D"
"9389",1969-08-27,1969,"Olympique Marseille","AS Saint-Etienne","2-3",2,3,"1",1,5,-1,"D"
"9390",1969-08-27,1969,"Olympique Lyon","FC Sochaux","2-2",2,2,"1",1,4,0,"D"
"9391",1969-08-27,1969,"SC Bastia","Nimes Olympique","2-5",2,5,"1",1,7,-3,"D"
"9392",1969-08-27,1969,"Stade Rennes","FC Metz","2-0",2,0,"1",1,2,2,"H"
"9393",1969-08-29,1969,"Angers SCO","US Valenciennes-Anzin","0-1",0,1,"1",1,1,-1,"D"
"9394",1969-08-29,1969,"RC Strasbourg","AC Ajaccio","2-0",2,0,"1",1,2,2,"H"
"9395",1969-08-30,1969,"Red Star FC","Girondins Bordeaux","1-1",1,1,"1",1,2,0,"D"
"9396",1969-08-30,1969,"AS Angouleme","FC Nantes","2-2",2,2,"1",1,4,0,"D"
"9397",1969-08-30,1969,"CS Sedan","FC Rouen","1-0",1,0,"1",1,1,1,"H"
"9398",1969-09-03,1969,"AS Saint-Etienne","RC Strasbourg","3-0",3,0,"1",1,3,3,"H"
"9399",1969-09-03,1969,"FC Sochaux","Angers SCO","1-1",1,1,"1",1,2,0,"D"
"9400",1969-09-03,1969,"AC Ajaccio","Red Star FC","2-2",2,2,"1",1,4,0,"D"
"9401",1969-09-03,1969,"Girondins Bordeaux","Olympique Lyon","3-0",3,0,"1",1,3,3,"H"
"9402",1969-09-03,1969,"FC Rouen","Olympique Marseille","1-1",1,1,"1",1,2,0,"D"
"9403",1969-09-03,1969,"FC Metz","AS Angouleme","3-2",3,2,"1",1,5,1,"H"
"9404",1969-09-03,1969,"FC Nantes","Stade Rennes","6-1",6,1,"1",1,7,5,"H"
"9405",1969-09-03,1969,"Nimes Olympique","CS Sedan","5-1",5,1,"1",1,6,4,"H"
"9406",1969-09-03,1969,"US Valenciennes-Anzin","SC Bastia","2-0",2,0,"1",1,2,2,"H"
"9407",1969-09-17,1969,"Olympique Lyon","FC Rouen","3-0",3,0,"1",1,3,3,"H"
"9408",1969-09-19,1969,"RC Strasbourg","FC Nantes","2-1",2,1,"1",1,3,1,"H"
"9409",1969-09-20,1969,"Angers SCO","Girondins Bordeaux","3-1",3,1,"1",1,4,2,"H"
"9410",1969-09-20,1969,"Olympique Marseille","AC Ajaccio","1-0",1,0,"1",1,1,1,"H"
"9411",1969-09-20,1969,"AS Angouleme","Stade Rennes","3-0",3,0,"1",1,3,3,"H"
"9412",1969-09-20,1969,"FC Sochaux","Nimes Olympique","2-2",2,2,"1",1,4,0,"D"
"9413",1969-09-20,1969,"CS Sedan","US Valenciennes-Anzin","0-0",0,0,"1",1,0,0,"D"
"9414",1969-09-20,1969,"SC Bastia","FC Metz","2-2",2,2,"1",1,4,0,"D"
"9415",1969-09-21,1969,"Red Star FC","AS Saint-Etienne","1-5",1,5,"1",1,6,-4,"D"
"9416",1969-09-24,1969,"AS Saint-Etienne","AS Angouleme","1-1",1,1,"1",1,2,0,"D"
"9417",1969-09-24,1969,"Girondins Bordeaux","FC Sochaux","3-0",3,0,"1",1,3,3,"H"
"9418",1969-09-24,1969,"FC Metz","Olympique Marseille","2-1",2,1,"1",1,3,1,"H"
"9419",1969-09-24,1969,"FC Rouen","SC Bastia","3-0",3,0,"1",1,3,3,"H"
"9420",1969-09-24,1969,"AC Ajaccio","CS Sedan","0-1",0,1,"1",1,1,-1,"D"
"9421",1969-09-27,1969,"Nimes Olympique","Angers SCO","1-1",1,1,"1",1,2,0,"D"
"9422",1969-09-27,1969,"Stade Rennes","RC Strasbourg","4-5",4,5,"1",1,9,-1,"D"
"9423",1969-09-27,1969,"FC Nantes","Olympique Lyon","5-2",5,2,"1",1,7,3,"H"
"9424",1969-09-27,1969,"US Valenciennes-Anzin","Red Star FC","2-0",2,0,"1",1,2,2,"H"
"9425",1969-10-01,1969,"RC Strasbourg","AS Angouleme","3-1",3,1,"1",1,4,2,"H"
"9426",1969-10-04,1969,"Girondins Bordeaux","Nimes Olympique","1-0",1,0,"1",1,1,1,"H"
"9427",1969-10-04,1969,"Angers SCO","FC Nantes","0-3",0,3,"1",1,3,-3,"D"
"9428",1969-10-04,1969,"Red Star FC","FC Rouen","2-0",2,0,"1",1,2,2,"H"
"9429",1969-10-04,1969,"FC Sochaux","US Valenciennes-Anzin","6-1",6,1,"1",1,7,5,"H"
"9430",1969-10-04,1969,"CS Sedan","FC Metz","0-0",0,0,"1",1,0,0,"D"
"9431",1969-10-05,1969,"Olympique Lyon","AS Saint-Etienne","1-7",1,7,"1",1,8,-6,"D"
"9432",1969-10-05,1969,"Olympique Marseille","Stade Rennes","1-0",1,0,"1",1,1,1,"H"
"9433",1969-10-05,1969,"SC Bastia","AC Ajaccio","2-0",2,0,"1",1,2,2,"H"
"9434",1969-10-18,1969,"FC Nantes","SC Bastia","2-1",2,1,"1",1,3,1,"H"
"9435",1969-10-18,1969,"FC Metz","Angers SCO","2-1",2,1,"1",1,3,1,"H"
"9436",1969-10-18,1969,"Stade Rennes","Red Star FC","2-2",2,2,"1",1,4,0,"D"
"9437",1969-10-18,1969,"FC Rouen","FC Sochaux","1-3",1,3,"1",1,4,-2,"D"
"9438",1969-10-19,1969,"AC Ajaccio","Olympique Lyon","2-0",2,0,"1",1,2,2,"H"
"9439",1969-10-19,1969,"US Valenciennes-Anzin","Girondins Bordeaux","1-4",1,4,"1",1,5,-3,"D"
"9440",1969-10-21,1969,"AS Saint-Etienne","CS Sedan","3-1",3,1,"1",1,4,2,"H"
"9441",1969-10-22,1969,"AS Angouleme","Olympique Marseille","1-3",1,3,"1",1,4,-2,"D"
"9442",1969-10-22,1969,"Nimes Olympique","RC Strasbourg","3-2",3,2,"1",1,5,1,"H"
"9443",1969-10-24,1969,"Olympique Lyon","US Valenciennes-Anzin","1-0",1,0,"1",1,1,1,"H"
"9444",1969-10-25,1969,"FC Sochaux","AS Saint-Etienne","3-3",3,3,"1",1,6,0,"D"
"9445",1969-10-25,1969,"Girondins Bordeaux","FC Rouen","1-1",1,1,"1",1,2,0,"D"
"9446",1969-10-25,1969,"Angers SCO","AC Ajaccio","3-2",3,2,"1",1,5,1,"H"
"9447",1969-10-26,1969,"Olympique Marseille","RC Strasbourg","2-0",2,0,"1",1,2,2,"H"
"9448",1969-10-26,1969,"CS Sedan","FC Nantes","4-0",4,0,"1",1,4,4,"H"
"9449",1969-10-26,1969,"Red Star FC","AS Angouleme","0-0",0,0,"1",1,0,0,"D"
"9450",1969-10-26,1969,"Nimes Olympique","FC Metz","2-1",2,1,"1",1,3,1,"H"
"9451",1969-10-26,1969,"SC Bastia","Stade Rennes","4-0",4,0,"1",1,4,4,"H"
"9452",1969-11-02,1969,"US Valenciennes-Anzin","Nimes Olympique","0-2",0,2,"1",1,2,-2,"D"
"9453",1969-11-04,1969,"FC Metz","Girondins Bordeaux","4-1",4,1,"1",1,5,3,"H"
"9454",1969-11-04,1969,"Stade Rennes","CS Sedan","3-3",3,3,"1",1,6,0,"D"
"9455",1969-11-05,1969,"AS Saint-Etienne","SC Bastia","4-2",4,2,"1",1,6,2,"H"
"9456",1969-11-05,1969,"FC Nantes","Olympique Marseille","2-1",2,1,"1",1,3,1,"H"
"9457",1969-11-05,1969,"RC Strasbourg","Red Star FC","5-0",5,0,"1",1,5,5,"H"
"9458",1969-11-05,1969,"FC Rouen","Angers SCO","5-0",5,0,"1",1,5,5,"H"
"9459",1969-11-05,1969,"AS Angouleme","Olympique Lyon","1-1",1,1,"1",1,2,0,"D"
"9460",1969-11-05,1969,"AC Ajaccio","FC Sochaux","1-0",1,0,"1",1,1,1,"H"
"9461",1969-11-08,1969,"Olympique Lyon","Stade Rennes","4-4",4,4,"1",1,8,0,"D"
"9462",1969-11-09,1969,"Girondins Bordeaux","AC Ajaccio","2-1",2,1,"1",1,3,1,"H"
"9463",1969-11-09,1969,"Nimes Olympique","FC Rouen","6-1",6,1,"1",1,7,5,"H"
"9464",1969-11-09,1969,"SC Bastia","RC Strasbourg","2-1",2,1,"1",1,3,1,"H"
"9465",1969-11-09,1969,"CS Sedan","AS Angouleme","2-0",2,0,"1",1,2,2,"H"
"9466",1969-11-09,1969,"US Valenciennes-Anzin","FC Metz","0-0",0,0,"1",1,0,0,"D"
"9467",1969-11-15,1969,"FC Nantes","Red Star FC","1-1",1,1,"1",1,2,0,"D"
"9468",1969-11-15,1969,"FC Rouen","US Valenciennes-Anzin","3-3",3,3,"1",1,6,0,"D"
"9469",1969-11-16,1969,"AS Saint-Etienne","Girondins Bordeaux","2-0",2,0,"1",1,2,2,"H"
"9470",1969-11-16,1969,"Olympique Marseille","Olympique Lyon","4-1",4,1,"1",1,5,3,"H"
"9471",1969-11-16,1969,"AC Ajaccio","Nimes Olympique","1-0",1,0,"1",1,1,1,"H"
"9472",1969-11-16,1969,"RC Strasbourg","CS Sedan","2-3",2,3,"1",1,5,-1,"D"
"9473",1969-11-16,1969,"AS Angouleme","SC Bastia","5-1",5,1,"1",1,6,4,"H"
"9474",1969-11-16,1969,"FC Metz","FC Sochaux","1-2",1,2,"1",1,3,-1,"D"
"9475",1969-11-16,1969,"Stade Rennes","Angers SCO","1-0",1,0,"1",1,1,1,"H"
"9476",1969-11-20,1969,"Nimes Olympique","AS Saint-Etienne","1-3",1,3,"1",1,4,-2,"D"
"9477",1969-11-22,1969,"CS Sedan","Olympique Marseille","0-0",0,0,"1",1,0,0,"D"
"9478",1969-11-22,1969,"FC Sochaux","Stade Rennes","2-2",2,2,"1",1,4,0,"D"
"9479",1969-11-23,1969,"Girondins Bordeaux","FC Nantes","3-0",3,0,"1",1,3,3,"H"
"9480",1969-11-23,1969,"Olympique Lyon","RC Strasbourg","0-1",0,1,"1",1,1,-1,"D"
"9481",1969-11-23,1969,"Angers SCO","AS Angouleme","2-2",2,2,"1",1,4,0,"D"
"9482",1969-11-23,1969,"FC Rouen","FC Metz","1-1",1,1,"1",1,2,0,"D"
"9483",1969-11-23,1969,"SC Bastia","Red Star FC","3-0",3,0,"1",1,3,3,"H"
"9484",1969-11-23,1969,"US Valenciennes-Anzin","AC Ajaccio","2-1",2,1,"1",1,3,1,"H"
"9485",1969-11-29,1969,"FC Nantes","Nimes Olympique","1-0",1,0,"1",1,1,1,"H"
"9486",1969-11-30,1969,"AS Saint-Etienne","US Valenciennes-Anzin","1-0",1,0,"1",1,1,1,"H"
"9487",1969-11-30,1969,"Stade Rennes","Girondins Bordeaux","0-0",0,0,"1",1,0,0,"D"
"9488",1969-11-30,1969,"Olympique Marseille","SC Bastia","3-3",3,3,"1",1,6,0,"D"
"9489",1969-11-30,1969,"RC Strasbourg","Angers SCO","4-1",4,1,"1",1,5,3,"H"
"9490",1969-11-30,1969,"Red Star FC","CS Sedan","0-2",0,2,"1",1,2,-2,"D"
"9491",1969-11-30,1969,"AS Angouleme","FC Sochaux","4-0",4,0,"1",1,4,4,"H"
"9492",1969-11-30,1969,"FC Metz","Olympique Lyon","4-0",4,0,"1",1,4,4,"H"
"9493",1969-11-30,1969,"AC Ajaccio","FC Rouen","1-0",1,0,"1",1,1,1,"H"
"9494",1969-12-07,1969,"FC Rouen","AS Saint-Etienne","0-2",0,2,"1",1,2,-2,"D"
"9495",1969-12-07,1969,"Girondins Bordeaux","AS Angouleme","5-1",5,1,"1",1,6,4,"H"
"9496",1969-12-07,1969,"Angers SCO","Olympique Marseille","2-1",2,1,"1",1,3,1,"H"
"9497",1969-12-07,1969,"FC Sochaux","RC Strasbourg","2-0",2,0,"1",1,2,2,"H"
"9498",1969-12-07,1969,"CS Sedan","SC Bastia","0-2",0,2,"1",1,2,-2,"D"
"9499",1969-12-07,1969,"US Valenciennes-Anzin","FC Nantes","2-1",2,1,"1",1,3,1,"H"
"9500",1969-12-07,1969,"AC Ajaccio","FC Metz","0-0",0,0,"1",1,0,0,"D"
"9501",1969-12-07,1969,"Nimes Olympique","Stade Rennes","2-3",2,3,"1",1,5,-1,"D"
"9502",1969-12-07,1969,"Olympique Lyon","Red Star FC","2-0",2,0,"1",1,2,2,"H"
"9503",1969-12-13,1969,"FC Sochaux","SC Bastia","2-1",2,1,"1",1,3,1,"H"
"9504",1969-12-14,1969,"Girondins Bordeaux","Olympique Marseille","2-2",2,2,"1",1,4,0,"D"
"9505",1969-12-14,1969,"Angers SCO","CS Sedan","1-3",1,3,"1",1,4,-2,"D"
"9506",1969-12-14,1969,"US Valenciennes-Anzin","RC Strasbourg","2-0",2,0,"1",1,2,2,"H"
"9507",1969-12-14,1969,"Nimes Olympique","Olympique Lyon","5-2",5,2,"1",1,7,3,"H"
"9508",1969-12-14,1969,"AC Ajaccio","Stade Rennes","4-2",4,2,"1",1,6,2,"H"
"9509",1969-12-21,1969,"Stade Rennes","AS Saint-Etienne","1-0",1,0,"1",1,1,1,"H"
"9510",1969-12-21,1969,"SC Bastia","Girondins Bordeaux","2-2",2,2,"1",1,4,0,"D"
"9511",1969-12-21,1969,"Olympique Marseille","US Valenciennes-Anzin","3-1",3,1,"1",1,4,2,"H"
"9512",1969-12-21,1969,"AS Angouleme","AC Ajaccio","2-1",2,1,"1",1,3,1,"H"
"9513",1969-12-21,1969,"Red Star FC","Nimes Olympique","3-0",3,0,"1",1,3,3,"H"
"9514",1969-12-21,1969,"FC Nantes","FC Rouen","0-2",0,2,"1",1,2,-2,"D"
"9515",1969-12-21,1969,"Olympique Lyon","Angers SCO","2-1",2,1,"1",1,3,1,"H"
"9516",1970-01-18,1969,"FC Rouen","AS Angouleme","0-2",0,2,"1",1,2,-2,"D"
"9517",1970-01-25,1969,"FC Metz","AS Saint-Etienne","1-2",1,2,"1",1,3,-1,"D"
"9518",1970-01-25,1969,"Olympique Marseille","Nimes Olympique","4-0",4,0,"1",1,4,4,"H"
"9519",1970-01-25,1969,"AS Angouleme","US Valenciennes-Anzin","6-1",6,1,"1",1,7,5,"H"
"9520",1970-01-25,1969,"CS Sedan","Olympique Lyon","1-0",1,0,"1",1,1,1,"H"
"9521",1970-01-25,1969,"FC Nantes","AC Ajaccio","6-0",6,0,"1",1,6,6,"H"
"9522",1970-01-25,1969,"Red Star FC","FC Sochaux","1-0",1,0,"1",1,1,1,"H"
"9523",1970-01-25,1969,"SC Bastia","Angers SCO","3-1",3,1,"1",1,4,2,"H"
"9524",1970-01-25,1969,"Stade Rennes","FC Rouen","1-1",1,1,"1",1,2,0,"D"
"9525",1970-02-01,1969,"AS Saint-Etienne","Olympique Marseille","2-1",2,1,"1",1,3,1,"H"
"9526",1970-02-01,1969,"Girondins Bordeaux","Red Star FC","0-1",0,1,"1",1,1,-1,"D"
"9527",1970-02-01,1969,"FC Nantes","AS Angouleme","1-1",1,1,"1",1,2,0,"D"
"9528",1970-02-01,1969,"FC Rouen","CS Sedan","0-0",0,0,"1",1,0,0,"D"
"9529",1970-02-01,1969,"Nimes Olympique","SC Bastia","4-1",4,1,"1",1,5,3,"H"
"9530",1970-02-01,1969,"AC Ajaccio","RC Strasbourg","1-0",1,0,"1",1,1,1,"H"
"9531",1970-02-01,1969,"US Valenciennes-Anzin","Angers SCO","0-2",0,2,"1",1,2,-2,"D"
"9532",1970-02-01,1969,"FC Sochaux","Olympique Lyon","0-2",0,2,"1",1,2,-2,"D"
"9533",1970-02-01,1969,"FC Metz","Stade Rennes","2-0",2,0,"1",1,2,2,"H"
"9534",1970-02-15,1969,"RC Strasbourg","AS Saint-Etienne","1-1",1,1,"1",1,2,0,"D"
"9535",1970-02-15,1969,"Olympique Marseille","FC Rouen","2-0",2,0,"1",1,2,2,"H"
"9536",1970-02-15,1969,"Olympique Lyon","Girondins Bordeaux","1-3",1,3,"1",1,4,-2,"D"
"9537",1970-02-15,1969,"CS Sedan","Nimes Olympique","1-0",1,0,"1",1,1,1,"H"
"9538",1970-02-15,1969,"Stade Rennes","FC Nantes","1-2",1,2,"1",1,3,-1,"D"
"9539",1970-02-15,1969,"Red Star FC","AC Ajaccio","4-1",4,1,"1",1,5,3,"H"
"9540",1970-02-15,1969,"Angers SCO","FC Sochaux","2-2",2,2,"1",1,4,0,"D"
"9541",1970-02-22,1969,"AS Saint-Etienne","Red Star FC","0-0",0,0,"1",1,0,0,"D"
"9542",1970-02-22,1969,"AC Ajaccio","Olympique Marseille","2-4",2,4,"1",1,6,-2,"D"
"9543",1970-02-22,1969,"Girondins Bordeaux","Angers SCO","1-0",1,0,"1",1,1,1,"H"
"9544",1970-02-22,1969,"US Valenciennes-Anzin","CS Sedan","1-3",1,3,"1",1,4,-2,"D"
"9545",1970-02-22,1969,"Stade Rennes","AS Angouleme","2-0",2,0,"1",1,2,2,"H"
"9546",1970-02-22,1969,"FC Nantes","RC Strasbourg","0-1",0,1,"1",1,1,-1,"D"
"9547",1970-02-22,1969,"Nimes Olympique","FC Sochaux","2-0",2,0,"1",1,2,2,"H"
"9548",1970-02-22,1969,"FC Metz","SC Bastia","3-0",3,0,"1",1,3,3,"H"
"9549",1970-02-22,1969,"FC Rouen","Olympique Lyon","1-0",1,0,"1",1,1,1,"H"
"9550",1970-03-06,1969,"RC Strasbourg","Stade Rennes","1-1",1,1,"1",1,2,0,"D"
"9551",1970-03-08,1969,"AS Angouleme","AS Saint-Etienne","0-1",0,1,"1",1,1,-1,"D"
"9552",1970-03-08,1969,"Olympique Marseille","FC Metz","3-2",3,2,"1",1,5,1,"H"
"9553",1970-03-08,1969,"Olympique Lyon","FC Nantes","2-5",2,5,"1",1,7,-3,"D"
"9554",1970-03-08,1969,"Red Star FC","US Valenciennes-Anzin","1-1",1,1,"1",1,2,0,"D"
"9555",1970-03-08,1969,"Angers SCO","Nimes Olympique","1-0",1,0,"1",1,1,1,"H"
"9556",1970-03-08,1969,"SC Bastia","FC Rouen","0-2",0,2,"1",1,2,-2,"D"
"9557",1970-03-14,1969,"Nimes Olympique","Girondins Bordeaux","3-0",3,0,"1",1,3,3,"H"
"9558",1970-03-14,1969,"FC Nantes","Angers SCO","1-0",1,0,"1",1,1,1,"H"
"9559",1970-03-14,1969,"FC Rouen","Red Star FC","2-0",2,0,"1",1,2,2,"H"
"9560",1970-03-15,1969,"AS Saint-Etienne","Olympique Lyon","6-0",6,0,"1",1,6,6,"H"
"9561",1970-03-15,1969,"Stade Rennes","Olympique Marseille","1-1",1,1,"1",1,2,0,"D"
"9562",1970-03-15,1969,"FC Metz","CS Sedan","0-2",0,2,"1",1,2,-2,"D"
"9563",1970-03-15,1969,"AS Angouleme","RC Strasbourg","1-1",1,1,"1",1,2,0,"D"
"9564",1970-03-15,1969,"US Valenciennes-Anzin","FC Sochaux","0-1",0,1,"1",1,1,-1,"D"
"9565",1970-03-15,1969,"AC Ajaccio","SC Bastia","2-0",2,0,"1",1,2,2,"H"
"9566",1970-03-20,1969,"RC Strasbourg","Girondins Bordeaux","3-1",3,1,"1",1,4,2,"H"
"9567",1970-03-22,1969,"Red Star FC","Olympique Marseille","1-6",1,6,"1",1,7,-5,"D"
"9568",1970-03-22,1969,"CS Sedan","FC Sochaux","3-0",3,0,"1",1,3,3,"H"
"9569",1970-03-27,1969,"FC Sochaux","Girondins Bordeaux","3-2",3,2,"1",1,5,1,"H"
"9570",1970-03-28,1969,"CS Sedan","AC Ajaccio","2-0",2,0,"1",1,2,2,"H"
"9571",1970-04-01,1969,"Olympique Marseille","AS Angouleme","1-1",1,1,"1",1,2,0,"D"
"9572",1970-04-01,1969,"Girondins Bordeaux","US Valenciennes-Anzin","0-2",0,2,"1",1,2,-2,"D"
"9573",1970-04-01,1969,"SC Bastia","FC Nantes","3-2",3,2,"1",1,5,1,"H"
"9574",1970-04-01,1969,"Angers SCO","FC Metz","0-0",0,0,"1",1,0,0,"D"
"9575",1970-04-01,1969,"Olympique Lyon","AC Ajaccio","2-1",2,1,"1",1,3,1,"H"
"9576",1970-04-04,1969,"FC Sochaux","FC Rouen","1-1",1,1,"1",1,2,0,"D"
"9577",1970-04-05,1969,"Red Star FC","Stade Rennes","2-4",2,4,"1",1,6,-2,"D"
"9578",1970-04-11,1969,"RC Strasbourg","Nimes Olympique","4-1",4,1,"1",1,5,3,"H"
"9579",1970-04-14,1969,"FC Metz","Nimes Olympique","3-1",3,1,"1",1,4,2,"H"
"9580",1970-04-15,1969,"AS Saint-Etienne","FC Sochaux","2-0",2,0,"1",1,2,2,"H"
"9581",1970-04-15,1969,"FC Nantes","CS Sedan","2-2",2,2,"1",1,4,0,"D"
"9582",1970-04-15,1969,"FC Rouen","Girondins Bordeaux","0-0",0,0,"1",1,0,0,"D"
"9583",1970-04-15,1969,"AC Ajaccio","Angers SCO","0-1",0,1,"1",1,1,-1,"D"
"9584",1970-04-15,1969,"Stade Rennes","SC Bastia","3-1",3,1,"1",1,4,2,"H"
"9585",1970-04-15,1969,"US Valenciennes-Anzin","Olympique Lyon","1-1",1,1,"1",1,2,0,"D"
"9586",1970-04-18,1969,"RC Strasbourg","Olympique Marseille","2-3",2,3,"1",1,5,-1,"D"
"9587",1970-04-18,1969,"AS Angouleme","Red Star FC","1-1",1,1,"1",1,2,0,"D"
"9588",1970-04-22,1969,"SC Bastia","AS Saint-Etienne","0-1",0,1,"1",1,1,-1,"D"
"9589",1970-04-22,1969,"Olympique Marseille","FC Nantes","4-2",4,2,"1",1,6,2,"H"
"9590",1970-04-22,1969,"CS Sedan","Stade Rennes","3-2",3,2,"1",1,5,1,"H"
"9591",1970-04-22,1969,"Girondins Bordeaux","FC Metz","1-0",1,0,"1",1,1,1,"H"
"9592",1970-04-22,1969,"Olympique Lyon","AS Angouleme","1-2",1,2,"1",1,3,-1,"D"
"9593",1970-04-22,1969,"Red Star FC","RC Strasbourg","2-1",2,1,"1",1,3,1,"H"
"9594",1970-04-22,1969,"Angers SCO","FC Rouen","1-1",1,1,"1",1,2,0,"D"
"9595",1970-04-22,1969,"Nimes Olympique","US Valenciennes-Anzin","2-1",2,1,"1",1,3,1,"H"
"9596",1970-04-22,1969,"FC Sochaux","AC Ajaccio","0-2",0,2,"1",1,2,-2,"D"
"9597",1970-04-25,1969,"FC Metz","Red Star FC","2-1",2,1,"1",1,3,1,"H"
"9598",1970-05-03,1969,"SC Bastia","US Valenciennes-Anzin","3-1",3,1,"1",1,4,2,"H"
"9599",1970-05-03,1969,"AS Angouleme","FC Metz","2-1",2,1,"1",1,3,1,"H"
"9600",1970-05-09,1969,"RC Strasbourg","FC Metz","2-0",2,0,"1",1,2,2,"H"
"9601",1970-05-12,1969,"Girondins Bordeaux","AS Saint-Etienne","1-4",1,4,"1",1,5,-3,"D"
"9602",1970-05-12,1969,"Angers SCO","Stade Rennes","1-0",1,0,"1",1,1,1,"H"
"9603",1970-05-13,1969,"Olympique Lyon","Olympique Marseille","1-0",1,0,"1",1,1,1,"H"
"9604",1970-05-13,1969,"CS Sedan","RC Strasbourg","2-1",2,1,"1",1,3,1,"H"
"9605",1970-05-13,1969,"SC Bastia","AS Angouleme","1-1",1,1,"1",1,2,0,"D"
"9606",1970-05-13,1969,"US Valenciennes-Anzin","FC Rouen","1-3",1,3,"1",1,4,-2,"D"
"9607",1970-05-13,1969,"Red Star FC","FC Nantes","3-0",3,0,"1",1,3,3,"H"
"9608",1970-05-13,1969,"Nimes Olympique","AC Ajaccio","2-0",2,0,"1",1,2,2,"H"
"9609",1970-05-16,1969,"FC Sochaux","FC Metz","4-1",4,1,"1",1,5,3,"H"
"9610",1970-05-20,1969,"AS Saint-Etienne","Nimes Olympique","2-1",2,1,"1",1,3,1,"H"
"9611",1970-05-20,1969,"Olympique Marseille","CS Sedan","2-0",2,0,"1",1,2,2,"H"
"9612",1970-05-20,1969,"FC Nantes","Girondins Bordeaux","1-1",1,1,"1",1,2,0,"D"
"9613",1970-05-20,1969,"Red Star FC","SC Bastia","2-1",2,1,"1",1,3,1,"H"
"9614",1970-05-20,1969,"Stade Rennes","FC Sochaux","2-4",2,4,"1",1,6,-2,"D"
"9615",1970-05-22,1969,"AC Ajaccio","US Valenciennes-Anzin","3-1",3,1,"1",1,4,2,"H"
"9616",1970-05-23,1969,"AS Angouleme","Angers SCO","1-1",1,1,"1",1,2,0,"D"
"9617",1970-05-23,1969,"RC Strasbourg","Olympique Lyon","2-1",2,1,"1",1,3,1,"H"
"9618",1970-05-23,1969,"FC Metz","FC Rouen","2-0",2,0,"1",1,2,2,"H"
"9619",1970-05-27,1969,"US Valenciennes-Anzin","AS Saint-Etienne","0-3",0,3,"1",1,3,-3,"D"
"9620",1970-05-27,1969,"SC Bastia","Olympique Marseille","3-2",3,2,"1",1,5,1,"H"
"9621",1970-05-27,1969,"Girondins Bordeaux","Stade Rennes","1-1",1,1,"1",1,2,0,"D"
"9622",1970-05-27,1969,"Angers SCO","RC Strasbourg","4-1",4,1,"1",1,5,3,"H"
"9623",1970-05-27,1969,"FC Rouen","AC Ajaccio","2-0",2,0,"1",1,2,2,"H"
"9624",1970-05-27,1969,"Nimes Olympique","FC Nantes","4-2",4,2,"1",1,6,2,"H"
"9625",1970-05-27,1969,"Olympique Lyon","FC Metz","2-4",2,4,"1",1,6,-2,"D"
"9626",1970-05-30,1969,"CS Sedan","Red Star FC","3-0",3,0,"1",1,3,3,"H"
"9627",1970-05-30,1969,"FC Sochaux","AS Angouleme","1-0",1,0,"1",1,1,1,"H"
"9628",1970-06-03,1969,"AS Saint-Etienne","FC Rouen","5-0",5,0,"1",1,5,5,"H"
"9629",1970-06-03,1969,"Olympique Marseille","Angers SCO","5-2",5,2,"1",1,7,3,"H"
"9630",1970-06-03,1969,"SC Bastia","CS Sedan","2-3",2,3,"1",1,5,-1,"D"
"9631",1970-06-03,1969,"RC Strasbourg","FC Sochaux","2-2",2,2,"1",1,4,0,"D"
"9632",1970-06-03,1969,"Stade Rennes","Nimes Olympique","1-1",1,1,"1",1,2,0,"D"
"9633",1970-06-03,1969,"Red Star FC","Olympique Lyon","1-5",1,5,"1",1,6,-4,"D"
"9634",1970-06-03,1969,"FC Nantes","US Valenciennes-Anzin","1-2",1,2,"1",1,3,-1,"D"
"9635",1970-06-05,1969,"AS Angouleme","Girondins Bordeaux","3-2",3,2,"1",1,5,1,"H"
"9636",1970-06-06,1969,"FC Sochaux","FC Nantes","0-3",0,3,"1",1,3,-3,"D"
"9637",1970-06-06,1969,"Angers SCO","AS Saint-Etienne","0-0",0,0,"1",1,0,0,"D"
"9638",1970-06-06,1969,"CS Sedan","AS Saint-Etienne","1-2",1,2,"1",1,3,-1,"D"
"9639",1970-06-06,1969,"FC Metz","AC Ajaccio","1-0",1,0,"1",1,1,1,"H"
"9640",1970-06-06,1969,"Olympique Marseille","Red Star FC","4-0",4,0,"1",1,4,4,"H"
"9641",1970-06-09,1969,"FC Rouen","RC Strasbourg","1-1",1,1,"1",1,2,0,"D"
"9642",1970-06-10,1969,"AC Ajaccio","AS Saint-Etienne","1-2",1,2,"1",1,3,-1,"D"
"9643",1970-06-10,1969,"Nimes Olympique","AS Angouleme","2-2",2,2,"1",1,4,0,"D"
"9644",1970-06-10,1969,"Angers SCO","Red Star FC","5-1",5,1,"1",1,6,4,"H"
"9645",1970-06-10,1969,"FC Metz","FC Nantes","2-2",2,2,"1",1,4,0,"D"
"9646",1970-06-10,1969,"Olympique Lyon","SC Bastia","2-1",2,1,"1",1,3,1,"H"
"9647",1970-06-10,1969,"US Valenciennes-Anzin","Stade Rennes","0-1",0,1,"1",1,1,-1,"D"
"9648",1970-06-13,1969,"AS Saint-Etienne","FC Nantes","2-3",2,3,"1",1,5,-1,"D"
"9649",1970-06-13,1969,"FC Sochaux","Olympique Marseille","2-2",2,2,"1",1,4,0,"D"
"9650",1970-06-13,1969,"Girondins Bordeaux","CS Sedan","4-1",4,1,"1",1,5,3,"H"
"9651",1970-06-17,1969,"AS Saint-Etienne","Angers SCO","1-2",1,2,"1",1,3,-1,"D"
"9652",1970-06-17,1969,"RC Strasbourg","SC Bastia","4-0",4,0,"1",1,4,4,"H"
"9653",1970-06-17,1969,"AC Ajaccio","Girondins Bordeaux","1-1",1,1,"1",1,2,0,"D"
"9654",1970-06-17,1969,"FC Nantes","FC Sochaux","1-2",1,2,"1",1,3,-1,"D"
"9655",1970-06-17,1969,"FC Rouen","Nimes Olympique","1-1",1,1,"1",1,2,0,"D"
"9656",1970-06-17,1969,"Stade Rennes","Olympique Lyon","4-3",4,3,"1",1,7,1,"H"
"9657",1970-06-20,1969,"AS Angouleme","CS Sedan","2-1",2,1,"1",1,3,1,"H"
"9658",1970-06-23,1969,"FC Metz","US Valenciennes-Anzin","3-0",3,0,"1",1,3,3,"H"
"9659",1970-08-12,1970,"AC Ajaccio","AS Nancy","5-0",5,0,"1",1,5,5,"H"
"9660",1970-08-12,1970,"CS Sedan","Angers SCO","6-2",6,2,"1",1,8,4,"H"
"9661",1970-08-12,1970,"Nimes Olympique","AS Angouleme","3-1",3,1,"1",1,4,2,"H"
"9662",1970-08-12,1970,"OGC Nice","Olympique Lyon","2-0",2,0,"1",1,2,2,"H"
"9663",1970-08-12,1970,"AS Saint-Etienne","FC Nantes","2-3",2,3,"1",1,5,-1,"D"
"9664",1970-08-12,1970,"Red Star FC","US Valenciennes-Anzin","3-2",3,2,"1",1,5,1,"H"
"9665",1970-08-12,1970,"RC Strasbourg","Olympique Marseille","1-2",1,2,"1",1,3,-1,"D"
"9666",1970-08-12,1970,"Girondins Bordeaux","FC Sochaux","1-2",1,2,"1",1,3,-1,"D"
"9667",1970-08-12,1970,"FC Metz","SC Bastia","1-0",1,0,"1",1,1,1,"H"
"9668",1970-08-12,1970,"Stade Rennes","Stade Reims","0-0",0,0,"1",1,0,0,"D"
"9669",1970-08-19,1970,"FC Nantes","CS Sedan","2-0",2,0,"1",1,2,2,"H"
"9670",1970-08-19,1970,"FC Sochaux","Red Star FC","2-1",2,1,"1",1,3,1,"H"
"9671",1970-08-19,1970,"Olympique Marseille","AC Ajaccio","1-0",1,0,"1",1,1,1,"H"
"9672",1970-08-19,1970,"Stade Reims","Girondins Bordeaux","3-0",3,0,"1",1,3,3,"H"
"9673",1970-08-19,1970,"FC Metz","OGC Nice","0-0",0,0,"1",1,0,0,"D"
"9674",1970-08-19,1970,"US Valenciennes-Anzin","Nimes Olympique","3-1",3,1,"1",1,4,2,"H"
"9675",1970-08-19,1970,"SC Bastia","Stade Rennes","2-2",2,2,"1",1,4,0,"D"
"9676",1970-08-19,1970,"Angers SCO","AS Nancy","2-1",2,1,"1",1,3,1,"H"
"9677",1970-08-19,1970,"AS Angouleme","AS Saint-Etienne","1-1",1,1,"1",1,2,0,"D"
"9678",1970-08-19,1970,"Olympique Lyon","RC Strasbourg","2-2",2,2,"1",1,4,0,"D"
"9679",1970-08-22,1970,"AS Nancy","FC Nantes","1-2",1,2,"1",1,3,-1,"D"
"9680",1970-08-22,1970,"OGC Nice","SC Bastia","2-0",2,0,"1",1,2,2,"H"
"9681",1970-08-22,1970,"Nimes Olympique","Olympique Marseille","3-0",3,0,"1",1,3,3,"H"
"9682",1970-08-22,1970,"AS Saint-Etienne","FC Sochaux","1-0",1,0,"1",1,1,1,"H"
"9683",1970-08-22,1970,"Stade Rennes","FC Metz","0-0",0,0,"1",1,0,0,"D"
"9684",1970-08-22,1970,"AC Ajaccio","Angers SCO","0-0",0,0,"1",1,0,0,"D"
"9685",1970-08-22,1970,"CS Sedan","AS Angouleme","1-1",1,1,"1",1,2,0,"D"
"9686",1970-08-22,1970,"RC Strasbourg","US Valenciennes-Anzin","0-0",0,0,"1",1,0,0,"D"
"9687",1970-08-22,1970,"Girondins Bordeaux","Olympique Lyon","3-0",3,0,"1",1,3,3,"H"
"9688",1970-08-23,1970,"Red Star FC","Stade Reims","2-1",2,1,"1",1,3,1,"H"
"9689",1970-08-26,1970,"FC Nantes","Angers SCO","1-0",1,0,"1",1,1,1,"H"
"9690",1970-08-26,1970,"Olympique Marseille","CS Sedan","5-0",5,0,"1",1,5,5,"H"
"9691",1970-08-26,1970,"Stade Reims","OGC Nice","1-1",1,1,"1",1,2,0,"D"
"9692",1970-08-26,1970,"FC Sochaux","RC Strasbourg","1-0",1,0,"1",1,1,1,"H"
"9693",1970-08-26,1970,"FC Metz","Girondins Bordeaux","1-0",1,0,"1",1,1,1,"H"
"9694",1970-08-26,1970,"Stade Rennes","Nimes Olympique","2-0",2,0,"1",1,2,2,"H"
"9695",1970-08-26,1970,"US Valenciennes-Anzin","AS Saint-Etienne","0-1",0,1,"1",1,1,-1,"D"
"9696",1970-08-26,1970,"SC Bastia","Red Star FC","2-1",2,1,"1",1,3,1,"H"
"9697",1970-08-26,1970,"AS Angouleme","AS Nancy","1-0",1,0,"1",1,1,1,"H"
"9698",1970-08-26,1970,"Olympique Lyon","AC Ajaccio","3-0",3,0,"1",1,3,3,"H"
"9699",1970-08-29,1970,"AC Ajaccio","FC Nantes","2-1",2,1,"1",1,3,1,"H"
"9700",1970-08-29,1970,"OGC Nice","Stade Rennes","0-1",0,1,"1",1,1,-1,"D"
"9701",1970-08-29,1970,"Angers SCO","AS Angouleme","1-4",1,4,"1",1,5,-3,"D"
"9702",1970-08-29,1970,"AS Nancy","FC Sochaux","2-1",2,1,"1",1,3,1,"H"
"9703",1970-08-29,1970,"Nimes Olympique","Olympique Lyon","1-1",1,1,"1",1,2,0,"D"
"9704",1970-08-29,1970,"CS Sedan","US Valenciennes-Anzin","0-1",0,1,"1",1,1,-1,"D"
"9705",1970-08-29,1970,"Girondins Bordeaux","SC Bastia","2-0",2,0,"1",1,2,2,"H"
"9706",1970-08-29,1970,"RC Strasbourg","Stade Reims","2-0",2,0,"1",1,2,2,"H"
"9707",1970-08-30,1970,"Red Star FC","FC Metz","0-0",0,0,"1",1,0,0,"D"
"9708",1970-09-09,1970,"Stade Rennes","Girondins Bordeaux","3-0",3,0,"1",1,3,3,"H"
"9709",1970-09-09,1970,"Olympique Marseille","Angers SCO","5-1",5,1,"1",1,6,4,"H"
"9710",1970-09-09,1970,"AS Angouleme","FC Nantes","1-0",1,0,"1",1,1,1,"H"
"9711",1970-09-09,1970,"FC Sochaux","CS Sedan","3-1",3,1,"1",1,4,2,"H"
"9712",1970-09-09,1970,"FC Metz","AS Saint-Etienne","2-2",2,2,"1",1,4,0,"D"
"9713",1970-09-09,1970,"OGC Nice","AC Ajaccio","2-3",2,3,"1",1,5,-1,"D"
"9714",1970-09-09,1970,"Stade Reims","Nimes Olympique","1-1",1,1,"1",1,2,0,"D"
"9715",1970-09-09,1970,"US Valenciennes-Anzin","AS Nancy","1-1",1,1,"1",1,2,0,"D"
"9716",1970-09-09,1970,"Olympique Lyon","Red Star FC","2-1",2,1,"1",1,3,1,"H"
"9717",1970-09-09,1970,"SC Bastia","RC Strasbourg","3-1",3,1,"1",1,4,2,"H"
"9718",1970-09-19,1970,"FC Nantes","FC Sochaux","1-1",1,1,"1",1,2,0,"D"
"9719",1970-09-19,1970,"AS Nancy","Olympique Marseille","2-0",2,0,"1",1,2,2,"H"
"9720",1970-09-19,1970,"Nimes Olympique","SC Bastia","2-0",2,0,"1",1,2,2,"H"
"9721",1970-09-19,1970,"AS Saint-Etienne","Stade Reims","3-1",3,1,"1",1,4,2,"H"
"9722",1970-09-19,1970,"RC Strasbourg","FC Metz","2-1",2,1,"1",1,3,1,"H"
"9723",1970-09-19,1970,"Angers SCO","US Valenciennes-Anzin","5-3",5,3,"1",1,8,2,"H"
"9724",1970-09-19,1970,"CS Sedan","Olympique Lyon","3-1",3,1,"1",1,4,2,"H"
"9725",1970-09-20,1970,"AC Ajaccio","AS Angouleme","0-0",0,0,"1",1,0,0,"D"
"9726",1970-09-20,1970,"Girondins Bordeaux","OGC Nice","3-1",3,1,"1",1,4,2,"H"
"9727",1970-09-20,1970,"Red Star FC","Stade Rennes","1-5",1,5,"1",1,6,-4,"D"
"9728",1970-09-23,1970,"Stade Rennes","RC Strasbourg","2-0",2,0,"1",1,2,2,"H"
"9729",1970-09-23,1970,"US Valenciennes-Anzin","FC Nantes","1-2",1,2,"1",1,3,-1,"D"
"9730",1970-09-23,1970,"Olympique Marseille","AS Angouleme","5-0",5,0,"1",1,5,5,"H"
"9731",1970-09-23,1970,"SC Bastia","AS Saint-Etienne","4-2",4,2,"1",1,6,2,"H"
"9732",1970-09-23,1970,"Olympique Lyon","AS Nancy","2-1",2,1,"1",1,3,1,"H"
"9733",1970-09-23,1970,"Stade Reims","Angers SCO","3-1",3,1,"1",1,4,2,"H"
"9734",1970-09-23,1970,"OGC Nice","Red Star FC","1-1",1,1,"1",1,2,0,"D"
"9735",1970-09-23,1970,"Girondins Bordeaux","CS Sedan","1-2",1,2,"1",1,3,-1,"D"
"9736",1970-09-26,1970,"FC Sochaux","AC Ajaccio","5-1",5,1,"1",1,6,4,"H"
"9737",1970-09-26,1970,"FC Metz","Nimes Olympique","4-2",4,2,"1",1,6,2,"H"
"9738",1970-10-03,1970,"Angers SCO","Stade Rennes","2-1",2,1,"1",1,3,1,"H"
"9739",1970-10-03,1970,"FC Nantes","Olympique Marseille","1-3",1,3,"1",1,4,-2,"D"
"9740",1970-10-03,1970,"Nimes Olympique","FC Sochaux","4-3",4,3,"1",1,7,1,"H"
"9741",1970-10-03,1970,"AS Nancy","FC Metz","1-1",1,1,"1",1,2,0,"D"
"9742",1970-10-03,1970,"AS Angouleme","US Valenciennes-Anzin","1-0",1,0,"1",1,1,1,"H"
"9743",1970-10-03,1970,"AS Saint-Etienne","Olympique Lyon","1-0",1,0,"1",1,1,1,"H"
"9744",1970-10-03,1970,"CS Sedan","Stade Reims","1-1",1,1,"1",1,2,0,"D"
"9745",1970-10-03,1970,"RC Strasbourg","OGC Nice","2-2",2,2,"1",1,4,0,"D"
"9746",1970-10-03,1970,"Red Star FC","Girondins Bordeaux","3-1",3,1,"1",1,4,2,"H"
"9747",1970-10-04,1970,"AC Ajaccio","SC Bastia","6-1",6,1,"1",1,7,5,"H"
"9748",1970-10-10,1970,"FC Sochaux","AS Angouleme","3-0",3,0,"1",1,3,3,"H"
"9749",1970-10-10,1970,"FC Metz","CS Sedan","1-0",1,0,"1",1,1,1,"H"
"9750",1970-10-10,1970,"Olympique Lyon","FC Nantes","2-0",2,0,"1",1,2,2,"H"
"9751",1970-10-10,1970,"Stade Reims","AC Ajaccio","1-0",1,0,"1",1,1,1,"H"
"9752",1970-10-10,1970,"OGC Nice","Nimes Olympique","3-0",3,0,"1",1,3,3,"H"
"9753",1970-10-10,1970,"Girondins Bordeaux","RC Strasbourg","1-4",1,4,"1",1,5,-3,"D"
"9754",1970-10-11,1970,"US Valenciennes-Anzin","Olympique Marseille","1-2",1,2,"1",1,3,-1,"D"
"9755",1970-10-11,1970,"Stade Rennes","AS Saint-Etienne","0-3",0,3,"1",1,3,-3,"D"
"9756",1970-10-11,1970,"Red Star FC","Angers SCO","0-5",0,5,"1",1,5,-5,"D"
"9757",1970-10-11,1970,"SC Bastia","AS Nancy","0-2",0,2,"1",1,2,-2,"D"
"9758",1970-10-18,1970,"AS Saint-Etienne","Olympique Marseille","2-1",2,1,"1",1,3,1,"H"
"9759",1970-10-24,1970,"FC Metz","Angers SCO","2-1",2,1,"1",1,3,1,"H"
"9760",1970-10-24,1970,"Stade Rennes","AS Nancy","5-1",5,1,"1",1,6,4,"H"
"9761",1970-10-24,1970,"FC Sochaux","US Valenciennes-Anzin","0-1",0,1,"1",1,1,-1,"D"
"9762",1970-10-24,1970,"Stade Reims","AS Angouleme","2-0",2,0,"1",1,2,2,"H"
"9763",1970-10-24,1970,"RC Strasbourg","Nimes Olympique","0-2",0,2,"1",1,2,-2,"D"
"9764",1970-10-25,1970,"OGC Nice","CS Sedan","2-0",2,0,"1",1,2,2,"H"
"9765",1970-10-25,1970,"Red Star FC","AC Ajaccio","3-0",3,0,"1",1,3,3,"H"
"9766",1970-10-25,1970,"SC Bastia","FC Nantes","1-0",1,0,"1",1,1,1,"H"
"9767",1970-10-25,1970,"Girondins Bordeaux","AS Saint-Etienne","1-2",1,2,"1",1,3,-1,"D"
"9768",1970-10-25,1970,"Olympique Lyon","Olympique Marseille","1-4",1,4,"1",1,5,-3,"D"
"9769",1970-10-28,1970,"AS Saint-Etienne","RC Strasbourg","2-1",2,1,"1",1,3,1,"H"
"9770",1970-10-28,1970,"FC Nantes","Stade Reims","3-0",3,0,"1",1,3,3,"H"
"9771",1970-10-30,1970,"AS Nancy","OGC Nice","0-0",0,0,"1",1,0,0,"D"
"9772",1970-10-31,1970,"AS Angouleme","SC Bastia","2-2",2,2,"1",1,4,0,"D"
"9773",1970-10-31,1970,"Nimes Olympique","Red Star FC","1-2",1,2,"1",1,3,-1,"D"
"9774",1970-11-01,1970,"Olympique Marseille","FC Metz","2-1",2,1,"1",1,3,1,"H"
"9775",1970-11-01,1970,"CS Sedan","Stade Rennes","0-1",0,1,"1",1,1,-1,"D"
"9776",1970-11-01,1970,"AC Ajaccio","Girondins Bordeaux","2-0",2,0,"1",1,2,2,"H"
"9777",1970-11-01,1970,"US Valenciennes-Anzin","Olympique Lyon","1-2",1,2,"1",1,3,-1,"D"
"9778",1970-11-12,1970,"Nimes Olympique","Girondins Bordeaux","1-1",1,1,"1",1,2,0,"D"
"9779",1970-11-12,1970,"Angers SCO","Olympique Lyon","3-2",3,2,"1",1,5,1,"H"
"9780",1970-11-12,1970,"CS Sedan","SC Bastia","5-1",5,1,"1",1,6,4,"H"
"9781",1970-11-14,1970,"Olympique Marseille","FC Sochaux","2-2",2,2,"1",1,4,0,"D"
"9782",1970-11-14,1970,"AS Saint-Etienne","OGC Nice","2-1",2,1,"1",1,3,1,"H"
"9783",1970-11-14,1970,"FC Nantes","FC Metz","0-0",0,0,"1",1,0,0,"D"
"9784",1970-11-14,1970,"RC Strasbourg","Red Star FC","2-1",2,1,"1",1,3,1,"H"
"9785",1970-11-14,1970,"AS Nancy","Stade Reims","2-2",2,2,"1",1,4,0,"D"
"9786",1970-11-18,1970,"AS Angouleme","Stade Rennes","1-0",1,0,"1",1,1,1,"H"
"9787",1970-11-18,1970,"AC Ajaccio","US Valenciennes-Anzin","1-0",1,0,"1",1,1,1,"H"
"9788",1970-11-18,1970,"SC Bastia","Olympique Marseille","0-3",0,3,"1",1,3,-3,"D"
"9789",1970-11-18,1970,"Red Star FC","AS Saint-Etienne","1-1",1,1,"1",1,2,0,"D"
"9790",1970-11-18,1970,"Stade Rennes","FC Nantes","4-0",4,0,"1",1,4,4,"H"
"9791",1970-11-18,1970,"FC Metz","AS Angouleme","1-0",1,0,"1",1,1,1,"H"
"9792",1970-11-18,1970,"OGC Nice","Angers SCO","2-1",2,1,"1",1,3,1,"H"
"9793",1970-11-18,1970,"Nimes Olympique","CS Sedan","4-0",4,0,"1",1,4,4,"H"
"9794",1970-11-18,1970,"Stade Reims","US Valenciennes-Anzin","2-0",2,0,"1",1,2,2,"H"
"9795",1970-11-18,1970,"Olympique Lyon","FC Sochaux","2-0",2,0,"1",1,2,2,"H"
"9796",1970-11-18,1970,"RC Strasbourg","AC Ajaccio","3-0",3,0,"1",1,3,3,"H"
"9797",1970-11-18,1970,"Girondins Bordeaux","AS Nancy","2-3",2,3,"1",1,5,-1,"D"
"9798",1970-11-22,1970,"Olympique Marseille","Stade Reims","1-0",1,0,"1",1,1,1,"H"
"9799",1970-11-22,1970,"AS Saint-Etienne","Nimes Olympique","0-0",0,0,"1",1,0,0,"D"
"9800",1970-11-22,1970,"AC Ajaccio","Stade Rennes","3-0",3,0,"1",1,3,3,"H"
"9801",1970-11-22,1970,"FC Sochaux","FC Metz","5-1",5,1,"1",1,6,4,"H"
"9802",1970-11-22,1970,"FC Nantes","OGC Nice","3-1",3,1,"1",1,4,2,"H"
"9803",1970-11-22,1970,"AS Angouleme","Olympique Lyon","2-2",2,2,"1",1,4,0,"D"
"9804",1970-11-22,1970,"AS Nancy","Red Star FC","0-0",0,0,"1",1,0,0,"D"
"9805",1970-11-22,1970,"CS Sedan","RC Strasbourg","1-0",1,0,"1",1,1,1,"H"
"9806",1970-11-22,1970,"Angers SCO","Girondins Bordeaux","0-3",0,3,"1",1,3,-3,"D"
"9807",1970-11-22,1970,"US Valenciennes-Anzin","SC Bastia","2-0",2,0,"1",1,2,2,"H"
"9808",1970-11-29,1970,"Stade Rennes","Olympique Marseille","2-2",2,2,"1",1,4,0,"D"
"9809",1970-11-29,1970,"AS Saint-Etienne","Angers SCO","3-1",3,1,"1",1,4,2,"H"
"9810",1970-11-29,1970,"FC Metz","US Valenciennes-Anzin","2-2",2,2,"1",1,4,0,"D"
"9811",1970-11-29,1970,"Nimes Olympique","AC Ajaccio","4-0",4,0,"1",1,4,4,"H"
"9812",1970-11-29,1970,"Girondins Bordeaux","FC Nantes","2-3",2,3,"1",1,5,-1,"D"
"9813",1970-11-29,1970,"SC Bastia","FC Sochaux","2-2",2,2,"1",1,4,0,"D"
"9814",1970-11-29,1970,"OGC Nice","AS Angouleme","3-1",3,1,"1",1,4,2,"H"
"9815",1970-11-29,1970,"Stade Reims","Olympique Lyon","1-0",1,0,"1",1,1,1,"H"
"9816",1970-11-29,1970,"Red Star FC","CS Sedan","4-2",4,2,"1",1,6,2,"H"
"9817",1970-11-29,1970,"RC Strasbourg","AS Nancy","0-2",0,2,"1",1,2,-2,"D"
"9818",1970-12-05,1970,"AS Nancy","Nimes Olympique","2-0",2,0,"1",1,2,2,"H"
"9819",1970-12-05,1970,"AS Angouleme","Girondins Bordeaux","1-1",1,1,"1",1,2,0,"D"
"9820",1970-12-06,1970,"Olympique Marseille","OGC Nice","4-0",4,0,"1",1,4,4,"H"
"9821",1970-12-06,1970,"CS Sedan","AS Saint-Etienne","3-1",3,1,"1",1,4,2,"H"
"9822",1970-12-06,1970,"US Valenciennes-Anzin","Stade Rennes","0-0",0,0,"1",1,0,0,"D"
"9823",1970-12-06,1970,"FC Sochaux","Stade Reims","2-1",2,1,"1",1,3,1,"H"
"9824",1970-12-06,1970,"FC Nantes","Red Star FC","1-1",1,1,"1",1,2,0,"D"
"9825",1970-12-06,1970,"AC Ajaccio","FC Metz","2-0",2,0,"1",1,2,2,"H"
"9826",1970-12-06,1970,"Olympique Lyon","SC Bastia","1-1",1,1,"1",1,2,0,"D"
"9827",1970-12-06,1970,"Angers SCO","RC Strasbourg","1-3",1,3,"1",1,4,-2,"D"
"9828",1970-12-09,1970,"Angers SCO","FC Sochaux","1-0",1,0,"1",1,1,1,"H"
"9829",1970-12-13,1970,"Girondins Bordeaux","Olympique Marseille","3-1",3,1,"1",1,4,2,"H"
"9830",1970-12-13,1970,"AS Saint-Etienne","AS Nancy","4-1",4,1,"1",1,5,3,"H"
"9831",1970-12-13,1970,"Stade Rennes","FC Sochaux","4-0",4,0,"1",1,4,4,"H"
"9832",1970-12-13,1970,"FC Metz","Olympique Lyon","6-1",6,1,"1",1,7,5,"H"
"9833",1970-12-13,1970,"RC Strasbourg","FC Nantes","2-2",2,2,"1",1,4,0,"D"
"9834",1970-12-13,1970,"SC Bastia","Stade Reims","0-6",0,6,"1",1,6,-6,"D"
"9835",1970-12-13,1970,"OGC Nice","US Valenciennes-Anzin","4-2",4,2,"1",1,6,2,"H"
"9836",1970-12-13,1970,"Nimes Olympique","Angers SCO","0-1",0,1,"1",1,1,-1,"D"
"9837",1970-12-13,1970,"CS Sedan","AC Ajaccio","3-1",3,1,"1",1,4,2,"H"
"9838",1970-12-13,1970,"Red Star FC","AS Angouleme","0-0",0,0,"1",1,0,0,"D"
"9839",1970-12-20,1970,"AS Angouleme","RC Strasbourg","0-1",0,1,"1",1,1,-1,"D"
"9840",1970-12-20,1970,"Olympique Marseille","Red Star FC","1-1",1,1,"1",1,2,0,"D"
"9841",1970-12-20,1970,"AC Ajaccio","AS Saint-Etienne","1-1",1,1,"1",1,2,0,"D"
"9842",1970-12-20,1970,"Olympique Lyon","Stade Rennes","3-2",3,2,"1",1,5,1,"H"
"9843",1970-12-20,1970,"FC Nantes","Nimes Olympique","5-1",5,1,"1",1,6,4,"H"
"9844",1970-12-20,1970,"Stade Reims","FC Metz","1-1",1,1,"1",1,2,0,"D"
"9845",1970-12-20,1970,"FC Sochaux","OGC Nice","1-0",1,0,"1",1,1,1,"H"
"9846",1970-12-20,1970,"AS Nancy","CS Sedan","1-0",1,0,"1",1,1,1,"H"
"9847",1970-12-20,1970,"Angers SCO","SC Bastia","3-0",3,0,"1",1,3,3,"H"
"9848",1970-12-20,1970,"US Valenciennes-Anzin","Girondins Bordeaux","1-1",1,1,"1",1,2,0,"D"
"9849",1971-01-30,1970,"AS Nancy","Angers SCO","0-1",0,1,"1",1,1,-1,"D"
"9850",1971-01-31,1970,"AC Ajaccio","Olympique Marseille","1-2",1,2,"1",1,3,-1,"D"
"9851",1971-01-31,1970,"AS Saint-Etienne","AS Angouleme","1-0",1,0,"1",1,1,1,"H"
"9852",1971-01-31,1970,"Stade Rennes","SC Bastia","3-2",3,2,"1",1,5,1,"H"
"9853",1971-01-31,1970,"OGC Nice","FC Metz","0-1",0,1,"1",1,1,-1,"D"
"9854",1971-01-31,1970,"CS Sedan","FC Nantes","0-0",0,0,"1",1,0,0,"D"
"9855",1971-01-31,1970,"Red Star FC","FC Sochaux","0-0",0,0,"1",1,0,0,"D"
"9856",1971-01-31,1970,"Girondins Bordeaux","Stade Reims","3-1",3,1,"1",1,4,2,"H"
"9857",1971-01-31,1970,"Nimes Olympique","US Valenciennes-Anzin","4-1",4,1,"1",1,5,3,"H"
"9858",1971-01-31,1970,"RC Strasbourg","Olympique Lyon","0-1",0,1,"1",1,1,-1,"D"
"9859",1971-02-14,1970,"Olympique Marseille","Nimes Olympique","2-2",2,2,"1",1,4,0,"D"
"9860",1971-02-14,1970,"FC Sochaux","AS Saint-Etienne","1-1",1,1,"1",1,2,0,"D"
"9861",1971-02-14,1970,"FC Metz","Stade Rennes","2-1",2,1,"1",1,3,1,"H"
"9862",1971-02-14,1970,"FC Nantes","AS Nancy","7-0",7,0,"1",1,7,7,"H"
"9863",1971-02-14,1970,"Olympique Lyon","Girondins Bordeaux","2-2",2,2,"1",1,4,0,"D"
"9864",1971-02-14,1970,"Angers SCO","AC Ajaccio","1-1",1,1,"1",1,2,0,"D"
"9865",1971-02-14,1970,"SC Bastia","OGC Nice","3-1",3,1,"1",1,4,2,"H"
"9866",1971-02-14,1970,"AS Angouleme","CS Sedan","1-0",1,0,"1",1,1,1,"H"
"9867",1971-02-14,1970,"US Valenciennes-Anzin","RC Strasbourg","3-0",3,0,"1",1,3,3,"H"
"9868",1971-02-20,1970,"OGC Nice","Stade Reims","2-0",2,0,"1",1,2,2,"H"
"9869",1971-02-21,1970,"CS Sedan","Olympique Marseille","1-2",1,2,"1",1,3,-1,"D"
"9870",1971-02-21,1970,"AS Saint-Etienne","US Valenciennes-Anzin","4-0",4,0,"1",1,4,4,"H"
"9871",1971-02-21,1970,"Angers SCO","FC Nantes","0-1",0,1,"1",1,1,-1,"D"
"9872",1971-02-21,1970,"Girondins Bordeaux","FC Metz","1-1",1,1,"1",1,2,0,"D"
"9873",1971-02-21,1970,"Nimes Olympique","Stade Rennes","3-2",3,2,"1",1,5,1,"H"
"9874",1971-02-21,1970,"RC Strasbourg","FC Sochaux","2-1",2,1,"1",1,3,1,"H"
"9875",1971-02-21,1970,"AC Ajaccio","Olympique Lyon","0-0",0,0,"1",1,0,0,"D"
"9876",1971-02-21,1970,"Red Star FC","SC Bastia","1-1",1,1,"1",1,2,0,"D"
"9877",1971-02-21,1970,"AS Nancy","AS Angouleme","2-1",2,1,"1",1,3,1,"H"
"9878",1971-03-06,1970,"Olympique Marseille","AS Saint-Etienne","2-2",2,2,"1",1,4,0,"D"
"9879",1971-03-06,1970,"FC Nantes","AC Ajaccio","3-0",3,0,"1",1,3,3,"H"
"9880",1971-03-06,1970,"FC Metz","Red Star FC","2-2",2,2,"1",1,4,0,"D"
"9881",1971-03-06,1970,"Stade Reims","RC Strasbourg","1-0",1,0,"1",1,1,1,"H"
"9882",1971-03-07,1970,"Stade Rennes","OGC Nice","1-3",1,3,"1",1,4,-2,"D"
"9883",1971-03-07,1970,"FC Sochaux","AS Nancy","1-0",1,0,"1",1,1,1,"H"
"9884",1971-03-07,1970,"Olympique Lyon","Nimes Olympique","0-1",0,1,"1",1,1,-1,"D"
"9885",1971-03-07,1970,"AS Angouleme","Angers SCO","1-1",1,1,"1",1,2,0,"D"
"9886",1971-03-10,1970,"Angers SCO","Olympique Marseille","2-1",2,1,"1",1,3,1,"H"
"9887",1971-03-10,1970,"Girondins Bordeaux","Stade Rennes","0-1",0,1,"1",1,1,-1,"D"
"9888",1971-03-10,1970,"Nimes Olympique","Stade Reims","1-1",1,1,"1",1,2,0,"D"
"9889",1971-03-10,1970,"Red Star FC","Olympique Lyon","1-3",1,3,"1",1,4,-2,"D"
"9890",1971-03-11,1970,"FC Nantes","AS Angouleme","0-0",0,0,"1",1,0,0,"D"
"9891",1971-03-12,1970,"AS Nancy","US Valenciennes-Anzin","0-2",0,2,"1",1,2,-2,"D"
"9892",1971-03-19,1970,"US Valenciennes-Anzin","Angers SCO","1-3",1,3,"1",1,4,-2,"D"
"9893",1971-03-20,1970,"Olympique Marseille","AS Nancy","3-0",3,0,"1",1,3,3,"H"
"9894",1971-03-20,1970,"Stade Reims","AS Saint-Etienne","2-2",2,2,"1",1,4,0,"D"
"9895",1971-03-20,1970,"FC Sochaux","FC Nantes","2-0",2,0,"1",1,2,2,"H"
"9896",1971-03-20,1970,"SC Bastia","Nimes Olympique","2-2",2,2,"1",1,4,0,"D"
"9897",1971-03-20,1970,"Olympique Lyon","CS Sedan","0-0",0,0,"1",1,0,0,"D"
"9898",1971-03-20,1970,"OGC Nice","Girondins Bordeaux","0-1",0,1,"1",1,1,-1,"D"
"9899",1971-03-20,1970,"AS Angouleme","AC Ajaccio","2-0",2,0,"1",1,2,2,"H"
"9900",1971-03-21,1970,"FC Metz","RC Strasbourg","2-1",2,1,"1",1,3,1,"H"
"9901",1971-03-21,1970,"Stade Rennes","Red Star FC","3-0",3,0,"1",1,3,3,"H"
"9902",1971-03-24,1970,"AS Angouleme","Olympique Marseille","0-0",0,0,"1",1,0,0,"D"
"9903",1971-03-24,1970,"AS Saint-Etienne","SC Bastia","6-0",6,0,"1",1,6,6,"H"
"9904",1971-03-24,1970,"FC Nantes","US Valenciennes-Anzin","2-0",2,0,"1",1,2,2,"H"
"9905",1971-03-24,1970,"RC Strasbourg","Stade Rennes","3-4",3,4,"1",1,7,-1,"D"
"9906",1971-03-24,1970,"AC Ajaccio","FC Sochaux","1-0",1,0,"1",1,1,1,"H"
"9907",1971-03-24,1970,"Angers SCO","Stade Reims","0-3",0,3,"1",1,3,-3,"D"
"9908",1971-03-24,1970,"AS Nancy","Olympique Lyon","0-0",0,0,"1",1,0,0,"D"
"9909",1971-03-24,1970,"Red Star FC","OGC Nice","0-0",0,0,"1",1,0,0,"D"
"9910",1971-03-24,1970,"CS Sedan","Girondins Bordeaux","0-2",0,2,"1",1,2,-2,"D"
"9911",1971-03-26,1970,"Nimes Olympique","FC Metz","4-0",4,0,"1",1,4,4,"H"
"9912",1971-03-28,1970,"RC Strasbourg","SC Bastia","2-2",2,2,"1",1,4,0,"D"
"9913",1971-03-28,1970,"Olympique Lyon","AS Saint-Etienne","1-2",1,2,"1",1,3,-1,"D"
"9914",1971-04-03,1970,"Olympique Marseille","FC Nantes","2-2",2,2,"1",1,4,0,"D"
"9915",1971-04-03,1970,"Stade Rennes","Angers SCO","1-0",1,0,"1",1,1,1,"H"
"9916",1971-04-03,1970,"FC Metz","AS Nancy","1-1",1,1,"1",1,2,0,"D"
"9917",1971-04-03,1970,"FC Sochaux","Nimes Olympique","3-0",3,0,"1",1,3,3,"H"
"9918",1971-04-03,1970,"Stade Reims","CS Sedan","2-1",2,1,"1",1,3,1,"H"
"9919",1971-04-03,1970,"OGC Nice","RC Strasbourg","1-0",1,0,"1",1,1,1,"H"
"9920",1971-04-03,1970,"US Valenciennes-Anzin","AS Angouleme","2-1",2,1,"1",1,3,1,"H"
"9921",1971-04-03,1970,"Girondins Bordeaux","Red Star FC","4-1",4,1,"1",1,5,3,"H"
"9922",1971-04-04,1970,"SC Bastia","AC Ajaccio","1-4",1,4,"1",1,5,-3,"D"
"9923",1971-04-09,1970,"US Valenciennes-Anzin","CS Sedan","0-0",0,0,"1",1,0,0,"D"
"9924",1971-04-14,1970,"AS Saint-Etienne","Stade Rennes","1-0",1,0,"1",1,1,1,"H"
"9925",1971-04-14,1970,"Olympique Marseille","US Valenciennes-Anzin","5-2",5,2,"1",1,7,3,"H"
"9926",1971-04-14,1970,"FC Nantes","Olympique Lyon","1-1",1,1,"1",1,2,0,"D"
"9927",1971-04-14,1970,"CS Sedan","FC Metz","1-0",1,0,"1",1,1,1,"H"
"9928",1971-04-14,1970,"Nimes Olympique","OGC Nice","1-1",1,1,"1",1,2,0,"D"
"9929",1971-04-14,1970,"AS Angouleme","FC Sochaux","1-0",1,0,"1",1,1,1,"H"
"9930",1971-04-14,1970,"AC Ajaccio","Stade Reims","1-0",1,0,"1",1,1,1,"H"
"9931",1971-04-14,1970,"Angers SCO","Red Star FC","3-1",3,1,"1",1,4,2,"H"
"9932",1971-04-14,1970,"RC Strasbourg","Girondins Bordeaux","0-1",0,1,"1",1,1,-1,"D"
"9933",1971-04-14,1970,"AS Nancy","SC Bastia","3-0",3,0,"1",1,3,3,"H"
"9934",1971-04-17,1970,"FC Sochaux","Olympique Marseille","1-1",1,1,"1",1,2,0,"D"
"9935",1971-04-17,1970,"FC Metz","FC Nantes","0-0",0,0,"1",1,0,0,"D"
"9936",1971-04-17,1970,"Stade Rennes","AS Angouleme","0-0",0,0,"1",1,0,0,"D"
"9937",1971-04-17,1970,"Stade Reims","AS Nancy","2-1",2,1,"1",1,3,1,"H"
"9938",1971-04-17,1970,"Girondins Bordeaux","Nimes Olympique","3-0",3,0,"1",1,3,3,"H"
"9939",1971-04-17,1970,"Olympique Lyon","Angers SCO","1-0",1,0,"1",1,1,1,"H"
"9940",1971-04-17,1970,"SC Bastia","CS Sedan","4-0",4,0,"1",1,4,4,"H"
"9941",1971-04-18,1970,"US Valenciennes-Anzin","AC Ajaccio","0-0",0,0,"1",1,0,0,"D"
"9942",1971-04-18,1970,"Red Star FC","RC Strasbourg","2-1",2,1,"1",1,3,1,"H"
"9943",1971-04-18,1970,"OGC Nice","AS Saint-Etienne","0-0",0,0,"1",1,0,0,"D"
"9944",1971-04-27,1970,"Olympique Lyon","US Valenciennes-Anzin","3-1",3,1,"1",1,4,2,"H"
"9945",1971-04-28,1970,"FC Metz","Olympique Marseille","2-1",2,1,"1",1,3,1,"H"
"9946",1971-04-28,1970,"Stade Reims","FC Nantes","0-0",0,0,"1",1,0,0,"D"
"9947",1971-04-28,1970,"Stade Rennes","CS Sedan","0-0",0,0,"1",1,0,0,"D"
"9948",1971-04-28,1970,"FC Sochaux","Angers SCO","0-0",0,0,"1",1,0,0,"D"
"9949",1971-04-28,1970,"OGC Nice","AS Nancy","0-0",0,0,"1",1,0,0,"D"
"9950",1971-04-28,1970,"Girondins Bordeaux","AC Ajaccio","2-2",2,2,"1",1,4,0,"D"
"9951",1971-04-28,1970,"SC Bastia","AS Angouleme","3-1",3,1,"1",1,4,2,"H"
"9952",1971-04-30,1970,"RC Strasbourg","AS Saint-Etienne","1-0",1,0,"1",1,1,1,"H"
"9953",1971-05-01,1970,"AC Ajaccio","OGC Nice","3-1",3,1,"1",1,4,2,"H"
"9954",1971-05-02,1970,"Red Star FC","Nimes Olympique","1-2",1,2,"1",1,3,-1,"D"
"9955",1971-05-04,1970,"AS Saint-Etienne","FC Metz","6-0",6,0,"1",1,6,6,"H"
"9956",1971-05-05,1970,"Stade Reims","Red Star FC","0-1",0,1,"1",1,1,-1,"D"
"9957",1971-05-08,1970,"AS Saint-Etienne","Girondins Bordeaux","2-3",2,3,"1",1,5,-1,"D"
"9958",1971-05-08,1970,"Olympique Marseille","Olympique Lyon","2-2",2,2,"1",1,4,0,"D"
"9959",1971-05-08,1970,"FC Nantes","SC Bastia","3-1",3,1,"1",1,4,2,"H"
"9960",1971-05-08,1970,"AS Nancy","Stade Rennes","5-0",5,0,"1",1,5,5,"H"
"9961",1971-05-08,1970,"Nimes Olympique","RC Strasbourg","3-0",3,0,"1",1,3,3,"H"
"9962",1971-05-08,1970,"Angers SCO","FC Metz","5-0",5,0,"1",1,5,5,"H"
"9963",1971-05-08,1970,"AS Angouleme","Stade Reims","1-3",1,3,"1",1,4,-2,"D"
"9964",1971-05-08,1970,"US Valenciennes-Anzin","FC Sochaux","4-0",4,0,"1",1,4,4,"H"
"9965",1971-05-08,1970,"CS Sedan","OGC Nice","0-1",0,1,"1",1,1,-1,"D"
"9966",1971-05-09,1970,"AC Ajaccio","Red Star FC","0-1",0,1,"1",1,1,-1,"D"
"9967",1971-05-12,1970,"SC Bastia","Girondins Bordeaux","2-0",2,0,"1",1,2,2,"H"
"9968",1971-05-12,1970,"CS Sedan","FC Sochaux","2-1",2,1,"1",1,3,1,"H"
"9969",1971-05-15,1970,"AS Saint-Etienne","Red Star FC","2-1",2,1,"1",1,3,1,"H"
"9970",1971-05-15,1970,"Olympique Marseille","SC Bastia","5-2",5,2,"1",1,7,3,"H"
"9971",1971-05-15,1970,"FC Nantes","Stade Rennes","1-0",1,0,"1",1,1,1,"H"
"9972",1971-05-15,1970,"CS Sedan","Nimes Olympique","1-1",1,1,"1",1,2,0,"D"
"9973",1971-05-15,1970,"AS Angouleme","FC Metz","1-0",1,0,"1",1,1,1,"H"
"9974",1971-05-15,1970,"US Valenciennes-Anzin","Stade Reims","3-1",3,1,"1",1,4,2,"H"
"9975",1971-05-15,1970,"AC Ajaccio","RC Strasbourg","4-0",4,0,"1",1,4,4,"H"
"9976",1971-05-15,1970,"FC Sochaux","Olympique Lyon","0-0",0,0,"1",1,0,0,"D"
"9977",1971-05-15,1970,"Angers SCO","OGC Nice","6-0",6,0,"1",1,6,6,"H"
"9978",1971-05-15,1970,"AS Nancy","Girondins Bordeaux","0-0",0,0,"1",1,0,0,"D"
"9979",1971-05-18,1970,"Stade Reims","Olympique Marseille","1-2",1,2,"1",1,3,-1,"D"
"9980",1971-05-18,1970,"Nimes Olympique","AS Saint-Etienne","5-3",5,3,"1",1,8,2,"H"
"9981",1971-05-18,1970,"OGC Nice","FC Nantes","3-1",3,1,"1",1,4,2,"H"
"9982",1971-05-18,1970,"Stade Rennes","AC Ajaccio","0-1",0,1,"1",1,1,-1,"D"
"9983",1971-05-18,1970,"Olympique Lyon","AS Angouleme","3-0",3,0,"1",1,3,3,"H"
"9984",1971-05-18,1970,"FC Metz","FC Sochaux","3-3",3,3,"1",1,6,0,"D"
"9985",1971-05-18,1970,"Girondins Bordeaux","Angers SCO","3-0",3,0,"1",1,3,3,"H"
"9986",1971-05-18,1970,"Red Star FC","AS Nancy","3-1",3,1,"1",1,4,2,"H"
"9987",1971-05-18,1970,"RC Strasbourg","CS Sedan","3-0",3,0,"1",1,3,3,"H"
"9988",1971-05-18,1970,"SC Bastia","US Valenciennes-Anzin","1-0",1,0,"1",1,1,1,"H"
"9989",1971-05-21,1970,"Olympique Lyon","Stade Reims","0-0",0,0,"1",1,0,0,"D"
"9990",1971-05-22,1970,"Angers SCO","AS Saint-Etienne","2-2",2,2,"1",1,4,0,"D"
"9991",1971-05-22,1970,"FC Nantes","Girondins Bordeaux","2-2",2,2,"1",1,4,0,"D"
"9992",1971-05-22,1970,"AC Ajaccio","Nimes Olympique","2-2",2,2,"1",1,4,0,"D"
"9993",1971-05-22,1970,"US Valenciennes-Anzin","FC Metz","2-2",2,2,"1",1,4,0,"D"
"9994",1971-05-22,1970,"FC Sochaux","SC Bastia","1-1",1,1,"1",1,2,0,"D"
"9995",1971-05-22,1970,"AS Angouleme","OGC Nice","1-1",1,1,"1",1,2,0,"D"
"9996",1971-05-22,1970,"AS Nancy","RC Strasbourg","3-2",3,2,"1",1,5,1,"H"
"9997",1971-05-22,1970,"CS Sedan","Red Star FC","5-0",5,0,"1",1,5,5,"H"
"9998",1971-05-23,1970,"Olympique Marseille","Stade Rennes","5-0",5,0,"1",1,5,5,"H"
"9999",1971-06-04,1970,"AS Saint-Etienne","CS Sedan","8-0",8,0,"1",1,8,8,"H"
"10000",1971-06-05,1970,"OGC Nice","Olympique Marseille","1-2",1,2,"1",1,3,-1,"D"
"10001",1971-06-05,1970,"Nimes Olympique","AS Nancy","1-0",1,0,"1",1,1,1,"H"
"10002",1971-06-05,1970,"FC Metz","AC Ajaccio","1-3",1,3,"1",1,4,-2,"D"
"10003",1971-06-05,1970,"Stade Reims","FC Sochaux","4-1",4,1,"1",1,5,3,"H"
"10004",1971-06-05,1970,"Girondins Bordeaux","AS Angouleme","1-0",1,0,"1",1,1,1,"H"
"10005",1971-06-05,1970,"Stade Rennes","US Valenciennes-Anzin","1-1",1,1,"1",1,2,0,"D"
"10006",1971-06-05,1970,"SC Bastia","Olympique Lyon","2-1",2,1,"1",1,3,1,"H"
"10007",1971-06-05,1970,"RC Strasbourg","Angers SCO","6-2",6,2,"1",1,8,4,"H"
"10008",1971-06-06,1970,"Red Star FC","FC Nantes","0-3",0,3,"1",1,3,-3,"D"
"10009",1971-06-11,1970,"Olympique Marseille","Girondins Bordeaux","3-0",3,0,"1",1,3,3,"H"
"10010",1971-06-11,1970,"AS Nancy","AS Saint-Etienne","1-1",1,1,"1",1,2,0,"D"
"10011",1971-06-11,1970,"Olympique Lyon","FC Metz","1-2",1,2,"1",1,3,-1,"D"
"10012",1971-06-12,1970,"FC Nantes","RC Strasbourg","1-2",1,2,"1",1,3,-1,"D"
"10013",1971-06-12,1970,"Angers SCO","Nimes Olympique","1-2",1,2,"1",1,3,-1,"D"
"10014",1971-06-12,1970,"AC Ajaccio","CS Sedan","1-0",1,0,"1",1,1,1,"H"
"10015",1971-06-12,1970,"Stade Reims","SC Bastia","5-2",5,2,"1",1,7,3,"H"
"10016",1971-06-12,1970,"FC Sochaux","Stade Rennes","4-2",4,2,"1",1,6,2,"H"
"10017",1971-06-12,1970,"US Valenciennes-Anzin","OGC Nice","3-1",3,1,"1",1,4,2,"H"
"10018",1971-06-12,1970,"AS Angouleme","Red Star FC","1-0",1,0,"1",1,1,1,"H"
"10019",1971-06-19,1970,"Red Star FC","Olympique Marseille","3-4",3,4,"1",1,7,-1,"D"
"10020",1971-06-19,1970,"AS Saint-Etienne","AC Ajaccio","5-2",5,2,"1",1,7,3,"H"
"10021",1971-06-19,1970,"Nimes Olympique","FC Nantes","2-2",2,2,"1",1,4,0,"D"
"10022",1971-06-19,1970,"FC Metz","Stade Reims","2-0",2,0,"1",1,2,2,"H"
"10023",1971-06-19,1970,"OGC Nice","FC Sochaux","4-5",4,5,"1",1,9,-1,"D"
"10024",1971-06-19,1970,"Girondins Bordeaux","US Valenciennes-Anzin","1-0",1,0,"1",1,1,1,"H"
"10025",1971-06-19,1970,"SC Bastia","Angers SCO","2-0",2,0,"1",1,2,2,"H"
"10026",1971-06-19,1970,"CS Sedan","AS Nancy","2-2",2,2,"1",1,4,0,"D"
"10027",1971-06-19,1970,"RC Strasbourg","AS Angouleme","2-1",2,1,"1",1,3,1,"H"
"10028",1971-06-23,1970,"Stade Rennes","Olympique Lyon","2-3",2,3,"1",1,5,-1,"D"
"10029",1971-06-26,1970,"Olympique Marseille","RC Strasbourg","6-3",6,3,"1",1,9,3,"H"
"10030",1971-06-26,1970,"FC Nantes","AS Saint-Etienne","2-1",2,1,"1",1,3,1,"H"
"10031",1971-06-26,1970,"AS Angouleme","Nimes Olympique","0-2",0,2,"1",1,2,-2,"D"
"10032",1971-06-26,1970,"FC Sochaux","Girondins Bordeaux","1-3",1,3,"1",1,4,-2,"D"
"10033",1971-06-26,1970,"AS Nancy","AC Ajaccio","3-1",3,1,"1",1,4,2,"H"
"10034",1971-06-26,1970,"Olympique Lyon","OGC Nice","2-1",2,1,"1",1,3,1,"H"
"10035",1971-06-26,1970,"SC Bastia","FC Metz","2-0",2,0,"1",1,2,2,"H"
"10036",1971-06-26,1970,"Stade Reims","Stade Rennes","1-1",1,1,"1",1,2,0,"D"
"10037",1971-06-26,1970,"Angers SCO","CS Sedan","3-1",3,1,"1",1,4,2,"H"
"10038",1971-06-26,1970,"US Valenciennes-Anzin","Red Star FC","1-2",1,2,"1",1,3,-1,"D"
"10039",1971-08-11,1971,"Olympique Marseille","Olympique Lyon","1-1",1,1,"1",1,2,0,"D"
"10040",1971-08-11,1971,"OGC Nice","FC Nantes","1-1",1,1,"1",1,2,0,"D"
"10041",1971-08-11,1971,"AS Saint-Etienne","Nimes Olympique","1-3",1,3,"1",1,4,-2,"D"
"10042",1971-08-11,1971,"Girondins Bordeaux","FC Metz","0-0",0,0,"1",1,0,0,"D"
"10043",1971-08-11,1971,"AS Nancy","Stade Reims","0-0",0,0,"1",1,0,0,"D"
"10044",1971-08-11,1971,"Stade Rennes","SC Bastia","1-0",1,0,"1",1,1,1,"H"
"10045",1971-08-11,1971,"Angers SCO","Paris Saint-Germain","2-0",2,0,"1",1,2,2,"H"
"10046",1971-08-11,1971,"Lille OSC","FC Sochaux","2-3",2,3,"1",1,5,-1,"D"
"10047",1971-08-11,1971,"AC Ajaccio","AS Monaco","3-0",3,0,"1",1,3,3,"H"
"10048",1971-08-11,1971,"Red Star FC","AS Angouleme","1-1",1,1,"1",1,2,0,"D"
"10049",1971-08-18,1971,"Olympique Lyon","Stade Rennes","0-2",0,2,"1",1,2,-2,"D"
"10050",1971-08-18,1971,"FC Sochaux","AS Nancy","2-1",2,1,"1",1,3,1,"H"
"10051",1971-08-18,1971,"AC Ajaccio","Olympique Marseille","1-1",1,1,"1",1,2,0,"D"
"10052",1971-08-18,1971,"Nimes Olympique","SC Bastia","6-2",6,2,"1",1,8,4,"H"
"10053",1971-08-18,1971,"AS Monaco","Angers SCO","3-0",3,0,"1",1,3,3,"H"
"10054",1971-08-18,1971,"FC Metz","Lille OSC","4-0",4,0,"1",1,4,4,"H"
"10055",1971-08-18,1971,"FC Nantes","AS Saint-Etienne","4-3",4,3,"1",1,7,1,"H"
"10056",1971-08-18,1971,"Paris Saint-Germain","Girondins Bordeaux","0-0",0,0,"1",1,0,0,"D"
"10057",1971-08-18,1971,"Stade Reims","Red Star FC","0-1",0,1,"1",1,1,-1,"D"
"10058",1971-08-18,1971,"AS Angouleme","OGC Nice","1-1",1,1,"1",1,2,0,"D"
"10059",1971-08-25,1971,"Red Star FC","FC Sochaux","2-1",2,1,"1",1,3,1,"H"
"10060",1971-08-25,1971,"Stade Rennes","Olympique Marseille","1-2",1,2,"1",1,3,-1,"D"
"10061",1971-08-25,1971,"OGC Nice","FC Metz","1-1",1,1,"1",1,2,0,"D"
"10062",1971-08-25,1971,"Girondins Bordeaux","AS Monaco","3-1",3,1,"1",1,4,2,"H"
"10063",1971-08-25,1971,"SC Bastia","FC Nantes","2-1",2,1,"1",1,3,1,"H"
"10064",1971-08-25,1971,"Lille OSC","AC Ajaccio","3-1",3,1,"1",1,4,2,"H"
"10065",1971-08-25,1971,"Angers SCO","Olympique Lyon","2-1",2,1,"1",1,3,1,"H"
"10066",1971-08-25,1971,"AS Nancy","Paris Saint-Germain","2-3",2,3,"1",1,5,-1,"D"
"10067",1971-08-25,1971,"AS Saint-Etienne","Stade Reims","9-1",9,1,"1",1,10,8,"H"
"10068",1971-08-25,1971,"Nimes Olympique","AS Angouleme","3-0",3,0,"1",1,3,3,"H"
"10069",1971-08-28,1971,"FC Nantes","Nimes Olympique","2-0",2,0,"1",1,2,2,"H"
"10070",1971-08-28,1971,"AS Monaco","Red Star FC","0-0",0,0,"1",1,0,0,"D"
"10071",1971-08-28,1971,"FC Metz","AS Nancy","0-1",0,1,"1",1,1,-1,"D"
"10072",1971-08-28,1971,"AC Ajaccio","Stade Rennes","1-2",1,2,"1",1,3,-1,"D"
"10073",1971-08-28,1971,"Olympique Lyon","Girondins Bordeaux","2-2",2,2,"1",1,4,0,"D"
"10074",1971-08-28,1971,"FC Sochaux","AS Saint-Etienne","0-2",0,2,"1",1,2,-2,"D"
"10075",1971-08-28,1971,"Stade Reims","OGC Nice","1-2",1,2,"1",1,3,-1,"D"
"10076",1971-08-28,1971,"Paris Saint-Germain","Lille OSC","4-1",4,1,"1",1,5,3,"H"
"10077",1971-08-28,1971,"AS Angouleme","SC Bastia","2-1",2,1,"1",1,3,1,"H"
"10078",1971-08-28,1971,"Olympique Marseille","Angers SCO","2-1",2,1,"1",1,3,1,"H"
"10079",1971-09-01,1971,"Girondins Bordeaux","Olympique Marseille","0-2",0,2,"1",1,2,-2,"D"
"10080",1971-09-01,1971,"Nimes Olympique","Stade Reims","2-1",2,1,"1",1,3,1,"H"
"10081",1971-09-01,1971,"Red Star FC","FC Metz","1-1",1,1,"1",1,2,0,"D"
"10082",1971-09-01,1971,"Angers SCO","Stade Rennes","1-1",1,1,"1",1,2,0,"D"
"10083",1971-09-01,1971,"FC Nantes","Paris Saint-Germain","6-0",6,0,"1",1,6,6,"H"
"10084",1971-09-01,1971,"OGC Nice","AC Ajaccio","2-0",2,0,"1",1,2,2,"H"
"10085",1971-09-01,1971,"AS Saint-Etienne","AS Angouleme","4-0",4,0,"1",1,4,4,"H"
"10086",1971-09-01,1971,"SC Bastia","FC Sochaux","6-1",6,1,"1",1,7,5,"H"
"10087",1971-09-01,1971,"AS Nancy","AS Monaco","3-0",3,0,"1",1,3,3,"H"
"10088",1971-09-01,1971,"Lille OSC","Olympique Lyon","0-1",0,1,"1",1,1,-1,"D"
"10089",1971-09-10,1971,"Olympique Marseille","Red Star FC","6-0",6,0,"1",1,6,6,"H"
"10090",1971-09-11,1971,"Stade Rennes","Girondins Bordeaux","2-0",2,0,"1",1,2,2,"H"
"10091",1971-09-11,1971,"Paris Saint-Germain","OGC Nice","1-1",1,1,"1",1,2,0,"D"
"10092",1971-09-11,1971,"AS Angouleme","FC Nantes","2-5",2,5,"1",1,7,-3,"D"
"10093",1971-09-11,1971,"FC Metz","AS Saint-Etienne","0-4",0,4,"1",1,4,-4,"D"
"10094",1971-09-11,1971,"Olympique Lyon","AS Nancy","3-2",3,2,"1",1,5,1,"H"
"10095",1971-09-11,1971,"Stade Reims","SC Bastia","0-2",0,2,"1",1,2,-2,"D"
"10096",1971-09-11,1971,"AS Monaco","Lille OSC","1-1",1,1,"1",1,2,0,"D"
"10097",1971-09-11,1971,"AC Ajaccio","Angers SCO","1-3",1,3,"1",1,4,-2,"D"
"10098",1971-09-18,1971,"AS Nancy","Olympique Marseille","1-2",1,2,"1",1,3,-1,"D"
"10099",1971-09-18,1971,"FC Nantes","Stade Reims","0-2",0,2,"1",1,2,-2,"D"
"10100",1971-09-18,1971,"Lille OSC","Stade Rennes","0-0",0,0,"1",1,0,0,"D"
"10101",1971-09-18,1971,"AS Saint-Etienne","Paris Saint-Germain","0-1",0,1,"1",1,1,-1,"D"
"10102",1971-09-18,1971,"OGC Nice","FC Sochaux","1-2",1,2,"1",1,3,-1,"D"
"10103",1971-09-18,1971,"Nimes Olympique","AS Monaco","5-1",5,1,"1",1,6,4,"H"
"10104",1971-09-18,1971,"SC Bastia","FC Metz","1-0",1,0,"1",1,1,1,"H"
"10105",1971-09-18,1971,"Girondins Bordeaux","Angers SCO","1-1",1,1,"1",1,2,0,"D"
"10106",1971-09-18,1971,"AS Angouleme","AC Ajaccio","1-3",1,3,"1",1,4,-2,"D"
"10107",1971-09-19,1971,"Red Star FC","Olympique Lyon","1-1",1,1,"1",1,2,0,"D"
"10108",1971-09-22,1971,"Olympique Marseille","Lille OSC","3-0",3,0,"1",1,3,3,"H"
"10109",1971-09-22,1971,"FC Metz","Nimes Olympique","3-1",3,1,"1",1,4,2,"H"
"10110",1971-09-22,1971,"Stade Rennes","AS Nancy","3-1",3,1,"1",1,4,2,"H"
"10111",1971-09-22,1971,"Olympique Lyon","OGC Nice","2-0",2,0,"1",1,2,2,"H"
"10112",1971-09-22,1971,"FC Sochaux","FC Nantes","2-0",2,0,"1",1,2,2,"H"
"10113",1971-09-22,1971,"AS Monaco","AS Saint-Etienne","1-2",1,2,"1",1,3,-1,"D"
"10114",1971-09-22,1971,"Paris Saint-Germain","SC Bastia","4-1",4,1,"1",1,5,3,"H"
"10115",1971-09-22,1971,"Angers SCO","Red Star FC","1-0",1,0,"1",1,1,1,"H"
"10116",1971-09-22,1971,"Stade Reims","AS Angouleme","3-1",3,1,"1",1,4,2,"H"
"10117",1971-09-22,1971,"AC Ajaccio","Girondins Bordeaux","3-1",3,1,"1",1,4,2,"H"
"10118",1971-10-01,1971,"Lille OSC","Girondins Bordeaux","0-0",0,0,"1",1,0,0,"D"
"10119",1971-10-02,1971,"AS Saint-Etienne","Stade Rennes","4-2",4,2,"1",1,6,2,"H"
"10120",1971-10-02,1971,"Nimes Olympique","Paris Saint-Germain","4-1",4,1,"1",1,5,3,"H"
"10121",1971-10-02,1971,"AS Nancy","Angers SCO","1-0",1,0,"1",1,1,1,"H"
"10122",1971-10-02,1971,"FC Nantes","FC Metz","5-1",5,1,"1",1,6,4,"H"
"10123",1971-10-02,1971,"Stade Reims","Olympique Lyon","0-0",0,0,"1",1,0,0,"D"
"10124",1971-10-02,1971,"SC Bastia","AS Monaco","1-2",1,2,"1",1,3,-1,"D"
"10125",1971-10-02,1971,"AS Angouleme","FC Sochaux","0-0",0,0,"1",1,0,0,"D"
"10126",1971-10-03,1971,"OGC Nice","Olympique Marseille","2-0",2,0,"1",1,2,2,"H"
"10127",1971-10-03,1971,"Red Star FC","AC Ajaccio","3-1",3,1,"1",1,4,2,"H"
"10128",1971-10-13,1971,"Olympique Marseille","Nimes Olympique","3-1",3,1,"1",1,4,2,"H"
"10129",1971-10-13,1971,"Stade Rennes","FC Nantes","1-1",1,1,"1",1,2,0,"D"
"10130",1971-10-13,1971,"Olympique Lyon","AS Saint-Etienne","2-0",2,0,"1",1,2,2,"H"
"10131",1971-10-13,1971,"Paris Saint-Germain","Red Star FC","4-1",4,1,"1",1,5,3,"H"
"10132",1971-10-13,1971,"AS Monaco","OGC Nice","0-2",0,2,"1",1,2,-2,"D"
"10133",1971-10-13,1971,"Angers SCO","Lille OSC","3-1",3,1,"1",1,4,2,"H"
"10134",1971-10-13,1971,"FC Sochaux","Stade Reims","1-1",1,1,"1",1,2,0,"D"
"10135",1971-10-13,1971,"Girondins Bordeaux","AS Nancy","1-0",1,0,"1",1,1,1,"H"
"10136",1971-10-13,1971,"FC Metz","AS Angouleme","1-0",1,0,"1",1,1,1,"H"
"10137",1971-10-16,1971,"Nimes Olympique","Olympique Lyon","2-0",2,0,"1",1,2,2,"H"
"10138",1971-10-16,1971,"FC Sochaux","Stade Rennes","3-2",3,2,"1",1,5,1,"H"
"10139",1971-10-16,1971,"FC Nantes","AS Monaco","1-1",1,1,"1",1,2,0,"D"
"10140",1971-10-16,1971,"AS Angouleme","Paris Saint-Germain","3-1",3,1,"1",1,4,2,"H"
"10141",1971-10-16,1971,"Stade Reims","FC Metz","0-1",0,1,"1",1,1,-1,"D"
"10142",1971-10-16,1971,"AS Nancy","Lille OSC","2-1",2,1,"1",1,3,1,"H"
"10143",1971-10-17,1971,"OGC Nice","Angers SCO","3-1",3,1,"1",1,4,2,"H"
"10144",1971-10-17,1971,"AS Saint-Etienne","AC Ajaccio","1-1",1,1,"1",1,2,0,"D"
"10145",1971-10-17,1971,"Red Star FC","Girondins Bordeaux","1-0",1,0,"1",1,1,1,"H"
"10146",1971-10-22,1971,"Olympique Lyon","SC Bastia","3-0",3,0,"1",1,3,3,"H"
"10147",1971-10-22,1971,"Lille OSC","Red Star FC","3-1",3,1,"1",1,4,2,"H"
"10148",1971-10-22,1971,"Stade Rennes","OGC Nice","2-2",2,2,"1",1,4,0,"D"
"10149",1971-10-22,1971,"Angers SCO","Nimes Olympique","0-0",0,0,"1",1,0,0,"D"
"10150",1971-10-22,1971,"Girondins Bordeaux","FC Nantes","2-2",2,2,"1",1,4,0,"D"
"10151",1971-10-23,1971,"FC Metz","FC Sochaux","0-1",0,1,"1",1,1,-1,"D"
"10152",1971-10-23,1971,"Paris Saint-Germain","Stade Reims","2-4",2,4,"1",1,6,-2,"D"
"10153",1971-10-24,1971,"Olympique Marseille","AS Saint-Etienne","2-3",2,3,"1",1,5,-1,"D"
"10154",1971-10-24,1971,"AC Ajaccio","AS Nancy","3-1",3,1,"1",1,4,2,"H"
"10155",1971-10-24,1971,"AS Monaco","AS Angouleme","1-0",1,0,"1",1,1,1,"H"
"10156",1971-10-27,1971,"FC Sochaux","Nimes Olympique","1-0",1,0,"1",1,1,1,"H"
"10157",1971-10-29,1971,"FC Nantes","Olympique Marseille","1-1",1,1,"1",1,2,0,"D"
"10158",1971-10-30,1971,"AS Saint-Etienne","Girondins Bordeaux","1-1",1,1,"1",1,2,0,"D"
"10159",1971-10-30,1971,"AS Angouleme","Olympique Lyon","2-0",2,0,"1",1,2,2,"H"
"10160",1971-10-30,1971,"SC Bastia","Angers SCO","3-1",3,1,"1",1,4,2,"H"
"10161",1971-10-30,1971,"Stade Reims","AS Monaco","1-1",1,1,"1",1,2,0,"D"
"10162",1971-10-30,1971,"FC Metz","Paris Saint-Germain","2-0",2,0,"1",1,2,2,"H"
"10163",1971-10-30,1971,"FC Sochaux","AC Ajaccio","3-1",3,1,"1",1,4,2,"H"
"10164",1971-10-30,1971,"Red Star FC","AS Nancy","1-1",1,1,"1",1,2,0,"D"
"10165",1971-10-30,1971,"Nimes Olympique","Stade Rennes","3-0",3,0,"1",1,3,3,"H"
"10166",1971-11-01,1971,"OGC Nice","Lille OSC","3-1",3,1,"1",1,4,2,"H"
"10167",1971-11-04,1971,"AC Ajaccio","SC Bastia","2-0",2,0,"1",1,2,2,"H"
"10168",1971-11-13,1971,"Paris Saint-Germain","FC Sochaux","1-0",1,0,"1",1,1,1,"H"
"10169",1971-11-13,1971,"Lille OSC","Nimes Olympique","1-1",1,1,"1",1,2,0,"D"
"10170",1971-11-13,1971,"Angers SCO","AS Saint-Etienne","1-1",1,1,"1",1,2,0,"D"
"10171",1971-11-14,1971,"Olympique Marseille","AS Angouleme","3-0",3,0,"1",1,3,3,"H"
"10172",1971-11-14,1971,"AS Nancy","OGC Nice","3-2",3,2,"1",1,5,1,"H"
"10173",1971-11-14,1971,"Olympique Lyon","FC Nantes","1-3",1,3,"1",1,4,-2,"D"
"10174",1971-11-14,1971,"Stade Rennes","Red Star FC","2-0",2,0,"1",1,2,2,"H"
"10175",1971-11-14,1971,"AS Monaco","FC Metz","3-2",3,2,"1",1,5,1,"H"
"10176",1971-11-14,1971,"Girondins Bordeaux","SC Bastia","2-1",2,1,"1",1,3,1,"H"
"10177",1971-11-14,1971,"AC Ajaccio","Stade Reims","2-2",2,2,"1",1,4,0,"D"
"10178",1971-11-17,1971,"Stade Reims","Olympique Marseille","1-3",1,3,"1",1,4,-2,"D"
"10179",1971-11-17,1971,"Nimes Olympique","Girondins Bordeaux","1-1",1,1,"1",1,2,0,"D"
"10180",1971-11-17,1971,"FC Sochaux","AS Monaco","3-1",3,1,"1",1,4,2,"H"
"10181",1971-11-17,1971,"FC Nantes","Angers SCO","1-0",1,0,"1",1,1,1,"H"
"10182",1971-11-17,1971,"OGC Nice","Red Star FC","1-0",1,0,"1",1,1,1,"H"
"10183",1971-11-17,1971,"AS Saint-Etienne","AS Nancy","1-3",1,3,"1",1,4,-2,"D"
"10184",1971-11-17,1971,"AS Angouleme","Stade Rennes","0-0",0,0,"1",1,0,0,"D"
"10185",1971-11-17,1971,"Paris Saint-Germain","Olympique Lyon","1-2",1,2,"1",1,3,-1,"D"
"10186",1971-11-17,1971,"FC Metz","AC Ajaccio","3-0",3,0,"1",1,3,3,"H"
"10187",1971-11-17,1971,"SC Bastia","Lille OSC","1-0",1,0,"1",1,1,1,"H"
"10188",1971-11-21,1971,"Olympique Marseille","FC Sochaux","3-0",3,0,"1",1,3,3,"H"
"10189",1971-11-21,1971,"Red Star FC","Nimes Olympique","1-5",1,5,"1",1,6,-4,"D"
"10190",1971-11-21,1971,"Girondins Bordeaux","OGC Nice","2-1",2,1,"1",1,3,1,"H"
"10191",1971-11-21,1971,"AC Ajaccio","FC Nantes","4-2",4,2,"1",1,6,2,"H"
"10192",1971-11-21,1971,"Olympique Lyon","FC Metz","2-1",2,1,"1",1,3,1,"H"
"10193",1971-11-21,1971,"Stade Rennes","Stade Reims","4-1",4,1,"1",1,5,3,"H"
"10194",1971-11-21,1971,"Lille OSC","AS Saint-Etienne","2-0",2,0,"1",1,2,2,"H"
"10195",1971-11-21,1971,"AS Nancy","SC Bastia","2-0",2,0,"1",1,2,2,"H"
"10196",1971-11-21,1971,"Angers SCO","AS Angouleme","8-1",8,1,"1",1,9,7,"H"
"10197",1971-11-21,1971,"AS Monaco","Paris Saint-Germain","2-1",2,1,"1",1,3,1,"H"
"10198",1971-11-27,1971,"AS Angouleme","Girondins Bordeaux","3-0",3,0,"1",1,3,3,"H"
"10199",1971-11-28,1971,"FC Metz","Olympique Marseille","1-3",1,3,"1",1,4,-2,"D"
"10200",1971-11-28,1971,"Nimes Olympique","AS Nancy","0-0",0,0,"1",1,0,0,"D"
"10201",1971-11-28,1971,"FC Sochaux","Olympique Lyon","4-0",4,0,"1",1,4,4,"H"
"10202",1971-11-28,1971,"FC Nantes","Lille OSC","2-1",2,1,"1",1,3,1,"H"
"10203",1971-11-28,1971,"AS Saint-Etienne","OGC Nice","2-2",2,2,"1",1,4,0,"D"
"10204",1971-11-28,1971,"AS Monaco","Stade Rennes","0-1",0,1,"1",1,1,-1,"D"
"10205",1971-11-28,1971,"Stade Reims","Angers SCO","2-1",2,1,"1",1,3,1,"H"
"10206",1971-11-28,1971,"Paris Saint-Germain","AC Ajaccio","1-1",1,1,"1",1,2,0,"D"
"10207",1971-11-28,1971,"SC Bastia","Red Star FC","2-0",2,0,"1",1,2,2,"H"
"10208",1971-12-08,1971,"SC Bastia","Olympique Marseille","2-1",2,1,"1",1,3,1,"H"
"10209",1971-12-12,1971,"Olympique Marseille","Paris Saint-Germain","4-2",4,2,"1",1,6,2,"H"
"10210",1971-12-12,1971,"AC Ajaccio","Nimes Olympique","0-0",0,0,"1",1,0,0,"D"
"10211",1971-12-12,1971,"Angers SCO","FC Sochaux","2-0",2,0,"1",1,2,2,"H"
"10212",1971-12-12,1971,"AS Nancy","FC Nantes","1-0",1,0,"1",1,1,1,"H"
"10213",1971-12-12,1971,"Stade Rennes","FC Metz","3-0",3,0,"1",1,3,3,"H"
"10214",1971-12-12,1971,"OGC Nice","SC Bastia","0-1",0,1,"1",1,1,-1,"D"
"10215",1971-12-12,1971,"Red Star FC","AS Saint-Etienne","1-2",1,2,"1",1,3,-1,"D"
"10216",1971-12-12,1971,"Olympique Lyon","AS Monaco","2-2",2,2,"1",1,4,0,"D"
"10217",1971-12-12,1971,"Girondins Bordeaux","Stade Reims","1-1",1,1,"1",1,2,0,"D"
"10218",1971-12-12,1971,"Lille OSC","AS Angouleme","4-2",4,2,"1",1,6,2,"H"
"10219",1971-12-19,1971,"AS Monaco","Olympique Marseille","0-1",0,1,"1",1,1,-1,"D"
"10220",1971-12-19,1971,"Nimes Olympique","OGC Nice","2-0",2,0,"1",1,2,2,"H"
"10221",1971-12-19,1971,"Paris Saint-Germain","Stade Rennes","1-1",1,1,"1",1,2,0,"D"
"10222",1971-12-19,1971,"FC Sochaux","Girondins Bordeaux","0-0",0,0,"1",1,0,0,"D"
"10223",1971-12-19,1971,"FC Nantes","Red Star FC","1-1",1,1,"1",1,2,0,"D"
"10224",1971-12-19,1971,"SC Bastia","AS Saint-Etienne","3-0",3,0,"1",1,3,3,"H"
"10225",1971-12-19,1971,"AS Angouleme","AS Nancy","1-1",1,1,"1",1,2,0,"D"
"10226",1971-12-19,1971,"Olympique Lyon","AC Ajaccio","2-1",2,1,"1",1,3,1,"H"
"10227",1971-12-19,1971,"FC Metz","Angers SCO","0-0",0,0,"1",1,0,0,"D"
"10228",1971-12-19,1971,"Stade Reims","Lille OSC","2-0",2,0,"1",1,2,2,"H"
"10229",1972-01-08,1971,"Stade Rennes","Olympique Lyon","0-0",0,0,"1",1,0,0,"D"
"10230",1972-01-09,1971,"Olympique Marseille","AC Ajaccio","1-1",1,1,"1",1,2,0,"D"
"10231",1972-01-09,1971,"Red Star FC","Stade Reims","2-2",2,2,"1",1,4,0,"D"
"10232",1972-01-09,1971,"SC Bastia","Nimes Olympique","1-0",1,0,"1",1,1,1,"H"
"10233",1972-01-09,1971,"AS Nancy","FC Sochaux","0-0",0,0,"1",1,0,0,"D"
"10234",1972-01-09,1971,"AS Saint-Etienne","FC Nantes","2-1",2,1,"1",1,3,1,"H"
"10235",1972-01-09,1971,"OGC Nice","AS Angouleme","3-0",3,0,"1",1,3,3,"H"
"10236",1972-01-09,1971,"Angers SCO","AS Monaco","4-1",4,1,"1",1,5,3,"H"
"10237",1972-01-09,1971,"Girondins Bordeaux","Paris Saint-Germain","2-0",2,0,"1",1,2,2,"H"
"10238",1972-01-09,1971,"Lille OSC","FC Metz","3-0",3,0,"1",1,3,3,"H"
"10239",1972-01-16,1971,"Olympique Marseille","Stade Rennes","1-1",1,1,"1",1,2,0,"D"
"10240",1972-01-16,1971,"AS Angouleme","Nimes Olympique","0-3",0,3,"1",1,3,-3,"D"
"10241",1972-01-16,1971,"FC Sochaux","Red Star FC","1-2",1,2,"1",1,3,-1,"D"
"10242",1972-01-16,1971,"FC Nantes","SC Bastia","4-0",4,0,"1",1,4,4,"H"
"10243",1972-01-16,1971,"Olympique Lyon","Angers SCO","1-2",1,2,"1",1,3,-1,"D"
"10244",1972-01-16,1971,"Stade Reims","AS Saint-Etienne","2-1",2,1,"1",1,3,1,"H"
"10245",1972-01-16,1971,"FC Metz","OGC Nice","1-0",1,0,"1",1,1,1,"H"
"10246",1972-01-16,1971,"Paris Saint-Germain","AS Nancy","1-4",1,4,"1",1,5,-3,"D"
"10247",1972-01-16,1971,"AS Monaco","Girondins Bordeaux","1-2",1,2,"1",1,3,-1,"D"
"10248",1972-01-16,1971,"AC Ajaccio","Lille OSC","0-1",0,1,"1",1,1,-1,"D"
"10249",1972-01-30,1971,"Angers SCO","Olympique Marseille","1-0",1,0,"1",1,1,1,"H"
"10250",1972-01-30,1971,"Nimes Olympique","FC Nantes","4-0",4,0,"1",1,4,4,"H"
"10251",1972-01-30,1971,"AS Saint-Etienne","FC Sochaux","0-1",0,1,"1",1,1,-1,"D"
"10252",1972-01-30,1971,"AS Nancy","FC Metz","1-1",1,1,"1",1,2,0,"D"
"10253",1972-01-30,1971,"OGC Nice","Stade Reims","3-0",3,0,"1",1,3,3,"H"
"10254",1972-01-30,1971,"Girondins Bordeaux","Olympique Lyon","0-3",0,3,"1",1,3,-3,"D"
"10255",1972-01-30,1971,"SC Bastia","AS Angouleme","2-0",2,0,"1",1,2,2,"H"
"10256",1972-01-30,1971,"Red Star FC","AS Monaco","1-0",1,0,"1",1,1,1,"H"
"10257",1972-01-30,1971,"Lille OSC","Paris Saint-Germain","1-3",1,3,"1",1,4,-2,"D"
"10258",1972-02-05,1971,"AS Angouleme","AS Saint-Etienne","3-4",3,4,"1",1,7,-1,"D"
"10259",1972-02-06,1971,"Olympique Marseille","Girondins Bordeaux","3-0",3,0,"1",1,3,3,"H"
"10260",1972-02-06,1971,"Stade Reims","Nimes Olympique","1-1",1,1,"1",1,2,0,"D"
"10261",1972-02-06,1971,"Stade Rennes","Angers SCO","3-1",3,1,"1",1,4,2,"H"
"10262",1972-02-06,1971,"FC Sochaux","SC Bastia","6-1",6,1,"1",1,7,5,"H"
"10263",1972-02-06,1971,"Paris Saint-Germain","FC Nantes","2-3",2,3,"1",1,5,-1,"D"
"10264",1972-02-06,1971,"AC Ajaccio","OGC Nice","0-0",0,0,"1",1,0,0,"D"
"10265",1972-02-06,1971,"AS Monaco","AS Nancy","4-2",4,2,"1",1,6,2,"H"
"10266",1972-02-06,1971,"Olympique Lyon","Lille OSC","1-0",1,0,"1",1,1,1,"H"
"10267",1972-02-06,1971,"FC Metz","Red Star FC","3-0",3,0,"1",1,3,3,"H"
"10268",1972-02-12,1971,"OGC Nice","Paris Saint-Germain","1-1",1,1,"1",1,2,0,"D"
"10269",1972-02-12,1971,"AS Saint-Etienne","FC Metz","2-0",2,0,"1",1,2,2,"H"
"10270",1972-02-13,1971,"Red Star FC","Olympique Marseille","2-4",2,4,"1",1,6,-2,"D"
"10271",1972-02-13,1971,"Nimes Olympique","FC Sochaux","2-1",2,1,"1",1,3,1,"H"
"10272",1972-02-13,1971,"Girondins Bordeaux","Stade Rennes","2-1",2,1,"1",1,3,1,"H"
"10273",1972-02-13,1971,"FC Nantes","AS Angouleme","5-0",5,0,"1",1,5,5,"H"
"10274",1972-02-13,1971,"AS Nancy","Olympique Lyon","2-2",2,2,"1",1,4,0,"D"
"10275",1972-02-13,1971,"Angers SCO","AC Ajaccio","2-1",2,1,"1",1,3,1,"H"
"10276",1972-02-13,1971,"SC Bastia","Stade Reims","3-1",3,1,"1",1,4,2,"H"
"10277",1972-02-13,1971,"Lille OSC","AS Monaco","1-1",1,1,"1",1,2,0,"D"
"10278",1972-02-27,1971,"Olympique Marseille","AS Nancy","1-1",1,1,"1",1,2,0,"D"
"10279",1972-02-27,1971,"AS Monaco","Nimes Olympique","1-1",1,1,"1",1,2,0,"D"
"10280",1972-02-27,1971,"FC Sochaux","OGC Nice","1-1",1,1,"1",1,2,0,"D"
"10281",1972-02-27,1971,"Stade Reims","FC Nantes","0-0",0,0,"1",1,0,0,"D"
"10282",1972-02-27,1971,"Stade Rennes","Lille OSC","5-2",5,2,"1",1,7,3,"H"
"10283",1972-02-27,1971,"Angers SCO","Girondins Bordeaux","3-1",3,1,"1",1,4,2,"H"
"10284",1972-02-27,1971,"Olympique Lyon","Red Star FC","5-1",5,1,"1",1,6,4,"H"
"10285",1972-02-27,1971,"Paris Saint-Germain","AS Saint-Etienne","1-3",1,3,"1",1,4,-2,"D"
"10286",1972-02-27,1971,"FC Metz","SC Bastia","2-1",2,1,"1",1,3,1,"H"
"10287",1972-02-27,1971,"AC Ajaccio","AS Angouleme","3-0",3,0,"1",1,3,3,"H"
"10288",1972-03-01,1971,"Stade Rennes","AC Ajaccio","1-1",1,1,"1",1,2,0,"D"
"10289",1972-03-04,1971,"FC Nantes","FC Sochaux","2-0",2,0,"1",1,2,2,"H"
"10290",1972-03-04,1971,"AS Nancy","Stade Rennes","3-1",3,1,"1",1,4,2,"H"
"10291",1972-03-04,1971,"OGC Nice","Olympique Lyon","2-1",2,1,"1",1,3,1,"H"
"10292",1972-03-04,1971,"Lille OSC","Olympique Marseille","0-2",0,2,"1",1,2,-2,"D"
"10293",1972-03-05,1971,"Nimes Olympique","FC Metz","1-1",1,1,"1",1,2,0,"D"
"10294",1972-03-05,1971,"Red Star FC","Angers SCO","2-1",2,1,"1",1,3,1,"H"
"10295",1972-03-05,1971,"AS Saint-Etienne","AS Monaco","3-2",3,2,"1",1,5,1,"H"
"10296",1972-03-05,1971,"SC Bastia","Paris Saint-Germain","1-0",1,0,"1",1,1,1,"H"
"10297",1972-03-05,1971,"Girondins Bordeaux","AC Ajaccio","1-0",1,0,"1",1,1,1,"H"
"10298",1972-03-05,1971,"AS Angouleme","Stade Reims","2-1",2,1,"1",1,3,1,"H"
"10299",1972-03-15,1971,"Angers SCO","AS Nancy","1-1",1,1,"1",1,2,0,"D"
"10300",1972-03-17,1971,"Girondins Bordeaux","Lille OSC","3-1",3,1,"1",1,4,2,"H"
"10301",1972-03-18,1971,"Stade Rennes","AS Saint-Etienne","2-4",2,4,"1",1,6,-2,"D"
"10302",1972-03-18,1971,"FC Metz","FC Nantes","3-0",3,0,"1",1,3,3,"H"
"10303",1972-03-18,1971,"Paris Saint-Germain","Nimes Olympique","1-1",1,1,"1",1,2,0,"D"
"10304",1972-03-18,1971,"FC Sochaux","AS Angouleme","4-1",4,1,"1",1,5,3,"H"
"10305",1972-03-19,1971,"Olympique Marseille","OGC Nice","1-0",1,0,"1",1,1,1,"H"
"10306",1972-03-19,1971,"Olympique Lyon","Stade Reims","5-0",5,0,"1",1,5,5,"H"
"10307",1972-03-19,1971,"AS Monaco","SC Bastia","0-1",0,1,"1",1,1,-1,"D"
"10308",1972-03-19,1971,"AC Ajaccio","Red Star FC","1-0",1,0,"1",1,1,1,"H"
"10309",1972-03-24,1971,"OGC Nice","AS Monaco","2-0",2,0,"1",1,2,2,"H"
"10310",1972-03-24,1971,"AS Nancy","Girondins Bordeaux","2-1",2,1,"1",1,3,1,"H"
"10311",1972-03-24,1971,"Lille OSC","Angers SCO","0-1",0,1,"1",1,1,-1,"D"
"10312",1972-03-24,1971,"AS Angouleme","FC Metz","1-0",1,0,"1",1,1,1,"H"
"10313",1972-03-25,1971,"Nimes Olympique","Olympique Marseille","1-3",1,3,"1",1,4,-2,"D"
"10314",1972-03-25,1971,"FC Nantes","Stade Rennes","4-0",4,0,"1",1,4,4,"H"
"10315",1972-03-25,1971,"Stade Reims","FC Sochaux","2-3",2,3,"1",1,5,-1,"D"
"10316",1972-03-26,1971,"AS Saint-Etienne","Olympique Lyon","0-1",0,1,"1",1,1,-1,"D"
"10317",1972-03-26,1971,"SC Bastia","AC Ajaccio","2-1",2,1,"1",1,3,1,"H"
"10318",1972-03-26,1971,"Red Star FC","Paris Saint-Germain","0-0",0,0,"1",1,0,0,"D"
"10319",1972-03-29,1971,"Olympique Marseille","SC Bastia","0-2",0,2,"1",1,2,-2,"D"
"10320",1972-03-29,1971,"Olympique Lyon","Nimes Olympique","3-2",3,2,"1",1,5,1,"H"
"10321",1972-03-29,1971,"Stade Rennes","FC Sochaux","0-2",0,2,"1",1,2,-2,"D"
"10322",1972-03-29,1971,"AS Monaco","FC Nantes","2-1",2,1,"1",1,3,1,"H"
"10323",1972-03-29,1971,"Angers SCO","OGC Nice","2-0",2,0,"1",1,2,2,"H"
"10324",1972-03-29,1971,"AC Ajaccio","AS Saint-Etienne","2-1",2,1,"1",1,3,1,"H"
"10325",1972-03-29,1971,"Lille OSC","AS Nancy","1-1",1,1,"1",1,2,0,"D"
"10326",1972-03-29,1971,"Girondins Bordeaux","Red Star FC","2-0",2,0,"1",1,2,2,"H"
"10327",1972-03-29,1971,"FC Metz","Stade Reims","3-0",3,0,"1",1,3,3,"H"
"10328",1972-03-29,1971,"Paris Saint-Germain","AS Angouleme","3-0",3,0,"1",1,3,3,"H"
"10329",1972-04-01,1971,"AS Saint-Etienne","Olympique Marseille","2-1",2,1,"1",1,3,1,"H"
"10330",1972-04-01,1971,"Nimes Olympique","Angers SCO","1-0",1,0,"1",1,1,1,"H"
"10331",1972-04-01,1971,"SC Bastia","Olympique Lyon","1-1",1,1,"1",1,2,0,"D"
"10332",1972-04-01,1971,"FC Sochaux","FC Metz","1-0",1,0,"1",1,1,1,"H"
"10333",1972-04-01,1971,"FC Nantes","Girondins Bordeaux","0-0",0,0,"1",1,0,0,"D"
"10334",1972-04-01,1971,"AS Nancy","AC Ajaccio","2-0",2,0,"1",1,2,2,"H"
"10335",1972-04-01,1971,"OGC Nice","Stade Rennes","0-0",0,0,"1",1,0,0,"D"
"10336",1972-04-01,1971,"Stade Reims","Paris Saint-Germain","3-3",3,3,"1",1,6,0,"D"
"10337",1972-04-01,1971,"Red Star FC","Lille OSC","0-0",0,0,"1",1,0,0,"D"
"10338",1972-04-01,1971,"AS Angouleme","AS Monaco","2-0",2,0,"1",1,2,2,"H"
"10339",1972-04-12,1971,"Olympique Marseille","FC Nantes","2-0",2,0,"1",1,2,2,"H"
"10340",1972-04-12,1971,"Stade Rennes","Nimes Olympique","0-2",0,2,"1",1,2,-2,"D"
"10341",1972-04-12,1971,"AC Ajaccio","FC Sochaux","1-2",1,2,"1",1,3,-1,"D"
"10342",1972-04-12,1971,"Olympique Lyon","AS Angouleme","2-0",2,0,"1",1,2,2,"H"
"10343",1972-04-12,1971,"Angers SCO","SC Bastia","2-0",2,0,"1",1,2,2,"H"
"10344",1972-04-12,1971,"AS Nancy","Red Star FC","1-1",1,1,"1",1,2,0,"D"
"10345",1972-04-12,1971,"Girondins Bordeaux","AS Saint-Etienne","0-2",0,2,"1",1,2,-2,"D"
"10346",1972-04-12,1971,"Lille OSC","OGC Nice","3-3",3,3,"1",1,6,0,"D"
"10347",1972-04-12,1971,"Paris Saint-Germain","FC Metz","3-1",3,1,"1",1,4,2,"H"
"10348",1972-04-12,1971,"AS Monaco","Stade Reims","1-1",1,1,"1",1,2,0,"D"
"10349",1972-04-21,1971,"AS Saint-Etienne","Angers SCO","0-1",0,1,"1",1,1,-1,"D"
"10350",1972-04-22,1971,"AS Angouleme","Olympique Marseille","2-3",2,3,"1",1,5,-1,"D"
"10351",1972-04-22,1971,"FC Sochaux","Paris Saint-Germain","0-2",0,2,"1",1,2,-2,"D"
"10352",1972-04-22,1971,"Nimes Olympique","Lille OSC","5-2",5,2,"1",1,7,3,"H"
"10353",1972-04-22,1971,"FC Nantes","Olympique Lyon","2-0",2,0,"1",1,2,2,"H"
"10354",1972-04-22,1971,"OGC Nice","AS Nancy","1-0",1,0,"1",1,1,1,"H"
"10355",1972-04-22,1971,"SC Bastia","Girondins Bordeaux","1-0",1,0,"1",1,1,1,"H"
"10356",1972-04-22,1971,"FC Metz","AS Monaco","4-0",4,0,"1",1,4,4,"H"
"10357",1972-04-22,1971,"Stade Reims","AC Ajaccio","3-1",3,1,"1",1,4,2,"H"
"10358",1972-04-23,1971,"Red Star FC","Stade Rennes","1-0",1,0,"1",1,1,1,"H"
"10359",1972-04-28,1971,"Olympique Marseille","Stade Reims","0-0",0,0,"1",1,0,0,"D"
"10360",1972-04-28,1971,"Girondins Bordeaux","Nimes Olympique","1-4",1,4,"1",1,5,-3,"D"
"10361",1972-04-28,1971,"Olympique Lyon","Paris Saint-Germain","3-1",3,1,"1",1,4,2,"H"
"10362",1972-04-28,1971,"Lille OSC","SC Bastia","1-0",1,0,"1",1,1,1,"H"
"10363",1972-04-28,1971,"AS Nancy","AS Saint-Etienne","3-1",3,1,"1",1,4,2,"H"
"10364",1972-04-28,1971,"Stade Rennes","AS Angouleme","2-2",2,2,"1",1,4,0,"D"
"10365",1972-04-28,1971,"AS Monaco","FC Sochaux","1-3",1,3,"1",1,4,-2,"D"
"10366",1972-04-29,1971,"Angers SCO","FC Nantes","2-1",2,1,"1",1,3,1,"H"
"10367",1972-04-29,1971,"AC Ajaccio","FC Metz","1-0",1,0,"1",1,1,1,"H"
"10368",1972-04-29,1971,"Red Star FC","OGC Nice","1-2",1,2,"1",1,3,-1,"D"
"10369",1972-05-03,1971,"FC Sochaux","Olympique Marseille","0-1",0,1,"1",1,1,-1,"D"
"10370",1972-05-03,1971,"Nimes Olympique","Red Star FC","2-0",2,0,"1",1,2,2,"H"
"10371",1972-05-03,1971,"FC Metz","Olympique Lyon","1-0",1,0,"1",1,1,1,"H"
"10372",1972-05-03,1971,"AS Angouleme","Angers SCO","1-0",1,0,"1",1,1,1,"H"
"10373",1972-05-03,1971,"SC Bastia","AS Nancy","2-0",2,0,"1",1,2,2,"H"
"10374",1972-05-03,1971,"OGC Nice","Girondins Bordeaux","5-1",5,1,"1",1,6,4,"H"
"10375",1972-05-03,1971,"FC Nantes","AC Ajaccio","2-0",2,0,"1",1,2,2,"H"
"10376",1972-05-03,1971,"AS Saint-Etienne","Lille OSC","4-0",4,0,"1",1,4,4,"H"
"10377",1972-05-03,1971,"Stade Reims","Stade Rennes","0-2",0,2,"1",1,2,-2,"D"
"10378",1972-05-03,1971,"Paris Saint-Germain","AS Monaco","0-0",0,0,"1",1,0,0,"D"
"10379",1972-05-06,1971,"Olympique Marseille","FC Metz","3-0",3,0,"1",1,3,3,"H"
"10380",1972-05-06,1971,"AS Nancy","Nimes Olympique","0-1",0,1,"1",1,1,-1,"D"
"10381",1972-05-06,1971,"Olympique Lyon","FC Sochaux","1-0",1,0,"1",1,1,1,"H"
"10382",1972-05-06,1971,"Angers SCO","Stade Reims","3-2",3,2,"1",1,5,1,"H"
"10383",1972-05-06,1971,"OGC Nice","AS Saint-Etienne","1-2",1,2,"1",1,3,-1,"D"
"10384",1972-05-06,1971,"Lille OSC","FC Nantes","3-0",3,0,"1",1,3,3,"H"
"10385",1972-05-06,1971,"Stade Rennes","AS Monaco","1-3",1,3,"1",1,4,-2,"D"
"10386",1972-05-06,1971,"Girondins Bordeaux","AS Angouleme","2-0",2,0,"1",1,2,2,"H"
"10387",1972-05-06,1971,"AC Ajaccio","Paris Saint-Germain","3-0",3,0,"1",1,3,3,"H"
"10388",1972-05-07,1971,"Red Star FC","SC Bastia","2-1",2,1,"1",1,3,1,"H"
"10389",1972-05-17,1971,"Paris Saint-Germain","Olympique Marseille","1-2",1,2,"1",1,3,-1,"D"
"10390",1972-05-17,1971,"Nimes Olympique","AC Ajaccio","2-0",2,0,"1",1,2,2,"H"
"10391",1972-05-17,1971,"FC Sochaux","Angers SCO","2-0",2,0,"1",1,2,2,"H"
"10392",1972-05-17,1971,"AS Monaco","Olympique Lyon","0-1",0,1,"1",1,1,-1,"D"
"10393",1972-05-17,1971,"AS Saint-Etienne","Red Star FC","5-1",5,1,"1",1,6,4,"H"
"10394",1972-05-17,1971,"SC Bastia","OGC Nice","3-3",3,3,"1",1,6,0,"D"
"10395",1972-05-17,1971,"FC Nantes","AS Nancy","2-2",2,2,"1",1,4,0,"D"
"10396",1972-05-17,1971,"FC Metz","Stade Rennes","1-2",1,2,"1",1,3,-1,"D"
"10397",1972-05-17,1971,"Stade Reims","Girondins Bordeaux","2-1",2,1,"1",1,3,1,"H"
"10398",1972-05-17,1971,"AS Angouleme","Lille OSC","3-3",3,3,"1",1,6,0,"D"
"10399",1972-05-20,1971,"Olympique Marseille","AS Monaco","4-2",4,2,"1",1,6,2,"H"
"10400",1972-05-20,1971,"OGC Nice","Nimes Olympique","4-0",4,0,"1",1,4,4,"H"
"10401",1972-05-20,1971,"AC Ajaccio","Olympique Lyon","2-0",2,0,"1",1,2,2,"H"
"10402",1972-05-20,1971,"Girondins Bordeaux","FC Sochaux","0-1",0,1,"1",1,1,-1,"D"
"10403",1972-05-20,1971,"AS Saint-Etienne","SC Bastia","5-3",5,3,"1",1,8,2,"H"
"10404",1972-05-20,1971,"Angers SCO","FC Metz","1-1",1,1,"1",1,2,0,"D"
"10405",1972-05-20,1971,"Red Star FC","FC Nantes","0-1",0,1,"1",1,1,-1,"D"
"10406",1972-05-20,1971,"AS Nancy","AS Angouleme","3-2",3,2,"1",1,5,1,"H"
"10407",1972-05-20,1971,"Stade Rennes","Paris Saint-Germain","1-1",1,1,"1",1,2,0,"D"
"10408",1972-05-20,1971,"Lille OSC","Stade Reims","0-0",0,0,"1",1,0,0,"D"
"10409",1972-05-26,1971,"Olympique Lyon","Olympique Marseille","3-3",3,3,"1",1,6,0,"D"
"10410",1972-05-26,1971,"FC Metz","Girondins Bordeaux","1-3",1,3,"1",1,4,-2,"D"
"10411",1972-05-27,1971,"Nimes Olympique","AS Saint-Etienne","4-0",4,0,"1",1,4,4,"H"
"10412",1972-05-27,1971,"FC Sochaux","Lille OSC","2-0",2,0,"1",1,2,2,"H"
"10413",1972-05-27,1971,"Paris Saint-Germain","Angers SCO","0-1",0,1,"1",1,1,-1,"D"
"10414",1972-05-27,1971,"FC Nantes","OGC Nice","4-0",4,0,"1",1,4,4,"H"
"10415",1972-05-27,1971,"Stade Reims","AS Nancy","3-2",3,2,"1",1,5,1,"H"
"10416",1972-05-27,1971,"SC Bastia","Stade Rennes","4-1",4,1,"1",1,5,3,"H"
"10417",1972-05-27,1971,"AS Monaco","AC Ajaccio","2-2",2,2,"1",1,4,0,"D"
"10418",1972-05-27,1971,"AS Angouleme","Red Star FC","0-2",0,2,"1",1,2,-2,"D"
"10419",1972-08-09,1972,"Angers SCO","AC Ajaccio","4-0",4,0,"1",1,4,4,"H"
"10420",1972-08-09,1972,"OGC Nice","FC Sochaux","4-1",4,1,"1",1,5,3,"H"
"10421",1972-08-09,1972,"RC Strasbourg","Stade Reims","4-1",4,1,"1",1,5,3,"H"
"10422",1972-08-09,1972,"FC Metz","Red Star FC","3-0",3,0,"1",1,3,3,"H"
"10423",1972-08-09,1972,"Olympique Lyon","Stade Rennes","3-1",3,1,"1",1,4,2,"H"
"10424",1972-08-09,1972,"CS Sedan","Olympique Marseille","0-2",0,2,"1",1,2,-2,"D"
"10425",1972-08-09,1972,"Paris FC","AS Nancy","3-2",3,2,"1",1,5,1,"H"
"10426",1972-08-09,1972,"Girondins Bordeaux","AS Saint-Etienne","1-1",1,1,"1",1,2,0,"D"
"10427",1972-08-09,1972,"Nimes Olympique","US Valenciennes-Anzin","1-1",1,1,"1",1,2,0,"D"
"10428",1972-08-09,1972,"SC Bastia","FC Nantes","0-0",0,0,"1",1,0,0,"D"
"10429",1972-08-16,1972,"Olympique Marseille","Olympique Lyon","5-2",5,2,"1",1,7,3,"H"
"10430",1972-08-16,1972,"Red Star FC","Angers SCO","1-2",1,2,"1",1,3,-1,"D"
"10431",1972-08-16,1972,"AC Ajaccio","RC Strasbourg","0-2",0,2,"1",1,2,-2,"D"
"10432",1972-08-16,1972,"Stade Reims","OGC Nice","2-3",2,3,"1",1,5,-1,"D"
"10433",1972-08-16,1972,"FC Metz","Girondins Bordeaux","1-1",1,1,"1",1,2,0,"D"
"10434",1972-08-16,1972,"AS Saint-Etienne","Nimes Olympique","3-1",3,1,"1",1,4,2,"H"
"10435",1972-08-16,1972,"FC Nantes","Paris FC","2-0",2,0,"1",1,2,2,"H"
"10436",1972-08-16,1972,"US Valenciennes-Anzin","AS Nancy","0-1",0,1,"1",1,1,-1,"D"
"10437",1972-08-16,1972,"Stade Rennes","SC Bastia","2-1",2,1,"1",1,3,1,"H"
"10438",1972-08-16,1972,"FC Sochaux","CS Sedan","1-0",1,0,"1",1,1,1,"H"
"10439",1972-08-23,1972,"OGC Nice","AC Ajaccio","5-3",5,3,"1",1,8,2,"H"
"10440",1972-08-23,1972,"Angers SCO","FC Metz","3-2",3,2,"1",1,5,1,"H"
"10441",1972-08-23,1972,"SC Bastia","Olympique Marseille","0-0",0,0,"1",1,0,0,"D"
"10442",1972-08-23,1972,"RC Strasbourg","AS Saint-Etienne","0-0",0,0,"1",1,0,0,"D"
"10443",1972-08-23,1972,"AS Nancy","FC Nantes","1-1",1,1,"1",1,2,0,"D"
"10444",1972-08-23,1972,"Stade Rennes","Paris FC","2-1",2,1,"1",1,3,1,"H"
"10445",1972-08-23,1972,"Nimes Olympique","FC Sochaux","3-0",3,0,"1",1,3,3,"H"
"10446",1972-08-23,1972,"Girondins Bordeaux","Red Star FC","1-1",1,1,"1",1,2,0,"D"
"10447",1972-08-23,1972,"Olympique Lyon","Stade Reims","1-1",1,1,"1",1,2,0,"D"
"10448",1972-08-23,1972,"CS Sedan","US Valenciennes-Anzin","3-1",3,1,"1",1,4,2,"H"
"10449",1972-08-26,1972,"Red Star FC","OGC Nice","1-1",1,1,"1",1,2,0,"D"
"10450",1972-08-26,1972,"Angers SCO","CS Sedan","2-2",2,2,"1",1,4,0,"D"
"10451",1972-08-26,1972,"Olympique Marseille","FC Nantes","1-0",1,0,"1",1,1,1,"H"
"10452",1972-08-26,1972,"FC Metz","RC Strasbourg","1-1",1,1,"1",1,2,0,"D"
"10453",1972-08-26,1972,"AS Saint-Etienne","Paris FC","3-0",3,0,"1",1,3,3,"H"
"10454",1972-08-26,1972,"Stade Rennes","AS Nancy","4-1",4,1,"1",1,5,3,"H"
"10455",1972-08-26,1972,"Stade Reims","Nimes Olympique","0-1",0,1,"1",1,1,-1,"D"
"10456",1972-08-26,1972,"AC Ajaccio","Girondins Bordeaux","2-2",2,2,"1",1,4,0,"D"
"10457",1972-08-26,1972,"FC Sochaux","Olympique Lyon","3-1",3,1,"1",1,4,2,"H"
"10458",1972-08-26,1972,"US Valenciennes-Anzin","SC Bastia","1-0",1,0,"1",1,1,1,"H"
"10459",1972-09-06,1972,"OGC Nice","FC Metz","6-0",6,0,"1",1,6,6,"H"
"10460",1972-09-06,1972,"Paris FC","Olympique Marseille","1-3",1,3,"1",1,4,-2,"D"
"10461",1972-09-06,1972,"Girondins Bordeaux","Angers SCO","1-2",1,2,"1",1,3,-1,"D"
"10462",1972-09-06,1972,"CS Sedan","AS Saint-Etienne","1-3",1,3,"1",1,4,-2,"D"
"10463",1972-09-06,1972,"RC Strasbourg","Red Star FC","2-2",2,2,"1",1,4,0,"D"
"10464",1972-09-06,1972,"Nimes Olympique","AC Ajaccio","2-1",2,1,"1",1,3,1,"H"
"10465",1972-09-06,1972,"FC Nantes","Stade Rennes","1-0",1,0,"1",1,1,1,"H"
"10466",1972-09-06,1972,"AS Nancy","Stade Reims","3-0",3,0,"1",1,3,3,"H"
"10467",1972-09-06,1972,"Olympique Lyon","US Valenciennes-Anzin","1-0",1,0,"1",1,1,1,"H"
"10468",1972-09-06,1972,"SC Bastia","FC Sochaux","3-1",3,1,"1",1,4,2,"H"
"10469",1972-09-15,1972,"AS Saint-Etienne","OGC Nice","0-1",0,1,"1",1,1,-1,"D"
"10470",1972-09-16,1972,"Olympique Marseille","Stade Rennes","3-0",3,0,"1",1,3,3,"H"
"10471",1972-09-16,1972,"Angers SCO","RC Strasbourg","1-0",1,0,"1",1,1,1,"H"
"10472",1972-09-16,1972,"Red Star FC","Nimes Olympique","1-1",1,1,"1",1,2,0,"D"
"10473",1972-09-16,1972,"US Valenciennes-Anzin","FC Nantes","1-1",1,1,"1",1,2,0,"D"
"10474",1972-09-16,1972,"FC Sochaux","AS Nancy","2-2",2,2,"1",1,4,0,"D"
"10475",1972-09-16,1972,"FC Metz","Olympique Lyon","2-2",2,2,"1",1,4,0,"D"
"10476",1972-09-16,1972,"Girondins Bordeaux","Paris FC","0-1",0,1,"1",1,1,-1,"D"
"10477",1972-09-16,1972,"Stade Reims","SC Bastia","2-0",2,0,"1",1,2,2,"H"
"10478",1972-09-16,1972,"AC Ajaccio","CS Sedan","2-1",2,1,"1",1,3,1,"H"
"10479",1972-09-20,1972,"OGC Nice","Angers SCO","2-4",2,4,"1",1,6,-2,"D"
"10480",1972-09-20,1972,"AS Nancy","Olympique Marseille","1-0",1,0,"1",1,1,1,"H"
"10481",1972-09-20,1972,"SC Bastia","AS Saint-Etienne","3-3",3,3,"1",1,6,0,"D"
"10482",1972-09-20,1972,"Nimes Olympique","FC Metz","0-0",0,0,"1",1,0,0,"D"
"10483",1972-09-20,1972,"FC Nantes","FC Sochaux","4-3",4,3,"1",1,7,1,"H"
"10484",1972-09-20,1972,"RC Strasbourg","Girondins Bordeaux","2-2",2,2,"1",1,4,0,"D"
"10485",1972-09-20,1972,"Stade Rennes","Stade Reims","1-0",1,0,"1",1,1,1,"H"
"10486",1972-09-20,1972,"Olympique Lyon","AC Ajaccio","1-0",1,0,"1",1,1,1,"H"
"10487",1972-09-20,1972,"CS Sedan","Red Star FC","0-1",0,1,"1",1,1,-1,"D"
"10488",1972-09-20,1972,"Paris FC","US Valenciennes-Anzin","1-1",1,1,"1",1,2,0,"D"
"10489",1972-09-29,1972,"Girondins Bordeaux","OGC Nice","0-1",0,1,"1",1,1,-1,"D"
"10490",1972-09-29,1972,"AS Saint-Etienne","AS Nancy","1-0",1,0,"1",1,1,1,"H"
"10491",1972-09-29,1972,"RC Strasbourg","SC Bastia","0-4",0,4,"1",1,4,-4,"D"
"10492",1972-09-30,1972,"Angers SCO","Nimes Olympique","0-1",0,1,"1",1,1,-1,"D"
"10493",1972-09-30,1972,"US Valenciennes-Anzin","Olympique Marseille","1-0",1,0,"1",1,1,1,"H"
"10494",1972-09-30,1972,"AC Ajaccio","FC Nantes","1-1",1,1,"1",1,2,0,"D"
"10495",1972-09-30,1972,"Red Star FC","Olympique Lyon","0-1",0,1,"1",1,1,-1,"D"
"10496",1972-09-30,1972,"FC Sochaux","Stade Rennes","2-1",2,1,"1",1,3,1,"H"
"10497",1972-09-30,1972,"FC Metz","CS Sedan","4-2",4,2,"1",1,6,2,"H"
"10498",1972-09-30,1972,"Stade Reims","Paris FC","1-1",1,1,"1",1,2,0,"D"
"10499",1972-10-04,1972,"OGC Nice","RC Strasbourg","3-0",3,0,"1",1,3,3,"H"
"10500",1972-10-04,1972,"Olympique Lyon","Angers SCO","2-1",2,1,"1",1,3,1,"H"
"10501",1972-10-04,1972,"Nimes Olympique","Girondins Bordeaux","2-0",2,0,"1",1,2,2,"H"
"10502",1972-10-04,1972,"Olympique Marseille","FC Sochaux","1-1",1,1,"1",1,2,0,"D"
"10503",1972-10-04,1972,"FC Nantes","AS Saint-Etienne","1-0",1,0,"1",1,1,1,"H"
"10504",1972-10-04,1972,"Stade Rennes","US Valenciennes-Anzin","2-0",2,0,"1",1,2,2,"H"
"10505",1972-10-04,1972,"AS Nancy","FC Metz","0-2",0,2,"1",1,2,-2,"D"
"10506",1972-10-04,1972,"SC Bastia","AC Ajaccio","1-0",1,0,"1",1,1,1,"H"
"10507",1972-10-04,1972,"Paris FC","Red Star FC","3-0",3,0,"1",1,3,3,"H"
"10508",1972-10-04,1972,"CS Sedan","Stade Reims","2-0",2,0,"1",1,2,2,"H"
"10509",1972-10-07,1972,"OGC Nice","FC Nantes","3-0",3,0,"1",1,3,3,"H"
"10510",1972-10-07,1972,"Angers SCO","Stade Rennes","0-2",0,2,"1",1,2,-2,"D"
"10511",1972-10-07,1972,"RC Strasbourg","Nimes Olympique","2-1",2,1,"1",1,3,1,"H"
"10512",1972-10-07,1972,"AS Saint-Etienne","Olympique Lyon","1-1",1,1,"1",1,2,0,"D"
"10513",1972-10-07,1972,"Stade Reims","Olympique Marseille","2-1",2,1,"1",1,3,1,"H"
"10514",1972-10-07,1972,"FC Metz","SC Bastia","3-2",3,2,"1",1,5,1,"H"
"10515",1972-10-07,1972,"Red Star FC","AS Nancy","0-1",0,1,"1",1,1,-1,"D"
"10516",1972-10-07,1972,"FC Sochaux","US Valenciennes-Anzin","3-0",3,0,"1",1,3,3,"H"
"10517",1972-10-07,1972,"AC Ajaccio","Paris FC","2-1",2,1,"1",1,3,1,"H"
"10518",1972-10-07,1972,"Girondins Bordeaux","CS Sedan","6-1",6,1,"1",1,7,5,"H"
"10519",1972-10-17,1972,"Nimes Olympique","OGC Nice","0-1",0,1,"1",1,1,-1,"D"
"10520",1972-10-17,1972,"Olympique Marseille","FC Metz","5-0",5,0,"1",1,5,5,"H"
"10521",1972-10-17,1972,"FC Nantes","Angers SCO","2-0",2,0,"1",1,2,2,"H"
"10522",1972-10-17,1972,"Stade Rennes","AS Saint-Etienne","2-2",2,2,"1",1,4,0,"D"
"10523",1972-10-17,1972,"Olympique Lyon","Girondins Bordeaux","0-1",0,1,"1",1,1,-1,"D"
"10524",1972-10-17,1972,"Paris FC","FC Sochaux","0-2",0,2,"1",1,2,-2,"D"
"10525",1972-10-17,1972,"AS Nancy","AC Ajaccio","2-1",2,1,"1",1,3,1,"H"
"10526",1972-10-17,1972,"SC Bastia","Red Star FC","3-0",3,0,"1",1,3,3,"H"
"10527",1972-10-17,1972,"CS Sedan","RC Strasbourg","0-0",0,0,"1",1,0,0,"D"
"10528",1972-10-17,1972,"US Valenciennes-Anzin","Stade Reims","1-2",1,2,"1",1,3,-1,"D"
"10529",1972-10-20,1972,"RC Strasbourg","Olympique Lyon","0-2",0,2,"1",1,2,-2,"D"
"10530",1972-10-20,1972,"Angers SCO","AS Nancy","0-0",0,0,"1",1,0,0,"D"
"10531",1972-10-20,1972,"Girondins Bordeaux","SC Bastia","1-1",1,1,"1",1,2,0,"D"
"10532",1972-10-20,1972,"Stade Reims","FC Sochaux","1-0",1,0,"1",1,1,1,"H"
"10533",1972-10-20,1972,"Nimes Olympique","CS Sedan","2-1",2,1,"1",1,3,1,"H"
"10534",1972-10-21,1972,"FC Metz","FC Nantes","0-2",0,2,"1",1,2,-2,"D"
"10535",1972-10-22,1972,"OGC Nice","Paris FC","3-2",3,2,"1",1,5,1,"H"
"10536",1972-10-22,1972,"AS Saint-Etienne","US Valenciennes-Anzin","3-2",3,2,"1",1,5,1,"H"
"10537",1972-10-22,1972,"AC Ajaccio","Olympique Marseille","1-0",1,0,"1",1,1,1,"H"
"10538",1972-10-22,1972,"Red Star FC","Stade Rennes","2-0",2,0,"1",1,2,2,"H"
"10539",1972-10-27,1972,"Olympique Lyon","Nimes Olympique","1-0",1,0,"1",1,1,1,"H"
"10540",1972-10-27,1972,"AS Nancy","Girondins Bordeaux","2-1",2,1,"1",1,3,1,"H"
"10541",1972-10-27,1972,"Paris FC","RC Strasbourg","1-1",1,1,"1",1,2,0,"D"
"10542",1972-10-28,1972,"CS Sedan","OGC Nice","0-5",0,5,"1",1,5,-5,"D"
"10543",1972-10-28,1972,"FC Nantes","Stade Reims","0-0",0,0,"1",1,0,0,"D"
"10544",1972-10-28,1972,"Olympique Marseille","Red Star FC","3-0",3,0,"1",1,3,3,"H"
"10545",1972-10-28,1972,"FC Sochaux","AS Saint-Etienne","2-1",2,1,"1",1,3,1,"H"
"10546",1972-10-28,1972,"SC Bastia","Angers SCO","2-0",2,0,"1",1,2,2,"H"
"10547",1972-10-28,1972,"Stade Rennes","AC Ajaccio","1-1",1,1,"1",1,2,0,"D"
"10548",1972-10-28,1972,"US Valenciennes-Anzin","FC Metz","1-0",1,0,"1",1,1,1,"H"
"10549",1972-11-01,1972,"Angers SCO","Olympique Marseille","0-2",0,2,"1",1,2,-2,"D"
"10550",1972-11-01,1972,"Girondins Bordeaux","FC Nantes","2-1",2,1,"1",1,3,1,"H"
"10551",1972-11-01,1972,"CS Sedan","SC Bastia","2-1",2,1,"1",1,3,1,"H"
"10552",1972-11-01,1972,"AC Ajaccio","FC Sochaux","2-0",2,0,"1",1,2,2,"H"
"10553",1972-11-04,1972,"Nimes Olympique","Paris FC","2-0",2,0,"1",1,2,2,"H"
"10554",1972-11-04,1972,"RC Strasbourg","AS Nancy","1-1",1,1,"1",1,2,0,"D"
"10555",1972-11-05,1972,"OGC Nice","Olympique Lyon","2-2",2,2,"1",1,4,0,"D"
"10556",1972-11-05,1972,"AS Saint-Etienne","Stade Reims","2-1",2,1,"1",1,3,1,"H"
"10557",1972-11-05,1972,"FC Metz","Stade Rennes","2-1",2,1,"1",1,3,1,"H"
"10558",1972-11-05,1972,"Red Star FC","US Valenciennes-Anzin","1-0",1,0,"1",1,1,1,"H"
"10559",1972-11-18,1972,"FC Nantes","RC Strasbourg","6-2",6,2,"1",1,8,4,"H"
"10560",1972-11-19,1972,"AS Nancy","OGC Nice","3-0",3,0,"1",1,3,3,"H"
"10561",1972-11-19,1972,"Olympique Marseille","AS Saint-Etienne","3-1",3,1,"1",1,4,2,"H"
"10562",1972-11-19,1972,"Olympique Lyon","CS Sedan","1-2",1,2,"1",1,3,-1,"D"
"10563",1972-11-19,1972,"SC Bastia","Nimes Olympique","3-0",3,0,"1",1,3,3,"H"
"10564",1972-11-19,1972,"Stade Rennes","Girondins Bordeaux","3-0",3,0,"1",1,3,3,"H"
"10565",1972-11-19,1972,"Paris FC","Angers SCO","1-2",1,2,"1",1,3,-1,"D"
"10566",1972-11-19,1972,"FC Sochaux","Red Star FC","1-0",1,0,"1",1,1,1,"H"
"10567",1972-11-19,1972,"Stade Reims","FC Metz","0-0",0,0,"1",1,0,0,"D"
"10568",1972-11-19,1972,"US Valenciennes-Anzin","AC Ajaccio","3-2",3,2,"1",1,5,1,"H"
"10569",1972-11-25,1972,"Olympique Lyon","FC Nantes","2-4",2,4,"1",1,6,-2,"D"
"10570",1972-11-26,1972,"OGC Nice","SC Bastia","1-0",1,0,"1",1,1,1,"H"
"10571",1972-11-26,1972,"Girondins Bordeaux","Olympique Marseille","2-1",2,1,"1",1,3,1,"H"
"10572",1972-11-26,1972,"Nimes Olympique","AS Nancy","2-1",2,1,"1",1,3,1,"H"
"10573",1972-11-26,1972,"Angers SCO","US Valenciennes-Anzin","5-1",5,1,"1",1,6,4,"H"
"10574",1972-11-26,1972,"AC Ajaccio","AS Saint-Etienne","2-0",2,0,"1",1,2,2,"H"
"10575",1972-11-26,1972,"FC Metz","FC Sochaux","2-1",2,1,"1",1,3,1,"H"
"10576",1972-11-26,1972,"RC Strasbourg","Stade Rennes","2-1",2,1,"1",1,3,1,"H"
"10577",1972-11-26,1972,"Red Star FC","Stade Reims","1-2",1,2,"1",1,3,-1,"D"
"10578",1972-11-26,1972,"CS Sedan","Paris FC","3-1",3,1,"1",1,4,2,"H"
"10579",1972-12-09,1972,"FC Metz","AS Saint-Etienne","1-2",1,2,"1",1,3,-1,"D"
"10580",1972-12-10,1972,"OGC Nice","Olympique Marseille","1-1",1,1,"1",1,2,0,"D"
"10581",1972-12-10,1972,"CS Sedan","FC Nantes","0-3",0,3,"1",1,3,-3,"D"
"10582",1972-12-10,1972,"Angers SCO","Stade Reims","1-1",1,1,"1",1,2,0,"D"
"10583",1972-12-10,1972,"Olympique Lyon","AS Nancy","2-2",2,2,"1",1,4,0,"D"
"10584",1972-12-10,1972,"Nimes Olympique","Stade Rennes","1-1",1,1,"1",1,2,0,"D"
"10585",1972-12-10,1972,"SC Bastia","Paris FC","1-0",1,0,"1",1,1,1,"H"
"10586",1972-12-10,1972,"Girondins Bordeaux","FC Sochaux","1-1",1,1,"1",1,2,0,"D"
"10587",1972-12-10,1972,"RC Strasbourg","US Valenciennes-Anzin","1-1",1,1,"1",1,2,0,"D"
"10588",1972-12-10,1972,"Red Star FC","AC Ajaccio","3-0",3,0,"1",1,3,3,"H"
"10589",1972-12-16,1972,"Stade Rennes","CS Sedan","1-1",1,1,"1",1,2,0,"D"
"10590",1972-12-17,1972,"US Valenciennes-Anzin","OGC Nice","1-1",1,1,"1",1,2,0,"D"
"10591",1972-12-17,1972,"FC Nantes","Red Star FC","3-1",3,1,"1",1,4,2,"H"
"10592",1972-12-17,1972,"Olympique Marseille","Nimes Olympique","1-2",1,2,"1",1,3,-1,"D"
"10593",1972-12-17,1972,"AS Saint-Etienne","Angers SCO","5-0",5,0,"1",1,5,5,"H"
"10594",1972-12-17,1972,"AS Nancy","SC Bastia","3-2",3,2,"1",1,5,1,"H"
"10595",1972-12-17,1972,"Paris FC","Olympique Lyon","5-1",5,1,"1",1,6,4,"H"
"10596",1972-12-17,1972,"AC Ajaccio","FC Metz","0-0",0,0,"1",1,0,0,"D"
"10597",1972-12-17,1972,"FC Sochaux","RC Strasbourg","1-1",1,1,"1",1,2,0,"D"
"10598",1972-12-17,1972,"Stade Reims","Girondins Bordeaux","3-1",3,1,"1",1,4,2,"H"
"10599",1973-01-07,1972,"OGC Nice","Stade Reims","2-2",2,2,"1",1,4,0,"D"
"10600",1973-01-07,1972,"Paris FC","FC Nantes","1-2",1,2,"1",1,3,-1,"D"
"10601",1973-01-07,1972,"Olympique Lyon","Olympique Marseille","4-4",4,4,"1",1,8,0,"D"
"10602",1973-01-07,1972,"Nimes Olympique","AS Saint-Etienne","4-0",4,0,"1",1,4,4,"H"
"10603",1973-01-07,1972,"AS Nancy","US Valenciennes-Anzin","1-1",1,1,"1",1,2,0,"D"
"10604",1973-01-07,1972,"Angers SCO","Red Star FC","1-0",1,0,"1",1,1,1,"H"
"10605",1973-01-07,1972,"SC Bastia","Stade Rennes","4-0",4,0,"1",1,4,4,"H"
"10606",1973-01-07,1972,"CS Sedan","FC Sochaux","1-1",1,1,"1",1,2,0,"D"
"10607",1973-01-07,1972,"Girondins Bordeaux","FC Metz","2-0",2,0,"1",1,2,2,"H"
"10608",1973-01-07,1972,"RC Strasbourg","AC Ajaccio","6-0",6,0,"1",1,6,6,"H"
"10609",1973-01-14,1972,"AC Ajaccio","OGC Nice","0-3",0,3,"1",1,3,-3,"D"
"10610",1973-01-14,1972,"FC Nantes","AS Nancy","2-1",2,1,"1",1,3,1,"H"
"10611",1973-01-14,1972,"Olympique Marseille","SC Bastia","1-0",1,0,"1",1,1,1,"H"
"10612",1973-01-14,1972,"FC Sochaux","Nimes Olympique","0-0",0,0,"1",1,0,0,"D"
"10613",1973-01-14,1972,"AS Saint-Etienne","RC Strasbourg","5-1",5,1,"1",1,6,4,"H"
"10614",1973-01-14,1972,"FC Metz","Angers SCO","2-0",2,0,"1",1,2,2,"H"
"10615",1973-01-14,1972,"Stade Reims","Olympique Lyon","2-1",2,1,"1",1,3,1,"H"
"10616",1973-01-14,1972,"US Valenciennes-Anzin","CS Sedan","5-1",5,1,"1",1,6,4,"H"
"10617",1973-01-14,1972,"Red Star FC","Girondins Bordeaux","3-1",3,1,"1",1,4,2,"H"
"10618",1973-01-17,1972,"Paris FC","Stade Rennes","2-2",2,2,"1",1,4,0,"D"
"10619",1973-01-21,1972,"OGC Nice","Red Star FC","1-1",1,1,"1",1,2,0,"D"
"10620",1973-01-21,1972,"FC Nantes","Olympique Marseille","1-2",1,2,"1",1,3,-1,"D"
"10621",1973-01-21,1972,"Nimes Olympique","Stade Reims","2-1",2,1,"1",1,3,1,"H"
"10622",1973-01-21,1972,"Paris FC","AS Saint-Etienne","1-1",1,1,"1",1,2,0,"D"
"10623",1973-01-21,1972,"RC Strasbourg","FC Metz","0-1",0,1,"1",1,1,-1,"D"
"10624",1973-01-21,1972,"SC Bastia","US Valenciennes-Anzin","2-0",2,0,"1",1,2,2,"H"
"10625",1973-01-21,1972,"CS Sedan","Angers SCO","2-2",2,2,"1",1,4,0,"D"
"10626",1973-01-21,1972,"Olympique Lyon","FC Sochaux","2-0",2,0,"1",1,2,2,"H"
"10627",1973-01-21,1972,"Girondins Bordeaux","AC Ajaccio","3-0",3,0,"1",1,3,3,"H"
"10628",1973-02-04,1972,"FC Metz","OGC Nice","1-0",1,0,"1",1,1,1,"H"
"10629",1973-02-04,1972,"Stade Rennes","FC Nantes","0-0",0,0,"1",1,0,0,"D"
"10630",1973-02-04,1972,"Olympique Marseille","Paris FC","0-0",0,0,"1",1,0,0,"D"
"10631",1973-02-04,1972,"AC Ajaccio","Nimes Olympique","1-1",1,1,"1",1,2,0,"D"
"10632",1973-02-04,1972,"AS Saint-Etienne","CS Sedan","2-0",2,0,"1",1,2,2,"H"
"10633",1973-02-04,1972,"Stade Reims","AS Nancy","2-3",2,3,"1",1,5,-1,"D"
"10634",1973-02-04,1972,"Angers SCO","Girondins Bordeaux","3-1",3,1,"1",1,4,2,"H"
"10635",1973-02-04,1972,"US Valenciennes-Anzin","Olympique Lyon","1-2",1,2,"1",1,3,-1,"D"
"10636",1973-02-04,1972,"FC Sochaux","SC Bastia","3-2",3,2,"1",1,5,1,"H"
"10637",1973-02-04,1972,"Red Star FC","RC Strasbourg","0-0",0,0,"1",1,0,0,"D"
"10638",1973-02-11,1972,"FC Nantes","US Valenciennes-Anzin","1-0",1,0,"1",1,1,1,"H"
"10639",1973-02-11,1972,"OGC Nice","AS Saint-Etienne","1-1",1,1,"1",1,2,0,"D"
"10640",1973-02-11,1972,"Stade Rennes","Olympique Marseille","2-3",2,3,"1",1,5,-1,"D"
"10641",1973-02-11,1972,"Nimes Olympique","Red Star FC","1-1",1,1,"1",1,2,0,"D"
"10642",1973-02-11,1972,"AS Nancy","FC Sochaux","4-2",4,2,"1",1,6,2,"H"
"10643",1973-02-11,1972,"Olympique Lyon","FC Metz","3-0",3,0,"1",1,3,3,"H"
"10644",1973-02-11,1972,"RC Strasbourg","Angers SCO","0-0",0,0,"1",1,0,0,"D"
"10645",1973-02-11,1972,"SC Bastia","Stade Reims","1-1",1,1,"1",1,2,0,"D"
"10646",1973-02-11,1972,"Paris FC","Girondins Bordeaux","4-3",4,3,"1",1,7,1,"H"
"10647",1973-02-11,1972,"CS Sedan","AC Ajaccio","5-0",5,0,"1",1,5,5,"H"
"10648",1973-02-25,1972,"FC Sochaux","FC Nantes","0-1",0,1,"1",1,1,-1,"D"
"10649",1973-02-25,1972,"Angers SCO","OGC Nice","0-0",0,0,"1",1,0,0,"D"
"10650",1973-02-25,1972,"Olympique Marseille","AS Nancy","0-0",0,0,"1",1,0,0,"D"
"10651",1973-02-25,1972,"FC Metz","Nimes Olympique","0-1",0,1,"1",1,1,-1,"D"
"10652",1973-02-25,1972,"AS Saint-Etienne","SC Bastia","2-1",2,1,"1",1,3,1,"H"
"10653",1973-02-25,1972,"AC Ajaccio","Olympique Lyon","4-3",4,3,"1",1,7,1,"H"
"10654",1973-02-25,1972,"Stade Reims","Stade Rennes","1-1",1,1,"1",1,2,0,"D"
"10655",1973-02-25,1972,"Girondins Bordeaux","RC Strasbourg","2-1",2,1,"1",1,3,1,"H"
"10656",1973-02-25,1972,"US Valenciennes-Anzin","Paris FC","1-1",1,1,"1",1,2,0,"D"
"10657",1973-02-25,1972,"Red Star FC","CS Sedan","1-1",1,1,"1",1,2,0,"D"
"10658",1973-03-09,1972,"Stade Rennes","OGC Nice","1-0",1,0,"1",1,1,1,"H"
"10659",1973-03-09,1972,"AS Nancy","CS Sedan","1-1",1,1,"1",1,2,0,"D"
"10660",1973-03-17,1972,"FC Nantes","AC Ajaccio","6-1",6,1,"1",1,7,5,"H"
"10661",1973-03-17,1972,"Stade Rennes","FC Sochaux","0-0",0,0,"1",1,0,0,"D"
"10662",1973-03-17,1972,"CS Sedan","FC Metz","1-1",1,1,"1",1,2,0,"D"
"10663",1973-03-18,1972,"OGC Nice","Girondins Bordeaux","0-1",0,1,"1",1,1,-1,"D"
"10664",1973-03-18,1972,"Olympique Marseille","US Valenciennes-Anzin","1-0",1,0,"1",1,1,1,"H"
"10665",1973-03-18,1972,"Nimes Olympique","Angers SCO","2-2",2,2,"1",1,4,0,"D"
"10666",1973-03-18,1972,"AS Nancy","AS Saint-Etienne","4-0",4,0,"1",1,4,4,"H"
"10667",1973-03-18,1972,"Olympique Lyon","Red Star FC","1-2",1,2,"1",1,3,-1,"D"
"10668",1973-03-18,1972,"SC Bastia","RC Strasbourg","3-0",3,0,"1",1,3,3,"H"
"10669",1973-03-18,1972,"Paris FC","Stade Reims","0-0",0,0,"1",1,0,0,"D"
"10670",1973-03-23,1972,"AS Saint-Etienne","FC Nantes","1-2",1,2,"1",1,3,-1,"D"
"10671",1973-03-23,1972,"RC Strasbourg","OGC Nice","0-1",0,1,"1",1,1,-1,"D"
"10672",1973-03-23,1972,"Girondins Bordeaux","Nimes Olympique","0-1",0,1,"1",1,1,-1,"D"
"10673",1973-03-23,1972,"Red Star FC","Paris FC","2-3",2,3,"1",1,5,-1,"D"
"10674",1973-03-24,1972,"FC Sochaux","Olympique Marseille","1-2",1,2,"1",1,3,-1,"D"
"10675",1973-03-24,1972,"FC Metz","AS Nancy","1-0",1,0,"1",1,1,1,"H"
"10676",1973-03-24,1972,"Angers SCO","Olympique Lyon","1-0",1,0,"1",1,1,1,"H"
"10677",1973-03-24,1972,"Stade Reims","CS Sedan","5-1",5,1,"1",1,6,4,"H"
"10678",1973-03-24,1972,"US Valenciennes-Anzin","Stade Rennes","2-0",2,0,"1",1,2,2,"H"
"10679",1973-03-25,1972,"AC Ajaccio","SC Bastia","0-1",0,1,"1",1,1,-1,"D"
"10680",1973-03-27,1972,"Nimes Olympique","RC Strasbourg","3-0",3,0,"1",1,3,3,"H"
"10681",1973-03-28,1972,"FC Nantes","OGC Nice","2-2",2,2,"1",1,4,0,"D"
"10682",1973-03-28,1972,"Olympique Marseille","Stade Reims","3-1",3,1,"1",1,4,2,"H"
"10683",1973-03-28,1972,"AS Nancy","Red Star FC","2-1",2,1,"1",1,3,1,"H"
"10684",1973-03-28,1972,"Stade Rennes","Angers SCO","1-2",1,2,"1",1,3,-1,"D"
"10685",1973-03-28,1972,"SC Bastia","FC Metz","4-0",4,0,"1",1,4,4,"H"
"10686",1973-03-28,1972,"Olympique Lyon","AS Saint-Etienne","2-0",2,0,"1",1,2,2,"H"
"10687",1973-03-28,1972,"US Valenciennes-Anzin","FC Sochaux","0-0",0,0,"1",1,0,0,"D"
"10688",1973-03-28,1972,"CS Sedan","Girondins Bordeaux","1-0",1,0,"1",1,1,1,"H"
"10689",1973-03-28,1972,"Paris FC","AC Ajaccio","3-1",3,1,"1",1,4,2,"H"
"10690",1973-03-31,1972,"Angers SCO","FC Nantes","1-0",1,0,"1",1,1,1,"H"
"10691",1973-03-31,1972,"OGC Nice","Nimes Olympique","2-0",2,0,"1",1,2,2,"H"
"10692",1973-03-31,1972,"FC Metz","Olympique Marseille","2-0",2,0,"1",1,2,2,"H"
"10693",1973-03-31,1972,"AS Saint-Etienne","Stade Rennes","2-0",2,0,"1",1,2,2,"H"
"10694",1973-03-31,1972,"Red Star FC","SC Bastia","2-2",2,2,"1",1,4,0,"D"
"10695",1973-03-31,1972,"Girondins Bordeaux","Olympique Lyon","1-0",1,0,"1",1,1,1,"H"
"10696",1973-03-31,1972,"Stade Reims","US Valenciennes-Anzin","1-0",1,0,"1",1,1,1,"H"
"10697",1973-03-31,1972,"FC Sochaux","Paris FC","1-1",1,1,"1",1,2,0,"D"
"10698",1973-03-31,1972,"RC Strasbourg","CS Sedan","2-1",2,1,"1",1,3,1,"H"
"10699",1973-04-01,1972,"AC Ajaccio","AS Nancy","2-2",2,2,"1",1,4,0,"D"
"10700",1973-04-04,1972,"FC Nantes","Nimes Olympique","2-1",2,1,"1",1,3,1,"H"
"10701",1973-04-04,1972,"Olympique Marseille","RC Strasbourg","3-1",3,1,"1",1,4,2,"H"
"10702",1973-04-04,1972,"SC Bastia","Olympique Lyon","1-1",1,1,"1",1,2,0,"D"
"10703",1973-04-04,1972,"Paris FC","FC Metz","1-3",1,3,"1",1,4,-2,"D"
"10704",1973-04-04,1972,"AS Saint-Etienne","Red Star FC","1-1",1,1,"1",1,2,0,"D"
"10705",1973-04-06,1972,"AS Nancy","Angers SCO","0-0",0,0,"1",1,0,0,"D"
"10706",1973-04-07,1972,"FC Nantes","FC Metz","0-0",0,0,"1",1,0,0,"D"
"10707",1973-04-07,1972,"Olympique Marseille","AC Ajaccio","3-0",3,0,"1",1,3,3,"H"
"10708",1973-04-07,1972,"Paris FC","OGC Nice","2-0",2,0,"1",1,2,2,"H"
"10709",1973-04-07,1972,"CS Sedan","Nimes Olympique","2-1",2,1,"1",1,3,1,"H"
"10710",1973-04-07,1972,"US Valenciennes-Anzin","AS Saint-Etienne","0-1",0,1,"1",1,1,-1,"D"
"10711",1973-04-07,1972,"Olympique Lyon","RC Strasbourg","4-0",4,0,"1",1,4,4,"H"
"10712",1973-04-07,1972,"SC Bastia","Girondins Bordeaux","1-1",1,1,"1",1,2,0,"D"
"10713",1973-04-07,1972,"FC Sochaux","Stade Reims","2-1",2,1,"1",1,3,1,"H"
"10714",1973-04-07,1972,"Stade Rennes","Red Star FC","1-1",1,1,"1",1,2,0,"D"
"10715",1973-04-10,1972,"FC Metz","US Valenciennes-Anzin","1-1",1,1,"1",1,2,0,"D"
"10716",1973-04-11,1972,"Red Star FC","Olympique Marseille","1-2",1,2,"1",1,3,-1,"D"
"10717",1973-04-11,1972,"Stade Reims","FC Nantes","2-1",2,1,"1",1,3,1,"H"
"10718",1973-04-11,1972,"Nimes Olympique","Olympique Lyon","3-1",3,1,"1",1,4,2,"H"
"10719",1973-04-11,1972,"Angers SCO","SC Bastia","3-0",3,0,"1",1,3,3,"H"
"10720",1973-04-11,1972,"Girondins Bordeaux","AS Nancy","3-1",3,1,"1",1,4,2,"H"
"10721",1973-04-11,1972,"AC Ajaccio","Stade Rennes","2-3",2,3,"1",1,5,-1,"D"
"10722",1973-04-11,1972,"RC Strasbourg","Paris FC","2-0",2,0,"1",1,2,2,"H"
"10723",1973-04-13,1972,"OGC Nice","CS Sedan","4-2",4,2,"1",1,6,2,"H"
"10724",1973-04-14,1972,"Stade Reims","AC Ajaccio","0-0",0,0,"1",1,0,0,"D"
"10725",1973-04-14,1972,"US Valenciennes-Anzin","Girondins Bordeaux","3-0",3,0,"1",1,3,3,"H"
"10726",1973-04-14,1972,"FC Sochaux","Angers SCO","1-1",1,1,"1",1,2,0,"D"
"10727",1973-04-14,1972,"AS Nancy","Stade Rennes","4-0",4,0,"1",1,4,4,"H"
"10728",1973-04-20,1972,"Olympique Lyon","OGC Nice","1-2",1,2,"1",1,3,-1,"D"
"10729",1973-04-20,1972,"AS Nancy","RC Strasbourg","2-1",2,1,"1",1,3,1,"H"
"10730",1973-04-20,1972,"Stade Rennes","FC Metz","1-0",1,0,"1",1,1,1,"H"
"10731",1973-04-20,1972,"FC Sochaux","AC Ajaccio","4-0",4,0,"1",1,4,4,"H"
"10732",1973-04-21,1972,"Olympique Marseille","Angers SCO","3-2",3,2,"1",1,5,1,"H"
"10733",1973-04-21,1972,"FC Nantes","Girondins Bordeaux","3-0",3,0,"1",1,3,3,"H"
"10734",1973-04-21,1972,"Paris FC","Nimes Olympique","3-1",3,1,"1",1,4,2,"H"
"10735",1973-04-21,1972,"SC Bastia","CS Sedan","3-0",3,0,"1",1,3,3,"H"
"10736",1973-04-21,1972,"US Valenciennes-Anzin","Red Star FC","0-0",0,0,"1",1,0,0,"D"
"10737",1973-04-24,1972,"Stade Reims","AS Saint-Etienne","0-0",0,0,"1",1,0,0,"D"
"10738",1973-04-27,1972,"RC Strasbourg","FC Nantes","0-3",0,3,"1",1,3,-3,"D"
"10739",1973-04-27,1972,"OGC Nice","AS Nancy","1-0",1,0,"1",1,1,1,"H"
"10740",1973-04-27,1972,"Nimes Olympique","SC Bastia","2-1",2,1,"1",1,3,1,"H"
"10741",1973-04-27,1972,"Girondins Bordeaux","Stade Rennes","1-1",1,1,"1",1,2,0,"D"
"10742",1973-04-28,1972,"AS Saint-Etienne","Olympique Marseille","2-1",2,1,"1",1,3,1,"H"
"10743",1973-04-28,1972,"Angers SCO","Paris FC","1-1",1,1,"1",1,2,0,"D"
"10744",1973-04-28,1972,"FC Metz","Stade Reims","1-2",1,2,"1",1,3,-1,"D"
"10745",1973-04-28,1972,"Red Star FC","FC Sochaux","3-3",3,3,"1",1,6,0,"D"
"10746",1973-04-28,1972,"AC Ajaccio","US Valenciennes-Anzin","3-1",3,1,"1",1,4,2,"H"
"10747",1973-04-28,1972,"CS Sedan","Olympique Lyon","4-1",4,1,"1",1,5,3,"H"
"10748",1973-05-01,1972,"FC Nantes","Olympique Lyon","3-0",3,0,"1",1,3,3,"H"
"10749",1973-05-02,1972,"Olympique Marseille","Girondins Bordeaux","1-1",1,1,"1",1,2,0,"D"
"10750",1973-05-02,1972,"SC Bastia","OGC Nice","3-0",3,0,"1",1,3,3,"H"
"10751",1973-05-02,1972,"AS Nancy","Nimes Olympique","2-1",2,1,"1",1,3,1,"H"
"10752",1973-05-02,1972,"AS Saint-Etienne","AC Ajaccio","3-1",3,1,"1",1,4,2,"H"
"10753",1973-05-02,1972,"US Valenciennes-Anzin","Angers SCO","3-0",3,0,"1",1,3,3,"H"
"10754",1973-05-02,1972,"Stade Reims","Red Star FC","3-0",3,0,"1",1,3,3,"H"
"10755",1973-05-02,1972,"FC Sochaux","FC Metz","4-1",4,1,"1",1,5,3,"H"
"10756",1973-05-02,1972,"Stade Rennes","RC Strasbourg","1-0",1,0,"1",1,1,1,"H"
"10757",1973-05-02,1972,"Paris FC","CS Sedan","2-1",2,1,"1",1,3,1,"H"
"10758",1973-05-05,1972,"Nimes Olympique","FC Nantes","1-1",1,1,"1",1,2,0,"D"
"10759",1973-05-05,1972,"OGC Nice","Stade Rennes","2-0",2,0,"1",1,2,2,"H"
"10760",1973-05-05,1972,"RC Strasbourg","Olympique Marseille","1-1",1,1,"1",1,2,0,"D"
"10761",1973-05-05,1972,"Red Star FC","AS Saint-Etienne","0-3",0,3,"1",1,3,-3,"D"
"10762",1973-05-05,1972,"CS Sedan","AS Nancy","1-0",1,0,"1",1,1,1,"H"
"10763",1973-05-05,1972,"Angers SCO","FC Sochaux","1-0",1,0,"1",1,1,1,"H"
"10764",1973-05-05,1972,"AC Ajaccio","Stade Reims","2-3",2,3,"1",1,5,-1,"D"
"10765",1973-05-05,1972,"Olympique Lyon","SC Bastia","2-0",2,0,"1",1,2,2,"H"
"10766",1973-05-05,1972,"FC Metz","Paris FC","0-1",0,1,"1",1,1,-1,"D"
"10767",1973-05-05,1972,"Girondins Bordeaux","US Valenciennes-Anzin","2-0",2,0,"1",1,2,2,"H"
"10768",1973-05-08,1972,"AS Saint-Etienne","FC Sochaux","2-2",2,2,"1",1,4,0,"D"
"10769",1973-05-11,1972,"AS Saint-Etienne","FC Metz","1-0",1,0,"1",1,1,1,"H"
"10770",1973-05-11,1972,"AS Nancy","Olympique Lyon","4-1",4,1,"1",1,5,3,"H"
"10771",1973-05-11,1972,"Paris FC","SC Bastia","2-0",2,0,"1",1,2,2,"H"
"10772",1973-05-12,1972,"FC Nantes","CS Sedan","1-0",1,0,"1",1,1,1,"H"
"10773",1973-05-12,1972,"Olympique Marseille","OGC Nice","1-1",1,1,"1",1,2,0,"D"
"10774",1973-05-12,1972,"Stade Rennes","Nimes Olympique","1-0",1,0,"1",1,1,1,"H"
"10775",1973-05-12,1972,"Stade Reims","Angers SCO","3-2",3,2,"1",1,5,1,"H"
"10776",1973-05-12,1972,"FC Sochaux","Girondins Bordeaux","0-0",0,0,"1",1,0,0,"D"
"10777",1973-05-12,1972,"US Valenciennes-Anzin","RC Strasbourg","1-2",1,2,"1",1,3,-1,"D"
"10778",1973-05-12,1972,"AC Ajaccio","Red Star FC","2-2",2,2,"1",1,4,0,"D"
"10779",1973-05-29,1972,"Red Star FC","FC Nantes","1-3",1,3,"1",1,4,-2,"D"
"10780",1973-05-29,1972,"OGC Nice","US Valenciennes-Anzin","4-1",4,1,"1",1,5,3,"H"
"10781",1973-05-29,1972,"Nimes Olympique","Olympique Marseille","1-1",1,1,"1",1,2,0,"D"
"10782",1973-05-29,1972,"Angers SCO","AS Saint-Etienne","2-0",2,0,"1",1,2,2,"H"
"10783",1973-05-29,1972,"SC Bastia","AS Nancy","3-1",3,1,"1",1,4,2,"H"
"10784",1973-05-29,1972,"Girondins Bordeaux","Stade Reims","2-0",2,0,"1",1,2,2,"H"
"10785",1973-05-29,1972,"CS Sedan","Stade Rennes","2-3",2,3,"1",1,5,-1,"D"
"10786",1973-05-29,1972,"RC Strasbourg","FC Sochaux","4-2",4,2,"1",1,6,2,"H"
"10787",1973-05-29,1972,"Olympique Lyon","Paris FC","5-2",5,2,"1",1,7,3,"H"
"10788",1973-05-29,1972,"FC Metz","AC Ajaccio","7-0",7,0,"1",1,7,7,"H"
"10789",1973-06-02,1972,"FC Nantes","SC Bastia","1-0",1,0,"1",1,1,1,"H"
"10790",1973-06-02,1972,"FC Sochaux","OGC Nice","5-1",5,1,"1",1,6,4,"H"
"10791",1973-06-02,1972,"Olympique Marseille","CS Sedan","0-1",0,1,"1",1,1,-1,"D"
"10792",1973-06-02,1972,"AS Saint-Etienne","Girondins Bordeaux","6-2",6,2,"1",1,8,4,"H"
"10793",1973-06-02,1972,"AC Ajaccio","Angers SCO","1-1",1,1,"1",1,2,0,"D"
"10794",1973-06-02,1972,"AS Nancy","Paris FC","1-2",1,2,"1",1,3,-1,"D"
"10795",1973-06-02,1972,"US Valenciennes-Anzin","Nimes Olympique","1-0",1,0,"1",1,1,1,"H"
"10796",1973-06-02,1972,"Stade Reims","RC Strasbourg","1-0",1,0,"1",1,1,1,"H"
"10797",1973-06-02,1972,"Stade Rennes","Olympique Lyon","3-2",3,2,"1",1,5,1,"H"
"10798",1973-06-02,1972,"Red Star FC","FC Metz","1-0",1,0,"1",1,1,1,"H"
"10799",1973-08-07,1973,"Olympique Lyon","AS Nancy","4-0",4,0,"1",1,4,4,"H"
"10800",1973-08-07,1973,"FC Sochaux","Girondins Bordeaux","4-1",4,1,"1",1,5,3,"H"
"10801",1973-08-07,1973,"Olympique Marseille","AS Saint-Etienne","0-2",0,2,"1",1,2,-2,"D"
"10802",1973-08-07,1973,"Stade Rennes","OGC Nice","1-0",1,0,"1",1,1,1,"H"
"10803",1973-08-07,1973,"RC Lens","Nimes Olympique","0-1",0,1,"1",1,1,-1,"D"
"10804",1973-08-07,1973,"AS Monaco","Stade Reims","3-3",3,3,"1",1,6,0,"D"
"10805",1973-08-07,1973,"Troyes AF","CS Sedan","2-2",2,2,"1",1,4,0,"D"
"10806",1973-08-07,1973,"Angers SCO","Paris FC","1-1",1,1,"1",1,2,0,"D"
"10807",1973-08-07,1973,"FC Metz","FC Nantes","1-1",1,1,"1",1,2,0,"D"
"10808",1973-08-07,1973,"SC Bastia","RC Strasbourg","0-0",0,0,"1",1,0,0,"D"
"10809",1973-08-10,1973,"Troyes AF","Olympique Lyon","1-2",1,2,"1",1,3,-1,"D"
"10810",1973-08-10,1973,"AS Saint-Etienne","FC Metz","2-0",2,0,"1",1,2,2,"H"
"10811",1973-08-10,1973,"Stade Reims","Paris FC","4-0",4,0,"1",1,4,4,"H"
"10812",1973-08-10,1973,"Nimes Olympique","FC Sochaux","1-1",1,1,"1",1,2,0,"D"
"10813",1973-08-10,1973,"FC Nantes","AS Monaco","2-1",2,1,"1",1,3,1,"H"
"10814",1973-08-10,1973,"CS Sedan","Stade Rennes","1-1",1,1,"1",1,2,0,"D"
"10815",1973-08-10,1973,"OGC Nice","RC Lens","2-4",2,4,"1",1,6,-2,"D"
"10816",1973-08-10,1973,"RC Strasbourg","Angers SCO","2-2",2,2,"1",1,4,0,"D"
"10817",1973-08-10,1973,"AS Nancy","SC Bastia","2-0",2,0,"1",1,2,2,"H"
"10818",1973-08-10,1973,"Girondins Bordeaux","Olympique Marseille","0-0",0,0,"1",1,0,0,"D"
"10819",1973-08-14,1973,"Olympique Lyon","CS Sedan","2-0",2,0,"1",1,2,2,"H"
"10820",1973-08-14,1973,"AS Monaco","AS Saint-Etienne","2-3",2,3,"1",1,5,-1,"D"
"10821",1973-08-14,1973,"Paris FC","FC Nantes","2-5",2,5,"1",1,7,-3,"D"
"10822",1973-08-14,1973,"Stade Rennes","Troyes AF","2-1",2,1,"1",1,3,1,"H"
"10823",1973-08-14,1973,"Angers SCO","Stade Reims","3-1",3,1,"1",1,4,2,"H"
"10824",1973-08-14,1973,"RC Lens","AS Nancy","1-0",1,0,"1",1,1,1,"H"
"10825",1973-08-14,1973,"FC Metz","Nimes Olympique","1-1",1,1,"1",1,2,0,"D"
"10826",1973-08-14,1973,"Olympique Marseille","RC Strasbourg","6-1",6,1,"1",1,7,5,"H"
"10827",1973-08-14,1973,"FC Sochaux","OGC Nice","0-1",0,1,"1",1,1,-1,"D"
"10828",1973-08-14,1973,"SC Bastia","Girondins Bordeaux","2-0",2,0,"1",1,2,2,"H"
"10829",1973-08-17,1973,"AS Saint-Etienne","Paris FC","4-0",4,0,"1",1,4,4,"H"
"10830",1973-08-17,1973,"FC Nantes","Angers SCO","1-0",1,0,"1",1,1,1,"H"
"10831",1973-08-17,1973,"OGC Nice","Olympique Lyon","4-1",4,1,"1",1,5,3,"H"
"10832",1973-08-17,1973,"Nimes Olympique","Olympique Marseille","4-1",4,1,"1",1,5,3,"H"
"10833",1973-08-17,1973,"Stade Rennes","SC Bastia","1-2",1,2,"1",1,3,-1,"D"
"10834",1973-08-17,1973,"AS Nancy","Stade Reims","2-2",2,2,"1",1,4,0,"D"
"10835",1973-08-17,1973,"CS Sedan","FC Sochaux","1-1",1,1,"1",1,2,0,"D"
"10836",1973-08-17,1973,"Troyes AF","RC Lens","4-1",4,1,"1",1,5,3,"H"
"10837",1973-08-17,1973,"RC Strasbourg","AS Monaco","3-1",3,1,"1",1,4,2,"H"
"10838",1973-08-17,1973,"Girondins Bordeaux","FC Metz","3-1",3,1,"1",1,4,2,"H"
"10839",1973-08-24,1973,"Angers SCO","AS Saint-Etienne","4-0",4,0,"1",1,4,4,"H"
"10840",1973-08-24,1973,"Olympique Lyon","Stade Rennes","2-2",2,2,"1",1,4,0,"D"
"10841",1973-08-24,1973,"Stade Reims","FC Nantes","4-2",4,2,"1",1,6,2,"H"
"10842",1973-08-24,1973,"SC Bastia","OGC Nice","1-0",1,0,"1",1,1,1,"H"
"10843",1973-08-24,1973,"FC Sochaux","Troyes AF","2-0",2,0,"1",1,2,2,"H"
"10844",1973-08-24,1973,"Paris FC","Nimes Olympique","3-1",3,1,"1",1,4,2,"H"
"10845",1973-08-24,1973,"RC Lens","CS Sedan","4-2",4,2,"1",1,6,2,"H"
"10846",1973-08-24,1973,"Olympique Marseille","AS Nancy","2-2",2,2,"1",1,4,0,"D"
"10847",1973-08-24,1973,"FC Metz","RC Strasbourg","2-0",2,0,"1",1,2,2,"H"
"10848",1973-08-24,1973,"AS Monaco","Girondins Bordeaux","1-1",1,1,"1",1,2,0,"D"
"10849",1973-09-01,1973,"Olympique Lyon","Angers SCO","3-1",3,1,"1",1,4,2,"H"
"10850",1973-09-01,1973,"AS Saint-Etienne","FC Nantes","1-1",1,1,"1",1,2,0,"D"
"10851",1973-09-01,1973,"AS Nancy","FC Sochaux","0-1",0,1,"1",1,1,-1,"D"
"10852",1973-09-01,1973,"Nimes Olympique","AS Monaco","4-3",4,3,"1",1,7,1,"H"
"10853",1973-09-01,1973,"Stade Rennes","RC Lens","0-1",0,1,"1",1,1,-1,"D"
"10854",1973-09-01,1973,"CS Sedan","SC Bastia","1-0",1,0,"1",1,1,1,"H"
"10855",1973-09-01,1973,"OGC Nice","Olympique Marseille","3-0",3,0,"1",1,3,3,"H"
"10856",1973-09-01,1973,"Girondins Bordeaux","Paris FC","6-1",6,1,"1",1,7,5,"H"
"10857",1973-09-01,1973,"RC Strasbourg","Stade Reims","4-1",4,1,"1",1,5,3,"H"
"10858",1973-09-01,1973,"Troyes AF","FC Metz","2-0",2,0,"1",1,2,2,"H"
"10859",1973-09-12,1973,"Stade Reims","AS Saint-Etienne","0-1",0,1,"1",1,1,-1,"D"
"10860",1973-09-12,1973,"FC Sochaux","Stade Rennes","4-1",4,1,"1",1,5,3,"H"
"10861",1973-09-12,1973,"RC Lens","Olympique Lyon","1-1",1,1,"1",1,2,0,"D"
"10862",1973-09-12,1973,"FC Nantes","Nimes Olympique","0-2",0,2,"1",1,2,-2,"D"
"10863",1973-09-12,1973,"SC Bastia","Troyes AF","1-0",1,0,"1",1,1,1,"H"
"10864",1973-09-12,1973,"Angers SCO","Girondins Bordeaux","4-3",4,3,"1",1,7,1,"H"
"10865",1973-09-12,1973,"Olympique Marseille","CS Sedan","4-0",4,0,"1",1,4,4,"H"
"10866",1973-09-12,1973,"FC Metz","OGC Nice","2-0",2,0,"1",1,2,2,"H"
"10867",1973-09-12,1973,"Paris FC","RC Strasbourg","3-0",3,0,"1",1,3,3,"H"
"10868",1973-09-12,1973,"AS Monaco","AS Nancy","3-3",3,3,"1",1,6,0,"D"
"10869",1973-09-22,1973,"Olympique Lyon","FC Sochaux","2-1",2,1,"1",1,3,1,"H"
"10870",1973-09-22,1973,"Nimes Olympique","SC Bastia","3-1",3,1,"1",1,4,2,"H"
"10871",1973-09-22,1973,"RC Strasbourg","AS Saint-Etienne","1-1",1,1,"1",1,2,0,"D"
"10872",1973-09-22,1973,"RC Lens","AS Monaco","2-1",2,1,"1",1,3,1,"H"
"10873",1973-09-22,1973,"Stade Rennes","Angers SCO","1-2",1,2,"1",1,3,-1,"D"
"10874",1973-09-22,1973,"OGC Nice","Stade Reims","3-0",3,0,"1",1,3,3,"H"
"10875",1973-09-22,1973,"Girondins Bordeaux","FC Nantes","2-1",2,1,"1",1,3,1,"H"
"10876",1973-09-22,1973,"CS Sedan","FC Metz","1-2",1,2,"1",1,3,-1,"D"
"10877",1973-09-22,1973,"Troyes AF","Olympique Marseille","2-1",2,1,"1",1,3,1,"H"
"10878",1973-09-22,1973,"AS Nancy","Paris FC","1-1",1,1,"1",1,2,0,"D"
"10879",1973-09-25,1973,"Angers SCO","Nimes Olympique","1-2",1,2,"1",1,3,-1,"D"
"10880",1973-09-25,1973,"AS Saint-Etienne","Girondins Bordeaux","0-0",0,0,"1",1,0,0,"D"
"10881",1973-09-25,1973,"FC Sochaux","RC Lens","2-3",2,3,"1",1,5,-1,"D"
"10882",1973-09-25,1973,"SC Bastia","Olympique Lyon","5-1",5,1,"1",1,6,4,"H"
"10883",1973-09-25,1973,"FC Nantes","RC Strasbourg","3-0",3,0,"1",1,3,3,"H"
"10884",1973-09-25,1973,"FC Metz","AS Nancy","3-3",3,3,"1",1,6,0,"D"
"10885",1973-09-25,1973,"Paris FC","OGC Nice","3-2",3,2,"1",1,5,1,"H"
"10886",1973-09-25,1973,"Olympique Marseille","Stade Rennes","2-1",2,1,"1",1,3,1,"H"
"10887",1973-09-25,1973,"AS Monaco","Troyes AF","1-1",1,1,"1",1,2,0,"D"
"10888",1973-09-25,1973,"Stade Reims","CS Sedan","0-1",0,1,"1",1,1,-1,"D"
"10889",1973-10-06,1973,"Nimes Olympique","AS Saint-Etienne","1-2",1,2,"1",1,3,-1,"D"
"10890",1973-10-06,1973,"RC Lens","SC Bastia","3-1",3,1,"1",1,4,2,"H"
"10891",1973-10-06,1973,"Olympique Lyon","Olympique Marseille","2-2",2,2,"1",1,4,0,"D"
"10892",1973-10-06,1973,"OGC Nice","Angers SCO","4-0",4,0,"1",1,4,4,"H"
"10893",1973-10-06,1973,"FC Sochaux","Stade Reims","1-2",1,2,"1",1,3,-1,"D"
"10894",1973-10-06,1973,"Troyes AF","Paris FC","4-1",4,1,"1",1,5,3,"H"
"10895",1973-10-06,1973,"Girondins Bordeaux","RC Strasbourg","2-2",2,2,"1",1,4,0,"D"
"10896",1973-10-06,1973,"AS Nancy","FC Nantes","1-0",1,0,"1",1,1,1,"H"
"10897",1973-10-06,1973,"Stade Rennes","FC Metz","1-0",1,0,"1",1,1,1,"H"
"10898",1973-10-06,1973,"CS Sedan","AS Monaco","0-2",0,2,"1",1,2,-2,"D"
"10899",1973-10-17,1973,"AS Saint-Etienne","Stade Rennes","0-0",0,0,"1",1,0,0,"D"
"10900",1973-10-17,1973,"FC Metz","Olympique Lyon","0-2",0,2,"1",1,2,-2,"D"
"10901",1973-10-17,1973,"Olympique Marseille","RC Lens","5-2",5,2,"1",1,7,3,"H"
"10902",1973-10-17,1973,"RC Strasbourg","Nimes Olympique","2-0",2,0,"1",1,2,2,"H"
"10903",1973-10-17,1973,"SC Bastia","FC Sochaux","2-0",2,0,"1",1,2,2,"H"
"10904",1973-10-17,1973,"FC Nantes","Troyes AF","3-0",3,0,"1",1,3,3,"H"
"10905",1973-10-17,1973,"Angers SCO","AS Nancy","1-0",1,0,"1",1,1,1,"H"
"10906",1973-10-17,1973,"AS Monaco","OGC Nice","1-1",1,1,"1",1,2,0,"D"
"10907",1973-10-17,1973,"Stade Reims","Girondins Bordeaux","2-0",2,0,"1",1,2,2,"H"
"10908",1973-10-17,1973,"Paris FC","CS Sedan","3-1",3,1,"1",1,4,2,"H"
"10909",1973-10-27,1973,"RC Lens","FC Metz","2-1",2,1,"1",1,3,1,"H"
"10910",1973-10-27,1973,"OGC Nice","AS Saint-Etienne","4-1",4,1,"1",1,5,3,"H"
"10911",1973-10-27,1973,"SC Bastia","Olympique Marseille","4-0",4,0,"1",1,4,4,"H"
"10912",1973-10-27,1973,"Nimes Olympique","Girondins Bordeaux","0-0",0,0,"1",1,0,0,"D"
"10913",1973-10-27,1973,"Olympique Lyon","AS Monaco","0-1",0,1,"1",1,1,-1,"D"
"10914",1973-10-27,1973,"CS Sedan","FC Nantes","0-1",0,1,"1",1,1,-1,"D"
"10915",1973-10-27,1973,"FC Sochaux","Angers SCO","4-2",4,2,"1",1,6,2,"H"
"10916",1973-10-27,1973,"Troyes AF","Stade Reims","0-2",0,2,"1",1,2,-2,"D"
"10917",1973-10-27,1973,"AS Nancy","RC Strasbourg","3-1",3,1,"1",1,4,2,"H"
"10918",1973-10-27,1973,"Stade Rennes","Paris FC","1-0",1,0,"1",1,1,1,"H"
"10919",1973-10-30,1973,"AS Saint-Etienne","CS Sedan","4-1",4,1,"1",1,5,3,"H"
"10920",1973-10-30,1973,"Angers SCO","RC Lens","3-1",3,1,"1",1,4,2,"H"
"10921",1973-10-30,1973,"FC Nantes","OGC Nice","1-1",1,1,"1",1,2,0,"D"
"10922",1973-10-30,1973,"FC Metz","SC Bastia","3-0",3,0,"1",1,3,3,"H"
"10923",1973-10-30,1973,"Stade Reims","Nimes Olympique","1-0",1,0,"1",1,1,1,"H"
"10924",1973-10-30,1973,"Paris FC","Olympique Lyon","2-0",2,0,"1",1,2,2,"H"
"10925",1973-10-30,1973,"Olympique Marseille","FC Sochaux","1-1",1,1,"1",1,2,0,"D"
"10926",1973-10-30,1973,"Girondins Bordeaux","AS Nancy","1-1",1,1,"1",1,2,0,"D"
"10927",1973-10-30,1973,"RC Strasbourg","Troyes AF","2-0",2,0,"1",1,2,2,"H"
"10928",1973-10-30,1973,"AS Monaco","Stade Rennes","2-0",2,0,"1",1,2,2,"H"
"10929",1973-11-02,1973,"RC Lens","Paris FC","3-2",3,2,"1",1,5,1,"H"
"10930",1973-11-02,1973,"Troyes AF","AS Saint-Etienne","1-0",1,0,"1",1,1,1,"H"
"10931",1973-11-02,1973,"OGC Nice","Girondins Bordeaux","2-1",2,1,"1",1,3,1,"H"
"10932",1973-11-02,1973,"Stade Rennes","FC Nantes","0-0",0,0,"1",1,0,0,"D"
"10933",1973-11-02,1973,"SC Bastia","Angers SCO","0-0",0,0,"1",1,0,0,"D"
"10934",1973-11-02,1973,"AS Nancy","Nimes Olympique","1-1",1,1,"1",1,2,0,"D"
"10935",1973-11-02,1973,"Olympique Lyon","Stade Reims","4-4",4,4,"1",1,8,0,"D"
"10936",1973-11-02,1973,"FC Sochaux","FC Metz","1-0",1,0,"1",1,1,1,"H"
"10937",1973-11-02,1973,"Olympique Marseille","AS Monaco","0-2",0,2,"1",1,2,-2,"D"
"10938",1973-11-02,1973,"CS Sedan","RC Strasbourg","2-1",2,1,"1",1,3,1,"H"
"10939",1973-11-10,1973,"AS Saint-Etienne","AS Nancy","6-0",6,0,"1",1,6,6,"H"
"10940",1973-11-10,1973,"Stade Reims","RC Lens","3-1",3,1,"1",1,4,2,"H"
"10941",1973-11-10,1973,"RC Strasbourg","OGC Nice","0-4",0,4,"1",1,4,-4,"D"
"10942",1973-11-10,1973,"FC Nantes","Olympique Lyon","1-2",1,2,"1",1,3,-1,"D"
"10943",1973-11-10,1973,"Paris FC","FC Sochaux","2-3",2,3,"1",1,5,-1,"D"
"10944",1973-11-10,1973,"Angers SCO","CS Sedan","4-0",4,0,"1",1,4,4,"H"
"10945",1973-11-10,1973,"AS Monaco","SC Bastia","3-3",3,3,"1",1,6,0,"D"
"10946",1973-11-10,1973,"Nimes Olympique","Troyes AF","1-1",1,1,"1",1,2,0,"D"
"10947",1973-11-10,1973,"Girondins Bordeaux","Stade Rennes","0-1",0,1,"1",1,1,-1,"D"
"10948",1973-11-10,1973,"FC Metz","Olympique Marseille","1-0",1,0,"1",1,1,1,"H"
"10949",1973-11-16,1973,"Olympique Lyon","AS Saint-Etienne","0-0",0,0,"1",1,0,0,"D"
"10950",1973-11-16,1973,"OGC Nice","AS Nancy","1-1",1,1,"1",1,2,0,"D"
"10951",1973-11-16,1973,"FC Sochaux","AS Monaco","1-0",1,0,"1",1,1,1,"H"
"10952",1973-11-16,1973,"RC Lens","FC Nantes","0-1",0,1,"1",1,1,-1,"D"
"10953",1973-11-16,1973,"Olympique Marseille","Angers SCO","2-2",2,2,"1",1,4,0,"D"
"10954",1973-11-16,1973,"SC Bastia","Paris FC","1-1",1,1,"1",1,2,0,"D"
"10955",1973-11-16,1973,"FC Metz","Stade Reims","1-0",1,0,"1",1,1,1,"H"
"10956",1973-11-16,1973,"CS Sedan","Nimes Olympique","2-0",2,0,"1",1,2,2,"H"
"10957",1973-11-16,1973,"Stade Rennes","RC Strasbourg","2-1",2,1,"1",1,3,1,"H"
"10958",1973-11-16,1973,"Troyes AF","Girondins Bordeaux","3-1",3,1,"1",1,4,2,"H"
"10959",1973-12-02,1973,"AS Saint-Etienne","RC Lens","2-1",2,1,"1",1,3,1,"H"
"10960",1973-12-02,1973,"RC Strasbourg","Olympique Lyon","1-2",1,2,"1",1,3,-1,"D"
"10961",1973-12-02,1973,"Nimes Olympique","OGC Nice","0-0",0,0,"1",1,0,0,"D"
"10962",1973-12-02,1973,"Angers SCO","Troyes AF","6-1",6,1,"1",1,7,5,"H"
"10963",1973-12-02,1973,"FC Nantes","FC Sochaux","2-1",2,1,"1",1,3,1,"H"
"10964",1973-12-02,1973,"Stade Reims","SC Bastia","1-0",1,0,"1",1,1,1,"H"
"10965",1973-12-02,1973,"AS Monaco","FC Metz","2-1",2,1,"1",1,3,1,"H"
"10966",1973-12-02,1973,"Paris FC","Olympique Marseille","0-1",0,1,"1",1,1,-1,"D"
"10967",1973-12-02,1973,"Girondins Bordeaux","CS Sedan","2-1",2,1,"1",1,3,1,"H"
"10968",1973-12-09,1973,"FC Sochaux","AS Saint-Etienne","0-2",0,2,"1",1,2,-2,"D"
"10969",1973-12-09,1973,"Olympique Lyon","Girondins Bordeaux","2-0",2,0,"1",1,2,2,"H"
"10970",1973-12-09,1973,"AS Monaco","Angers SCO","1-2",1,2,"1",1,3,-1,"D"
"10971",1973-12-09,1973,"SC Bastia","FC Nantes","0-1",0,1,"1",1,1,-1,"D"
"10972",1973-12-09,1973,"RC Lens","RC Strasbourg","3-1",3,1,"1",1,4,2,"H"
"10973",1973-12-09,1973,"CS Sedan","OGC Nice","2-0",2,0,"1",1,2,2,"H"
"10974",1973-12-09,1973,"Stade Rennes","Nimes Olympique","1-2",1,2,"1",1,3,-1,"D"
"10975",1973-12-09,1973,"Olympique Marseille","Stade Reims","1-0",1,0,"1",1,1,1,"H"
"10976",1973-12-09,1973,"FC Metz","Paris FC","4-0",4,0,"1",1,4,4,"H"
"10977",1973-12-09,1973,"Troyes AF","AS Nancy","4-4",4,4,"1",1,8,0,"D"
"10978",1973-12-16,1973,"AS Saint-Etienne","SC Bastia","2-0",2,0,"1",1,2,2,"H"
"10979",1973-12-16,1973,"Angers SCO","FC Metz","2-1",2,1,"1",1,3,1,"H"
"10980",1973-12-16,1973,"FC Nantes","Olympique Marseille","4-1",4,1,"1",1,5,3,"H"
"10981",1973-12-16,1973,"Nimes Olympique","Olympique Lyon","0-0",0,0,"1",1,0,0,"D"
"10982",1973-12-16,1973,"Girondins Bordeaux","RC Lens","1-1",1,1,"1",1,2,0,"D"
"10983",1973-12-16,1973,"OGC Nice","Troyes AF","1-1",1,1,"1",1,2,0,"D"
"10984",1973-12-16,1973,"Stade Reims","Stade Rennes","4-0",4,0,"1",1,4,4,"H"
"10985",1973-12-16,1973,"RC Strasbourg","FC Sochaux","2-2",2,2,"1",1,4,0,"D"
"10986",1973-12-16,1973,"AS Nancy","CS Sedan","4-1",4,1,"1",1,5,3,"H"
"10987",1973-12-16,1973,"Paris FC","AS Monaco","4-0",4,0,"1",1,4,4,"H"
"10988",1973-12-22,1973,"FC Metz","AS Saint-Etienne","5-1",5,1,"1",1,6,4,"H"
"10989",1973-12-22,1973,"FC Sochaux","Nimes Olympique","0-1",0,1,"1",1,1,-1,"D"
"10990",1973-12-22,1973,"Stade Rennes","CS Sedan","1-1",1,1,"1",1,2,0,"D"
"10991",1973-12-23,1973,"Olympique Lyon","Troyes AF","2-0",2,0,"1",1,2,2,"H"
"10992",1973-12-23,1973,"Angers SCO","RC Strasbourg","3-3",3,3,"1",1,6,0,"D"
"10993",1973-12-23,1973,"RC Lens","OGC Nice","2-0",2,0,"1",1,2,2,"H"
"10994",1973-12-23,1973,"Paris FC","Stade Reims","3-0",3,0,"1",1,3,3,"H"
"10995",1973-12-23,1973,"SC Bastia","AS Nancy","3-2",3,2,"1",1,5,1,"H"
"10996",1973-12-23,1973,"Olympique Marseille","Girondins Bordeaux","3-1",3,1,"1",1,4,2,"H"
"10997",1974-01-06,1973,"AS Saint-Etienne","AS Monaco","3-2",3,2,"1",1,5,1,"H"
"10998",1974-01-06,1973,"CS Sedan","Olympique Lyon","1-1",1,1,"1",1,2,0,"D"
"10999",1974-01-06,1973,"FC Nantes","Paris FC","3-0",3,0,"1",1,3,3,"H"
"11000",1974-01-06,1973,"Stade Reims","Angers SCO","4-2",4,2,"1",1,6,2,"H"
"11001",1974-01-06,1973,"Nimes Olympique","FC Metz","0-0",0,0,"1",1,0,0,"D"
"11002",1974-01-06,1973,"AS Nancy","RC Lens","3-2",3,2,"1",1,5,1,"H"
"11003",1974-01-06,1973,"OGC Nice","FC Sochaux","2-2",2,2,"1",1,4,0,"D"
"11004",1974-01-06,1973,"Girondins Bordeaux","SC Bastia","3-1",3,1,"1",1,4,2,"H"
"11005",1974-01-06,1973,"RC Strasbourg","Olympique Marseille","2-2",2,2,"1",1,4,0,"D"
"11006",1974-01-06,1973,"Troyes AF","Stade Rennes","1-2",1,2,"1",1,3,-1,"D"
"11007",1974-01-13,1973,"Paris FC","AS Saint-Etienne","0-1",0,1,"1",1,1,-1,"D"
"11008",1974-01-13,1973,"Olympique Lyon","OGC Nice","5-2",5,2,"1",1,7,3,"H"
"11009",1974-01-13,1973,"Angers SCO","FC Nantes","2-3",2,3,"1",1,5,-1,"D"
"11010",1974-01-13,1973,"Olympique Marseille","Nimes Olympique","1-2",1,2,"1",1,3,-1,"D"
"11011",1974-01-13,1973,"RC Lens","Troyes AF","0-0",0,0,"1",1,0,0,"D"
"11012",1974-01-13,1973,"FC Sochaux","CS Sedan","3-0",3,0,"1",1,3,3,"H"
"11013",1974-01-13,1973,"Stade Reims","AS Nancy","1-2",1,2,"1",1,3,-1,"D"
"11014",1974-01-13,1973,"FC Metz","Girondins Bordeaux","1-0",1,0,"1",1,1,1,"H"
"11015",1974-01-13,1973,"SC Bastia","Stade Rennes","1-0",1,0,"1",1,1,1,"H"
"11016",1974-01-13,1973,"AS Monaco","RC Strasbourg","1-1",1,1,"1",1,2,0,"D"
"11017",1974-01-20,1973,"AS Saint-Etienne","Angers SCO","3-2",3,2,"1",1,5,1,"H"
"11018",1974-01-20,1973,"FC Nantes","Stade Reims","2-1",2,1,"1",1,3,1,"H"
"11019",1974-01-20,1973,"Stade Rennes","Olympique Lyon","1-0",1,0,"1",1,1,1,"H"
"11020",1974-01-20,1973,"Nimes Olympique","Paris FC","1-1",1,1,"1",1,2,0,"D"
"11021",1974-01-20,1973,"CS Sedan","RC Lens","1-1",1,1,"1",1,2,0,"D"
"11022",1974-01-20,1973,"OGC Nice","SC Bastia","3-0",3,0,"1",1,3,3,"H"
"11023",1974-01-20,1973,"Troyes AF","FC Sochaux","3-0",3,0,"1",1,3,3,"H"
"11024",1974-01-20,1973,"RC Strasbourg","FC Metz","2-1",2,1,"1",1,3,1,"H"
"11025",1974-01-20,1973,"AS Nancy","Olympique Marseille","0-0",0,0,"1",1,0,0,"D"
"11026",1974-01-20,1973,"Girondins Bordeaux","AS Monaco","1-2",1,2,"1",1,3,-1,"D"
"11027",1974-01-27,1973,"FC Nantes","AS Saint-Etienne","3-1",3,1,"1",1,4,2,"H"
"11028",1974-01-27,1973,"Angers SCO","Olympique Lyon","1-0",1,0,"1",1,1,1,"H"
"11029",1974-01-27,1973,"AS Monaco","Nimes Olympique","0-2",0,2,"1",1,2,-2,"D"
"11030",1974-01-27,1973,"RC Lens","Stade Rennes","3-0",3,0,"1",1,3,3,"H"
"11031",1974-01-27,1973,"FC Sochaux","AS Nancy","4-1",4,1,"1",1,5,3,"H"
"11032",1974-01-27,1973,"Stade Reims","RC Strasbourg","3-2",3,2,"1",1,5,1,"H"
"11033",1974-01-27,1973,"Olympique Marseille","OGC Nice","2-0",2,0,"1",1,2,2,"H"
"11034",1974-01-27,1973,"SC Bastia","CS Sedan","2-0",2,0,"1",1,2,2,"H"
"11035",1974-01-27,1973,"FC Metz","Troyes AF","1-1",1,1,"1",1,2,0,"D"
"11036",1974-01-27,1973,"Paris FC","Girondins Bordeaux","2-2",2,2,"1",1,4,0,"D"
"11037",1974-02-10,1973,"AS Saint-Etienne","Stade Reims","2-2",2,2,"1",1,4,0,"D"
"11038",1974-02-10,1973,"Nimes Olympique","FC Nantes","0-0",0,0,"1",1,0,0,"D"
"11039",1974-02-10,1973,"Olympique Lyon","RC Lens","4-2",4,2,"1",1,6,2,"H"
"11040",1974-02-10,1973,"Girondins Bordeaux","Angers SCO","0-2",0,2,"1",1,2,-2,"D"
"11041",1974-02-10,1973,"Stade Rennes","FC Sochaux","0-2",0,2,"1",1,2,-2,"D"
"11042",1974-02-10,1973,"OGC Nice","FC Metz","4-0",4,0,"1",1,4,4,"H"
"11043",1974-02-10,1973,"Troyes AF","SC Bastia","1-1",1,1,"1",1,2,0,"D"
"11044",1974-02-10,1973,"AS Nancy","AS Monaco","2-1",2,1,"1",1,3,1,"H"
"11045",1974-02-10,1973,"CS Sedan","Olympique Marseille","3-1",3,1,"1",1,4,2,"H"
"11046",1974-02-10,1973,"RC Strasbourg","Paris FC","1-1",1,1,"1",1,2,0,"D"
"11047",1974-02-17,1973,"FC Nantes","Girondins Bordeaux","3-1",3,1,"1",1,4,2,"H"
"11048",1974-02-17,1973,"AS Saint-Etienne","RC Strasbourg","3-3",3,3,"1",1,6,0,"D"
"11049",1974-02-17,1973,"FC Sochaux","Olympique Lyon","1-1",1,1,"1",1,2,0,"D"
"11050",1974-02-17,1973,"Angers SCO","Stade Rennes","0-1",0,1,"1",1,1,-1,"D"
"11051",1974-02-17,1973,"AS Monaco","RC Lens","4-2",4,2,"1",1,6,2,"H"
"11052",1974-02-17,1973,"Stade Reims","OGC Nice","2-2",2,2,"1",1,4,0,"D"
"11053",1974-02-17,1973,"FC Metz","CS Sedan","4-1",4,1,"1",1,5,3,"H"
"11054",1974-02-17,1973,"Olympique Marseille","Troyes AF","2-3",2,3,"1",1,5,-1,"D"
"11055",1974-02-17,1973,"Paris FC","AS Nancy","4-2",4,2,"1",1,6,2,"H"
"11056",1974-02-23,1973,"OGC Nice","Paris FC","2-1",2,1,"1",1,3,1,"H"
"11057",1974-02-24,1973,"Girondins Bordeaux","AS Saint-Etienne","0-5",0,5,"1",1,5,-5,"D"
"11058",1974-02-24,1973,"RC Strasbourg","FC Nantes","3-2",3,2,"1",1,5,1,"H"
"11059",1974-02-24,1973,"Olympique Lyon","SC Bastia","1-0",1,0,"1",1,1,1,"H"
"11060",1974-02-24,1973,"Nimes Olympique","Angers SCO","0-0",0,0,"1",1,0,0,"D"
"11061",1974-02-24,1973,"RC Lens","FC Sochaux","1-1",1,1,"1",1,2,0,"D"
"11062",1974-02-24,1973,"CS Sedan","Stade Reims","4-1",4,1,"1",1,5,3,"H"
"11063",1974-02-24,1973,"AS Nancy","FC Metz","2-1",2,1,"1",1,3,1,"H"
"11064",1974-02-24,1973,"Stade Rennes","Olympique Marseille","3-1",3,1,"1",1,4,2,"H"
"11065",1974-02-24,1973,"Troyes AF","AS Monaco","0-2",0,2,"1",1,2,-2,"D"
"11066",1974-03-13,1973,"AS Saint-Etienne","Nimes Olympique","2-1",2,1,"1",1,3,1,"H"
"11067",1974-03-13,1973,"FC Nantes","AS Nancy","0-0",0,0,"1",1,0,0,"D"
"11068",1974-03-13,1973,"Olympique Marseille","Olympique Lyon","1-1",1,1,"1",1,2,0,"D"
"11069",1974-03-13,1973,"Angers SCO","OGC Nice","4-1",4,1,"1",1,5,3,"H"
"11070",1974-03-13,1973,"SC Bastia","RC Lens","0-0",0,0,"1",1,0,0,"D"
"11071",1974-03-13,1973,"Stade Reims","FC Sochaux","1-0",1,0,"1",1,1,1,"H"
"11072",1974-03-13,1973,"FC Metz","Stade Rennes","4-0",4,0,"1",1,4,4,"H"
"11073",1974-03-13,1973,"Paris FC","Troyes AF","0-2",0,2,"1",1,2,-2,"D"
"11074",1974-03-13,1973,"AS Monaco","CS Sedan","3-0",3,0,"1",1,3,3,"H"
"11075",1974-03-13,1973,"RC Strasbourg","Girondins Bordeaux","0-0",0,0,"1",1,0,0,"D"
"11076",1974-03-16,1973,"Stade Rennes","AS Saint-Etienne","1-0",1,0,"1",1,1,1,"H"
"11077",1974-03-16,1973,"Olympique Lyon","FC Metz","2-0",2,0,"1",1,2,2,"H"
"11078",1974-03-16,1973,"Troyes AF","FC Nantes","1-0",1,0,"1",1,1,1,"H"
"11079",1974-03-16,1973,"AS Nancy","Angers SCO","0-3",0,3,"1",1,3,-3,"D"
"11080",1974-03-16,1973,"OGC Nice","AS Monaco","3-2",3,2,"1",1,5,1,"H"
"11081",1974-03-16,1973,"FC Sochaux","SC Bastia","1-0",1,0,"1",1,1,1,"H"
"11082",1974-03-16,1973,"Nimes Olympique","RC Strasbourg","1-2",1,2,"1",1,3,-1,"D"
"11083",1974-03-16,1973,"RC Lens","Olympique Marseille","2-3",2,3,"1",1,5,-1,"D"
"11084",1974-03-16,1973,"Girondins Bordeaux","Stade Reims","3-0",3,0,"1",1,3,3,"H"
"11085",1974-03-16,1973,"CS Sedan","Paris FC","2-2",2,2,"1",1,4,0,"D"
"11086",1974-03-22,1973,"AS Nancy","Stade Rennes","1-2",1,2,"1",1,3,-1,"D"
"11087",1974-03-26,1973,"FC Metz","RC Lens","1-0",1,0,"1",1,1,1,"H"
"11088",1974-03-26,1973,"RC Strasbourg","AS Nancy","2-1",2,1,"1",1,3,1,"H"
"11089",1974-03-27,1973,"AS Saint-Etienne","OGC Nice","1-0",1,0,"1",1,1,1,"H"
"11090",1974-03-27,1973,"FC Nantes","CS Sedan","1-0",1,0,"1",1,1,1,"H"
"11091",1974-03-27,1973,"AS Monaco","Olympique Lyon","1-1",1,1,"1",1,2,0,"D"
"11092",1974-03-27,1973,"Angers SCO","FC Sochaux","2-4",2,4,"1",1,6,-2,"D"
"11093",1974-03-27,1973,"Girondins Bordeaux","Nimes Olympique","1-1",1,1,"1",1,2,0,"D"
"11094",1974-03-27,1973,"Stade Reims","Troyes AF","3-2",3,2,"1",1,5,1,"H"
"11095",1974-03-27,1973,"Paris FC","Stade Rennes","0-0",0,0,"1",1,0,0,"D"
"11096",1974-03-27,1973,"Olympique Marseille","SC Bastia","2-1",2,1,"1",1,3,1,"H"
"11097",1974-04-09,1973,"RC Lens","Angers SCO","1-1",1,1,"1",1,2,0,"D"
"11098",1974-04-09,1973,"FC Sochaux","Olympique Marseille","2-0",2,0,"1",1,2,2,"H"
"11099",1974-04-09,1973,"Nimes Olympique","Stade Reims","2-0",2,0,"1",1,2,2,"H"
"11100",1974-04-09,1973,"Stade Rennes","AS Monaco","1-1",1,1,"1",1,2,0,"D"
"11101",1974-04-09,1973,"SC Bastia","FC Metz","0-0",0,0,"1",1,0,0,"D"
"11102",1974-04-09,1973,"Troyes AF","RC Strasbourg","1-3",1,3,"1",1,4,-2,"D"
"11103",1974-04-09,1973,"AS Nancy","Girondins Bordeaux","0-2",0,2,"1",1,2,-2,"D"
"11104",1974-04-09,1973,"CS Sedan","AS Saint-Etienne","0-0",0,0,"1",1,0,0,"D"
"11105",1974-04-09,1973,"Olympique Lyon","Paris FC","5-4",5,4,"1",1,9,1,"H"
"11106",1974-04-09,1973,"OGC Nice","FC Nantes","1-1",1,1,"1",1,2,0,"D"
"11107",1974-04-12,1973,"AS Saint-Etienne","Troyes AF","2-0",2,0,"1",1,2,2,"H"
"11108",1974-04-12,1973,"Stade Reims","Olympique Lyon","0-0",0,0,"1",1,0,0,"D"
"11109",1974-04-12,1973,"FC Nantes","Stade Rennes","1-1",1,1,"1",1,2,0,"D"
"11110",1974-04-12,1973,"Nimes Olympique","AS Nancy","1-0",1,0,"1",1,1,1,"H"
"11111",1974-04-12,1973,"Angers SCO","SC Bastia","1-2",1,2,"1",1,3,-1,"D"
"11112",1974-04-12,1973,"FC Metz","FC Sochaux","3-2",3,2,"1",1,5,1,"H"
"11113",1974-04-12,1973,"Paris FC","RC Lens","1-3",1,3,"1",1,4,-2,"D"
"11114",1974-04-12,1973,"Girondins Bordeaux","OGC Nice","4-0",4,0,"1",1,4,4,"H"
"11115",1974-04-12,1973,"RC Strasbourg","CS Sedan","2-0",2,0,"1",1,2,2,"H"
"11116",1974-04-12,1973,"AS Monaco","Olympique Marseille","1-1",1,1,"1",1,2,0,"D"
"11117",1974-04-16,1973,"AS Nancy","AS Saint-Etienne","1-1",1,1,"1",1,2,0,"D"
"11118",1974-04-16,1973,"Olympique Lyon","FC Nantes","3-1",3,1,"1",1,4,2,"H"
"11119",1974-04-16,1973,"CS Sedan","Angers SCO","0-4",0,4,"1",1,4,-4,"D"
"11120",1974-04-16,1973,"FC Sochaux","Paris FC","2-1",2,1,"1",1,3,1,"H"
"11121",1974-04-16,1973,"Troyes AF","Nimes Olympique","0-0",0,0,"1",1,0,0,"D"
"11122",1974-04-16,1973,"RC Lens","Stade Reims","2-1",2,1,"1",1,3,1,"H"
"11123",1974-04-16,1973,"OGC Nice","RC Strasbourg","3-2",3,2,"1",1,5,1,"H"
"11124",1974-04-16,1973,"Stade Rennes","Girondins Bordeaux","4-2",4,2,"1",1,6,2,"H"
"11125",1974-04-16,1973,"Olympique Marseille","FC Metz","3-1",3,1,"1",1,4,2,"H"
"11126",1974-04-16,1973,"SC Bastia","AS Monaco","4-0",4,0,"1",1,4,4,"H"
"11127",1974-04-19,1973,"AS Saint-Etienne","Olympique Lyon","2-0",2,0,"1",1,2,2,"H"
"11128",1974-04-19,1973,"FC Nantes","RC Lens","4-0",4,0,"1",1,4,4,"H"
"11129",1974-04-19,1973,"Angers SCO","Olympique Marseille","3-0",3,0,"1",1,3,3,"H"
"11130",1974-04-19,1973,"Nimes Olympique","CS Sedan","2-0",2,0,"1",1,2,2,"H"
"11131",1974-04-19,1973,"AS Monaco","FC Sochaux","2-1",2,1,"1",1,3,1,"H"
"11132",1974-04-19,1973,"AS Nancy","OGC Nice","0-1",0,1,"1",1,1,-1,"D"
"11133",1974-04-19,1973,"Stade Reims","FC Metz","4-0",4,0,"1",1,4,4,"H"
"11134",1974-04-19,1973,"RC Strasbourg","Stade Rennes","2-1",2,1,"1",1,3,1,"H"
"11135",1974-04-19,1973,"Paris FC","SC Bastia","0-1",0,1,"1",1,1,-1,"D"
"11136",1974-04-19,1973,"Girondins Bordeaux","Troyes AF","4-1",4,1,"1",1,5,3,"H"
"11137",1974-04-26,1973,"SC Bastia","Nimes Olympique","2-0",2,0,"1",1,2,2,"H"
"11138",1974-04-30,1973,"RC Lens","AS Saint-Etienne","2-3",2,3,"1",1,5,-1,"D"
"11139",1974-04-30,1973,"Olympique Lyon","RC Strasbourg","3-2",3,2,"1",1,5,1,"H"
"11140",1974-04-30,1973,"FC Sochaux","FC Nantes","2-0",2,0,"1",1,2,2,"H"
"11141",1974-04-30,1973,"OGC Nice","Nimes Olympique","2-2",2,2,"1",1,4,0,"D"
"11142",1974-04-30,1973,"Troyes AF","Angers SCO","3-2",3,2,"1",1,5,1,"H"
"11143",1974-04-30,1973,"SC Bastia","Stade Reims","1-1",1,1,"1",1,2,0,"D"
"11144",1974-04-30,1973,"Stade Rennes","AS Nancy","3-0",3,0,"1",1,3,3,"H"
"11145",1974-04-30,1973,"FC Metz","AS Monaco","3-2",3,2,"1",1,5,1,"H"
"11146",1974-04-30,1973,"Olympique Marseille","Paris FC","3-0",3,0,"1",1,3,3,"H"
"11147",1974-04-30,1973,"CS Sedan","Girondins Bordeaux","2-2",2,2,"1",1,4,0,"D"
"11148",1974-05-11,1973,"AS Saint-Etienne","FC Sochaux","2-0",2,0,"1",1,2,2,"H"
"11149",1974-05-11,1973,"Girondins Bordeaux","Olympique Lyon","3-0",3,0,"1",1,3,3,"H"
"11150",1974-05-11,1973,"FC Nantes","SC Bastia","3-0",3,0,"1",1,3,3,"H"
"11151",1974-05-11,1973,"Angers SCO","AS Monaco","2-2",2,2,"1",1,4,0,"D"
"11152",1974-05-11,1973,"Nimes Olympique","Stade Rennes","0-2",0,2,"1",1,2,-2,"D"
"11153",1974-05-11,1973,"OGC Nice","CS Sedan","7-2",7,2,"1",1,9,5,"H"
"11154",1974-05-11,1973,"Stade Reims","Olympique Marseille","1-0",1,0,"1",1,1,1,"H"
"11155",1974-05-11,1973,"RC Strasbourg","RC Lens","3-0",3,0,"1",1,3,3,"H"
"11156",1974-05-11,1973,"Paris FC","FC Metz","3-2",3,2,"1",1,5,1,"H"
"11157",1974-05-11,1973,"AS Nancy","Troyes AF","0-0",0,0,"1",1,0,0,"D"
"11158",1974-05-14,1973,"AS Monaco","FC Nantes","1-4",1,4,"1",1,5,-3,"D"
"11159",1974-05-22,1973,"SC Bastia","AS Saint-Etienne","1-6",1,6,"1",1,7,-5,"D"
"11160",1974-05-22,1973,"Olympique Lyon","Nimes Olympique","2-0",2,0,"1",1,2,2,"H"
"11161",1974-05-22,1973,"Olympique Marseille","FC Nantes","3-0",3,0,"1",1,3,3,"H"
"11162",1974-05-22,1973,"FC Metz","Angers SCO","0-1",0,1,"1",1,1,-1,"D"
"11163",1974-05-22,1973,"FC Sochaux","RC Strasbourg","1-0",1,0,"1",1,1,1,"H"
"11164",1974-05-22,1973,"Troyes AF","OGC Nice","2-2",2,2,"1",1,4,0,"D"
"11165",1974-05-22,1973,"Stade Rennes","Stade Reims","2-0",2,0,"1",1,2,2,"H"
"11166",1974-05-22,1973,"RC Lens","Girondins Bordeaux","0-1",0,1,"1",1,1,-1,"D"
"11167",1974-05-22,1973,"AS Monaco","Paris FC","3-0",3,0,"1",1,3,3,"H"
"11168",1974-05-22,1973,"CS Sedan","AS Nancy","2-3",2,3,"1",1,5,-1,"D"
"11169",1974-05-25,1973,"AS Saint-Etienne","Olympique Marseille","3-1",3,1,"1",1,4,2,"H"
"11170",1974-05-25,1973,"FC Nantes","FC Metz","2-2",2,2,"1",1,4,0,"D"
"11171",1974-05-25,1973,"AS Nancy","Olympique Lyon","3-1",3,1,"1",1,4,2,"H"
"11172",1974-05-25,1973,"Paris FC","Angers SCO","2-2",2,2,"1",1,4,0,"D"
"11173",1974-05-25,1973,"OGC Nice","Stade Rennes","3-1",3,1,"1",1,4,2,"H"
"11174",1974-05-25,1973,"Girondins Bordeaux","FC Sochaux","1-1",1,1,"1",1,2,0,"D"
"11175",1974-05-25,1973,"Nimes Olympique","RC Lens","1-1",1,1,"1",1,2,0,"D"
"11176",1974-05-25,1973,"Stade Reims","AS Monaco","8-4",8,4,"1",1,12,4,"H"
"11177",1974-05-25,1973,"RC Strasbourg","SC Bastia","3-1",3,1,"1",1,4,2,"H"
"11178",1974-05-25,1973,"CS Sedan","Troyes AF","4-3",4,3,"1",1,7,1,"H"
"11179",1974-08-02,1974,"Angers SCO","OGC Nice","1-3",1,3,"1",1,4,-2,"D"
"11180",1974-08-02,1974,"SC Bastia","Lille OSC","2-0",2,0,"1",1,2,2,"H"
"11181",1974-08-02,1974,"Girondins Bordeaux","FC Nantes","2-1",2,1,"1",1,3,1,"H"
"11182",1974-08-02,1974,"Troyes AF","AS Saint-Etienne","1-0",1,0,"1",1,1,1,"H"
"11183",1974-08-02,1974,"FC Sochaux","Paris Saint-Germain","0-1",0,1,"1",1,1,-1,"D"
"11184",1974-08-02,1974,"Olympique Lyon","Stade Reims","3-3",3,3,"1",1,6,0,"D"
"11185",1974-08-02,1974,"AS Monaco","Nimes Olympique","3-3",3,3,"1",1,6,0,"D"
"11186",1974-08-02,1974,"Olympique Marseille","RC Strasbourg","1-1",1,1,"1",1,2,0,"D"
"11187",1974-08-02,1974,"RC Lens","Red Star FC","0-0",0,0,"1",1,0,0,"D"
"11188",1974-08-02,1974,"Stade Rennes","FC Metz","0-0",0,0,"1",1,0,0,"D"
"11189",1974-08-09,1974,"OGC Nice","Stade Rennes","4-1",4,1,"1",1,5,3,"H"
"11190",1974-08-09,1974,"FC Metz","SC Bastia","0-2",0,2,"1",1,2,-2,"D"
"11191",1974-08-09,1974,"Stade Reims","Paris Saint-Germain","6-1",6,1,"1",1,7,5,"H"
"11192",1974-08-09,1974,"Angers SCO","Olympique Lyon","0-2",0,2,"1",1,2,-2,"D"
"11193",1974-08-09,1974,"FC Nantes","Nimes Olympique","0-1",0,1,"1",1,1,-1,"D"
"11194",1974-08-09,1974,"RC Strasbourg","Girondins Bordeaux","1-0",1,0,"1",1,1,1,"H"
"11195",1974-08-09,1974,"Red Star FC","Troyes AF","2-1",2,1,"1",1,3,1,"H"
"11196",1974-08-09,1974,"FC Sochaux","RC Lens","0-1",0,1,"1",1,1,-1,"D"
"11197",1974-08-09,1974,"AS Saint-Etienne","AS Monaco","3-2",3,2,"1",1,5,1,"H"
"11198",1974-08-09,1974,"Lille OSC","Olympique Marseille","1-0",1,0,"1",1,1,1,"H"
"11199",1974-08-13,1974,"SC Bastia","Stade Reims","0-1",0,1,"1",1,1,-1,"D"
"11200",1974-08-13,1974,"Olympique Lyon","OGC Nice","0-0",0,0,"1",1,0,0,"D"
"11201",1974-08-13,1974,"Nimes Olympique","Red Star FC","3-0",3,0,"1",1,3,3,"H"
"11202",1974-08-13,1974,"RC Lens","RC Strasbourg","0-1",0,1,"1",1,1,-1,"D"
"11203",1974-08-13,1974,"Girondins Bordeaux","AS Saint-Etienne","1-0",1,0,"1",1,1,1,"H"
"11204",1974-08-13,1974,"Troyes AF","Lille OSC","0-1",0,1,"1",1,1,-1,"D"
"11205",1974-08-13,1974,"Olympique Marseille","FC Sochaux","2-0",2,0,"1",1,2,2,"H"
"11206",1974-08-13,1974,"Stade Rennes","Angers SCO","2-0",2,0,"1",1,2,2,"H"
"11207",1974-08-13,1974,"Paris Saint-Germain","FC Metz","2-2",2,2,"1",1,4,0,"D"
"11208",1974-08-13,1974,"AS Monaco","FC Nantes","1-3",1,3,"1",1,4,-2,"D"
"11209",1974-08-16,1974,"Stade Reims","Girondins Bordeaux","2-1",2,1,"1",1,3,1,"H"
"11210",1974-08-16,1974,"Lille OSC","Paris Saint-Germain","5-0",5,0,"1",1,5,5,"H"
"11211",1974-08-16,1974,"RC Strasbourg","AS Monaco","2-2",2,2,"1",1,4,0,"D"
"11212",1974-08-16,1974,"OGC Nice","Olympique Marseille","1-3",1,3,"1",1,4,-2,"D"
"11213",1974-08-16,1974,"AS Saint-Etienne","Nimes Olympique","4-0",4,0,"1",1,4,4,"H"
"11214",1974-08-16,1974,"Stade Rennes","RC Lens","1-0",1,0,"1",1,1,1,"H"
"11215",1974-08-16,1974,"FC Metz","Olympique Lyon","3-1",3,1,"1",1,4,2,"H"
"11216",1974-08-16,1974,"Angers SCO","SC Bastia","3-0",3,0,"1",1,3,3,"H"
"11217",1974-08-16,1974,"FC Sochaux","Troyes AF","0-1",0,1,"1",1,1,-1,"D"
"11218",1974-08-16,1974,"Red Star FC","FC Nantes","4-4",4,4,"1",1,8,0,"D"
"11219",1974-08-23,1974,"RC Lens","Stade Reims","1-0",1,0,"1",1,1,1,"H"
"11220",1974-08-23,1974,"Olympique Marseille","FC Metz","1-0",1,0,"1",1,1,1,"H"
"11221",1974-08-23,1974,"Nimes Olympique","Lille OSC","2-1",2,1,"1",1,3,1,"H"
"11222",1974-08-23,1974,"Olympique Lyon","Stade Rennes","4-1",4,1,"1",1,5,3,"H"
"11223",1974-08-23,1974,"SC Bastia","OGC Nice","2-0",2,0,"1",1,2,2,"H"
"11224",1974-08-23,1974,"Troyes AF","RC Strasbourg","2-0",2,0,"1",1,2,2,"H"
"11225",1974-08-23,1974,"Girondins Bordeaux","FC Sochaux","2-1",2,1,"1",1,3,1,"H"
"11226",1974-08-23,1974,"FC Nantes","AS Saint-Etienne","2-1",2,1,"1",1,3,1,"H"
"11227",1974-08-23,1974,"Paris Saint-Germain","Angers SCO","3-2",3,2,"1",1,5,1,"H"
"11228",1974-08-23,1974,"AS Monaco","Red Star FC","4-3",4,3,"1",1,7,1,"H"
"11229",1974-08-27,1974,"Stade Reims","Olympique Marseille","4-3",4,3,"1",1,7,1,"H"
"11230",1974-08-27,1974,"Lille OSC","AS Saint-Etienne","2-0",2,0,"1",1,2,2,"H"
"11231",1974-08-27,1974,"Red Star FC","Girondins Bordeaux","1-2",1,2,"1",1,3,-1,"D"
"11232",1974-08-27,1974,"RC Strasbourg","FC Nantes","2-0",2,0,"1",1,2,2,"H"
"11233",1974-08-27,1974,"OGC Nice","Paris Saint-Germain","4-2",4,2,"1",1,6,2,"H"
"11234",1974-08-27,1974,"Stade Rennes","SC Bastia","1-1",1,1,"1",1,2,0,"D"
"11235",1974-08-27,1974,"Angers SCO","Troyes AF","1-1",1,1,"1",1,2,0,"D"
"11236",1974-08-27,1974,"FC Sochaux","Nimes Olympique","2-0",2,0,"1",1,2,2,"H"
"11237",1974-08-27,1974,"Olympique Lyon","AS Monaco","1-3",1,3,"1",1,4,-2,"D"
"11238",1974-08-27,1974,"FC Metz","RC Lens","2-1",2,1,"1",1,3,1,"H"
"11239",1974-08-31,1974,"Troyes AF","FC Metz","4-1",4,1,"1",1,5,3,"H"
"11240",1974-09-01,1974,"SC Bastia","Olympique Lyon","2-0",2,0,"1",1,2,2,"H"
"11241",1974-09-02,1974,"AS Monaco","Stade Reims","2-3",2,3,"1",1,5,-1,"D"
"11242",1974-09-02,1974,"Girondins Bordeaux","Lille OSC","4-2",4,2,"1",1,6,2,"H"
"11243",1974-09-02,1974,"Nimes Olympique","RC Strasbourg","6-0",6,0,"1",1,6,6,"H"
"11244",1974-09-02,1974,"Olympique Marseille","Angers SCO","3-1",3,1,"1",1,4,2,"H"
"11245",1974-09-02,1974,"RC Lens","OGC Nice","4-2",4,2,"1",1,6,2,"H"
"11246",1974-09-02,1974,"FC Nantes","FC Sochaux","1-0",1,0,"1",1,1,1,"H"
"11247",1974-09-02,1974,"Paris Saint-Germain","Stade Rennes","2-1",2,1,"1",1,3,1,"H"
"11248",1974-09-02,1974,"AS Saint-Etienne","Red Star FC","2-0",2,0,"1",1,2,2,"H"
"11249",1974-09-13,1974,"Stade Reims","Nimes Olympique","2-1",2,1,"1",1,3,1,"H"
"11250",1974-09-13,1974,"SC Bastia","Girondins Bordeaux","1-0",1,0,"1",1,1,1,"H"
"11251",1974-09-13,1974,"Lille OSC","AS Monaco","2-0",2,0,"1",1,2,2,"H"
"11252",1974-09-13,1974,"Stade Rennes","Olympique Marseille","1-0",1,0,"1",1,1,1,"H"
"11253",1974-09-13,1974,"OGC Nice","Troyes AF","2-1",2,1,"1",1,3,1,"H"
"11254",1974-09-13,1974,"Angers SCO","RC Lens","1-2",1,2,"1",1,3,-1,"D"
"11255",1974-09-13,1974,"RC Strasbourg","Red Star FC","1-1",1,1,"1",1,2,0,"D"
"11256",1974-09-13,1974,"FC Metz","FC Nantes","4-0",4,0,"1",1,4,4,"H"
"11257",1974-09-13,1974,"Olympique Lyon","Paris Saint-Germain","4-4",4,4,"1",1,8,0,"D"
"11258",1974-09-13,1974,"FC Sochaux","AS Saint-Etienne","1-1",1,1,"1",1,2,0,"D"
"11259",1974-09-23,1974,"Paris Saint-Germain","SC Bastia","1-1",1,1,"1",1,2,0,"D"
"11260",1974-09-24,1974,"Troyes AF","Stade Reims","2-0",2,0,"1",1,2,2,"H"
"11261",1974-09-24,1974,"Girondins Bordeaux","FC Metz","3-2",3,2,"1",1,5,1,"H"
"11262",1974-09-24,1974,"Nimes Olympique","Angers SCO","4-0",4,0,"1",1,4,4,"H"
"11263",1974-09-24,1974,"RC Lens","Lille OSC","1-0",1,0,"1",1,1,1,"H"
"11264",1974-09-24,1974,"Olympique Marseille","Olympique Lyon","0-1",0,1,"1",1,1,-1,"D"
"11265",1974-09-24,1974,"AS Saint-Etienne","RC Strasbourg","2-1",2,1,"1",1,3,1,"H"
"11266",1974-09-24,1974,"AS Monaco","OGC Nice","3-2",3,2,"1",1,5,1,"H"
"11267",1974-09-24,1974,"FC Nantes","Stade Rennes","1-1",1,1,"1",1,2,0,"D"
"11268",1974-09-24,1974,"Red Star FC","FC Sochaux","0-1",0,1,"1",1,1,-1,"D"
"11269",1974-09-27,1974,"Stade Reims","AS Saint-Etienne","0-2",0,2,"1",1,2,-2,"D"
"11270",1974-09-27,1974,"SC Bastia","Olympique Marseille","2-2",2,2,"1",1,4,0,"D"
"11271",1974-09-27,1974,"Angers SCO","Girondins Bordeaux","2-2",2,2,"1",1,4,0,"D"
"11272",1974-09-27,1974,"Lille OSC","Red Star FC","1-0",1,0,"1",1,1,1,"H"
"11273",1974-09-27,1974,"Stade Rennes","Troyes AF","1-1",1,1,"1",1,2,0,"D"
"11274",1974-09-27,1974,"Olympique Lyon","RC Lens","5-1",5,1,"1",1,6,4,"H"
"11275",1974-09-27,1974,"FC Metz","AS Monaco","1-0",1,0,"1",1,1,1,"H"
"11276",1974-09-27,1974,"Paris Saint-Germain","FC Nantes","2-3",2,3,"1",1,5,-1,"D"
"11277",1974-09-27,1974,"FC Sochaux","RC Strasbourg","0-0",0,0,"1",1,0,0,"D"
"11278",1974-10-05,1974,"FC Nantes","Stade Reims","0-1",0,1,"1",1,1,-1,"D"
"11279",1974-10-05,1974,"Girondins Bordeaux","OGC Nice","2-0",2,0,"1",1,2,2,"H"
"11280",1974-10-05,1974,"RC Lens","SC Bastia","3-3",3,3,"1",1,6,0,"D"
"11281",1974-10-05,1974,"Nimes Olympique","FC Metz","2-0",2,0,"1",1,2,2,"H"
"11282",1974-10-05,1974,"AS Saint-Etienne","Angers SCO","2-0",2,0,"1",1,2,2,"H"
"11283",1974-10-05,1974,"Troyes AF","Olympique Lyon","0-0",0,0,"1",1,0,0,"D"
"11284",1974-10-05,1974,"Olympique Marseille","Paris Saint-Germain","4-2",4,2,"1",1,6,2,"H"
"11285",1974-10-05,1974,"RC Strasbourg","Lille OSC","3-0",3,0,"1",1,3,3,"H"
"11286",1974-10-05,1974,"Red Star FC","Stade Rennes","0-2",0,2,"1",1,2,-2,"D"
"11287",1974-10-05,1974,"AS Monaco","FC Sochaux","3-1",3,1,"1",1,4,2,"H"
"11288",1974-10-18,1974,"Stade Reims","RC Strasbourg","2-0",2,0,"1",1,2,2,"H"
"11289",1974-10-18,1974,"SC Bastia","Troyes AF","5-1",5,1,"1",1,6,4,"H"
"11290",1974-10-18,1974,"Olympique Lyon","Girondins Bordeaux","1-0",1,0,"1",1,1,1,"H"
"11291",1974-10-18,1974,"Olympique Marseille","AS Monaco","4-1",4,1,"1",1,5,3,"H"
"11292",1974-10-18,1974,"Lille OSC","FC Sochaux","4-0",4,0,"1",1,4,4,"H"
"11293",1974-10-18,1974,"OGC Nice","AS Saint-Etienne","1-1",1,1,"1",1,2,0,"D"
"11294",1974-10-18,1974,"Stade Rennes","Nimes Olympique","2-1",2,1,"1",1,3,1,"H"
"11295",1974-10-18,1974,"FC Metz","Red Star FC","2-1",2,1,"1",1,3,1,"H"
"11296",1974-10-18,1974,"Paris Saint-Germain","RC Lens","3-1",3,1,"1",1,4,2,"H"
"11297",1974-10-18,1974,"Angers SCO","FC Nantes","0-0",0,0,"1",1,0,0,"D"
"11298",1974-10-26,1974,"FC Sochaux","Stade Reims","1-0",1,0,"1",1,1,1,"H"
"11299",1974-10-26,1974,"Girondins Bordeaux","Stade Rennes","1-0",1,0,"1",1,1,1,"H"
"11300",1974-10-26,1974,"AS Saint-Etienne","FC Metz","5-0",5,0,"1",1,5,5,"H"
"11301",1974-10-26,1974,"AS Monaco","SC Bastia","1-0",1,0,"1",1,1,1,"H"
"11302",1974-10-26,1974,"Nimes Olympique","Olympique Lyon","1-2",1,2,"1",1,3,-1,"D"
"11303",1974-10-26,1974,"RC Lens","Olympique Marseille","2-2",2,2,"1",1,4,0,"D"
"11304",1974-10-26,1974,"FC Nantes","Lille OSC","1-0",1,0,"1",1,1,1,"H"
"11305",1974-10-26,1974,"RC Strasbourg","Angers SCO","1-0",1,0,"1",1,1,1,"H"
"11306",1974-10-26,1974,"Troyes AF","Paris Saint-Germain","1-3",1,3,"1",1,4,-2,"D"
"11307",1974-10-26,1974,"Red Star FC","OGC Nice","4-1",4,1,"1",1,5,3,"H"
"11308",1974-10-29,1974,"Stade Reims","Lille OSC","4-3",4,3,"1",1,7,1,"H"
"11309",1974-10-29,1974,"SC Bastia","Nimes Olympique","4-0",4,0,"1",1,4,4,"H"
"11310",1974-10-29,1974,"Olympique Lyon","FC Nantes","1-1",1,1,"1",1,2,0,"D"
"11311",1974-10-29,1974,"RC Lens","Girondins Bordeaux","3-0",3,0,"1",1,3,3,"H"
"11312",1974-10-29,1974,"Stade Rennes","AS Saint-Etienne","3-1",3,1,"1",1,4,2,"H"
"11313",1974-10-29,1974,"Olympique Marseille","Troyes AF","0-0",0,0,"1",1,0,0,"D"
"11314",1974-10-29,1974,"Paris Saint-Germain","AS Monaco","0-1",0,1,"1",1,1,-1,"D"
"11315",1974-10-29,1974,"OGC Nice","RC Strasbourg","2-1",2,1,"1",1,3,1,"H"
"11316",1974-10-29,1974,"FC Metz","FC Sochaux","0-1",0,1,"1",1,1,-1,"D"
"11317",1974-10-29,1974,"Angers SCO","Red Star FC","1-1",1,1,"1",1,2,0,"D"
"11318",1974-11-01,1974,"FC Nantes","SC Bastia","0-0",0,0,"1",1,0,0,"D"
"11319",1974-11-01,1974,"Red Star FC","Stade Reims","2-1",2,1,"1",1,3,1,"H"
"11320",1974-11-01,1974,"AS Saint-Etienne","Olympique Lyon","1-0",1,0,"1",1,1,1,"H"
"11321",1974-11-01,1974,"Girondins Bordeaux","Paris Saint-Germain","1-2",1,2,"1",1,3,-1,"D"
"11322",1974-11-01,1974,"Troyes AF","RC Lens","0-1",0,1,"1",1,1,-1,"D"
"11323",1974-11-01,1974,"Nimes Olympique","Olympique Marseille","3-1",3,1,"1",1,4,2,"H"
"11324",1974-11-01,1974,"AS Monaco","Stade Rennes","2-0",2,0,"1",1,2,2,"H"
"11325",1974-11-01,1974,"RC Strasbourg","FC Metz","3-0",3,0,"1",1,3,3,"H"
"11326",1974-11-01,1974,"Lille OSC","Angers SCO","1-5",1,5,"1",1,6,-4,"D"
"11327",1974-11-01,1974,"FC Sochaux","OGC Nice","1-1",1,1,"1",1,2,0,"D"
"11328",1974-11-05,1974,"OGC Nice","Nimes Olympique","2-0",2,0,"1",1,2,2,"H"
"11329",1974-11-08,1974,"Red Star FC","Olympique Lyon","4-0",4,0,"1",1,4,4,"H"
"11330",1974-11-09,1974,"SC Bastia","AS Saint-Etienne","1-1",1,1,"1",1,2,0,"D"
"11331",1974-11-09,1974,"FC Metz","Stade Reims","1-1",1,1,"1",1,2,0,"D"
"11332",1974-11-09,1974,"RC Lens","AS Monaco","6-3",6,3,"1",1,9,3,"H"
"11333",1974-11-09,1974,"Olympique Marseille","Girondins Bordeaux","3-0",3,0,"1",1,3,3,"H"
"11334",1974-11-09,1974,"Stade Rennes","RC Strasbourg","5-1",5,1,"1",1,6,4,"H"
"11335",1974-11-09,1974,"OGC Nice","Lille OSC","2-1",2,1,"1",1,3,1,"H"
"11336",1974-11-09,1974,"Paris Saint-Germain","Nimes Olympique","1-1",1,1,"1",1,2,0,"D"
"11337",1974-11-09,1974,"Troyes AF","FC Nantes","0-0",0,0,"1",1,0,0,"D"
"11338",1974-11-09,1974,"Angers SCO","FC Sochaux","1-1",1,1,"1",1,2,0,"D"
"11339",1974-11-20,1974,"AS Saint-Etienne","Paris Saint-Germain","3-2",3,2,"1",1,5,1,"H"
"11340",1974-11-20,1974,"Red Star FC","SC Bastia","0-0",0,0,"1",1,0,0,"D"
"11341",1974-11-20,1974,"Stade Reims","OGC Nice","1-1",1,1,"1",1,2,0,"D"
"11342",1974-11-20,1974,"Girondins Bordeaux","Troyes AF","6-0",6,0,"1",1,6,6,"H"
"11343",1974-11-20,1974,"Nimes Olympique","RC Lens","3-1",3,1,"1",1,4,2,"H"
"11344",1974-11-20,1974,"FC Nantes","Olympique Marseille","2-0",2,0,"1",1,2,2,"H"
"11345",1974-11-20,1974,"FC Sochaux","Stade Rennes","2-1",2,1,"1",1,3,1,"H"
"11346",1974-11-20,1974,"RC Strasbourg","Olympique Lyon","2-0",2,0,"1",1,2,2,"H"
"11347",1974-11-20,1974,"Lille OSC","FC Metz","4-0",4,0,"1",1,4,4,"H"
"11348",1974-11-23,1974,"Angers SCO","Stade Reims","1-2",1,2,"1",1,3,-1,"D"
"11349",1974-11-23,1974,"Girondins Bordeaux","AS Monaco","0-0",0,0,"1",1,0,0,"D"
"11350",1974-11-23,1974,"Stade Rennes","Lille OSC","3-0",3,0,"1",1,3,3,"H"
"11351",1974-11-23,1974,"RC Lens","FC Nantes","2-2",2,2,"1",1,4,0,"D"
"11352",1974-11-23,1974,"Troyes AF","Nimes Olympique","1-1",1,1,"1",1,2,0,"D"
"11353",1974-11-23,1974,"Olympique Lyon","FC Sochaux","1-0",1,0,"1",1,1,1,"H"
"11354",1974-11-24,1974,"Olympique Marseille","AS Saint-Etienne","1-2",1,2,"1",1,3,-1,"D"
"11355",1974-11-24,1974,"SC Bastia","RC Strasbourg","2-1",2,1,"1",1,3,1,"H"
"11356",1974-11-24,1974,"OGC Nice","FC Metz","1-0",1,0,"1",1,1,1,"H"
"11357",1974-11-24,1974,"Paris Saint-Germain","Red Star FC","2-0",2,0,"1",1,2,2,"H"
"11358",1974-12-01,1974,"AS Saint-Etienne","RC Lens","3-2",3,2,"1",1,5,1,"H"
"11359",1974-12-01,1974,"Stade Reims","Stade Rennes","2-1",2,1,"1",1,3,1,"H"
"11360",1974-12-01,1974,"FC Sochaux","SC Bastia","3-0",3,0,"1",1,3,3,"H"
"11361",1974-12-01,1974,"Nimes Olympique","Girondins Bordeaux","2-1",2,1,"1",1,3,1,"H"
"11362",1974-12-01,1974,"Lille OSC","Olympique Lyon","1-2",1,2,"1",1,3,-1,"D"
"11363",1974-12-01,1974,"FC Nantes","OGC Nice","2-0",2,0,"1",1,2,2,"H"
"11364",1974-12-01,1974,"RC Strasbourg","Paris Saint-Germain","2-1",2,1,"1",1,3,1,"H"
"11365",1974-12-01,1974,"Red Star FC","Olympique Marseille","0-0",0,0,"1",1,0,0,"D"
"11366",1974-12-01,1974,"AS Monaco","Troyes AF","3-1",3,1,"1",1,4,2,"H"
"11367",1974-12-01,1974,"FC Metz","Angers SCO","2-0",2,0,"1",1,2,2,"H"
"11368",1974-12-08,1974,"AS Monaco","AS Saint-Etienne","3-1",3,1,"1",1,4,2,"H"
"11369",1974-12-08,1974,"Paris Saint-Germain","Stade Reims","3-0",3,0,"1",1,3,3,"H"
"11370",1974-12-08,1974,"SC Bastia","FC Metz","0-0",0,0,"1",1,0,0,"D"
"11371",1974-12-08,1974,"Nimes Olympique","FC Nantes","0-2",0,2,"1",1,2,-2,"D"
"11372",1974-12-08,1974,"Girondins Bordeaux","RC Strasbourg","4-1",4,1,"1",1,5,3,"H"
"11373",1974-12-08,1974,"RC Lens","FC Sochaux","3-2",3,2,"1",1,5,1,"H"
"11374",1974-12-08,1974,"Olympique Lyon","Angers SCO","0-0",0,0,"1",1,0,0,"D"
"11375",1974-12-08,1974,"Olympique Marseille","Lille OSC","2-0",2,0,"1",1,2,2,"H"
"11376",1974-12-08,1974,"Stade Rennes","OGC Nice","0-0",0,0,"1",1,0,0,"D"
"11377",1974-12-08,1974,"Troyes AF","Red Star FC","2-1",2,1,"1",1,3,1,"H"
"11378",1974-12-15,1974,"AS Saint-Etienne","Girondins Bordeaux","2-0",2,0,"1",1,2,2,"H"
"11379",1974-12-15,1974,"Stade Reims","SC Bastia","0-1",0,1,"1",1,1,-1,"D"
"11380",1974-12-15,1974,"FC Nantes","AS Monaco","4-2",4,2,"1",1,6,2,"H"
"11381",1974-12-15,1974,"Red Star FC","Nimes Olympique","0-1",0,1,"1",1,1,-1,"D"
"11382",1974-12-15,1974,"Angers SCO","Stade Rennes","1-2",1,2,"1",1,3,-1,"D"
"11383",1974-12-15,1974,"OGC Nice","Olympique Lyon","2-2",2,2,"1",1,4,0,"D"
"11384",1974-12-15,1974,"FC Sochaux","Olympique Marseille","1-1",1,1,"1",1,2,0,"D"
"11385",1974-12-15,1974,"RC Strasbourg","RC Lens","2-1",2,1,"1",1,3,1,"H"
"11386",1974-12-15,1974,"FC Metz","Paris Saint-Germain","1-3",1,3,"1",1,4,-2,"D"
"11387",1974-12-15,1974,"Lille OSC","Troyes AF","2-0",2,0,"1",1,2,2,"H"
"11388",1974-12-18,1974,"AS Monaco","Angers SCO","1-0",1,0,"1",1,1,1,"H"
"11389",1974-12-22,1974,"Nimes Olympique","AS Saint-Etienne","0-0",0,0,"1",1,0,0,"D"
"11390",1974-12-22,1974,"SC Bastia","Angers SCO","3-0",3,0,"1",1,3,3,"H"
"11391",1974-12-22,1974,"FC Nantes","Red Star FC","0-0",0,0,"1",1,0,0,"D"
"11392",1974-12-22,1974,"Girondins Bordeaux","Stade Reims","2-0",2,0,"1",1,2,2,"H"
"11393",1974-12-22,1974,"Olympique Lyon","FC Metz","2-0",2,0,"1",1,2,2,"H"
"11394",1974-12-22,1974,"AS Monaco","RC Strasbourg","1-0",1,0,"1",1,1,1,"H"
"11395",1974-12-22,1974,"RC Lens","Stade Rennes","1-0",1,0,"1",1,1,1,"H"
"11396",1974-12-22,1974,"Paris Saint-Germain","Lille OSC","0-0",0,0,"1",1,0,0,"D"
"11397",1974-12-22,1974,"Troyes AF","FC Sochaux","2-2",2,2,"1",1,4,0,"D"
"11398",1975-01-12,1974,"AS Saint-Etienne","FC Nantes","2-0",2,0,"1",1,2,2,"H"
"11399",1975-01-12,1974,"OGC Nice","SC Bastia","2-1",2,1,"1",1,3,1,"H"
"11400",1975-01-12,1974,"Stade Reims","RC Lens","5-1",5,1,"1",1,6,4,"H"
"11401",1975-01-12,1974,"Stade Rennes","Olympique Lyon","0-0",0,0,"1",1,0,0,"D"
"11402",1975-01-12,1974,"Lille OSC","Nimes Olympique","1-1",1,1,"1",1,2,0,"D"
"11403",1975-01-12,1974,"Red Star FC","AS Monaco","3-0",3,0,"1",1,3,3,"H"
"11404",1975-01-12,1974,"FC Sochaux","Girondins Bordeaux","5-2",5,2,"1",1,7,3,"H"
"11405",1975-01-12,1974,"RC Strasbourg","Troyes AF","1-0",1,0,"1",1,1,1,"H"
"11406",1975-01-12,1974,"Angers SCO","Paris Saint-Germain","3-1",3,1,"1",1,4,2,"H"
"11407",1975-01-12,1974,"FC Metz","Olympique Marseille","1-0",1,0,"1",1,1,1,"H"
"11408",1975-01-19,1974,"AS Saint-Etienne","Lille OSC","4-1",4,1,"1",1,5,3,"H"
"11409",1975-01-19,1974,"SC Bastia","Stade Rennes","3-0",3,0,"1",1,3,3,"H"
"11410",1975-01-19,1974,"Olympique Marseille","Stade Reims","1-1",1,1,"1",1,2,0,"D"
"11411",1975-01-19,1974,"FC Nantes","RC Strasbourg","3-1",3,1,"1",1,4,2,"H"
"11412",1975-01-19,1974,"Nimes Olympique","FC Sochaux","1-0",1,0,"1",1,1,1,"H"
"11413",1975-01-19,1974,"AS Monaco","Olympique Lyon","3-1",3,1,"1",1,4,2,"H"
"11414",1975-01-19,1974,"Girondins Bordeaux","Red Star FC","2-1",2,1,"1",1,3,1,"H"
"11415",1975-01-19,1974,"RC Lens","FC Metz","3-1",3,1,"1",1,4,2,"H"
"11416",1975-01-19,1974,"Troyes AF","Angers SCO","4-0",4,0,"1",1,4,4,"H"
"11417",1975-01-21,1974,"Paris Saint-Germain","OGC Nice","2-1",2,1,"1",1,3,1,"H"
"11418",1975-01-26,1974,"Red Star FC","AS Saint-Etienne","1-2",1,2,"1",1,3,-1,"D"
"11419",1975-01-26,1974,"Olympique Lyon","SC Bastia","8-1",8,1,"1",1,9,7,"H"
"11420",1975-01-26,1974,"FC Sochaux","FC Nantes","0-1",0,1,"1",1,1,-1,"D"
"11421",1975-01-26,1974,"Stade Reims","AS Monaco","2-3",2,3,"1",1,5,-1,"D"
"11422",1975-01-26,1974,"RC Strasbourg","Nimes Olympique","1-1",1,1,"1",1,2,0,"D"
"11423",1975-01-26,1974,"Lille OSC","Girondins Bordeaux","2-0",2,0,"1",1,2,2,"H"
"11424",1975-01-26,1974,"Stade Rennes","Paris Saint-Germain","2-1",2,1,"1",1,3,1,"H"
"11425",1975-01-26,1974,"OGC Nice","RC Lens","2-1",2,1,"1",1,3,1,"H"
"11426",1975-01-26,1974,"Angers SCO","Olympique Marseille","1-2",1,2,"1",1,3,-1,"D"
"11427",1975-01-26,1974,"FC Metz","Troyes AF","1-1",1,1,"1",1,2,0,"D"
"11428",1975-02-09,1974,"AS Saint-Etienne","FC Sochaux","1-0",1,0,"1",1,1,1,"H"
"11429",1975-02-09,1974,"AS Monaco","Lille OSC","1-0",1,0,"1",1,1,1,"H"
"11430",1975-02-09,1974,"Nimes Olympique","Stade Reims","2-0",2,0,"1",1,2,2,"H"
"11431",1975-02-09,1974,"Paris Saint-Germain","Olympique Lyon","2-2",2,2,"1",1,4,0,"D"
"11432",1975-02-09,1974,"Olympique Marseille","Stade Rennes","3-1",3,1,"1",1,4,2,"H"
"11433",1975-02-09,1974,"RC Lens","Angers SCO","0-0",0,0,"1",1,0,0,"D"
"11434",1975-02-09,1974,"Red Star FC","RC Strasbourg","0-1",0,1,"1",1,1,-1,"D"
"11435",1975-02-09,1974,"Troyes AF","OGC Nice","3-1",3,1,"1",1,4,2,"H"
"11436",1975-02-16,1974,"RC Strasbourg","AS Saint-Etienne","0-0",0,0,"1",1,0,0,"D"
"11437",1975-02-16,1974,"OGC Nice","AS Monaco","2-3",2,3,"1",1,5,-1,"D"
"11438",1975-02-16,1974,"Stade Rennes","FC Nantes","0-0",0,0,"1",1,0,0,"D"
"11439",1975-02-16,1974,"Stade Reims","Troyes AF","3-0",3,0,"1",1,3,3,"H"
"11440",1975-02-16,1974,"Angers SCO","Nimes Olympique","2-0",2,0,"1",1,2,2,"H"
"11441",1975-02-16,1974,"Olympique Lyon","Olympique Marseille","0-1",0,1,"1",1,1,-1,"D"
"11442",1975-02-16,1974,"Lille OSC","RC Lens","1-1",1,1,"1",1,2,0,"D"
"11443",1975-02-16,1974,"FC Metz","Girondins Bordeaux","3-3",3,3,"1",1,6,0,"D"
"11444",1975-02-16,1974,"FC Sochaux","Red Star FC","0-0",0,0,"1",1,0,0,"D"
"11445",1975-02-23,1974,"AS Saint-Etienne","Stade Reims","3-1",3,1,"1",1,4,2,"H"
"11446",1975-02-23,1974,"AS Monaco","FC Metz","1-2",1,2,"1",1,3,-1,"D"
"11447",1975-02-23,1974,"Nimes Olympique","OGC Nice","2-1",2,1,"1",1,3,1,"H"
"11448",1975-02-23,1974,"FC Nantes","Paris Saint-Germain","0-0",0,0,"1",1,0,0,"D"
"11449",1975-02-23,1974,"Olympique Marseille","SC Bastia","3-1",3,1,"1",1,4,2,"H"
"11450",1975-02-23,1974,"RC Lens","Olympique Lyon","4-0",4,0,"1",1,4,4,"H"
"11451",1975-02-23,1974,"RC Strasbourg","FC Sochaux","1-1",1,1,"1",1,2,0,"D"
"11452",1975-02-23,1974,"Girondins Bordeaux","Angers SCO","1-1",1,1,"1",1,2,0,"D"
"11453",1975-02-23,1974,"Troyes AF","Stade Rennes","2-0",2,0,"1",1,2,2,"H"
"11454",1975-02-23,1974,"Red Star FC","Lille OSC","2-1",2,1,"1",1,3,1,"H"
"11455",1975-03-04,1974,"AS Monaco","Olympique Marseille","0-2",0,2,"1",1,2,-2,"D"
"11456",1975-03-11,1974,"FC Sochaux","AS Monaco","4-2",4,2,"1",1,6,2,"H"
"11457",1975-03-11,1974,"FC Metz","Nimes Olympique","3-0",3,0,"1",1,3,3,"H"
"11458",1975-03-11,1974,"OGC Nice","Girondins Bordeaux","0-0",0,0,"1",1,0,0,"D"
"11459",1975-03-12,1974,"Angers SCO","AS Saint-Etienne","0-1",0,1,"1",1,1,-1,"D"
"11460",1975-03-12,1974,"Paris Saint-Germain","Olympique Marseille","1-1",1,1,"1",1,2,0,"D"
"11461",1975-03-12,1974,"Stade Reims","FC Nantes","2-1",2,1,"1",1,3,1,"H"
"11462",1975-03-12,1974,"SC Bastia","RC Lens","0-0",0,0,"1",1,0,0,"D"
"11463",1975-03-12,1974,"Olympique Lyon","Troyes AF","2-1",2,1,"1",1,3,1,"H"
"11464",1975-03-12,1974,"Lille OSC","RC Strasbourg","2-1",2,1,"1",1,3,1,"H"
"11465",1975-03-12,1974,"Stade Rennes","Red Star FC","0-2",0,2,"1",1,2,-2,"D"
"11466",1975-03-15,1974,"Olympique Marseille","OGC Nice","4-1",4,1,"1",1,5,3,"H"
"11467",1975-03-15,1974,"FC Nantes","Angers SCO","1-0",1,0,"1",1,1,1,"H"
"11468",1975-03-15,1974,"Nimes Olympique","Stade Rennes","0-0",0,0,"1",1,0,0,"D"
"11469",1975-03-15,1974,"RC Lens","Paris Saint-Germain","3-2",3,2,"1",1,5,1,"H"
"11470",1975-03-15,1974,"Girondins Bordeaux","Olympique Lyon","1-1",1,1,"1",1,2,0,"D"
"11471",1975-03-15,1974,"RC Strasbourg","Stade Reims","3-0",3,0,"1",1,3,3,"H"
"11472",1975-03-15,1974,"Troyes AF","SC Bastia","2-1",2,1,"1",1,3,1,"H"
"11473",1975-03-15,1974,"FC Sochaux","Lille OSC","1-1",1,1,"1",1,2,0,"D"
"11474",1975-03-15,1974,"Red Star FC","FC Metz","1-1",1,1,"1",1,2,0,"D"
"11475",1975-03-20,1974,"Olympique Marseille","RC Lens","4-0",4,0,"1",1,4,4,"H"
"11476",1975-03-20,1974,"Olympique Lyon","Nimes Olympique","2-2",2,2,"1",1,4,0,"D"
"11477",1975-03-20,1974,"Stade Reims","FC Sochaux","2-1",2,1,"1",1,3,1,"H"
"11478",1975-03-20,1974,"Lille OSC","FC Nantes","3-0",3,0,"1",1,3,3,"H"
"11479",1975-03-20,1974,"SC Bastia","AS Monaco","1-0",1,0,"1",1,1,1,"H"
"11480",1975-03-20,1974,"Stade Rennes","Girondins Bordeaux","1-1",1,1,"1",1,2,0,"D"
"11481",1975-03-20,1974,"Angers SCO","RC Strasbourg","5-1",5,1,"1",1,6,4,"H"
"11482",1975-03-20,1974,"Paris Saint-Germain","Troyes AF","0-0",0,0,"1",1,0,0,"D"
"11483",1975-03-20,1974,"OGC Nice","Red Star FC","2-1",2,1,"1",1,3,1,"H"
"11484",1975-03-22,1974,"FC Metz","AS Saint-Etienne","3-0",3,0,"1",1,3,3,"H"
"11485",1975-03-29,1974,"SC Bastia","Paris Saint-Germain","0-2",0,2,"1",1,2,-2,"D"
"11486",1975-04-01,1974,"AS Saint-Etienne","Stade Rennes","3-0",3,0,"1",1,3,3,"H"
"11487",1975-04-01,1974,"Troyes AF","Olympique Marseille","1-2",1,2,"1",1,3,-1,"D"
"11488",1975-04-01,1974,"FC Nantes","Olympique Lyon","3-1",3,1,"1",1,4,2,"H"
"11489",1975-04-01,1974,"Nimes Olympique","SC Bastia","3-3",3,3,"1",1,6,0,"D"
"11490",1975-04-01,1974,"AS Monaco","Paris Saint-Germain","3-0",3,0,"1",1,3,3,"H"
"11491",1975-04-01,1974,"Lille OSC","Stade Reims","2-1",2,1,"1",1,3,1,"H"
"11492",1975-04-01,1974,"Girondins Bordeaux","RC Lens","2-0",2,0,"1",1,2,2,"H"
"11493",1975-04-01,1974,"RC Strasbourg","OGC Nice","2-1",2,1,"1",1,3,1,"H"
"11494",1975-04-01,1974,"FC Sochaux","FC Metz","1-1",1,1,"1",1,2,0,"D"
"11495",1975-04-01,1974,"Red Star FC","Angers SCO","2-5",2,5,"1",1,7,-3,"D"
"11496",1975-04-04,1974,"Olympique Lyon","AS Saint-Etienne","1-0",1,0,"1",1,1,1,"H"
"11497",1975-04-05,1974,"Olympique Marseille","Nimes Olympique","1-1",1,1,"1",1,2,0,"D"
"11498",1975-04-05,1974,"SC Bastia","FC Nantes","1-0",1,0,"1",1,1,1,"H"
"11499",1975-04-05,1974,"Stade Rennes","AS Monaco","1-1",1,1,"1",1,2,0,"D"
"11500",1975-04-05,1974,"Stade Reims","Red Star FC","1-1",1,1,"1",1,2,0,"D"
"11501",1975-04-05,1974,"RC Lens","Troyes AF","1-0",1,0,"1",1,1,1,"H"
"11502",1975-04-05,1974,"Paris Saint-Germain","Girondins Bordeaux","1-0",1,0,"1",1,1,1,"H"
"11503",1975-04-05,1974,"FC Metz","RC Strasbourg","2-1",2,1,"1",1,3,1,"H"
"11504",1975-04-05,1974,"OGC Nice","FC Sochaux","5-1",5,1,"1",1,6,4,"H"
"11505",1975-04-05,1974,"Angers SCO","Lille OSC","4-1",4,1,"1",1,5,3,"H"
"11506",1975-04-19,1974,"Girondins Bordeaux","Olympique Marseille","1-0",1,0,"1",1,1,1,"H"
"11507",1975-04-19,1974,"FC Nantes","Troyes AF","4-1",4,1,"1",1,5,3,"H"
"11508",1975-04-19,1974,"Nimes Olympique","Paris Saint-Germain","2-1",2,1,"1",1,3,1,"H"
"11509",1975-04-19,1974,"AS Monaco","RC Lens","3-0",3,0,"1",1,3,3,"H"
"11510",1975-04-19,1974,"Olympique Lyon","Red Star FC","2-1",2,1,"1",1,3,1,"H"
"11511",1975-04-19,1974,"Stade Reims","FC Metz","1-2",1,2,"1",1,3,-1,"D"
"11512",1975-04-19,1974,"RC Strasbourg","Stade Rennes","2-0",2,0,"1",1,2,2,"H"
"11513",1975-04-19,1974,"Lille OSC","OGC Nice","4-2",4,2,"1",1,6,2,"H"
"11514",1975-04-19,1974,"FC Sochaux","Angers SCO","0-1",0,1,"1",1,1,-1,"D"
"11515",1975-04-30,1974,"Paris Saint-Germain","AS Saint-Etienne","2-2",2,2,"1",1,4,0,"D"
"11516",1975-04-30,1974,"Olympique Marseille","FC Nantes","2-1",2,1,"1",1,3,1,"H"
"11517",1975-04-30,1974,"Olympique Lyon","RC Strasbourg","4-1",4,1,"1",1,5,3,"H"
"11518",1975-04-30,1974,"SC Bastia","Red Star FC","2-0",2,0,"1",1,2,2,"H"
"11519",1975-04-30,1974,"RC Lens","Nimes Olympique","3-0",3,0,"1",1,3,3,"H"
"11520",1975-04-30,1974,"Angers SCO","AS Monaco","2-1",2,1,"1",1,3,1,"H"
"11521",1975-04-30,1974,"OGC Nice","Stade Reims","0-0",0,0,"1",1,0,0,"D"
"11522",1975-04-30,1974,"Troyes AF","Girondins Bordeaux","1-0",1,0,"1",1,1,1,"H"
"11523",1975-04-30,1974,"FC Metz","Lille OSC","2-1",2,1,"1",1,3,1,"H"
"11524",1975-04-30,1974,"Stade Rennes","FC Sochaux","0-1",0,1,"1",1,1,-1,"D"
"11525",1975-05-03,1974,"AS Saint-Etienne","Olympique Marseille","4-1",4,1,"1",1,5,3,"H"
"11526",1975-05-03,1974,"FC Nantes","RC Lens","2-1",2,1,"1",1,3,1,"H"
"11527",1975-05-03,1974,"AS Monaco","Girondins Bordeaux","2-0",2,0,"1",1,2,2,"H"
"11528",1975-05-03,1974,"FC Sochaux","Olympique Lyon","3-1",3,1,"1",1,4,2,"H"
"11529",1975-05-03,1974,"Nimes Olympique","Troyes AF","2-2",2,2,"1",1,4,0,"D"
"11530",1975-05-03,1974,"RC Strasbourg","SC Bastia","3-2",3,2,"1",1,5,1,"H"
"11531",1975-05-03,1974,"Stade Reims","Angers SCO","1-1",1,1,"1",1,2,0,"D"
"11532",1975-05-03,1974,"Red Star FC","Paris Saint-Germain","1-1",1,1,"1",1,2,0,"D"
"11533",1975-05-03,1974,"FC Metz","OGC Nice","2-2",2,2,"1",1,4,0,"D"
"11534",1975-05-03,1974,"Lille OSC","Stade Rennes","1-0",1,0,"1",1,1,1,"H"
"11535",1975-05-16,1974,"FC Nantes","FC Metz","0-2",0,2,"1",1,2,-2,"D"
"11536",1975-05-16,1974,"Girondins Bordeaux","SC Bastia","1-0",1,0,"1",1,1,1,"H"
"11537",1975-05-16,1974,"AS Saint-Etienne","OGC Nice","2-0",2,0,"1",1,2,2,"H"
"11538",1975-05-21,1974,"AS Saint-Etienne","SC Bastia","3-2",3,2,"1",1,5,1,"H"
"11539",1975-05-30,1974,"RC Lens","AS Saint-Etienne","3-1",3,1,"1",1,4,2,"H"
"11540",1975-05-30,1974,"Olympique Marseille","Red Star FC","3-2",3,2,"1",1,5,1,"H"
"11541",1975-05-30,1974,"Olympique Lyon","Lille OSC","5-1",5,1,"1",1,6,4,"H"
"11542",1975-05-30,1974,"OGC Nice","FC Nantes","2-2",2,2,"1",1,4,0,"D"
"11543",1975-05-30,1974,"Girondins Bordeaux","Nimes Olympique","0-1",0,1,"1",1,1,-1,"D"
"11544",1975-05-30,1974,"SC Bastia","FC Sochaux","4-2",4,2,"1",1,6,2,"H"
"11545",1975-05-30,1974,"Troyes AF","AS Monaco","5-0",5,0,"1",1,5,5,"H"
"11546",1975-05-30,1974,"Stade Rennes","Stade Reims","2-2",2,2,"1",1,4,0,"D"
"11547",1975-05-30,1974,"Angers SCO","FC Metz","2-2",2,2,"1",1,4,0,"D"
"11548",1975-05-30,1974,"Paris Saint-Germain","RC Strasbourg","1-1",1,1,"1",1,2,0,"D"
"11549",1975-06-03,1974,"AS Saint-Etienne","Troyes AF","5-1",5,1,"1",1,6,4,"H"
"11550",1975-06-03,1974,"RC Strasbourg","Olympique Marseille","3-2",3,2,"1",1,5,1,"H"
"11551",1975-06-03,1974,"Stade Reims","Olympique Lyon","0-2",0,2,"1",1,2,-2,"D"
"11552",1975-06-03,1974,"FC Nantes","Girondins Bordeaux","3-0",3,0,"1",1,3,3,"H"
"11553",1975-06-03,1974,"Nimes Olympique","AS Monaco","3-0",3,0,"1",1,3,3,"H"
"11554",1975-06-03,1974,"Lille OSC","SC Bastia","0-0",0,0,"1",1,0,0,"D"
"11555",1975-06-03,1974,"Red Star FC","RC Lens","1-1",1,1,"1",1,2,0,"D"
"11556",1975-06-03,1974,"FC Metz","Stade Rennes","5-2",5,2,"1",1,7,3,"H"
"11557",1975-06-03,1974,"OGC Nice","Angers SCO","4-1",4,1,"1",1,5,3,"H"
"11558",1975-06-03,1974,"Paris Saint-Germain","FC Sochaux","0-1",0,1,"1",1,1,-1,"D"
"11559",1975-08-07,1975,"Lille OSC","AS Monaco","3-3",3,3,"1",1,6,0,"D"
"11560",1975-08-08,1975,"Nimes Olympique","FC Nantes","0-0",0,0,"1",1,0,0,"D"
"11561",1975-08-08,1975,"Girondins Bordeaux","RC Strasbourg","1-1",1,1,"1",1,2,0,"D"
"11562",1975-08-08,1975,"RC Lens","FC Metz","4-1",4,1,"1",1,5,3,"H"
"11563",1975-08-08,1975,"SC Bastia","Paris Saint-Germain","3-0",3,0,"1",1,3,3,"H"
"11564",1975-08-08,1975,"OGC Nice","FC Sochaux","3-0",3,0,"1",1,3,3,"H"
"11565",1975-08-08,1975,"Olympique Marseille","Association Sportive Avignonaise","3-1",3,1,"1",1,4,2,"H"
"11566",1975-08-08,1975,"Troyes AF","Olympique Lyon","3-4",3,4,"1",1,7,-1,"D"
"11567",1975-08-08,1975,"AS Saint-Etienne","Stade Reims","2-1",2,1,"1",1,3,1,"H"
"11568",1975-08-08,1975,"AS Nancy","US Valenciennes-Anzin","3-3",3,3,"1",1,6,0,"D"
"11569",1975-08-13,1975,"Association Sportive Avignonaise","OGC Nice","1-5",1,5,"1",1,6,-4,"D"
"11570",1975-08-13,1975,"RC Lens","Olympique Marseille","2-3",2,3,"1",1,5,-1,"D"
"11571",1975-08-13,1975,"SC Bastia","Lille OSC","1-1",1,1,"1",1,2,0,"D"
"11572",1975-08-13,1975,"Olympique Lyon","US Valenciennes-Anzin","1-1",1,1,"1",1,2,0,"D"
"11573",1975-08-13,1975,"FC Metz","AS Saint-Etienne","1-1",1,1,"1",1,2,0,"D"
"11574",1975-08-13,1975,"RC Strasbourg","Nimes Olympique","0-1",0,1,"1",1,1,-1,"D"
"11575",1975-08-13,1975,"FC Sochaux","AS Nancy","3-0",3,0,"1",1,3,3,"H"
"11576",1975-08-13,1975,"Stade Reims","Paris Saint-Germain","1-1",1,1,"1",1,2,0,"D"
"11577",1975-08-13,1975,"FC Nantes","Troyes AF","2-2",2,2,"1",1,4,0,"D"
"11578",1975-08-14,1975,"AS Monaco","Girondins Bordeaux","1-1",1,1,"1",1,2,0,"D"
"11579",1975-08-22,1975,"OGC Nice","AS Monaco","4-1",4,1,"1",1,5,3,"H"
"11580",1975-08-22,1975,"Olympique Marseille","FC Metz","2-1",2,1,"1",1,3,1,"H"
"11581",1975-08-22,1975,"AS Nancy","Olympique Lyon","1-4",1,4,"1",1,5,-3,"D"
"11582",1975-08-22,1975,"Nimes Olympique","SC Bastia","3-0",3,0,"1",1,3,3,"H"
"11583",1975-08-22,1975,"AS Saint-Etienne","RC Lens","2-0",2,0,"1",1,2,2,"H"
"11584",1975-08-22,1975,"Girondins Bordeaux","FC Sochaux","1-2",1,2,"1",1,3,-1,"D"
"11585",1975-08-22,1975,"Paris Saint-Germain","Association Sportive Avignonaise","6-2",6,2,"1",1,8,4,"H"
"11586",1975-08-22,1975,"Lille OSC","Stade Reims","2-2",2,2,"1",1,4,0,"D"
"11587",1975-08-22,1975,"US Valenciennes-Anzin","FC Nantes","1-1",1,1,"1",1,2,0,"D"
"11588",1975-08-22,1975,"Troyes AF","RC Strasbourg","1-1",1,1,"1",1,2,0,"D"
"11589",1975-08-27,1975,"AS Saint-Etienne","Girondins Bordeaux","5-2",5,2,"1",1,7,3,"H"
"11590",1975-08-27,1975,"FC Nantes","Olympique Lyon","2-3",2,3,"1",1,5,-1,"D"
"11591",1975-08-27,1975,"Stade Reims","Olympique Marseille","3-1",3,1,"1",1,4,2,"H"
"11592",1975-08-27,1975,"AS Monaco","Nimes Olympique","3-1",3,1,"1",1,4,2,"H"
"11593",1975-08-27,1975,"FC Sochaux","Troyes AF","2-2",2,2,"1",1,4,0,"D"
"11594",1975-08-27,1975,"RC Lens","Paris Saint-Germain","3-3",3,3,"1",1,6,0,"D"
"11595",1975-08-27,1975,"RC Strasbourg","US Valenciennes-Anzin","1-0",1,0,"1",1,1,1,"H"
"11596",1975-08-27,1975,"FC Metz","Lille OSC","5-2",5,2,"1",1,7,3,"H"
"11597",1975-08-27,1975,"Association Sportive Avignonaise","AS Nancy","2-3",2,3,"1",1,5,-1,"D"
"11598",1975-09-09,1975,"Olympique Lyon","RC Strasbourg","2-1",2,1,"1",1,3,1,"H"
"11599",1975-09-09,1975,"OGC Nice","Stade Reims","2-1",2,1,"1",1,3,1,"H"
"11600",1975-09-09,1975,"Olympique Marseille","AS Saint-Etienne","4-2",4,2,"1",1,6,2,"H"
"11601",1975-09-09,1975,"Nimes Olympique","FC Sochaux","0-2",0,2,"1",1,2,-2,"D"
"11602",1975-09-09,1975,"Paris Saint-Germain","FC Metz","3-1",3,1,"1",1,4,2,"H"
"11603",1975-09-09,1975,"Troyes AF","AS Monaco","3-1",3,1,"1",1,4,2,"H"
"11604",1975-09-09,1975,"US Valenciennes-Anzin","SC Bastia","3-1",3,1,"1",1,4,2,"H"
"11605",1975-09-09,1975,"Lille OSC","RC Lens","4-2",4,2,"1",1,6,2,"H"
"11606",1975-09-09,1975,"AS Nancy","FC Nantes","1-1",1,1,"1",1,2,0,"D"
"11607",1975-09-09,1975,"Girondins Bordeaux","Association Sportive Avignonaise","2-1",2,1,"1",1,3,1,"H"
"11608",1975-09-12,1975,"FC Metz","OGC Nice","2-2",2,2,"1",1,4,0,"D"
"11609",1975-09-12,1975,"FC Sochaux","Olympique Lyon","1-0",1,0,"1",1,1,1,"H"
"11610",1975-09-12,1975,"AS Saint-Etienne","Paris Saint-Germain","1-1",1,1,"1",1,2,0,"D"
"11611",1975-09-12,1975,"Olympique Marseille","AS Nancy","1-3",1,3,"1",1,4,-2,"D"
"11612",1975-09-12,1975,"AS Monaco","US Valenciennes-Anzin","3-1",3,1,"1",1,4,2,"H"
"11613",1975-09-12,1975,"Stade Reims","Girondins Bordeaux","0-0",0,0,"1",1,0,0,"D"
"11614",1975-09-12,1975,"RC Strasbourg","FC Nantes","1-1",1,1,"1",1,2,0,"D"
"11615",1975-09-12,1975,"Association Sportive Avignonaise","Lille OSC","1-0",1,0,"1",1,1,1,"H"
"11616",1975-09-13,1975,"RC Lens","Nimes Olympique","1-1",1,1,"1",1,2,0,"D"
"11617",1975-09-13,1975,"SC Bastia","Troyes AF","3-1",3,1,"1",1,4,2,"H"
"11618",1975-09-19,1975,"US Valenciennes-Anzin","FC Sochaux","3-0",3,0,"1",1,3,3,"H"
"11619",1975-09-20,1975,"OGC Nice","RC Lens","5-0",5,0,"1",1,5,5,"H"
"11620",1975-09-20,1975,"Olympique Lyon","AS Monaco","4-1",4,1,"1",1,5,3,"H"
"11621",1975-09-20,1975,"Paris Saint-Germain","Olympique Marseille","2-3",2,3,"1",1,5,-1,"D"
"11622",1975-09-20,1975,"Lille OSC","AS Saint-Etienne","0-0",0,0,"1",1,0,0,"D"
"11623",1975-09-20,1975,"Nimes Olympique","Stade Reims","0-3",0,3,"1",1,3,-3,"D"
"11624",1975-09-20,1975,"FC Nantes","SC Bastia","1-0",1,0,"1",1,1,1,"H"
"11625",1975-09-20,1975,"Girondins Bordeaux","FC Metz","3-1",3,1,"1",1,4,2,"H"
"11626",1975-09-20,1975,"AS Nancy","RC Strasbourg","1-1",1,1,"1",1,2,0,"D"
"11627",1975-09-20,1975,"Troyes AF","Association Sportive Avignonaise","1-1",1,1,"1",1,2,0,"D"
"11628",1975-09-25,1975,"AS Saint-Etienne","OGC Nice","1-1",1,1,"1",1,2,0,"D"
"11629",1975-09-26,1975,"Olympique Marseille","Troyes AF","3-2",3,2,"1",1,5,1,"H"
"11630",1975-09-26,1975,"Stade Reims","Olympique Lyon","3-2",3,2,"1",1,5,1,"H"
"11631",1975-09-26,1975,"FC Sochaux","RC Strasbourg","1-1",1,1,"1",1,2,0,"D"
"11632",1975-09-26,1975,"Association Sportive Avignonaise","US Valenciennes-Anzin","1-2",1,2,"1",1,3,-1,"D"
"11633",1975-09-26,1975,"Paris Saint-Germain","Lille OSC","2-2",2,2,"1",1,4,0,"D"
"11634",1975-09-26,1975,"AS Monaco","FC Nantes","4-4",4,4,"1",1,8,0,"D"
"11635",1975-09-26,1975,"SC Bastia","AS Nancy","3-0",3,0,"1",1,3,3,"H"
"11636",1975-09-26,1975,"RC Lens","Girondins Bordeaux","3-2",3,2,"1",1,5,1,"H"
"11637",1975-09-26,1975,"FC Metz","Nimes Olympique","4-3",4,3,"1",1,7,1,"H"
"11638",1975-09-30,1975,"SC Bastia","OGC Nice","1-1",1,1,"1",1,2,0,"D"
"11639",1975-10-03,1975,"RC Strasbourg","AS Monaco","1-0",1,0,"1",1,1,1,"H"
"11640",1975-10-04,1975,"OGC Nice","Paris Saint-Germain","2-1",2,1,"1",1,3,1,"H"
"11641",1975-10-04,1975,"Olympique Lyon","Association Sportive Avignonaise","2-0",2,0,"1",1,2,2,"H"
"11642",1975-10-04,1975,"Lille OSC","Olympique Marseille","4-3",4,3,"1",1,7,1,"H"
"11643",1975-10-04,1975,"FC Nantes","FC Sochaux","2-2",2,2,"1",1,4,0,"D"
"11644",1975-10-04,1975,"US Valenciennes-Anzin","RC Lens","1-1",1,1,"1",1,2,0,"D"
"11645",1975-10-04,1975,"Nimes Olympique","AS Saint-Etienne","2-0",2,0,"1",1,2,2,"H"
"11646",1975-10-04,1975,"Troyes AF","Stade Reims","2-1",2,1,"1",1,3,1,"H"
"11647",1975-10-04,1975,"Girondins Bordeaux","SC Bastia","3-0",3,0,"1",1,3,3,"H"
"11648",1975-10-04,1975,"AS Nancy","FC Metz","0-0",0,0,"1",1,0,0,"D"
"11649",1975-10-16,1975,"RC Lens","Troyes AF","1-1",1,1,"1",1,2,0,"D"
"11650",1975-10-17,1975,"Olympique Marseille","OGC Nice","2-1",2,1,"1",1,3,1,"H"
"11651",1975-10-17,1975,"Lille OSC","Olympique Lyon","2-1",2,1,"1",1,3,1,"H"
"11652",1975-10-17,1975,"AS Monaco","FC Sochaux","0-0",0,0,"1",1,0,0,"D"
"11653",1975-10-17,1975,"AS Saint-Etienne","FC Nantes","2-2",2,2,"1",1,4,0,"D"
"11654",1975-10-17,1975,"Stade Reims","AS Nancy","1-1",1,1,"1",1,2,0,"D"
"11655",1975-10-17,1975,"Paris Saint-Germain","Girondins Bordeaux","2-2",2,2,"1",1,4,0,"D"
"11656",1975-10-17,1975,"FC Metz","US Valenciennes-Anzin","3-0",3,0,"1",1,3,3,"H"
"11657",1975-10-17,1975,"SC Bastia","RC Strasbourg","2-1",2,1,"1",1,3,1,"H"
"11658",1975-10-17,1975,"Association Sportive Avignonaise","Nimes Olympique","1-0",1,0,"1",1,1,1,"H"
"11659",1975-10-25,1975,"OGC Nice","Lille OSC","2-2",2,2,"1",1,4,0,"D"
"11660",1975-10-25,1975,"Olympique Lyon","AS Saint-Etienne","0-0",0,0,"1",1,0,0,"D"
"11661",1975-10-25,1975,"Girondins Bordeaux","Olympique Marseille","3-1",3,1,"1",1,4,2,"H"
"11662",1975-10-25,1975,"FC Sochaux","SC Bastia","2-2",2,2,"1",1,4,0,"D"
"11663",1975-10-25,1975,"FC Nantes","Association Sportive Avignonaise","4-0",4,0,"1",1,4,4,"H"
"11664",1975-10-25,1975,"US Valenciennes-Anzin","Stade Reims","2-1",2,1,"1",1,3,1,"H"
"11665",1975-10-25,1975,"Troyes AF","FC Metz","0-1",0,1,"1",1,1,-1,"D"
"11666",1975-10-25,1975,"AS Nancy","AS Monaco","3-0",3,0,"1",1,3,3,"H"
"11667",1975-10-25,1975,"RC Strasbourg","RC Lens","1-1",1,1,"1",1,2,0,"D"
"11668",1975-10-25,1975,"Nimes Olympique","Paris Saint-Germain","2-1",2,1,"1",1,3,1,"H"
"11669",1975-10-31,1975,"OGC Nice","Girondins Bordeaux","2-0",2,0,"1",1,2,2,"H"
"11670",1975-10-31,1975,"RC Lens","Olympique Lyon","3-1",3,1,"1",1,4,2,"H"
"11671",1975-10-31,1975,"AS Saint-Etienne","US Valenciennes-Anzin","2-0",2,0,"1",1,2,2,"H"
"11672",1975-10-31,1975,"Olympique Marseille","Nimes Olympique","0-1",0,1,"1",1,1,-1,"D"
"11673",1975-10-31,1975,"FC Metz","FC Nantes","3-0",3,0,"1",1,3,3,"H"
"11674",1975-10-31,1975,"SC Bastia","AS Monaco","3-0",3,0,"1",1,3,3,"H"
"11675",1975-10-31,1975,"Association Sportive Avignonaise","FC Sochaux","3-1",3,1,"1",1,4,2,"H"
"11676",1975-10-31,1975,"Stade Reims","RC Strasbourg","6-0",6,0,"1",1,6,6,"H"
"11677",1975-10-31,1975,"Paris Saint-Germain","Troyes AF","1-0",1,0,"1",1,1,1,"H"
"11678",1975-11-03,1975,"Lille OSC","AS Nancy","1-2",1,2,"1",1,3,-1,"D"
"11679",1975-11-08,1975,"Nimes Olympique","OGC Nice","2-1",2,1,"1",1,3,1,"H"
"11680",1975-11-08,1975,"Troyes AF","AS Saint-Etienne","0-1",0,1,"1",1,1,-1,"D"
"11681",1975-11-08,1975,"Olympique Lyon","SC Bastia","2-2",2,2,"1",1,4,0,"D"
"11682",1975-11-08,1975,"RC Strasbourg","FC Metz","1-2",1,2,"1",1,3,-1,"D"
"11683",1975-11-08,1975,"FC Sochaux","RC Lens","3-2",3,2,"1",1,5,1,"H"
"11684",1975-11-08,1975,"FC Nantes","Stade Reims","4-1",4,1,"1",1,5,3,"H"
"11685",1975-11-08,1975,"Girondins Bordeaux","Lille OSC","2-1",2,1,"1",1,3,1,"H"
"11686",1975-11-08,1975,"US Valenciennes-Anzin","Olympique Marseille","1-0",1,0,"1",1,1,1,"H"
"11687",1975-11-08,1975,"AS Nancy","Paris Saint-Germain","2-4",2,4,"1",1,6,-2,"D"
"11688",1975-11-08,1975,"AS Monaco","Association Sportive Avignonaise","1-0",1,0,"1",1,1,1,"H"
"11689",1975-11-18,1975,"Lille OSC","Nimes Olympique","2-1",2,1,"1",1,3,1,"H"
"11690",1975-11-19,1975,"OGC Nice","AS Nancy","2-1",2,1,"1",1,3,1,"H"
"11691",1975-11-19,1975,"AS Saint-Etienne","RC Strasbourg","2-1",2,1,"1",1,3,1,"H"
"11692",1975-11-19,1975,"FC Metz","FC Sochaux","3-1",3,1,"1",1,4,2,"H"
"11693",1975-11-19,1975,"Olympique Marseille","Olympique Lyon","2-0",2,0,"1",1,2,2,"H"
"11694",1975-11-19,1975,"Paris Saint-Germain","US Valenciennes-Anzin","2-0",2,0,"1",1,2,2,"H"
"11695",1975-11-19,1975,"Association Sportive Avignonaise","SC Bastia","1-1",1,1,"1",1,2,0,"D"
"11696",1975-11-19,1975,"Girondins Bordeaux","Troyes AF","2-2",2,2,"1",1,4,0,"D"
"11697",1975-11-19,1975,"RC Lens","FC Nantes","3-2",3,2,"1",1,5,1,"H"
"11698",1975-11-19,1975,"Stade Reims","AS Monaco","2-2",2,2,"1",1,4,0,"D"
"11699",1975-11-22,1975,"Troyes AF","OGC Nice","2-2",2,2,"1",1,4,0,"D"
"11700",1975-11-22,1975,"AS Nancy","AS Saint-Etienne","0-0",0,0,"1",1,0,0,"D"
"11701",1975-11-22,1975,"FC Nantes","Olympique Marseille","0-1",0,1,"1",1,1,-1,"D"
"11702",1975-11-22,1975,"Olympique Lyon","Paris Saint-Germain","2-0",2,0,"1",1,2,2,"H"
"11703",1975-11-22,1975,"AS Monaco","FC Metz","2-0",2,0,"1",1,2,2,"H"
"11704",1975-11-22,1975,"Nimes Olympique","Girondins Bordeaux","1-2",1,2,"1",1,3,-1,"D"
"11705",1975-11-22,1975,"SC Bastia","RC Lens","0-0",0,0,"1",1,0,0,"D"
"11706",1975-11-22,1975,"RC Strasbourg","Association Sportive Avignonaise","4-0",4,0,"1",1,4,4,"H"
"11707",1975-11-23,1975,"FC Sochaux","Stade Reims","1-0",1,0,"1",1,1,1,"H"
"11708",1975-11-23,1975,"US Valenciennes-Anzin","Lille OSC","0-1",0,1,"1",1,1,-1,"D"
"11709",1975-11-26,1975,"OGC Nice","US Valenciennes-Anzin","1-0",1,0,"1",1,1,1,"H"
"11710",1975-11-26,1975,"AS Saint-Etienne","FC Sochaux","2-0",2,0,"1",1,2,2,"H"
"11711",1975-11-26,1975,"Olympique Marseille","RC Strasbourg","1-0",1,0,"1",1,1,1,"H"
"11712",1975-11-26,1975,"FC Metz","SC Bastia","4-1",4,1,"1",1,5,3,"H"
"11713",1975-11-26,1975,"Lille OSC","Troyes AF","3-0",3,0,"1",1,3,3,"H"
"11714",1975-11-26,1975,"Girondins Bordeaux","AS Nancy","0-0",0,0,"1",1,0,0,"D"
"11715",1975-11-26,1975,"Paris Saint-Germain","FC Nantes","2-1",2,1,"1",1,3,1,"H"
"11716",1975-11-26,1975,"Nimes Olympique","Olympique Lyon","2-0",2,0,"1",1,2,2,"H"
"11717",1975-11-26,1975,"RC Lens","AS Monaco","3-0",3,0,"1",1,3,3,"H"
"11718",1975-11-26,1975,"Stade Reims","Association Sportive Avignonaise","4-1",4,1,"1",1,5,3,"H"
"11719",1975-11-29,1975,"Olympique Lyon","OGC Nice","1-0",1,0,"1",1,1,1,"H"
"11720",1975-11-29,1975,"SC Bastia","Stade Reims","2-0",2,0,"1",1,2,2,"H"
"11721",1975-11-29,1975,"FC Nantes","Lille OSC","4-0",4,0,"1",1,4,4,"H"
"11722",1975-11-29,1975,"Troyes AF","Nimes Olympique","1-1",1,1,"1",1,2,0,"D"
"11723",1975-11-29,1975,"AS Nancy","RC Lens","3-0",3,0,"1",1,3,3,"H"
"11724",1975-11-30,1975,"AS Monaco","AS Saint-Etienne","0-3",0,3,"1",1,3,-3,"D"
"11725",1975-11-30,1975,"Association Sportive Avignonaise","FC Metz","0-1",0,1,"1",1,1,-1,"D"
"11726",1975-11-30,1975,"FC Sochaux","Olympique Marseille","3-0",3,0,"1",1,3,3,"H"
"11727",1975-11-30,1975,"US Valenciennes-Anzin","Girondins Bordeaux","1-1",1,1,"1",1,2,0,"D"
"11728",1975-11-30,1975,"RC Strasbourg","Paris Saint-Germain","1-0",1,0,"1",1,1,1,"H"
"11729",1975-12-05,1975,"Lille OSC","RC Strasbourg","3-0",3,0,"1",1,3,3,"H"
"11730",1975-12-06,1975,"FC Metz","Stade Reims","2-4",2,4,"1",1,6,-2,"D"
"11731",1975-12-06,1975,"Girondins Bordeaux","Olympique Lyon","3-1",3,1,"1",1,4,2,"H"
"11732",1975-12-06,1975,"RC Lens","Association Sportive Avignonaise","3-1",3,1,"1",1,4,2,"H"
"11733",1975-12-06,1975,"Troyes AF","AS Nancy","3-0",3,0,"1",1,3,3,"H"
"11734",1975-12-07,1975,"AS Saint-Etienne","SC Bastia","4-2",4,2,"1",1,6,2,"H"
"11735",1975-12-07,1975,"OGC Nice","FC Nantes","2-2",2,2,"1",1,4,0,"D"
"11736",1975-12-07,1975,"Olympique Marseille","AS Monaco","1-0",1,0,"1",1,1,1,"H"
"11737",1975-12-07,1975,"Paris Saint-Germain","FC Sochaux","2-3",2,3,"1",1,5,-1,"D"
"11738",1975-12-07,1975,"Nimes Olympique","US Valenciennes-Anzin","1-0",1,0,"1",1,1,1,"H"
"11739",1975-12-13,1975,"Association Sportive Avignonaise","AS Saint-Etienne","1-3",1,3,"1",1,4,-2,"D"
"11740",1975-12-13,1975,"RC Strasbourg","OGC Nice","2-2",2,2,"1",1,4,0,"D"
"11741",1975-12-13,1975,"Olympique Lyon","FC Metz","2-3",2,3,"1",1,5,-1,"D"
"11742",1975-12-13,1975,"Stade Reims","RC Lens","4-0",4,0,"1",1,4,4,"H"
"11743",1975-12-13,1975,"US Valenciennes-Anzin","Troyes AF","3-0",3,0,"1",1,3,3,"H"
"11744",1975-12-14,1975,"SC Bastia","Olympique Marseille","2-3",2,3,"1",1,5,-1,"D"
"11745",1975-12-14,1975,"FC Sochaux","Lille OSC","4-1",4,1,"1",1,5,3,"H"
"11746",1975-12-14,1975,"FC Nantes","Girondins Bordeaux","5-1",5,1,"1",1,6,4,"H"
"11747",1975-12-14,1975,"AS Nancy","Nimes Olympique","1-1",1,1,"1",1,2,0,"D"
"11748",1975-12-14,1975,"AS Monaco","Paris Saint-Germain","3-0",3,0,"1",1,3,3,"H"
"11749",1975-12-20,1975,"Girondins Bordeaux","AS Monaco","3-1",3,1,"1",1,4,2,"H"
"11750",1975-12-20,1975,"Nimes Olympique","RC Strasbourg","2-1",2,1,"1",1,3,1,"H"
"11751",1975-12-20,1975,"Lille OSC","SC Bastia","2-0",2,0,"1",1,2,2,"H"
"11752",1975-12-20,1975,"Troyes AF","FC Nantes","0-0",0,0,"1",1,0,0,"D"
"11753",1975-12-20,1975,"US Valenciennes-Anzin","Olympique Lyon","0-0",0,0,"1",1,0,0,"D"
"11754",1975-12-21,1975,"AS Saint-Etienne","FC Metz","1-0",1,0,"1",1,1,1,"H"
"11755",1975-12-21,1975,"OGC Nice","Association Sportive Avignonaise","2-0",2,0,"1",1,2,2,"H"
"11756",1975-12-21,1975,"Olympique Marseille","RC Lens","3-2",3,2,"1",1,5,1,"H"
"11757",1975-12-21,1975,"AS Nancy","FC Sochaux","5-1",5,1,"1",1,6,4,"H"
"11758",1975-12-21,1975,"Paris Saint-Germain","Stade Reims","2-3",2,3,"1",1,5,-1,"D"
"11759",1976-01-17,1975,"RC Lens","AS Saint-Etienne","1-1",1,1,"1",1,2,0,"D"
"11760",1976-01-17,1975,"FC Metz","Olympique Marseille","1-0",1,0,"1",1,1,1,"H"
"11761",1976-01-17,1975,"FC Sochaux","Girondins Bordeaux","2-0",2,0,"1",1,2,2,"H"
"11762",1976-01-17,1975,"FC Nantes","US Valenciennes-Anzin","2-0",2,0,"1",1,2,2,"H"
"11763",1976-01-18,1975,"AS Monaco","OGC Nice","4-1",4,1,"1",1,5,3,"H"
"11764",1976-01-18,1975,"SC Bastia","Nimes Olympique","1-1",1,1,"1",1,2,0,"D"
"11765",1976-01-18,1975,"Olympique Lyon","AS Nancy","1-0",1,0,"1",1,1,1,"H"
"11766",1976-01-18,1975,"Association Sportive Avignonaise","Paris Saint-Germain","1-1",1,1,"1",1,2,0,"D"
"11767",1976-01-18,1975,"RC Strasbourg","Troyes AF","2-1",2,1,"1",1,3,1,"H"
"11768",1976-01-24,1975,"Lille OSC","FC Metz","1-1",1,1,"1",1,2,0,"D"
"11769",1976-01-24,1975,"Troyes AF","FC Sochaux","3-0",3,0,"1",1,3,3,"H"
"11770",1976-01-24,1975,"US Valenciennes-Anzin","RC Strasbourg","2-0",2,0,"1",1,2,2,"H"
"11771",1976-01-25,1975,"Girondins Bordeaux","AS Saint-Etienne","1-1",1,1,"1",1,2,0,"D"
"11772",1976-01-25,1975,"OGC Nice","SC Bastia","1-1",1,1,"1",1,2,0,"D"
"11773",1976-01-25,1975,"Olympique Marseille","Stade Reims","1-0",1,0,"1",1,1,1,"H"
"11774",1976-01-25,1975,"Nimes Olympique","AS Monaco","3-2",3,2,"1",1,5,1,"H"
"11775",1976-01-25,1975,"Olympique Lyon","FC Nantes","3-3",3,3,"1",1,6,0,"D"
"11776",1976-01-25,1975,"AS Nancy","Association Sportive Avignonaise","6-0",6,0,"1",1,6,6,"H"
"11777",1976-01-25,1975,"Paris Saint-Germain","RC Lens","4-2",4,2,"1",1,6,2,"H"
"11778",1976-01-28,1975,"Stade Reims","Lille OSC","2-0",2,0,"1",1,2,2,"H"
"11779",1976-02-06,1975,"RC Strasbourg","Olympique Lyon","5-0",5,0,"1",1,5,5,"H"
"11780",1976-02-07,1975,"FC Sochaux","Nimes Olympique","2-1",2,1,"1",1,3,1,"H"
"11781",1976-02-07,1975,"FC Metz","Paris Saint-Germain","1-2",1,2,"1",1,3,-1,"D"
"11782",1976-02-07,1975,"FC Nantes","AS Nancy","3-0",3,0,"1",1,3,3,"H"
"11783",1976-02-07,1975,"RC Lens","Lille OSC","2-0",2,0,"1",1,2,2,"H"
"11784",1976-02-08,1975,"AS Saint-Etienne","Olympique Marseille","1-0",1,0,"1",1,1,1,"H"
"11785",1976-02-08,1975,"Stade Reims","OGC Nice","1-0",1,0,"1",1,1,1,"H"
"11786",1976-02-08,1975,"Association Sportive Avignonaise","Girondins Bordeaux","3-4",3,4,"1",1,7,-1,"D"
"11787",1976-02-08,1975,"SC Bastia","US Valenciennes-Anzin","1-1",1,1,"1",1,2,0,"D"
"11788",1976-02-08,1975,"AS Monaco","Troyes AF","1-1",1,1,"1",1,2,0,"D"
"11789",1976-02-14,1975,"FC Nantes","RC Strasbourg","2-1",2,1,"1",1,3,1,"H"
"11790",1976-02-14,1975,"US Valenciennes-Anzin","AS Monaco","5-1",5,1,"1",1,6,4,"H"
"11791",1976-02-14,1975,"Troyes AF","SC Bastia","0-2",0,2,"1",1,2,-2,"D"
"11792",1976-02-15,1975,"Paris Saint-Germain","AS Saint-Etienne","2-1",2,1,"1",1,3,1,"H"
"11793",1976-02-15,1975,"OGC Nice","FC Metz","4-2",4,2,"1",1,6,2,"H"
"11794",1976-02-15,1975,"Olympique Lyon","FC Sochaux","1-2",1,2,"1",1,3,-1,"D"
"11795",1976-02-15,1975,"AS Nancy","Olympique Marseille","4-2",4,2,"1",1,6,2,"H"
"11796",1976-02-15,1975,"Girondins Bordeaux","Stade Reims","2-3",2,3,"1",1,5,-1,"D"
"11797",1976-02-15,1975,"Nimes Olympique","RC Lens","2-2",2,2,"1",1,4,0,"D"
"11798",1976-02-15,1975,"Lille OSC","Association Sportive Avignonaise","4-0",4,0,"1",1,4,4,"H"
"11799",1976-02-21,1975,"FC Sochaux","US Valenciennes-Anzin","3-0",3,0,"1",1,3,3,"H"
"11800",1976-02-21,1975,"RC Lens","OGC Nice","2-1",2,1,"1",1,3,1,"H"
"11801",1976-02-21,1975,"Stade Reims","Nimes Olympique","2-0",2,0,"1",1,2,2,"H"
"11802",1976-02-21,1975,"SC Bastia","FC Nantes","0-1",0,1,"1",1,1,-1,"D"
"11803",1976-02-21,1975,"FC Metz","Girondins Bordeaux","2-1",2,1,"1",1,3,1,"H"
"11804",1976-02-21,1975,"RC Strasbourg","AS Nancy","1-5",1,5,"1",1,6,-4,"D"
"11805",1976-02-21,1975,"Association Sportive Avignonaise","Troyes AF","0-1",0,1,"1",1,1,-1,"D"
"11806",1976-02-22,1975,"AS Saint-Etienne","Lille OSC","3-1",3,1,"1",1,4,2,"H"
"11807",1976-02-22,1975,"Olympique Marseille","Paris Saint-Germain","2-1",2,1,"1",1,3,1,"H"
"11808",1976-02-22,1975,"AS Monaco","Olympique Lyon","1-0",1,0,"1",1,1,1,"H"
"11809",1976-03-11,1975,"OGC Nice","AS Saint-Etienne","1-1",1,1,"1",1,2,0,"D"
"11810",1976-03-12,1975,"RC Strasbourg","FC Sochaux","0-0",0,0,"1",1,0,0,"D"
"11811",1976-03-12,1975,"FC Nantes","AS Monaco","3-1",3,1,"1",1,4,2,"H"
"11812",1976-03-12,1975,"Olympique Lyon","Stade Reims","1-2",1,2,"1",1,3,-1,"D"
"11813",1976-03-12,1975,"Troyes AF","Olympique Marseille","2-2",2,2,"1",1,4,0,"D"
"11814",1976-03-12,1975,"Nimes Olympique","FC Metz","3-2",3,2,"1",1,5,1,"H"
"11815",1976-03-12,1975,"Lille OSC","Paris Saint-Germain","2-1",2,1,"1",1,3,1,"H"
"11816",1976-03-12,1975,"Girondins Bordeaux","RC Lens","2-2",2,2,"1",1,4,0,"D"
"11817",1976-03-12,1975,"AS Nancy","SC Bastia","0-1",0,1,"1",1,1,-1,"D"
"11818",1976-03-12,1975,"US Valenciennes-Anzin","Association Sportive Avignonaise","2-0",2,0,"1",1,2,2,"H"
"11819",1976-03-16,1975,"Olympique Marseille","Lille OSC","2-0",2,0,"1",1,2,2,"H"
"11820",1976-03-16,1975,"FC Sochaux","FC Nantes","1-1",1,1,"1",1,2,0,"D"
"11821",1976-03-16,1975,"Stade Reims","Troyes AF","1-1",1,1,"1",1,2,0,"D"
"11822",1976-03-16,1975,"Paris Saint-Germain","OGC Nice","0-0",0,0,"1",1,0,0,"D"
"11823",1976-03-16,1975,"FC Metz","AS Nancy","4-1",4,1,"1",1,5,3,"H"
"11824",1976-03-16,1975,"RC Lens","US Valenciennes-Anzin","0-1",0,1,"1",1,1,-1,"D"
"11825",1976-03-16,1975,"Association Sportive Avignonaise","Olympique Lyon","2-1",2,1,"1",1,3,1,"H"
"11826",1976-03-20,1975,"FC Nantes","AS Saint-Etienne","3-0",3,0,"1",1,3,3,"H"
"11827",1976-03-20,1975,"FC Sochaux","AS Monaco","4-0",4,0,"1",1,4,4,"H"
"11828",1976-03-20,1975,"OGC Nice","Olympique Marseille","2-1",2,1,"1",1,3,1,"H"
"11829",1976-03-20,1975,"AS Nancy","Stade Reims","3-1",3,1,"1",1,4,2,"H"
"11830",1976-03-20,1975,"US Valenciennes-Anzin","FC Metz","3-0",3,0,"1",1,3,3,"H"
"11831",1976-03-20,1975,"Nimes Olympique","Association Sportive Avignonaise","1-0",1,0,"1",1,1,1,"H"
"11832",1976-03-20,1975,"Girondins Bordeaux","Paris Saint-Germain","2-1",2,1,"1",1,3,1,"H"
"11833",1976-03-20,1975,"RC Strasbourg","SC Bastia","1-3",1,3,"1",1,4,-2,"D"
"11834",1976-03-20,1975,"Olympique Lyon","Lille OSC","3-0",3,0,"1",1,3,3,"H"
"11835",1976-03-20,1975,"Troyes AF","RC Lens","1-1",1,1,"1",1,2,0,"D"
"11836",1976-03-30,1975,"Association Sportive Avignonaise","FC Nantes","0-2",0,2,"1",1,2,-2,"D"
"11837",1976-03-30,1975,"Lille OSC","OGC Nice","0-3",0,3,"1",1,3,-3,"D"
"11838",1976-03-30,1975,"SC Bastia","FC Sochaux","1-1",1,1,"1",1,2,0,"D"
"11839",1976-03-30,1975,"Olympique Marseille","Girondins Bordeaux","1-0",1,0,"1",1,1,1,"H"
"11840",1976-03-30,1975,"Stade Reims","US Valenciennes-Anzin","5-1",5,1,"1",1,6,4,"H"
"11841",1976-03-30,1975,"FC Metz","Troyes AF","0-1",0,1,"1",1,1,-1,"D"
"11842",1976-03-30,1975,"Paris Saint-Germain","Nimes Olympique","2-0",2,0,"1",1,2,2,"H"
"11843",1976-03-30,1975,"AS Monaco","AS Nancy","1-0",1,0,"1",1,1,1,"H"
"11844",1976-03-30,1975,"RC Lens","RC Strasbourg","1-1",1,1,"1",1,2,0,"D"
"11845",1976-04-02,1975,"FC Nantes","FC Metz","2-0",2,0,"1",1,2,2,"H"
"11846",1976-04-02,1975,"FC Sochaux","Association Sportive Avignonaise","1-1",1,1,"1",1,2,0,"D"
"11847",1976-04-02,1975,"Nimes Olympique","Olympique Marseille","0-1",0,1,"1",1,1,-1,"D"
"11848",1976-04-02,1975,"Girondins Bordeaux","OGC Nice","1-0",1,0,"1",1,1,1,"H"
"11849",1976-04-02,1975,"RC Strasbourg","Stade Reims","1-1",1,1,"1",1,2,0,"D"
"11850",1976-04-02,1975,"AS Nancy","Lille OSC","5-0",5,0,"1",1,5,5,"H"
"11851",1976-04-02,1975,"Troyes AF","Paris Saint-Germain","1-1",1,1,"1",1,2,0,"D"
"11852",1976-04-02,1975,"AS Monaco","SC Bastia","2-0",2,0,"1",1,2,2,"H"
"11853",1976-04-02,1975,"Olympique Lyon","RC Lens","4-1",4,1,"1",1,5,3,"H"
"11854",1976-04-07,1975,"AS Saint-Etienne","Troyes AF","3-0",3,0,"1",1,3,3,"H"
"11855",1976-04-09,1975,"AS Monaco","RC Strasbourg","1-2",1,2,"1",1,3,-1,"D"
"11856",1976-04-15,1975,"Olympique Marseille","US Valenciennes-Anzin","3-0",3,0,"1",1,3,3,"H"
"11857",1976-04-15,1975,"Stade Reims","FC Nantes","1-0",1,0,"1",1,1,1,"H"
"11858",1976-04-15,1975,"OGC Nice","Nimes Olympique","4-0",4,0,"1",1,4,4,"H"
"11859",1976-04-15,1975,"RC Lens","FC Sochaux","1-1",1,1,"1",1,2,0,"D"
"11860",1976-04-15,1975,"Paris Saint-Germain","AS Nancy","1-4",1,4,"1",1,5,-3,"D"
"11861",1976-04-15,1975,"FC Metz","RC Strasbourg","5-0",5,0,"1",1,5,5,"H"
"11862",1976-04-15,1975,"SC Bastia","Olympique Lyon","4-1",4,1,"1",1,5,3,"H"
"11863",1976-04-15,1975,"Association Sportive Avignonaise","AS Monaco","1-1",1,1,"1",1,2,0,"D"
"11864",1976-04-16,1975,"Lille OSC","Girondins Bordeaux","3-2",3,2,"1",1,5,1,"H"
"11865",1976-04-30,1975,"RC Strasbourg","AS Saint-Etienne","0-2",0,2,"1",1,2,-2,"D"
"11866",1976-04-30,1975,"FC Sochaux","FC Metz","3-2",3,2,"1",1,5,1,"H"
"11867",1976-04-30,1975,"Olympique Lyon","Olympique Marseille","2-1",2,1,"1",1,3,1,"H"
"11868",1976-04-30,1975,"AS Nancy","OGC Nice","2-0",2,0,"1",1,2,2,"H"
"11869",1976-04-30,1975,"AS Monaco","Stade Reims","1-0",1,0,"1",1,1,1,"H"
"11870",1976-04-30,1975,"SC Bastia","Association Sportive Avignonaise","2-0",2,0,"1",1,2,2,"H"
"11871",1976-04-30,1975,"Nimes Olympique","Lille OSC","5-1",5,1,"1",1,6,4,"H"
"11872",1976-04-30,1975,"Troyes AF","Girondins Bordeaux","2-0",2,0,"1",1,2,2,"H"
"11873",1976-04-30,1975,"US Valenciennes-Anzin","Paris Saint-Germain","2-2",2,2,"1",1,4,0,"D"
"11874",1976-05-01,1975,"FC Nantes","RC Lens","1-1",1,1,"1",1,2,0,"D"
"11875",1976-05-04,1975,"AS Saint-Etienne","Nimes Olympique","5-2",5,2,"1",1,7,3,"H"
"11876",1976-05-11,1975,"Olympique Marseille","FC Nantes","1-2",1,2,"1",1,3,-1,"D"
"11877",1976-05-11,1975,"Stade Reims","FC Sochaux","1-1",1,1,"1",1,2,0,"D"
"11878",1976-05-11,1975,"OGC Nice","Troyes AF","5-2",5,2,"1",1,7,3,"H"
"11879",1976-05-11,1975,"FC Metz","AS Monaco","4-1",4,1,"1",1,5,3,"H"
"11880",1976-05-11,1975,"RC Lens","SC Bastia","1-1",1,1,"1",1,2,0,"D"
"11881",1976-05-11,1975,"Girondins Bordeaux","Nimes Olympique","1-0",1,0,"1",1,1,1,"H"
"11882",1976-05-11,1975,"Paris Saint-Germain","Olympique Lyon","2-0",2,0,"1",1,2,2,"H"
"11883",1976-05-11,1975,"Lille OSC","US Valenciennes-Anzin","5-1",5,1,"1",1,6,4,"H"
"11884",1976-05-11,1975,"Association Sportive Avignonaise","RC Strasbourg","1-0",1,0,"1",1,1,1,"H"
"11885",1976-05-15,1975,"US Valenciennes-Anzin","OGC Nice","0-0",0,0,"1",1,0,0,"D"
"11886",1976-05-15,1975,"FC Nantes","Paris Saint-Germain","1-2",1,2,"1",1,3,-1,"D"
"11887",1976-05-15,1975,"RC Strasbourg","Olympique Marseille","2-0",2,0,"1",1,2,2,"H"
"11888",1976-05-15,1975,"Association Sportive Avignonaise","Stade Reims","1-0",1,0,"1",1,1,1,"H"
"11889",1976-05-15,1975,"AS Nancy","Girondins Bordeaux","3-2",3,2,"1",1,5,1,"H"
"11890",1976-05-15,1975,"SC Bastia","FC Metz","3-2",3,2,"1",1,5,1,"H"
"11891",1976-05-15,1975,"Olympique Lyon","Nimes Olympique","1-1",1,1,"1",1,2,0,"D"
"11892",1976-05-15,1975,"AS Monaco","RC Lens","1-1",1,1,"1",1,2,0,"D"
"11893",1976-05-15,1975,"Troyes AF","Lille OSC","1-0",1,0,"1",1,1,1,"H"
"11894",1976-05-16,1975,"FC Sochaux","AS Saint-Etienne","1-1",1,1,"1",1,2,0,"D"
"11895",1976-05-25,1975,"AS Saint-Etienne","AS Monaco","2-2",2,2,"1",1,4,0,"D"
"11896",1976-05-25,1975,"Olympique Marseille","FC Sochaux","0-3",0,3,"1",1,3,-3,"D"
"11897",1976-05-25,1975,"OGC Nice","Olympique Lyon","1-0",1,0,"1",1,1,1,"H"
"11898",1976-05-25,1975,"Lille OSC","FC Nantes","1-0",1,0,"1",1,1,1,"H"
"11899",1976-05-25,1975,"Stade Reims","SC Bastia","1-2",1,2,"1",1,3,-1,"D"
"11900",1976-05-25,1975,"RC Lens","AS Nancy","4-2",4,2,"1",1,6,2,"H"
"11901",1976-05-25,1975,"FC Metz","Association Sportive Avignonaise","1-0",1,0,"1",1,1,1,"H"
"11902",1976-05-25,1975,"Paris Saint-Germain","RC Strasbourg","0-0",0,0,"1",1,0,0,"D"
"11903",1976-05-25,1975,"Nimes Olympique","Troyes AF","1-1",1,1,"1",1,2,0,"D"
"11904",1976-05-25,1975,"Girondins Bordeaux","US Valenciennes-Anzin","0-1",0,1,"1",1,1,-1,"D"
"11905",1976-05-28,1975,"US Valenciennes-Anzin","AS Saint-Etienne","1-1",1,1,"1",1,2,0,"D"
"11906",1976-05-29,1975,"SC Bastia","Girondins Bordeaux","2-1",2,1,"1",1,3,1,"H"
"11907",1976-06-01,1975,"AS Saint-Etienne","Olympique Lyon","1-1",1,1,"1",1,2,0,"D"
"11908",1976-06-04,1975,"SC Bastia","AS Saint-Etienne","2-2",2,2,"1",1,4,0,"D"
"11909",1976-06-04,1975,"FC Nantes","OGC Nice","1-1",1,1,"1",1,2,0,"D"
"11910",1976-06-04,1975,"FC Sochaux","Paris Saint-Germain","1-4",1,4,"1",1,5,-3,"D"
"11911",1976-06-04,1975,"Stade Reims","FC Metz","3-2",3,2,"1",1,5,1,"H"
"11912",1976-06-04,1975,"AS Monaco","Olympique Marseille","2-1",2,1,"1",1,3,1,"H"
"11913",1976-06-04,1975,"AS Nancy","Troyes AF","0-0",0,0,"1",1,0,0,"D"
"11914",1976-06-04,1975,"US Valenciennes-Anzin","Nimes Olympique","0-3",0,3,"1",1,3,-3,"D"
"11915",1976-06-04,1975,"Olympique Lyon","Girondins Bordeaux","1-2",1,2,"1",1,3,-1,"D"
"11916",1976-06-04,1975,"Association Sportive Avignonaise","RC Lens","0-0",0,0,"1",1,0,0,"D"
"11917",1976-06-04,1975,"RC Strasbourg","Lille OSC","3-0",3,0,"1",1,3,3,"H"
"11918",1976-06-08,1975,"AS Saint-Etienne","AS Nancy","3-0",3,0,"1",1,3,3,"H"
"11919",1976-06-16,1975,"AS Saint-Etienne","Association Sportive Avignonaise","4-0",4,0,"1",1,4,4,"H"
"11920",1976-06-16,1975,"OGC Nice","RC Strasbourg","1-0",1,0,"1",1,1,1,"H"
"11921",1976-06-16,1975,"Lille OSC","FC Sochaux","1-1",1,1,"1",1,2,0,"D"
"11922",1976-06-16,1975,"Girondins Bordeaux","FC Nantes","2-1",2,1,"1",1,3,1,"H"
"11923",1976-06-16,1975,"Olympique Marseille","SC Bastia","4-3",4,3,"1",1,7,1,"H"
"11924",1976-06-16,1975,"RC Lens","Stade Reims","1-0",1,0,"1",1,1,1,"H"
"11925",1976-06-16,1975,"Nimes Olympique","AS Nancy","2-2",2,2,"1",1,4,0,"D"
"11926",1976-06-16,1975,"FC Metz","Olympique Lyon","3-1",3,1,"1",1,4,2,"H"
"11927",1976-06-16,1975,"Paris Saint-Germain","AS Monaco","1-2",1,2,"1",1,3,-1,"D"
"11928",1976-06-16,1975,"Troyes AF","US Valenciennes-Anzin","4-0",4,0,"1",1,4,4,"H"
"11929",1976-06-19,1975,"Stade Reims","AS Saint-Etienne","3-2",3,2,"1",1,5,1,"H"
"11930",1976-06-19,1975,"FC Sochaux","OGC Nice","0-0",0,0,"1",1,0,0,"D"
"11931",1976-06-19,1975,"FC Nantes","Nimes Olympique","1-0",1,0,"1",1,1,1,"H"
"11932",1976-06-19,1975,"Paris Saint-Germain","SC Bastia","1-1",1,1,"1",1,2,0,"D"
"11933",1976-06-19,1975,"Association Sportive Avignonaise","Olympique Marseille","2-1",2,1,"1",1,3,1,"H"
"11934",1976-06-19,1975,"FC Metz","RC Lens","2-1",2,1,"1",1,3,1,"H"
"11935",1976-06-19,1975,"RC Strasbourg","Girondins Bordeaux","0-2",0,2,"1",1,2,-2,"D"
"11936",1976-06-19,1975,"US Valenciennes-Anzin","AS Nancy","2-0",2,0,"1",1,2,2,"H"
"11937",1976-06-19,1975,"AS Monaco","Lille OSC","3-4",3,4,"1",1,7,-1,"D"
"11938",1976-06-19,1975,"Olympique Lyon","Troyes AF","2-0",2,0,"1",1,2,2,"H"
"11939",1976-08-06,1976,"US Valenciennes-Anzin","AS Saint-Etienne","1-1",1,1,"1",1,2,0,"D"
"11940",1976-08-06,1976,"Paris Saint-Germain","Olympique Lyon","2-4",2,4,"1",1,6,-2,"D"
"11941",1976-08-06,1976,"Angers SCO","AS Nancy","3-1",3,1,"1",1,4,2,"H"
"11942",1976-08-06,1976,"SC Bastia","Stade Laval","3-1",3,1,"1",1,4,2,"H"
"11943",1976-08-06,1976,"FC Sochaux","OGC Nice","1-2",1,2,"1",1,3,-1,"D"
"11944",1976-08-06,1976,"FC Metz","FC Nantes","1-2",1,2,"1",1,3,-1,"D"
"11945",1976-08-06,1976,"Lille OSC","Stade Reims","2-1",2,1,"1",1,3,1,"H"
"11946",1976-08-06,1976,"Stade Rennes","Nimes Olympique","0-1",0,1,"1",1,1,-1,"D"
"11947",1976-08-06,1976,"Troyes AF","Girondins Bordeaux","0-1",0,1,"1",1,1,-1,"D"
"11948",1976-08-06,1976,"Olympique Marseille","RC Lens","2-2",2,2,"1",1,4,0,"D"
"11949",1976-08-13,1976,"FC Nantes","Olympique Marseille","3-0",3,0,"1",1,3,3,"H"
"11950",1976-08-13,1976,"Nimes Olympique","Angers SCO","3-1",3,1,"1",1,4,2,"H"
"11951",1976-08-13,1976,"OGC Nice","Paris Saint-Germain","1-0",1,0,"1",1,1,1,"H"
"11952",1976-08-13,1976,"Girondins Bordeaux","Lille OSC","2-1",2,1,"1",1,3,1,"H"
"11953",1976-08-13,1976,"AS Nancy","Olympique Lyon","0-0",0,0,"1",1,0,0,"D"
"11954",1976-08-13,1976,"RC Lens","SC Bastia","4-3",4,3,"1",1,7,1,"H"
"11955",1976-08-13,1976,"Stade Reims","Stade Rennes","3-0",3,0,"1",1,3,3,"H"
"11956",1976-08-13,1976,"Stade Laval","FC Sochaux","0-2",0,2,"1",1,2,-2,"D"
"11957",1976-08-13,1976,"US Valenciennes-Anzin","Troyes AF","1-2",1,2,"1",1,3,-1,"D"
"11958",1976-08-13,1976,"AS Saint-Etienne","FC Metz","0-0",0,0,"1",1,0,0,"D"
"11959",1976-08-18,1976,"Lille OSC","OGC Nice","0-2",0,2,"1",1,2,-2,"D"
"11960",1976-08-18,1976,"Olympique Lyon","Nimes Olympique","4-0",4,0,"1",1,4,4,"H"
"11961",1976-08-18,1976,"SC Bastia","FC Nantes","3-0",3,0,"1",1,3,3,"H"
"11962",1976-08-18,1976,"Angers SCO","Stade Reims","1-2",1,2,"1",1,3,-1,"D"
"11963",1976-08-18,1976,"FC Sochaux","Girondins Bordeaux","1-0",1,0,"1",1,1,1,"H"
"11964",1976-08-18,1976,"Troyes AF","Stade Laval","2-1",2,1,"1",1,3,1,"H"
"11965",1976-08-18,1976,"Stade Rennes","RC Lens","2-1",2,1,"1",1,3,1,"H"
"11966",1976-08-18,1976,"Olympique Marseille","AS Saint-Etienne","1-0",1,0,"1",1,1,1,"H"
"11967",1976-08-18,1976,"Paris Saint-Germain","AS Nancy","2-0",2,0,"1",1,2,2,"H"
"11968",1976-08-18,1976,"FC Metz","US Valenciennes-Anzin","2-2",2,2,"1",1,4,0,"D"
"11969",1976-08-27,1976,"OGC Nice","Angers SCO","4-1",4,1,"1",1,5,3,"H"
"11970",1976-08-27,1976,"Stade Reims","Olympique Lyon","1-1",1,1,"1",1,2,0,"D"
"11971",1976-08-27,1976,"FC Nantes","Troyes AF","2-1",2,1,"1",1,3,1,"H"
"11972",1976-08-27,1976,"Girondins Bordeaux","Stade Rennes","2-1",2,1,"1",1,3,1,"H"
"11973",1976-08-27,1976,"SC Bastia","AS Saint-Etienne","1-1",1,1,"1",1,2,0,"D"
"11974",1976-08-27,1976,"RC Lens","FC Sochaux","2-1",2,1,"1",1,3,1,"H"
"11975",1976-08-27,1976,"Nimes Olympique","AS Nancy","2-2",2,2,"1",1,4,0,"D"
"11976",1976-08-27,1976,"US Valenciennes-Anzin","Olympique Marseille","3-1",3,1,"1",1,4,2,"H"
"11977",1976-08-27,1976,"FC Metz","Lille OSC","3-1",3,1,"1",1,4,2,"H"
"11978",1976-08-27,1976,"Stade Laval","Paris Saint-Germain","2-1",2,1,"1",1,3,1,"H"
"11979",1976-09-07,1976,"Stade Rennes","OGC Nice","0-0",0,0,"1",1,0,0,"D"
"11980",1976-09-07,1976,"FC Sochaux","FC Nantes","2-6",2,6,"1",1,8,-4,"D"
"11981",1976-09-07,1976,"SC Bastia","US Valenciennes-Anzin","4-0",4,0,"1",1,4,4,"H"
"11982",1976-09-07,1976,"Olympique Lyon","RC Lens","3-3",3,3,"1",1,6,0,"D"
"11983",1976-09-07,1976,"Nimes Olympique","Paris Saint-Germain","3-0",3,0,"1",1,3,3,"H"
"11984",1976-09-07,1976,"Angers SCO","Girondins Bordeaux","0-0",0,0,"1",1,0,0,"D"
"11985",1976-09-07,1976,"AS Nancy","Stade Reims","4-2",4,2,"1",1,6,2,"H"
"11986",1976-09-07,1976,"Troyes AF","AS Saint-Etienne","0-0",0,0,"1",1,0,0,"D"
"11987",1976-09-07,1976,"Olympique Marseille","FC Metz","3-1",3,1,"1",1,4,2,"H"
"11988",1976-09-07,1976,"Lille OSC","Stade Laval","3-3",3,3,"1",1,6,0,"D"
"11989",1976-09-10,1976,"OGC Nice","AS Nancy","2-0",2,0,"1",1,2,2,"H"
"11990",1976-09-10,1976,"FC Nantes","Angers SCO","3-0",3,0,"1",1,3,3,"H"
"11991",1976-09-10,1976,"Girondins Bordeaux","Olympique Lyon","1-2",1,2,"1",1,3,-1,"D"
"11992",1976-09-10,1976,"Paris Saint-Germain","SC Bastia","2-2",2,2,"1",1,4,0,"D"
"11993",1976-09-10,1976,"RC Lens","Lille OSC","4-2",4,2,"1",1,6,2,"H"
"11994",1976-09-10,1976,"Stade Reims","Nimes Olympique","2-0",2,0,"1",1,2,2,"H"
"11995",1976-09-10,1976,"AS Saint-Etienne","FC Sochaux","2-0",2,0,"1",1,2,2,"H"
"11996",1976-09-10,1976,"FC Metz","Troyes AF","2-1",2,1,"1",1,3,1,"H"
"11997",1976-09-10,1976,"US Valenciennes-Anzin","Stade Rennes","2-0",2,0,"1",1,2,2,"H"
"11998",1976-09-10,1976,"Stade Laval","Olympique Marseille","2-1",2,1,"1",1,3,1,"H"
"11999",1976-09-18,1976,"Olympique Lyon","OGC Nice","4-1",4,1,"1",1,5,3,"H"
"12000",1976-09-18,1976,"SC Bastia","FC Metz","2-0",2,0,"1",1,2,2,"H"
"12001",1976-09-18,1976,"Stade Rennes","FC Nantes","2-1",2,1,"1",1,3,1,"H"
"12002",1976-09-18,1976,"Nimes Olympique","RC Lens","0-2",0,2,"1",1,2,-2,"D"
"12003",1976-09-18,1976,"Paris Saint-Germain","Stade Reims","2-1",2,1,"1",1,3,1,"H"
"12004",1976-09-18,1976,"AS Nancy","Girondins Bordeaux","7-3",7,3,"1",1,10,4,"H"
"12005",1976-09-18,1976,"Lille OSC","AS Saint-Etienne","1-0",1,0,"1",1,1,1,"H"
"12006",1976-09-18,1976,"Troyes AF","Olympique Marseille","0-0",0,0,"1",1,0,0,"D"
"12007",1976-09-18,1976,"FC Sochaux","US Valenciennes-Anzin","2-1",2,1,"1",1,3,1,"H"
"12008",1976-09-18,1976,"Angers SCO","Stade Laval","1-1",1,1,"1",1,2,0,"D"
"12009",1976-09-24,1976,"FC Nantes","AS Nancy","3-1",3,1,"1",1,4,2,"H"
"12010",1976-09-24,1976,"Stade Laval","Olympique Lyon","3-0",3,0,"1",1,3,3,"H"
"12011",1976-09-24,1976,"RC Lens","Paris Saint-Germain","3-3",3,3,"1",1,6,0,"D"
"12012",1976-09-24,1976,"OGC Nice","Stade Reims","2-3",2,3,"1",1,5,-1,"D"
"12013",1976-09-24,1976,"Olympique Marseille","SC Bastia","4-1",4,1,"1",1,5,3,"H"
"12014",1976-09-24,1976,"AS Saint-Etienne","Stade Rennes","4-0",4,0,"1",1,4,4,"H"
"12015",1976-09-24,1976,"FC Metz","FC Sochaux","2-0",2,0,"1",1,2,2,"H"
"12016",1976-09-24,1976,"US Valenciennes-Anzin","Lille OSC","1-0",1,0,"1",1,1,1,"H"
"12017",1976-09-24,1976,"Girondins Bordeaux","Nimes Olympique","0-0",0,0,"1",1,0,0,"D"
"12018",1976-09-24,1976,"Troyes AF","Angers SCO","1-1",1,1,"1",1,2,0,"D"
"12019",1976-10-02,1976,"Lille OSC","FC Nantes","1-3",1,3,"1",1,4,-2,"D"
"12020",1976-10-02,1976,"Olympique Lyon","US Valenciennes-Anzin","2-0",2,0,"1",1,2,2,"H"
"12021",1976-10-02,1976,"SC Bastia","Troyes AF","3-0",3,0,"1",1,3,3,"H"
"12022",1976-10-02,1976,"Angers SCO","RC Lens","3-2",3,2,"1",1,5,1,"H"
"12023",1976-10-02,1976,"Stade Reims","Girondins Bordeaux","2-1",2,1,"1",1,3,1,"H"
"12024",1976-10-02,1976,"Stade Rennes","Stade Laval","1-3",1,3,"1",1,4,-2,"D"
"12025",1976-10-02,1976,"FC Sochaux","Olympique Marseille","1-2",1,2,"1",1,3,-1,"D"
"12026",1976-10-02,1976,"Paris Saint-Germain","AS Saint-Etienne","2-0",2,0,"1",1,2,2,"H"
"12027",1976-10-02,1976,"AS Nancy","FC Metz","4-1",4,1,"1",1,5,3,"H"
"12028",1976-10-15,1976,"FC Nantes","Paris Saint-Germain","3-3",3,3,"1",1,6,0,"D"
"12029",1976-10-15,1976,"SC Bastia","AS Nancy","3-2",3,2,"1",1,5,1,"H"
"12030",1976-10-15,1976,"AS Saint-Etienne","Olympique Lyon","1-1",1,1,"1",1,2,0,"D"
"12031",1976-10-15,1976,"RC Lens","Stade Reims","2-2",2,2,"1",1,4,0,"D"
"12032",1976-10-15,1976,"Olympique Marseille","Lille OSC","3-2",3,2,"1",1,5,1,"H"
"12033",1976-10-15,1976,"Girondins Bordeaux","OGC Nice","3-1",3,1,"1",1,4,2,"H"
"12034",1976-10-15,1976,"Stade Laval","Nimes Olympique","0-1",0,1,"1",1,1,-1,"D"
"12035",1976-10-15,1976,"FC Metz","Stade Rennes","1-0",1,0,"1",1,1,1,"H"
"12036",1976-10-15,1976,"Troyes AF","FC Sochaux","1-0",1,0,"1",1,1,1,"H"
"12037",1976-10-15,1976,"US Valenciennes-Anzin","Angers SCO","0-2",0,2,"1",1,2,-2,"D"
"12038",1976-10-19,1976,"Nimes Olympique","OGC Nice","3-2",3,2,"1",1,5,1,"H"
"12039",1976-10-23,1976,"Olympique Lyon","FC Nantes","2-0",2,0,"1",1,2,2,"H"
"12040",1976-10-23,1976,"FC Sochaux","SC Bastia","2-0",2,0,"1",1,2,2,"H"
"12041",1976-10-23,1976,"OGC Nice","RC Lens","1-0",1,0,"1",1,1,1,"H"
"12042",1976-10-23,1976,"Nimes Olympique","US Valenciennes-Anzin","2-2",2,2,"1",1,4,0,"D"
"12043",1976-10-23,1976,"Stade Reims","FC Metz","0-2",0,2,"1",1,2,-2,"D"
"12044",1976-10-23,1976,"Stade Rennes","Olympique Marseille","2-1",2,1,"1",1,3,1,"H"
"12045",1976-10-23,1976,"Paris Saint-Germain","Girondins Bordeaux","2-1",2,1,"1",1,3,1,"H"
"12046",1976-10-23,1976,"Angers SCO","AS Saint-Etienne","4-2",4,2,"1",1,6,2,"H"
"12047",1976-10-23,1976,"AS Nancy","Stade Laval","4-1",4,1,"1",1,5,3,"H"
"12048",1976-10-23,1976,"Lille OSC","Troyes AF","3-1",3,1,"1",1,4,2,"H"
"12049",1976-10-29,1976,"SC Bastia","Angers SCO","5-1",5,1,"1",1,6,4,"H"
"12050",1976-10-29,1976,"FC Nantes","Stade Reims","1-1",1,1,"1",1,2,0,"D"
"12051",1976-10-29,1976,"FC Metz","Olympique Lyon","2-0",2,0,"1",1,2,2,"H"
"12052",1976-10-29,1976,"RC Lens","Girondins Bordeaux","3-3",3,3,"1",1,6,0,"D"
"12053",1976-10-29,1976,"Stade Laval","OGC Nice","1-0",1,0,"1",1,1,1,"H"
"12054",1976-10-29,1976,"US Valenciennes-Anzin","AS Nancy","1-1",1,1,"1",1,2,0,"D"
"12055",1976-10-29,1976,"Troyes AF","Stade Rennes","2-1",2,1,"1",1,3,1,"H"
"12056",1976-10-29,1976,"FC Sochaux","Lille OSC","4-2",4,2,"1",1,6,2,"H"
"12057",1976-11-06,1976,"Lille OSC","SC Bastia","0-3",0,3,"1",1,3,-3,"D"
"12058",1976-11-06,1976,"Olympique Lyon","Olympique Marseille","2-1",2,1,"1",1,3,1,"H"
"12059",1976-11-06,1976,"Nimes Olympique","FC Nantes","0-0",0,0,"1",1,0,0,"D"
"12060",1976-11-06,1976,"Angers SCO","FC Metz","0-2",0,2,"1",1,2,-2,"D"
"12061",1976-11-06,1976,"OGC Nice","US Valenciennes-Anzin","2-1",2,1,"1",1,3,1,"H"
"12062",1976-11-06,1976,"AS Nancy","RC Lens","1-1",1,1,"1",1,2,0,"D"
"12063",1976-11-06,1976,"Stade Reims","AS Saint-Etienne","2-2",2,2,"1",1,4,0,"D"
"12064",1976-11-06,1976,"Girondins Bordeaux","Stade Laval","0-1",0,1,"1",1,1,-1,"D"
"12065",1976-11-06,1976,"Paris Saint-Germain","Troyes AF","2-1",2,1,"1",1,3,1,"H"
"12066",1976-11-06,1976,"Stade Rennes","FC Sochaux","2-2",2,2,"1",1,4,0,"D"
"12067",1976-11-10,1976,"SC Bastia","Stade Rennes","3-1",3,1,"1",1,4,2,"H"
"12068",1976-11-10,1976,"Troyes AF","Olympique Lyon","0-3",0,3,"1",1,3,-3,"D"
"12069",1976-11-10,1976,"FC Nantes","Girondins Bordeaux","2-0",2,0,"1",1,2,2,"H"
"12070",1976-11-10,1976,"FC Metz","Nimes Olympique","2-0",2,0,"1",1,2,2,"H"
"12071",1976-11-10,1976,"Stade Laval","RC Lens","1-3",1,3,"1",1,4,-2,"D"
"12072",1976-11-10,1976,"AS Saint-Etienne","OGC Nice","2-0",2,0,"1",1,2,2,"H"
"12073",1976-11-10,1976,"US Valenciennes-Anzin","Stade Reims","5-0",5,0,"1",1,5,5,"H"
"12074",1976-11-10,1976,"Lille OSC","Angers SCO","0-1",0,1,"1",1,1,-1,"D"
"12075",1976-11-20,1976,"Olympique Lyon","SC Bastia","1-1",1,1,"1",1,2,0,"D"
"12076",1976-11-20,1976,"OGC Nice","FC Nantes","1-2",1,2,"1",1,3,-1,"D"
"12077",1976-11-20,1976,"RC Lens","US Valenciennes-Anzin","1-0",1,0,"1",1,1,1,"H"
"12078",1976-11-20,1976,"Paris Saint-Germain","FC Metz","3-1",3,1,"1",1,4,2,"H"
"12079",1976-11-20,1976,"Stade Reims","Stade Laval","1-0",1,0,"1",1,1,1,"H"
"12080",1976-11-20,1976,"AS Nancy","Troyes AF","2-0",2,0,"1",1,2,2,"H"
"12081",1976-11-20,1976,"Nimes Olympique","Olympique Marseille","2-3",2,3,"1",1,5,-1,"D"
"12082",1976-11-20,1976,"Angers SCO","FC Sochaux","1-1",1,1,"1",1,2,0,"D"
"12083",1976-11-20,1976,"Girondins Bordeaux","AS Saint-Etienne","2-0",2,0,"1",1,2,2,"H"
"12084",1976-11-20,1976,"Stade Rennes","Lille OSC","3-1",3,1,"1",1,4,2,"H"
"12085",1976-11-24,1976,"Olympique Marseille","Paris Saint-Germain","2-1",2,1,"1",1,3,1,"H"
"12086",1976-11-27,1976,"SC Bastia","Stade Reims","3-2",3,2,"1",1,5,1,"H"
"12087",1976-11-27,1976,"FC Nantes","Stade Laval","4-0",4,0,"1",1,4,4,"H"
"12088",1976-11-27,1976,"FC Sochaux","Olympique Lyon","2-1",2,1,"1",1,3,1,"H"
"12089",1976-11-27,1976,"FC Metz","OGC Nice","2-2",2,2,"1",1,4,0,"D"
"12090",1976-11-27,1976,"AS Saint-Etienne","RC Lens","3-0",3,0,"1",1,3,3,"H"
"12091",1976-11-27,1976,"Stade Rennes","AS Nancy","0-3",0,3,"1",1,3,-3,"D"
"12092",1976-11-27,1976,"Lille OSC","Paris Saint-Germain","2-0",2,0,"1",1,2,2,"H"
"12093",1976-11-27,1976,"US Valenciennes-Anzin","Girondins Bordeaux","3-2",3,2,"1",1,5,1,"H"
"12094",1976-11-27,1976,"Troyes AF","Nimes Olympique","3-1",3,1,"1",1,4,2,"H"
"12095",1976-11-28,1976,"Olympique Marseille","Angers SCO","2-1",2,1,"1",1,3,1,"H"
"12096",1976-12-04,1976,"RC Lens","FC Nantes","1-1",1,1,"1",1,2,0,"D"
"12097",1976-12-04,1976,"Olympique Lyon","Lille OSC","1-0",1,0,"1",1,1,1,"H"
"12098",1976-12-04,1976,"AS Nancy","FC Sochaux","3-0",3,0,"1",1,3,3,"H"
"12099",1976-12-04,1976,"Stade Reims","Olympique Marseille","1-0",1,0,"1",1,1,1,"H"
"12100",1976-12-04,1976,"Paris Saint-Germain","US Valenciennes-Anzin","1-2",1,2,"1",1,3,-1,"D"
"12101",1976-12-04,1976,"Stade Laval","AS Saint-Etienne","3-1",3,1,"1",1,4,2,"H"
"12102",1976-12-04,1976,"Angers SCO","Stade Rennes","1-0",1,0,"1",1,1,1,"H"
"12103",1976-12-05,1976,"Nimes Olympique","SC Bastia","3-1",3,1,"1",1,4,2,"H"
"12104",1976-12-05,1976,"Girondins Bordeaux","FC Metz","3-3",3,3,"1",1,6,0,"D"
"12105",1976-12-05,1976,"OGC Nice","Troyes AF","2-0",2,0,"1",1,2,2,"H"
"12106",1976-12-08,1976,"AS Saint-Etienne","Nimes Olympique","2-0",2,0,"1",1,2,2,"H"
"12107",1976-12-11,1976,"SC Bastia","Girondins Bordeaux","4-1",4,1,"1",1,5,3,"H"
"12108",1976-12-11,1976,"Stade Rennes","Olympique Lyon","2-2",2,2,"1",1,4,0,"D"
"12109",1976-12-11,1976,"FC Metz","RC Lens","0-1",0,1,"1",1,1,-1,"D"
"12110",1976-12-11,1976,"Lille OSC","AS Nancy","1-1",1,1,"1",1,2,0,"D"
"12111",1976-12-11,1976,"US Valenciennes-Anzin","Stade Laval","1-2",1,2,"1",1,3,-1,"D"
"12112",1976-12-11,1976,"Troyes AF","Stade Reims","4-1",4,1,"1",1,5,3,"H"
"12113",1976-12-11,1976,"Angers SCO","Paris Saint-Germain","0-2",0,2,"1",1,2,-2,"D"
"12114",1976-12-11,1976,"FC Sochaux","Nimes Olympique","2-1",2,1,"1",1,3,1,"H"
"12115",1976-12-12,1976,"Olympique Marseille","OGC Nice","0-1",0,1,"1",1,1,-1,"D"
"12116",1976-12-12,1976,"AS Saint-Etienne","FC Nantes","2-0",2,0,"1",1,2,2,"H"
"12117",1976-12-15,1976,"Olympique Marseille","AS Nancy","2-4",2,4,"1",1,6,-2,"D"
"12118",1976-12-15,1976,"FC Sochaux","Paris Saint-Germain","1-1",1,1,"1",1,2,0,"D"
"12119",1976-12-18,1976,"FC Nantes","US Valenciennes-Anzin","3-1",3,1,"1",1,4,2,"H"
"12120",1976-12-18,1976,"OGC Nice","SC Bastia","5-0",5,0,"1",1,5,5,"H"
"12121",1976-12-18,1976,"Olympique Lyon","Angers SCO","1-1",1,1,"1",1,2,0,"D"
"12122",1976-12-18,1976,"RC Lens","Troyes AF","3-1",3,1,"1",1,4,2,"H"
"12123",1976-12-18,1976,"Stade Laval","FC Metz","1-1",1,1,"1",1,2,0,"D"
"12124",1976-12-19,1976,"AS Nancy","AS Saint-Etienne","2-0",2,0,"1",1,2,2,"H"
"12125",1976-12-19,1976,"Paris Saint-Germain","Stade Rennes","3-1",3,1,"1",1,4,2,"H"
"12126",1976-12-19,1976,"Stade Reims","FC Sochaux","1-1",1,1,"1",1,2,0,"D"
"12127",1976-12-19,1976,"Nimes Olympique","Lille OSC","1-0",1,0,"1",1,1,1,"H"
"12128",1976-12-19,1976,"Girondins Bordeaux","Olympique Marseille","5-0",5,0,"1",1,5,5,"H"
"12129",1977-01-08,1976,"SC Bastia","RC Lens","3-2",3,2,"1",1,5,1,"H"
"12130",1977-01-08,1976,"FC Metz","AS Saint-Etienne","0-0",0,0,"1",1,0,0,"D"
"12131",1977-01-08,1976,"FC Sochaux","Stade Laval","1-1",1,1,"1",1,2,0,"D"
"12132",1977-01-08,1976,"Stade Rennes","Stade Reims","2-2",2,2,"1",1,4,0,"D"
"12133",1977-01-08,1976,"Lille OSC","Girondins Bordeaux","2-2",2,2,"1",1,4,0,"D"
"12134",1977-01-09,1976,"Olympique Marseille","FC Nantes","1-1",1,1,"1",1,2,0,"D"
"12135",1977-01-09,1976,"Olympique Lyon","AS Nancy","2-1",2,1,"1",1,3,1,"H"
"12136",1977-01-09,1976,"Paris Saint-Germain","OGC Nice","3-0",3,0,"1",1,3,3,"H"
"12137",1977-01-09,1976,"Angers SCO","Nimes Olympique","0-0",0,0,"1",1,0,0,"D"
"12138",1977-01-09,1976,"Troyes AF","US Valenciennes-Anzin","2-1",2,1,"1",1,3,1,"H"
"12139",1977-01-15,1976,"FC Nantes","SC Bastia","3-1",3,1,"1",1,4,2,"H"
"12140",1977-01-15,1976,"RC Lens","Stade Rennes","3-1",3,1,"1",1,4,2,"H"
"12141",1977-01-15,1976,"US Valenciennes-Anzin","FC Metz","1-1",1,1,"1",1,2,0,"D"
"12142",1977-01-15,1976,"Stade Laval","Troyes AF","1-1",1,1,"1",1,2,0,"D"
"12143",1977-01-16,1976,"Nimes Olympique","Olympique Lyon","1-1",1,1,"1",1,2,0,"D"
"12144",1977-01-16,1976,"OGC Nice","Lille OSC","2-0",2,0,"1",1,2,2,"H"
"12145",1977-01-16,1976,"AS Nancy","Paris Saint-Germain","1-2",1,2,"1",1,3,-1,"D"
"12146",1977-01-16,1976,"Stade Reims","Angers SCO","2-1",2,1,"1",1,3,1,"H"
"12147",1977-01-16,1976,"Girondins Bordeaux","FC Sochaux","2-1",2,1,"1",1,3,1,"H"
"12148",1977-01-16,1976,"AS Saint-Etienne","Olympique Marseille","4-0",4,0,"1",1,4,4,"H"
"12149",1977-01-22,1976,"Troyes AF","FC Nantes","2-3",2,3,"1",1,5,-1,"D"
"12150",1977-01-22,1976,"FC Sochaux","RC Lens","1-5",1,5,"1",1,6,-4,"D"
"12151",1977-01-22,1976,"Angers SCO","OGC Nice","5-0",5,0,"1",1,5,5,"H"
"12152",1977-01-22,1976,"Lille OSC","FC Metz","2-0",2,0,"1",1,2,2,"H"
"12153",1977-01-23,1976,"Olympique Lyon","Stade Reims","2-1",2,1,"1",1,3,1,"H"
"12154",1977-01-23,1976,"AS Saint-Etienne","SC Bastia","2-1",2,1,"1",1,3,1,"H"
"12155",1977-01-23,1976,"Paris Saint-Germain","Stade Laval","5-0",5,0,"1",1,5,5,"H"
"12156",1977-01-23,1976,"AS Nancy","Nimes Olympique","3-1",3,1,"1",1,4,2,"H"
"12157",1977-01-23,1976,"Stade Rennes","Girondins Bordeaux","0-2",0,2,"1",1,2,-2,"D"
"12158",1977-01-23,1976,"Olympique Marseille","US Valenciennes-Anzin","1-1",1,1,"1",1,2,0,"D"
"12159",1977-01-29,1976,"FC Nantes","FC Sochaux","2-1",2,1,"1",1,3,1,"H"
"12160",1977-01-29,1976,"RC Lens","Olympique Lyon","2-0",2,0,"1",1,2,2,"H"
"12161",1977-01-29,1976,"US Valenciennes-Anzin","SC Bastia","1-2",1,2,"1",1,3,-1,"D"
"12162",1977-01-29,1976,"FC Metz","Olympique Marseille","3-0",3,0,"1",1,3,3,"H"
"12163",1977-01-29,1976,"Stade Laval","Lille OSC","1-0",1,0,"1",1,1,1,"H"
"12164",1977-01-30,1976,"Paris Saint-Germain","Nimes Olympique","0-0",0,0,"1",1,0,0,"D"
"12165",1977-01-30,1976,"Stade Reims","AS Nancy","3-3",3,3,"1",1,6,0,"D"
"12166",1977-01-30,1976,"OGC Nice","Stade Rennes","4-0",4,0,"1",1,4,4,"H"
"12167",1977-01-30,1976,"AS Saint-Etienne","Troyes AF","4-0",4,0,"1",1,4,4,"H"
"12168",1977-01-30,1976,"Girondins Bordeaux","Angers SCO","4-1",4,1,"1",1,5,3,"H"
"12169",1977-02-05,1976,"Angers SCO","FC Nantes","2-2",2,2,"1",1,4,0,"D"
"12170",1977-02-05,1976,"SC Bastia","Paris Saint-Germain","5-2",5,2,"1",1,7,3,"H"
"12171",1977-02-05,1976,"Lille OSC","RC Lens","0-1",0,1,"1",1,1,-1,"D"
"12172",1977-02-06,1976,"Olympique Lyon","Girondins Bordeaux","1-0",1,0,"1",1,1,1,"H"
"12173",1977-02-06,1976,"AS Nancy","OGC Nice","1-4",1,4,"1",1,5,-3,"D"
"12174",1977-02-06,1976,"FC Sochaux","AS Saint-Etienne","4-0",4,0,"1",1,4,4,"H"
"12175",1977-02-06,1976,"Troyes AF","FC Metz","3-2",3,2,"1",1,5,1,"H"
"12176",1977-02-06,1976,"Nimes Olympique","Stade Reims","1-1",1,1,"1",1,2,0,"D"
"12177",1977-02-06,1976,"Olympique Marseille","Stade Laval","2-1",2,1,"1",1,3,1,"H"
"12178",1977-02-06,1976,"Stade Rennes","US Valenciennes-Anzin","0-2",0,2,"1",1,2,-2,"D"
"12179",1977-02-18,1976,"FC Nantes","Stade Rennes","3-1",3,1,"1",1,4,2,"H"
"12180",1977-02-18,1976,"OGC Nice","Olympique Lyon","1-2",1,2,"1",1,3,-1,"D"
"12181",1977-02-18,1976,"RC Lens","Nimes Olympique","3-0",3,0,"1",1,3,3,"H"
"12182",1977-02-18,1976,"FC Metz","SC Bastia","1-1",1,1,"1",1,2,0,"D"
"12183",1977-02-18,1976,"Stade Reims","Paris Saint-Germain","2-3",2,3,"1",1,5,-1,"D"
"12184",1977-02-18,1976,"Girondins Bordeaux","AS Nancy","2-0",2,0,"1",1,2,2,"H"
"12185",1977-02-18,1976,"Stade Laval","Angers SCO","2-0",2,0,"1",1,2,2,"H"
"12186",1977-02-18,1976,"Olympique Marseille","Troyes AF","2-0",2,0,"1",1,2,2,"H"
"12187",1977-02-18,1976,"US Valenciennes-Anzin","FC Sochaux","0-0",0,0,"1",1,0,0,"D"
"12188",1977-02-19,1976,"AS Saint-Etienne","Lille OSC","2-0",2,0,"1",1,2,2,"H"
"12189",1977-02-25,1976,"SC Bastia","Olympique Marseille","4-0",4,0,"1",1,4,4,"H"
"12190",1977-02-26,1976,"AS Nancy","FC Nantes","3-0",3,0,"1",1,3,3,"H"
"12191",1977-02-26,1976,"Stade Reims","OGC Nice","0-1",0,1,"1",1,1,-1,"D"
"12192",1977-02-26,1976,"Stade Rennes","AS Saint-Etienne","0-1",0,1,"1",1,1,-1,"D"
"12193",1977-02-26,1976,"Lille OSC","US Valenciennes-Anzin","1-1",1,1,"1",1,2,0,"D"
"12194",1977-02-26,1976,"Angers SCO","Troyes AF","1-2",1,2,"1",1,3,-1,"D"
"12195",1977-02-27,1976,"Olympique Lyon","Stade Laval","2-0",2,0,"1",1,2,2,"H"
"12196",1977-02-27,1976,"Paris Saint-Germain","RC Lens","3-1",3,1,"1",1,4,2,"H"
"12197",1977-02-27,1976,"FC Sochaux","FC Metz","1-0",1,0,"1",1,1,1,"H"
"12198",1977-02-27,1976,"Nimes Olympique","Girondins Bordeaux","3-2",3,2,"1",1,5,1,"H"
"12199",1977-03-05,1976,"FC Nantes","Lille OSC","3-1",3,1,"1",1,4,2,"H"
"12200",1977-03-05,1976,"US Valenciennes-Anzin","Olympique Lyon","3-2",3,2,"1",1,5,1,"H"
"12201",1977-03-05,1976,"RC Lens","Angers SCO","2-0",2,0,"1",1,2,2,"H"
"12202",1977-03-05,1976,"Troyes AF","SC Bastia","1-0",1,0,"1",1,1,1,"H"
"12203",1977-03-05,1976,"OGC Nice","Nimes Olympique","1-0",1,0,"1",1,1,1,"H"
"12204",1977-03-05,1976,"AS Saint-Etienne","Paris Saint-Germain","1-0",1,0,"1",1,1,1,"H"
"12205",1977-03-05,1976,"FC Metz","AS Nancy","3-0",3,0,"1",1,3,3,"H"
"12206",1977-03-05,1976,"Girondins Bordeaux","Stade Reims","3-1",3,1,"1",1,4,2,"H"
"12207",1977-03-05,1976,"Stade Laval","Stade Rennes","0-0",0,0,"1",1,0,0,"D"
"12208",1977-03-05,1976,"Olympique Marseille","FC Sochaux","1-1",1,1,"1",1,2,0,"D"
"12209",1977-03-23,1976,"Paris Saint-Germain","FC Nantes","0-1",0,1,"1",1,1,-1,"D"
"12210",1977-03-23,1976,"Olympique Lyon","AS Saint-Etienne","0-2",0,2,"1",1,2,-2,"D"
"12211",1977-03-23,1976,"Stade Reims","RC Lens","2-0",2,0,"1",1,2,2,"H"
"12212",1977-03-23,1976,"AS Nancy","SC Bastia","4-1",4,1,"1",1,5,3,"H"
"12213",1977-03-23,1976,"OGC Nice","Girondins Bordeaux","2-1",2,1,"1",1,3,1,"H"
"12214",1977-03-23,1976,"Stade Rennes","FC Metz","2-3",2,3,"1",1,5,-1,"D"
"12215",1977-03-23,1976,"FC Sochaux","Troyes AF","2-0",2,0,"1",1,2,2,"H"
"12216",1977-03-23,1976,"Nimes Olympique","Stade Laval","4-2",4,2,"1",1,6,2,"H"
"12217",1977-03-23,1976,"Angers SCO","US Valenciennes-Anzin","0-0",0,0,"1",1,0,0,"D"
"12218",1977-03-23,1976,"Lille OSC","Olympique Marseille","2-0",2,0,"1",1,2,2,"H"
"12219",1977-04-02,1976,"FC Nantes","Olympique Lyon","3-0",3,0,"1",1,3,3,"H"
"12220",1977-04-02,1976,"SC Bastia","FC Sochaux","2-0",2,0,"1",1,2,2,"H"
"12221",1977-04-02,1976,"AS Saint-Etienne","Angers SCO","1-1",1,1,"1",1,2,0,"D"
"12222",1977-04-02,1976,"FC Metz","Stade Reims","2-0",2,0,"1",1,2,2,"H"
"12223",1977-04-02,1976,"Stade Laval","AS Nancy","1-1",1,1,"1",1,2,0,"D"
"12224",1977-04-02,1976,"Girondins Bordeaux","Paris Saint-Germain","5-2",5,2,"1",1,7,3,"H"
"12225",1977-04-02,1976,"US Valenciennes-Anzin","Nimes Olympique","2-0",2,0,"1",1,2,2,"H"
"12226",1977-04-02,1976,"Olympique Marseille","Stade Rennes","3-2",3,2,"1",1,5,1,"H"
"12227",1977-04-02,1976,"Troyes AF","Lille OSC","1-0",1,0,"1",1,1,1,"H"
"12228",1977-04-16,1976,"Stade Reims","FC Nantes","0-2",0,2,"1",1,2,-2,"D"
"12229",1977-04-16,1976,"Angers SCO","SC Bastia","0-3",0,3,"1",1,3,-3,"D"
"12230",1977-04-16,1976,"Olympique Lyon","FC Metz","1-0",1,0,"1",1,1,1,"H"
"12231",1977-04-16,1976,"OGC Nice","Stade Laval","2-1",2,1,"1",1,3,1,"H"
"12232",1977-04-16,1976,"Nimes Olympique","AS Saint-Etienne","1-1",1,1,"1",1,2,0,"D"
"12233",1977-04-16,1976,"Girondins Bordeaux","RC Lens","5-2",5,2,"1",1,7,3,"H"
"12234",1977-04-16,1976,"AS Nancy","US Valenciennes-Anzin","3-0",3,0,"1",1,3,3,"H"
"12235",1977-04-16,1976,"Paris Saint-Germain","Olympique Marseille","1-1",1,1,"1",1,2,0,"D"
"12236",1977-04-16,1976,"Lille OSC","FC Sochaux","1-1",1,1,"1",1,2,0,"D"
"12237",1977-04-16,1976,"Stade Rennes","Troyes AF","2-2",2,2,"1",1,4,0,"D"
"12238",1977-04-22,1976,"RC Lens","OGC Nice","1-1",1,1,"1",1,2,0,"D"
"12239",1977-04-28,1976,"FC Nantes","Nimes Olympique","1-0",1,0,"1",1,1,1,"H"
"12240",1977-04-28,1976,"SC Bastia","Lille OSC","1-1",1,1,"1",1,2,0,"D"
"12241",1977-04-28,1976,"US Valenciennes-Anzin","OGC Nice","1-1",1,1,"1",1,2,0,"D"
"12242",1977-04-28,1976,"Olympique Marseille","Olympique Lyon","3-1",3,1,"1",1,4,2,"H"
"12243",1977-04-28,1976,"RC Lens","AS Nancy","1-1",1,1,"1",1,2,0,"D"
"12244",1977-04-28,1976,"AS Saint-Etienne","Stade Reims","0-0",0,0,"1",1,0,0,"D"
"12245",1977-04-28,1976,"FC Metz","Angers SCO","4-2",4,2,"1",1,6,2,"H"
"12246",1977-04-28,1976,"Stade Laval","Girondins Bordeaux","0-0",0,0,"1",1,0,0,"D"
"12247",1977-04-28,1976,"Troyes AF","Paris Saint-Germain","2-1",2,1,"1",1,3,1,"H"
"12248",1977-04-28,1976,"FC Sochaux","Stade Rennes","2-1",2,1,"1",1,3,1,"H"
"12249",1977-05-03,1976,"Girondins Bordeaux","FC Nantes","1-2",1,2,"1",1,3,-1,"D"
"12250",1977-05-03,1976,"Stade Rennes","SC Bastia","1-1",1,1,"1",1,2,0,"D"
"12251",1977-05-03,1976,"OGC Nice","AS Saint-Etienne","2-0",2,0,"1",1,2,2,"H"
"12252",1977-05-03,1976,"RC Lens","Stade Laval","2-1",2,1,"1",1,3,1,"H"
"12253",1977-05-03,1976,"AS Nancy","Olympique Marseille","2-0",2,0,"1",1,2,2,"H"
"12254",1977-05-03,1976,"Paris Saint-Germain","FC Sochaux","1-0",1,0,"1",1,1,1,"H"
"12255",1977-05-03,1976,"Stade Reims","US Valenciennes-Anzin","3-0",3,0,"1",1,3,3,"H"
"12256",1977-05-03,1976,"Angers SCO","Lille OSC","3-0",3,0,"1",1,3,3,"H"
"12257",1977-05-07,1976,"FC Nantes","OGC Nice","6-1",6,1,"1",1,7,5,"H"
"12258",1977-05-07,1976,"SC Bastia","Olympique Lyon","3-0",3,0,"1",1,3,3,"H"
"12259",1977-05-07,1976,"US Valenciennes-Anzin","RC Lens","0-1",0,1,"1",1,1,-1,"D"
"12260",1977-05-07,1976,"Troyes AF","AS Nancy","0-1",0,1,"1",1,1,-1,"D"
"12261",1977-05-07,1976,"AS Saint-Etienne","Girondins Bordeaux","2-0",2,0,"1",1,2,2,"H"
"12262",1977-05-07,1976,"FC Metz","Paris Saint-Germain","3-1",3,1,"1",1,4,2,"H"
"12263",1977-05-07,1976,"Olympique Marseille","Nimes Olympique","1-0",1,0,"1",1,1,1,"H"
"12264",1977-05-07,1976,"FC Sochaux","Angers SCO","1-1",1,1,"1",1,2,0,"D"
"12265",1977-05-07,1976,"Stade Laval","Stade Reims","0-0",0,0,"1",1,0,0,"D"
"12266",1977-05-07,1976,"Lille OSC","Stade Rennes","2-2",2,2,"1",1,4,0,"D"
"12267",1977-05-13,1976,"Olympique Lyon","Troyes AF","0-0",0,0,"1",1,0,0,"D"
"12268",1977-05-21,1976,"Stade Laval","FC Nantes","1-2",1,2,"1",1,3,-1,"D"
"12269",1977-05-21,1976,"Stade Reims","SC Bastia","1-1",1,1,"1",1,2,0,"D"
"12270",1977-05-21,1976,"RC Lens","AS Saint-Etienne","1-1",1,1,"1",1,2,0,"D"
"12271",1977-05-21,1976,"Olympique Lyon","FC Sochaux","3-0",3,0,"1",1,3,3,"H"
"12272",1977-05-21,1976,"AS Nancy","Stade Rennes","3-2",3,2,"1",1,5,1,"H"
"12273",1977-05-21,1976,"OGC Nice","FC Metz","2-4",2,4,"1",1,6,-2,"D"
"12274",1977-05-21,1976,"Paris Saint-Germain","Lille OSC","2-1",2,1,"1",1,3,1,"H"
"12275",1977-05-21,1976,"Angers SCO","Olympique Marseille","1-2",1,2,"1",1,3,-1,"D"
"12276",1977-05-21,1976,"Girondins Bordeaux","US Valenciennes-Anzin","0-0",0,0,"1",1,0,0,"D"
"12277",1977-05-21,1976,"Nimes Olympique","Troyes AF","2-0",2,0,"1",1,2,2,"H"
"12278",1977-05-24,1976,"Nimes Olympique","FC Metz","1-1",1,1,"1",1,2,0,"D"
"12279",1977-05-27,1976,"FC Nantes","RC Lens","1-1",1,1,"1",1,2,0,"D"
"12280",1977-05-27,1976,"FC Sochaux","AS Nancy","0-3",0,3,"1",1,3,-3,"D"
"12281",1977-05-27,1976,"AS Saint-Etienne","Stade Laval","3-1",3,1,"1",1,4,2,"H"
"12282",1977-05-27,1976,"FC Metz","Girondins Bordeaux","4-2",4,2,"1",1,6,2,"H"
"12283",1977-05-27,1976,"Troyes AF","OGC Nice","2-2",2,2,"1",1,4,0,"D"
"12284",1977-05-27,1976,"Lille OSC","Olympique Lyon","3-0",3,0,"1",1,3,3,"H"
"12285",1977-05-27,1976,"US Valenciennes-Anzin","Paris Saint-Germain","0-3",0,3,"1",1,3,-3,"D"
"12286",1977-05-27,1976,"Olympique Marseille","Stade Reims","0-1",0,1,"1",1,1,-1,"D"
"12287",1977-05-27,1976,"Stade Rennes","Angers SCO","4-2",4,2,"1",1,6,2,"H"
"12288",1977-05-28,1976,"SC Bastia","Nimes Olympique","5-0",5,0,"1",1,5,5,"H"
"12289",1977-06-01,1976,"FC Nantes","AS Saint-Etienne","3-0",3,0,"1",1,3,3,"H"
"12290",1977-06-01,1976,"Girondins Bordeaux","SC Bastia","1-0",1,0,"1",1,1,1,"H"
"12291",1977-06-01,1976,"RC Lens","FC Metz","4-1",4,1,"1",1,5,3,"H"
"12292",1977-06-01,1976,"AS Nancy","Lille OSC","3-0",3,0,"1",1,3,3,"H"
"12293",1977-06-01,1976,"OGC Nice","Olympique Marseille","2-2",2,2,"1",1,4,0,"D"
"12294",1977-06-01,1976,"Olympique Lyon","Stade Rennes","1-2",1,2,"1",1,3,-1,"D"
"12295",1977-06-01,1976,"Paris Saint-Germain","Angers SCO","2-0",2,0,"1",1,2,2,"H"
"12296",1977-06-01,1976,"Stade Reims","Troyes AF","1-3",1,3,"1",1,4,-2,"D"
"12297",1977-06-01,1976,"Nimes Olympique","FC Sochaux","0-1",0,1,"1",1,1,-1,"D"
"12298",1977-06-01,1976,"Stade Laval","US Valenciennes-Anzin","1-1",1,1,"1",1,2,0,"D"
"12299",1977-06-04,1976,"US Valenciennes-Anzin","FC Nantes","0-0",0,0,"1",1,0,0,"D"
"12300",1977-06-04,1976,"SC Bastia","OGC Nice","2-0",2,0,"1",1,2,2,"H"
"12301",1977-06-04,1976,"Troyes AF","RC Lens","0-2",0,2,"1",1,2,-2,"D"
"12302",1977-06-04,1976,"AS Saint-Etienne","AS Nancy","3-2",3,2,"1",1,5,1,"H"
"12303",1977-06-04,1976,"FC Metz","Stade Laval","5-3",5,3,"1",1,8,2,"H"
"12304",1977-06-04,1976,"Angers SCO","Olympique Lyon","0-1",0,1,"1",1,1,-1,"D"
"12305",1977-06-04,1976,"Stade Rennes","Paris Saint-Germain","1-1",1,1,"1",1,2,0,"D"
"12306",1977-06-04,1976,"Olympique Marseille","Girondins Bordeaux","1-1",1,1,"1",1,2,0,"D"
"12307",1977-06-04,1976,"FC Sochaux","Stade Reims","2-2",2,2,"1",1,4,0,"D"
"12308",1977-06-04,1976,"Lille OSC","Nimes Olympique","1-2",1,2,"1",1,3,-1,"D"
"12309",1977-06-08,1976,"FC Nantes","FC Metz","3-2",3,2,"1",1,5,1,"H"
"12310",1977-06-08,1976,"RC Lens","Olympique Marseille","1-0",1,0,"1",1,1,1,"H"
"12311",1977-06-08,1976,"Stade Laval","SC Bastia","3-1",3,1,"1",1,4,2,"H"
"12312",1977-06-08,1976,"AS Nancy","Angers SCO","1-1",1,1,"1",1,2,0,"D"
"12313",1977-06-08,1976,"AS Saint-Etienne","US Valenciennes-Anzin","5-0",5,0,"1",1,5,5,"H"
"12314",1977-06-08,1976,"Olympique Lyon","Paris Saint-Germain","1-1",1,1,"1",1,2,0,"D"
"12315",1977-06-08,1976,"OGC Nice","FC Sochaux","1-0",1,0,"1",1,1,1,"H"
"12316",1977-06-08,1976,"Girondins Bordeaux","Troyes AF","3-0",3,0,"1",1,3,3,"H"
"12317",1977-06-08,1976,"Stade Reims","Lille OSC","3-1",3,1,"1",1,4,2,"H"
"12318",1977-06-08,1976,"Nimes Olympique","Stade Rennes","6-2",6,2,"1",1,8,4,"H"
"12319",1977-08-03,1977,"US Valenciennes-Anzin","Troyes AF","6-1",6,1,"1",1,7,5,"H"
"12320",1977-08-03,1977,"RC Strasbourg","Stade Laval","6-2",6,2,"1",1,8,4,"H"
"12321",1977-08-03,1977,"Olympique Marseille","FC Sochaux","4-0",4,0,"1",1,4,4,"H"
"12322",1977-08-03,1977,"FC Rouen","FC Metz","5-2",5,2,"1",1,7,3,"H"
"12323",1977-08-03,1977,"AS Nancy","Paris Saint-Germain","4-1",4,1,"1",1,5,3,"H"
"12324",1977-08-03,1977,"Olympique Lyon","Nimes Olympique","3-1",3,1,"1",1,4,2,"H"
"12325",1977-08-03,1977,"SC Bastia","AS Monaco","0-2",0,2,"1",1,2,-2,"D"
"12326",1977-08-03,1977,"OGC Nice","FC Nantes","1-0",1,0,"1",1,1,1,"H"
"12327",1977-08-03,1977,"Girondins Bordeaux","AS Saint-Etienne","2-2",2,2,"1",1,4,0,"D"
"12328",1977-08-03,1977,"Stade Reims","RC Lens","0-0",0,0,"1",1,0,0,"D"
"12329",1977-08-09,1977,"Troyes AF","Olympique Lyon","0-2",0,2,"1",1,2,-2,"D"
"12330",1977-08-09,1977,"AS Monaco","AS Nancy","2-0",2,0,"1",1,2,2,"H"
"12331",1977-08-09,1977,"FC Sochaux","OGC Nice","1-2",1,2,"1",1,3,-1,"D"
"12332",1977-08-09,1977,"RC Lens","RC Strasbourg","2-2",2,2,"1",1,4,0,"D"
"12333",1977-08-09,1977,"SC Bastia","Girondins Bordeaux","1-2",1,2,"1",1,3,-1,"D"
"12334",1977-08-09,1977,"AS Saint-Etienne","Olympique Marseille","2-1",2,1,"1",1,3,1,"H"
"12335",1977-08-09,1977,"Stade Laval","US Valenciennes-Anzin","3-1",3,1,"1",1,4,2,"H"
"12336",1977-08-09,1977,"Nimes Olympique","FC Rouen","3-2",3,2,"1",1,5,1,"H"
"12337",1977-08-09,1977,"Paris Saint-Germain","Stade Reims","2-2",2,2,"1",1,4,0,"D"
"12338",1977-08-09,1977,"FC Metz","FC Nantes","2-2",2,2,"1",1,4,0,"D"
"12339",1977-08-16,1977,"Girondins Bordeaux","AS Monaco","0-4",0,4,"1",1,4,-4,"D"
"12340",1977-08-16,1977,"Olympique Lyon","RC Lens","2-0",2,0,"1",1,2,2,"H"
"12341",1977-08-16,1977,"OGC Nice","FC Metz","1-1",1,1,"1",1,2,0,"D"
"12342",1977-08-16,1977,"RC Strasbourg","Paris Saint-Germain","1-1",1,1,"1",1,2,0,"D"
"12343",1977-08-16,1977,"AS Nancy","SC Bastia","3-0",3,0,"1",1,3,3,"H"
"12344",1977-08-16,1977,"FC Rouen","Troyes AF","2-1",2,1,"1",1,3,1,"H"
"12345",1977-08-16,1977,"Stade Reims","AS Saint-Etienne","0-0",0,0,"1",1,0,0,"D"
"12346",1977-08-16,1977,"Olympique Marseille","Stade Laval","0-1",0,1,"1",1,1,-1,"D"
"12347",1977-08-16,1977,"FC Nantes","Nimes Olympique","3-1",3,1,"1",1,4,2,"H"
"12348",1977-08-16,1977,"US Valenciennes-Anzin","FC Sochaux","1-2",1,2,"1",1,3,-1,"D"
"12349",1977-08-19,1977,"AS Monaco","RC Strasbourg","3-2",3,2,"1",1,5,1,"H"
"12350",1977-08-19,1977,"AS Saint-Etienne","OGC Nice","1-2",1,2,"1",1,3,-1,"D"
"12351",1977-08-19,1977,"Stade Laval","Olympique Lyon","1-0",1,0,"1",1,1,1,"H"
"12352",1977-08-19,1977,"AS Nancy","US Valenciennes-Anzin","2-2",2,2,"1",1,4,0,"D"
"12353",1977-08-19,1977,"Paris Saint-Germain","Girondins Bordeaux","1-2",1,2,"1",1,3,-1,"D"
"12354",1977-08-19,1977,"FC Sochaux","FC Rouen","3-0",3,0,"1",1,3,3,"H"
"12355",1977-08-19,1977,"Nimes Olympique","FC Metz","2-0",2,0,"1",1,2,2,"H"
"12356",1977-08-19,1977,"RC Lens","Olympique Marseille","3-2",3,2,"1",1,5,1,"H"
"12357",1977-08-19,1977,"Troyes AF","FC Nantes","1-0",1,0,"1",1,1,1,"H"
"12358",1977-08-19,1977,"SC Bastia","Stade Reims","3-0",3,0,"1",1,3,3,"H"
"12359",1977-08-30,1977,"Stade Reims","AS Monaco","0-2",0,2,"1",1,2,-2,"D"
"12360",1977-08-30,1977,"OGC Nice","Nimes Olympique","3-1",3,1,"1",1,4,2,"H"
"12361",1977-08-30,1977,"FC Rouen","Stade Laval","1-1",1,1,"1",1,2,0,"D"
"12362",1977-08-30,1977,"Girondins Bordeaux","AS Nancy","2-0",2,0,"1",1,2,2,"H"
"12363",1977-08-30,1977,"Olympique Lyon","FC Sochaux","0-2",0,2,"1",1,2,-2,"D"
"12364",1977-08-30,1977,"RC Strasbourg","SC Bastia","1-1",1,1,"1",1,2,0,"D"
"12365",1977-08-30,1977,"FC Nantes","RC Lens","2-0",2,0,"1",1,2,2,"H"
"12366",1977-08-30,1977,"US Valenciennes-Anzin","AS Saint-Etienne","1-1",1,1,"1",1,2,0,"D"
"12367",1977-08-30,1977,"Olympique Marseille","Paris Saint-Germain","2-1",2,1,"1",1,3,1,"H"
"12368",1977-08-30,1977,"FC Metz","Troyes AF","0-0",0,0,"1",1,0,0,"D"
"12369",1977-09-02,1977,"Girondins Bordeaux","OGC Nice","3-5",3,5,"1",1,8,-2,"D"
"12370",1977-09-02,1977,"AS Monaco","Olympique Marseille","2-3",2,3,"1",1,5,-1,"D"
"12371",1977-09-02,1977,"FC Sochaux","FC Metz","4-0",4,0,"1",1,4,4,"H"
"12372",1977-09-02,1977,"Stade Laval","FC Nantes","1-1",1,1,"1",1,2,0,"D"
"12373",1977-09-02,1977,"AS Nancy","Stade Reims","4-1",4,1,"1",1,5,3,"H"
"12374",1977-09-02,1977,"AS Saint-Etienne","RC Strasbourg","4-3",4,3,"1",1,7,1,"H"
"12375",1977-09-02,1977,"SC Bastia","Olympique Lyon","2-1",2,1,"1",1,3,1,"H"
"12376",1977-09-02,1977,"RC Lens","FC Rouen","5-1",5,1,"1",1,6,4,"H"
"12377",1977-09-02,1977,"Troyes AF","Nimes Olympique","2-2",2,2,"1",1,4,0,"D"
"12378",1977-09-02,1977,"Paris Saint-Germain","US Valenciennes-Anzin","2-0",2,0,"1",1,2,2,"H"
"12379",1977-09-09,1977,"OGC Nice","Troyes AF","4-1",4,1,"1",1,5,3,"H"
"12380",1977-09-09,1977,"US Valenciennes-Anzin","AS Monaco","1-1",1,1,"1",1,2,0,"D"
"12381",1977-09-09,1977,"Olympique Marseille","SC Bastia","2-0",2,0,"1",1,2,2,"H"
"12382",1977-09-09,1977,"FC Nantes","FC Sochaux","2-0",2,0,"1",1,2,2,"H"
"12383",1977-09-09,1977,"Olympique Lyon","AS Saint-Etienne","2-2",2,2,"1",1,4,0,"D"
"12384",1977-09-09,1977,"FC Metz","Stade Laval","1-0",1,0,"1",1,1,1,"H"
"12385",1977-09-09,1977,"RC Strasbourg","AS Nancy","2-0",2,0,"1",1,2,2,"H"
"12386",1977-09-09,1977,"Nimes Olympique","RC Lens","2-1",2,1,"1",1,3,1,"H"
"12387",1977-09-09,1977,"Stade Reims","Girondins Bordeaux","1-0",1,0,"1",1,1,1,"H"
"12388",1977-09-09,1977,"FC Rouen","Paris Saint-Germain","1-3",1,3,"1",1,4,-2,"D"
"12389",1977-09-17,1977,"AS Monaco","Olympique Lyon","3-1",3,1,"1",1,4,2,"H"
"12390",1977-09-17,1977,"RC Lens","OGC Nice","3-1",3,1,"1",1,4,2,"H"
"12391",1977-09-17,1977,"FC Sochaux","Troyes AF","5-2",5,2,"1",1,7,3,"H"
"12392",1977-09-17,1977,"AS Saint-Etienne","FC Nantes","2-1",2,1,"1",1,3,1,"H"
"12393",1977-09-17,1977,"Stade Laval","Nimes Olympique","2-1",2,1,"1",1,3,1,"H"
"12394",1977-09-17,1977,"AS Nancy","Olympique Marseille","1-1",1,1,"1",1,2,0,"D"
"12395",1977-09-17,1977,"Girondins Bordeaux","FC Rouen","4-0",4,0,"1",1,4,4,"H"
"12396",1977-09-17,1977,"Stade Reims","RC Strasbourg","0-0",0,0,"1",1,0,0,"D"
"12397",1977-09-17,1977,"Paris Saint-Germain","FC Metz","2-0",2,0,"1",1,2,2,"H"
"12398",1977-09-17,1977,"SC Bastia","US Valenciennes-Anzin","3-0",3,0,"1",1,3,3,"H"
"12399",1977-09-23,1977,"OGC Nice","AS Monaco","1-1",1,1,"1",1,2,0,"D"
"12400",1977-09-23,1977,"FC Rouen","AS Saint-Etienne","1-2",1,2,"1",1,3,-1,"D"
"12401",1977-09-23,1977,"Nimes Olympique","FC Sochaux","1-1",1,1,"1",1,2,0,"D"
"12402",1977-09-23,1977,"Olympique Marseille","Stade Reims","2-1",2,1,"1",1,3,1,"H"
"12403",1977-09-23,1977,"Troyes AF","Stade Laval","0-0",0,0,"1",1,0,0,"D"
"12404",1977-09-23,1977,"RC Strasbourg","Girondins Bordeaux","3-0",3,0,"1",1,3,3,"H"
"12405",1977-09-23,1977,"FC Nantes","SC Bastia","2-0",2,0,"1",1,2,2,"H"
"12406",1977-09-23,1977,"Olympique Lyon","Paris Saint-Germain","2-3",2,3,"1",1,5,-1,"D"
"12407",1977-09-23,1977,"US Valenciennes-Anzin","RC Lens","3-3",3,3,"1",1,6,0,"D"
"12408",1977-09-23,1977,"FC Metz","AS Nancy","3-0",3,0,"1",1,3,3,"H"
"12409",1977-09-30,1977,"AS Saint-Etienne","Nimes Olympique","2-1",2,1,"1",1,3,1,"H"
"12410",1977-09-30,1977,"RC Strasbourg","FC Metz","5-1",5,1,"1",1,6,4,"H"
"12411",1977-10-01,1977,"Paris Saint-Germain","OGC Nice","0-3",0,3,"1",1,3,-3,"D"
"12412",1977-10-01,1977,"AS Monaco","FC Nantes","1-1",1,1,"1",1,2,0,"D"
"12413",1977-10-01,1977,"Girondins Bordeaux","Olympique Marseille","1-2",1,2,"1",1,3,-1,"D"
"12414",1977-10-01,1977,"Stade Laval","FC Sochaux","3-1",3,1,"1",1,4,2,"H"
"12415",1977-10-01,1977,"RC Lens","Troyes AF","3-2",3,2,"1",1,5,1,"H"
"12416",1977-10-01,1977,"AS Nancy","Olympique Lyon","3-1",3,1,"1",1,4,2,"H"
"12417",1977-10-01,1977,"SC Bastia","FC Rouen","3-2",3,2,"1",1,5,1,"H"
"12418",1977-10-01,1977,"Stade Reims","US Valenciennes-Anzin","3-0",3,0,"1",1,3,3,"H"
"12419",1977-10-11,1977,"OGC Nice","Stade Laval","4-2",4,2,"1",1,6,2,"H"
"12420",1977-10-11,1977,"FC Rouen","AS Monaco","3-4",3,4,"1",1,7,-1,"D"
"12421",1977-10-11,1977,"FC Metz","AS Saint-Etienne","0-2",0,2,"1",1,2,-2,"D"
"12422",1977-10-11,1977,"Olympique Marseille","RC Strasbourg","1-0",1,0,"1",1,1,1,"H"
"12423",1977-10-11,1977,"FC Sochaux","RC Lens","7-2",7,2,"1",1,9,5,"H"
"12424",1977-10-11,1977,"FC Nantes","Paris Saint-Germain","3-1",3,1,"1",1,4,2,"H"
"12425",1977-10-11,1977,"US Valenciennes-Anzin","Girondins Bordeaux","0-1",0,1,"1",1,1,-1,"D"
"12426",1977-10-11,1977,"Nimes Olympique","AS Nancy","1-0",1,0,"1",1,1,1,"H"
"12427",1977-10-11,1977,"Olympique Lyon","Stade Reims","0-1",0,1,"1",1,1,-1,"D"
"12428",1977-10-11,1977,"Troyes AF","SC Bastia","1-0",1,0,"1",1,1,1,"H"
"12429",1977-10-14,1977,"AS Monaco","Nimes Olympique","2-1",2,1,"1",1,3,1,"H"
"12430",1977-10-14,1977,"RC Strasbourg","OGC Nice","2-1",2,1,"1",1,3,1,"H"
"12431",1977-10-14,1977,"AS Saint-Etienne","FC Sochaux","3-1",3,1,"1",1,4,2,"H"
"12432",1977-10-14,1977,"Olympique Marseille","US Valenciennes-Anzin","3-0",3,0,"1",1,3,3,"H"
"12433",1977-10-14,1977,"AS Nancy","FC Nantes","3-0",3,0,"1",1,3,3,"H"
"12434",1977-10-14,1977,"RC Lens","Stade Laval","1-1",1,1,"1",1,2,0,"D"
"12435",1977-10-14,1977,"Paris Saint-Germain","Troyes AF","8-2",8,2,"1",1,10,6,"H"
"12436",1977-10-14,1977,"Stade Reims","FC Rouen","3-1",3,1,"1",1,4,2,"H"
"12437",1977-10-14,1977,"SC Bastia","FC Metz","2-0",2,0,"1",1,2,2,"H"
"12438",1977-10-14,1977,"Girondins Bordeaux","Olympique Lyon","1-4",1,4,"1",1,5,-3,"D"
"12439",1977-10-22,1977,"OGC Nice","Stade Reims","4-2",4,2,"1",1,6,2,"H"
"12440",1977-10-22,1977,"Troyes AF","AS Monaco","3-0",3,0,"1",1,3,3,"H"
"12441",1977-10-22,1977,"Stade Laval","AS Saint-Etienne","1-0",1,0,"1",1,1,1,"H"
"12442",1977-10-22,1977,"Olympique Lyon","Olympique Marseille","4-2",4,2,"1",1,6,2,"H"
"12443",1977-10-22,1977,"US Valenciennes-Anzin","RC Strasbourg","0-0",0,0,"1",1,0,0,"D"
"12444",1977-10-22,1977,"FC Nantes","Girondins Bordeaux","4-1",4,1,"1",1,5,3,"H"
"12445",1977-10-22,1977,"FC Sochaux","SC Bastia","2-0",2,0,"1",1,2,2,"H"
"12446",1977-10-22,1977,"FC Metz","RC Lens","2-1",2,1,"1",1,3,1,"H"
"12447",1977-10-22,1977,"FC Rouen","AS Nancy","3-2",3,2,"1",1,5,1,"H"
"12448",1977-10-28,1977,"AS Monaco","FC Sochaux","2-1",2,1,"1",1,3,1,"H"
"12449",1977-10-28,1977,"Olympique Marseille","OGC Nice","2-0",2,0,"1",1,2,2,"H"
"12450",1977-10-28,1977,"AS Saint-Etienne","RC Lens","0-1",0,1,"1",1,1,-1,"D"
"12451",1977-10-28,1977,"Stade Reims","FC Nantes","1-3",1,3,"1",1,4,-2,"D"
"12452",1977-10-28,1977,"Paris Saint-Germain","Stade Laval","2-2",2,2,"1",1,4,0,"D"
"12453",1977-10-28,1977,"RC Strasbourg","Olympique Lyon","2-2",2,2,"1",1,4,0,"D"
"12454",1977-10-28,1977,"SC Bastia","Nimes Olympique","2-1",2,1,"1",1,3,1,"H"
"12455",1977-10-28,1977,"Girondins Bordeaux","FC Metz","1-0",1,0,"1",1,1,1,"H"
"12456",1977-10-28,1977,"AS Nancy","Troyes AF","1-0",1,0,"1",1,1,1,"H"
"12457",1977-10-28,1977,"US Valenciennes-Anzin","FC Rouen","3-0",3,0,"1",1,3,3,"H"
"12458",1977-11-04,1977,"Nimes Olympique","Paris Saint-Germain","2-1",2,1,"1",1,3,1,"H"
"12459",1977-11-09,1977,"AS Monaco","RC Lens","3-0",3,0,"1",1,3,3,"H"
"12460",1977-11-09,1977,"US Valenciennes-Anzin","OGC Nice","2-4",2,4,"1",1,6,-2,"D"
"12461",1977-11-09,1977,"Olympique Marseille","FC Nantes","2-2",2,2,"1",1,4,0,"D"
"12462",1977-11-09,1977,"RC Strasbourg","FC Rouen","2-0",2,0,"1",1,2,2,"H"
"12463",1977-11-09,1977,"Paris Saint-Germain","AS Saint-Etienne","4-1",4,1,"1",1,5,3,"H"
"12464",1977-11-09,1977,"AS Nancy","FC Sochaux","1-1",1,1,"1",1,2,0,"D"
"12465",1977-11-09,1977,"Olympique Lyon","FC Metz","4-1",4,1,"1",1,5,3,"H"
"12466",1977-11-09,1977,"Stade Reims","Nimes Olympique","2-1",2,1,"1",1,3,1,"H"
"12467",1977-11-09,1977,"Girondins Bordeaux","Troyes AF","1-1",1,1,"1",1,2,0,"D"
"12468",1977-11-12,1977,"SC Bastia","Stade Laval","1-0",1,0,"1",1,1,1,"H"
"12469",1977-11-19,1977,"OGC Nice","SC Bastia","3-1",3,1,"1",1,4,2,"H"
"12470",1977-11-19,1977,"AS Saint-Etienne","AS Monaco","1-0",1,0,"1",1,1,1,"H"
"12471",1977-11-19,1977,"FC Metz","Olympique Marseille","0-2",0,2,"1",1,2,-2,"D"
"12472",1977-11-19,1977,"FC Nantes","US Valenciennes-Anzin","4-1",4,1,"1",1,5,3,"H"
"12473",1977-11-19,1977,"Nimes Olympique","RC Strasbourg","0-1",0,1,"1",1,1,-1,"D"
"12474",1977-11-19,1977,"FC Sochaux","Girondins Bordeaux","0-0",0,0,"1",1,0,0,"D"
"12475",1977-11-19,1977,"Stade Laval","AS Nancy","1-2",1,2,"1",1,3,-1,"D"
"12476",1977-11-19,1977,"RC Lens","Paris Saint-Germain","3-1",3,1,"1",1,4,2,"H"
"12477",1977-11-19,1977,"FC Rouen","Olympique Lyon","3-2",3,2,"1",1,5,1,"H"
"12478",1977-11-19,1977,"Troyes AF","Stade Reims","3-0",3,0,"1",1,3,3,"H"
"12479",1977-11-22,1977,"FC Nantes","RC Strasbourg","1-1",1,1,"1",1,2,0,"D"
"12480",1977-11-22,1977,"FC Metz","Stade Reims","2-1",2,1,"1",1,3,1,"H"
"12481",1977-11-26,1977,"FC Rouen","OGC Nice","2-0",2,0,"1",1,2,2,"H"
"12482",1977-11-26,1977,"AS Monaco","Paris Saint-Germain","0-0",0,0,"1",1,0,0,"D"
"12483",1977-11-26,1977,"RC Strasbourg","Troyes AF","3-0",3,0,"1",1,3,3,"H"
"12484",1977-11-26,1977,"Olympique Marseille","Nimes Olympique","1-1",1,1,"1",1,2,0,"D"
"12485",1977-11-26,1977,"Olympique Lyon","FC Nantes","1-0",1,0,"1",1,1,1,"H"
"12486",1977-11-26,1977,"SC Bastia","AS Saint-Etienne","2-0",2,0,"1",1,2,2,"H"
"12487",1977-11-26,1977,"Stade Reims","FC Sochaux","1-1",1,1,"1",1,2,0,"D"
"12488",1977-11-26,1977,"Girondins Bordeaux","Stade Laval","1-1",1,1,"1",1,2,0,"D"
"12489",1977-11-26,1977,"AS Nancy","RC Lens","0-0",0,0,"1",1,0,0,"D"
"12490",1977-11-26,1977,"US Valenciennes-Anzin","FC Metz","2-1",2,1,"1",1,3,1,"H"
"12491",1977-11-30,1977,"OGC Nice","Olympique Lyon","3-1",3,1,"1",1,4,2,"H"
"12492",1977-11-30,1977,"Troyes AF","Olympique Marseille","0-1",0,1,"1",1,1,-1,"D"
"12493",1977-11-30,1977,"FC Metz","AS Monaco","2-1",2,1,"1",1,3,1,"H"
"12494",1977-11-30,1977,"FC Sochaux","RC Strasbourg","3-2",3,2,"1",1,5,1,"H"
"12495",1977-11-30,1977,"FC Nantes","FC Rouen","0-0",0,0,"1",1,0,0,"D"
"12496",1977-11-30,1977,"AS Saint-Etienne","AS Nancy","2-1",2,1,"1",1,3,1,"H"
"12497",1977-11-30,1977,"RC Lens","Girondins Bordeaux","2-0",2,0,"1",1,2,2,"H"
"12498",1977-11-30,1977,"Paris Saint-Germain","SC Bastia","3-3",3,3,"1",1,6,0,"D"
"12499",1977-11-30,1977,"Nimes Olympique","US Valenciennes-Anzin","1-2",1,2,"1",1,3,-1,"D"
"12500",1977-12-03,1977,"OGC Nice","FC Sochaux","4-2",4,2,"1",1,6,2,"H"
"12501",1977-12-03,1977,"RC Strasbourg","RC Lens","3-0",3,0,"1",1,3,3,"H"
"12502",1977-12-03,1977,"AS Nancy","AS Monaco","2-2",2,2,"1",1,4,0,"D"
"12503",1977-12-03,1977,"FC Nantes","FC Metz","2-0",2,0,"1",1,2,2,"H"
"12504",1977-12-03,1977,"US Valenciennes-Anzin","Stade Laval","2-3",2,3,"1",1,5,-1,"D"
"12505",1977-12-03,1977,"Stade Reims","Paris Saint-Germain","0-0",0,0,"1",1,0,0,"D"
"12506",1977-12-03,1977,"Girondins Bordeaux","SC Bastia","1-0",1,0,"1",1,1,1,"H"
"12507",1977-12-03,1977,"Olympique Lyon","Troyes AF","0-0",0,0,"1",1,0,0,"D"
"12508",1977-12-03,1977,"FC Rouen","Nimes Olympique","2-0",2,0,"1",1,2,2,"H"
"12509",1977-12-04,1977,"Olympique Marseille","AS Saint-Etienne","3-0",3,0,"1",1,3,3,"H"
"12510",1977-12-10,1977,"FC Metz","OGC Nice","2-0",2,0,"1",1,2,2,"H"
"12511",1977-12-10,1977,"Stade Laval","Olympique Marseille","2-1",2,1,"1",1,3,1,"H"
"12512",1977-12-10,1977,"AS Monaco","Girondins Bordeaux","3-2",3,2,"1",1,5,1,"H"
"12513",1977-12-10,1977,"AS Saint-Etienne","Stade Reims","2-0",2,0,"1",1,2,2,"H"
"12514",1977-12-10,1977,"FC Sochaux","US Valenciennes-Anzin","0-1",0,1,"1",1,1,-1,"D"
"12515",1977-12-10,1977,"SC Bastia","AS Nancy","1-0",1,0,"1",1,1,1,"H"
"12516",1977-12-10,1977,"RC Lens","Olympique Lyon","2-3",2,3,"1",1,5,-1,"D"
"12517",1977-12-10,1977,"Troyes AF","FC Rouen","3-1",3,1,"1",1,4,2,"H"
"12518",1977-12-11,1977,"Paris Saint-Germain","RC Strasbourg","2-2",2,2,"1",1,4,0,"D"
"12519",1977-12-11,1977,"Nimes Olympique","FC Nantes","0-0",0,0,"1",1,0,0,"D"
"12520",1977-12-13,1977,"FC Rouen","Olympique Marseille","0-2",0,2,"1",1,2,-2,"D"
"12521",1977-12-14,1977,"Stade Laval","AS Monaco","0-0",0,0,"1",1,0,0,"D"
"12522",1977-12-14,1977,"FC Sochaux","Paris Saint-Germain","2-1",2,1,"1",1,3,1,"H"
"12523",1977-12-14,1977,"Olympique Lyon","US Valenciennes-Anzin","1-2",1,2,"1",1,3,-1,"D"
"12524",1977-12-17,1977,"RC Strasbourg","AS Monaco","3-0",3,0,"1",1,3,3,"H"
"12525",1977-12-17,1977,"FC Nantes","Troyes AF","3-0",3,0,"1",1,3,3,"H"
"12526",1977-12-17,1977,"FC Rouen","FC Sochaux","1-2",1,2,"1",1,3,-1,"D"
"12527",1977-12-17,1977,"US Valenciennes-Anzin","AS Nancy","0-1",0,1,"1",1,1,-1,"D"
"12528",1977-12-18,1977,"Olympique Lyon","Stade Laval","5-0",5,0,"1",1,5,5,"H"
"12529",1977-12-18,1977,"Stade Reims","SC Bastia","1-3",1,3,"1",1,4,-2,"D"
"12530",1977-12-18,1977,"Girondins Bordeaux","Paris Saint-Germain","1-2",1,2,"1",1,3,-1,"D"
"12531",1977-12-18,1977,"Olympique Marseille","RC Lens","4-0",4,0,"1",1,4,4,"H"
"12532",1978-01-07,1977,"AS Monaco","Stade Reims","2-0",2,0,"1",1,2,2,"H"
"12533",1978-01-07,1977,"RC Lens","FC Nantes","0-1",0,1,"1",1,1,-1,"D"
"12534",1978-01-07,1977,"SC Bastia","RC Strasbourg","3-1",3,1,"1",1,4,2,"H"
"12535",1978-01-07,1977,"Stade Laval","FC Rouen","3-0",3,0,"1",1,3,3,"H"
"12536",1978-01-08,1977,"Paris Saint-Germain","Olympique Marseille","5-1",5,1,"1",1,6,4,"H"
"12537",1978-01-08,1977,"Nimes Olympique","OGC Nice","1-1",1,1,"1",1,2,0,"D"
"12538",1978-01-08,1977,"FC Sochaux","Olympique Lyon","1-0",1,0,"1",1,1,1,"H"
"12539",1978-01-08,1977,"AS Saint-Etienne","US Valenciennes-Anzin","2-1",2,1,"1",1,3,1,"H"
"12540",1978-01-08,1977,"AS Nancy","Girondins Bordeaux","4-1",4,1,"1",1,5,3,"H"
"12541",1978-01-08,1977,"Troyes AF","FC Metz","0-2",0,2,"1",1,2,-2,"D"
"12542",1978-01-14,1977,"FC Nantes","Stade Laval","3-1",3,1,"1",1,4,2,"H"
"12543",1978-01-14,1977,"FC Metz","FC Sochaux","1-1",1,1,"1",1,2,0,"D"
"12544",1978-01-14,1977,"US Valenciennes-Anzin","Paris Saint-Germain","2-1",2,1,"1",1,3,1,"H"
"12545",1978-01-14,1977,"FC Rouen","RC Lens","0-0",0,0,"1",1,0,0,"D"
"12546",1978-01-15,1977,"OGC Nice","Girondins Bordeaux","1-0",1,0,"1",1,1,1,"H"
"12547",1978-01-15,1977,"Olympique Marseille","AS Monaco","2-2",2,2,"1",1,4,0,"D"
"12548",1978-01-15,1977,"RC Strasbourg","AS Saint-Etienne","2-0",2,0,"1",1,2,2,"H"
"12549",1978-01-15,1977,"Olympique Lyon","SC Bastia","2-1",2,1,"1",1,3,1,"H"
"12550",1978-01-15,1977,"Stade Reims","AS Nancy","4-1",4,1,"1",1,5,3,"H"
"12551",1978-01-15,1977,"Nimes Olympique","Troyes AF","1-1",1,1,"1",1,2,0,"D"
"12552",1978-01-18,1977,"OGC Nice","AS Nancy","3-7",3,7,"1",1,10,-4,"D"
"12553",1978-01-18,1977,"RC Lens","SC Bastia","3-4",3,4,"1",1,7,-1,"D"
"12554",1978-01-18,1977,"Stade Laval","Stade Reims","2-0",2,0,"1",1,2,2,"H"
"12555",1978-01-18,1977,"FC Metz","Nimes Olympique","3-0",3,0,"1",1,3,3,"H"
"12556",1978-01-18,1977,"OGC Nice","AS Saint-Etienne","2-1",2,1,"1",1,3,1,"H"
"12557",1978-01-21,1977,"AS Monaco","US Valenciennes-Anzin","3-2",3,2,"1",1,5,1,"H"
"12558",1978-01-21,1977,"Troyes AF","OGC Nice","3-1",3,1,"1",1,4,2,"H"
"12559",1978-01-21,1977,"SC Bastia","Olympique Marseille","2-0",2,0,"1",1,2,2,"H"
"12560",1978-01-21,1977,"Stade Laval","FC Metz","3-0",3,0,"1",1,3,3,"H"
"12561",1978-01-21,1977,"RC Lens","Nimes Olympique","4-1",4,1,"1",1,5,3,"H"
"12562",1978-01-22,1977,"FC Sochaux","FC Nantes","1-1",1,1,"1",1,2,0,"D"
"12563",1978-01-22,1977,"AS Nancy","RC Strasbourg","3-1",3,1,"1",1,4,2,"H"
"12564",1978-01-22,1977,"AS Saint-Etienne","Olympique Lyon","1-0",1,0,"1",1,1,1,"H"
"12565",1978-01-22,1977,"Girondins Bordeaux","Stade Reims","2-0",2,0,"1",1,2,2,"H"
"12566",1978-01-24,1977,"Paris Saint-Germain","FC Rouen","3-1",3,1,"1",1,4,2,"H"
"12567",1978-02-03,1977,"OGC Nice","RC Lens","5-4",5,4,"1",1,9,1,"H"
"12568",1978-02-03,1977,"FC Nantes","AS Saint-Etienne","1-0",1,0,"1",1,1,1,"H"
"12569",1978-02-03,1977,"Olympique Lyon","AS Monaco","1-1",1,1,"1",1,2,0,"D"
"12570",1978-02-03,1977,"Olympique Marseille","AS Nancy","1-1",1,1,"1",1,2,0,"D"
"12571",1978-02-03,1977,"RC Strasbourg","Stade Reims","2-1",2,1,"1",1,3,1,"H"
"12572",1978-02-03,1977,"Nimes Olympique","Stade Laval","1-0",1,0,"1",1,1,1,"H"
"12573",1978-02-03,1977,"US Valenciennes-Anzin","SC Bastia","2-0",2,0,"1",1,2,2,"H"
"12574",1978-02-03,1977,"FC Rouen","Girondins Bordeaux","1-2",1,2,"1",1,3,-1,"D"
"12575",1978-02-04,1977,"Troyes AF","FC Sochaux","1-0",1,0,"1",1,1,1,"H"
"12576",1978-02-04,1977,"FC Metz","Paris Saint-Germain","2-1",2,1,"1",1,3,1,"H"
"12577",1978-02-11,1977,"AS Monaco","OGC Nice","2-0",2,0,"1",1,2,2,"H"
"12578",1978-02-11,1977,"SC Bastia","FC Nantes","0-0",0,0,"1",1,0,0,"D"
"12579",1978-02-11,1977,"Girondins Bordeaux","RC Strasbourg","3-0",3,0,"1",1,3,3,"H"
"12580",1978-02-11,1977,"Stade Laval","Troyes AF","2-1",2,1,"1",1,3,1,"H"
"12581",1978-02-11,1977,"FC Sochaux","Nimes Olympique","1-1",1,1,"1",1,2,0,"D"
"12582",1978-02-11,1977,"RC Lens","US Valenciennes-Anzin","0-2",0,2,"1",1,2,-2,"D"
"12583",1978-02-12,1977,"Stade Reims","Olympique Marseille","0-0",0,0,"1",1,0,0,"D"
"12584",1978-02-12,1977,"Paris Saint-Germain","Olympique Lyon","2-3",2,3,"1",1,5,-1,"D"
"12585",1978-02-15,1977,"Olympique Marseille","Girondins Bordeaux","4-0",4,0,"1",1,4,4,"H"
"12586",1978-02-15,1977,"OGC Nice","Paris Saint-Germain","2-3",2,3,"1",1,5,-1,"D"
"12587",1978-02-15,1977,"FC Metz","RC Strasbourg","0-0",0,0,"1",1,0,0,"D"
"12588",1978-02-15,1977,"FC Sochaux","Stade Laval","4-1",4,1,"1",1,5,3,"H"
"12589",1978-02-15,1977,"Nimes Olympique","AS Saint-Etienne","0-0",0,0,"1",1,0,0,"D"
"12590",1978-02-15,1977,"US Valenciennes-Anzin","Stade Reims","0-0",0,0,"1",1,0,0,"D"
"12591",1978-02-15,1977,"Troyes AF","RC Lens","0-0",0,0,"1",1,0,0,"D"
"12592",1978-02-22,1977,"AS Saint-Etienne","FC Rouen","2-1",2,1,"1",1,3,1,"H"
"12593",1978-02-25,1977,"AS Monaco","FC Rouen","6-1",6,1,"1",1,7,5,"H"
"12594",1978-02-25,1977,"RC Lens","FC Sochaux","1-3",1,3,"1",1,4,-2,"D"
"12595",1978-02-26,1977,"Stade Reims","Olympique Lyon","2-1",2,1,"1",1,3,1,"H"
"12596",1978-02-26,1977,"Girondins Bordeaux","US Valenciennes-Anzin","2-0",2,0,"1",1,2,2,"H"
"12597",1978-02-26,1977,"AS Saint-Etienne","FC Metz","2-0",2,0,"1",1,2,2,"H"
"12598",1978-02-26,1977,"AS Nancy","Nimes Olympique","2-2",2,2,"1",1,4,0,"D"
"12599",1978-03-04,1977,"Nimes Olympique","AS Monaco","3-4",3,4,"1",1,7,-1,"D"
"12600",1978-03-04,1977,"US Valenciennes-Anzin","Olympique Marseille","1-2",1,2,"1",1,3,-1,"D"
"12601",1978-03-04,1977,"FC Nantes","AS Nancy","2-0",2,0,"1",1,2,2,"H"
"12602",1978-03-04,1977,"OGC Nice","RC Strasbourg","0-1",0,1,"1",1,1,-1,"D"
"12603",1978-03-04,1977,"Stade Laval","RC Lens","3-0",3,0,"1",1,3,3,"H"
"12604",1978-03-04,1977,"FC Metz","SC Bastia","0-0",0,0,"1",1,0,0,"D"
"12605",1978-03-04,1977,"Olympique Lyon","Girondins Bordeaux","1-1",1,1,"1",1,2,0,"D"
"12606",1978-03-04,1977,"Troyes AF","Paris Saint-Germain","3-1",3,1,"1",1,4,2,"H"
"12607",1978-03-04,1977,"FC Rouen","Stade Reims","1-2",1,2,"1",1,3,-1,"D"
"12608",1978-03-05,1977,"FC Sochaux","AS Saint-Etienne","2-3",2,3,"1",1,5,-1,"D"
"12609",1978-03-10,1977,"RC Strasbourg","US Valenciennes-Anzin","1-1",1,1,"1",1,2,0,"D"
"12610",1978-03-11,1977,"AS Monaco","Troyes AF","1-1",1,1,"1",1,2,0,"D"
"12611",1978-03-11,1977,"Olympique Marseille","Olympique Lyon","4-0",4,0,"1",1,4,4,"H"
"12612",1978-03-11,1977,"Girondins Bordeaux","FC Nantes","1-0",1,0,"1",1,1,1,"H"
"12613",1978-03-11,1977,"AS Saint-Etienne","Stade Laval","1-0",1,0,"1",1,1,1,"H"
"12614",1978-03-11,1977,"Stade Reims","OGC Nice","0-0",0,0,"1",1,0,0,"D"
"12615",1978-03-11,1977,"SC Bastia","FC Sochaux","0-0",0,0,"1",1,0,0,"D"
"12616",1978-03-11,1977,"AS Nancy","FC Rouen","1-0",1,0,"1",1,1,1,"H"
"12617",1978-03-11,1977,"Paris Saint-Germain","Nimes Olympique","5-0",5,0,"1",1,5,5,"H"
"12618",1978-03-11,1977,"RC Lens","FC Metz","1-2",1,2,"1",1,3,-1,"D"
"12619",1978-03-14,1977,"Nimes Olympique","Girondins Bordeaux","3-1",3,1,"1",1,4,2,"H"
"12620",1978-03-14,1977,"FC Nantes","AS Monaco","1-0",1,0,"1",1,1,1,"H"
"12621",1978-03-14,1977,"Olympique Lyon","AS Nancy","1-3",1,3,"1",1,4,-2,"D"
"12622",1978-03-14,1977,"RC Strasbourg","Olympique Marseille","2-1",2,1,"1",1,3,1,"H"
"12623",1978-03-14,1977,"Stade Laval","OGC Nice","2-0",2,0,"1",1,2,2,"H"
"12624",1978-03-25,1977,"OGC Nice","Olympique Marseille","1-1",1,1,"1",1,2,0,"D"
"12625",1978-03-25,1977,"FC Nantes","Stade Reims","3-1",3,1,"1",1,4,2,"H"
"12626",1978-03-25,1977,"FC Sochaux","AS Monaco","3-2",3,2,"1",1,5,1,"H"
"12627",1978-03-25,1977,"Olympique Lyon","RC Strasbourg","1-1",1,1,"1",1,2,0,"D"
"12628",1978-03-25,1977,"RC Lens","AS Saint-Etienne","2-0",2,0,"1",1,2,2,"H"
"12629",1978-03-25,1977,"Troyes AF","AS Nancy","2-3",2,3,"1",1,5,-1,"D"
"12630",1978-03-25,1977,"Stade Laval","Paris Saint-Germain","1-2",1,2,"1",1,3,-1,"D"
"12631",1978-03-25,1977,"Nimes Olympique","SC Bastia","2-0",2,0,"1",1,2,2,"H"
"12632",1978-03-25,1977,"FC Metz","Girondins Bordeaux","5-0",5,0,"1",1,5,5,"H"
"12633",1978-03-25,1977,"FC Rouen","US Valenciennes-Anzin","1-1",1,1,"1",1,2,0,"D"
"12634",1978-03-28,1977,"Paris Saint-Germain","FC Nantes","0-1",0,1,"1",1,1,-1,"D"
"12635",1978-04-02,1977,"SC Bastia","Troyes AF","6-0",6,0,"1",1,6,6,"H"
"12636",1978-04-04,1977,"RC Strasbourg","FC Nantes","1-0",1,0,"1",1,1,1,"H"
"12637",1978-04-04,1977,"AS Nancy","OGC Nice","1-1",1,1,"1",1,2,0,"D"
"12638",1978-04-05,1977,"Olympique Marseille","FC Rouen","4-1",4,1,"1",1,5,3,"H"
"12639",1978-04-05,1977,"AS Monaco","Stade Laval","4-0",4,0,"1",1,4,4,"H"
"12640",1978-04-05,1977,"AS Saint-Etienne","Troyes AF","1-0",1,0,"1",1,1,1,"H"
"12641",1978-04-05,1977,"Paris Saint-Germain","FC Sochaux","3-1",3,1,"1",1,4,2,"H"
"12642",1978-04-05,1977,"SC Bastia","RC Lens","3-1",3,1,"1",1,4,2,"H"
"12643",1978-04-05,1977,"Girondins Bordeaux","Nimes Olympique","4-4",4,4,"1",1,8,0,"D"
"12644",1978-04-05,1977,"Stade Reims","FC Metz","0-0",0,0,"1",1,0,0,"D"
"12645",1978-04-05,1977,"US Valenciennes-Anzin","Olympique Lyon","1-0",1,0,"1",1,1,1,"H"
"12646",1978-04-08,1977,"RC Lens","AS Monaco","2-3",2,3,"1",1,5,-1,"D"
"12647",1978-04-08,1977,"FC Nantes","Olympique Marseille","1-0",1,0,"1",1,1,1,"H"
"12648",1978-04-08,1977,"FC Rouen","RC Strasbourg","0-3",0,3,"1",1,3,-3,"D"
"12649",1978-04-08,1977,"AS Saint-Etienne","Paris Saint-Germain","1-1",1,1,"1",1,2,0,"D"
"12650",1978-04-08,1977,"FC Sochaux","AS Nancy","2-0",2,0,"1",1,2,2,"H"
"12651",1978-04-08,1977,"OGC Nice","US Valenciennes-Anzin","0-2",0,2,"1",1,2,-2,"D"
"12652",1978-04-08,1977,"Stade Laval","SC Bastia","0-1",0,1,"1",1,1,-1,"D"
"12653",1978-04-08,1977,"FC Metz","Olympique Lyon","1-0",1,0,"1",1,1,1,"H"
"12654",1978-04-08,1977,"Troyes AF","Girondins Bordeaux","1-1",1,1,"1",1,2,0,"D"
"12655",1978-04-09,1977,"Nimes Olympique","Stade Reims","1-0",1,0,"1",1,1,1,"H"
"12656",1978-04-11,1977,"AS Nancy","FC Metz","0-0",0,0,"1",1,0,0,"D"
"12657",1978-04-15,1977,"Troyes AF","AS Saint-Etienne","1-0",1,0,"1",1,1,1,"H"
"12658",1978-04-20,1977,"Olympique Lyon","FC Rouen","4-0",4,0,"1",1,4,4,"H"
"12659",1978-04-21,1977,"AS Monaco","AS Saint-Etienne","3-1",3,1,"1",1,4,2,"H"
"12660",1978-04-21,1977,"US Valenciennes-Anzin","FC Nantes","0-2",0,2,"1",1,2,-2,"D"
"12661",1978-04-21,1977,"Olympique Marseille","FC Metz","4-0",4,0,"1",1,4,4,"H"
"12662",1978-04-21,1977,"RC Strasbourg","Nimes Olympique","3-0",3,0,"1",1,3,3,"H"
"12663",1978-04-21,1977,"Girondins Bordeaux","FC Sochaux","1-1",1,1,"1",1,2,0,"D"
"12664",1978-04-21,1977,"AS Nancy","Stade Laval","3-0",3,0,"1",1,3,3,"H"
"12665",1978-04-21,1977,"SC Bastia","OGC Nice","4-1",4,1,"1",1,5,3,"H"
"12666",1978-04-21,1977,"Paris Saint-Germain","RC Lens","2-1",2,1,"1",1,3,1,"H"
"12667",1978-04-21,1977,"Stade Reims","Troyes AF","5-1",5,1,"1",1,6,4,"H"
"12668",1978-04-25,1977,"FC Nantes","Olympique Lyon","2-0",2,0,"1",1,2,2,"H"
"12669",1978-04-25,1977,"Paris Saint-Germain","AS Monaco","1-2",1,2,"1",1,3,-1,"D"
"12670",1978-04-25,1977,"Troyes AF","RC Strasbourg","0-2",0,2,"1",1,2,-2,"D"
"12671",1978-04-25,1977,"Nimes Olympique","Olympique Marseille","2-1",2,1,"1",1,3,1,"H"
"12672",1978-04-25,1977,"OGC Nice","FC Rouen","6-1",6,1,"1",1,7,5,"H"
"12673",1978-04-25,1977,"FC Sochaux","Stade Reims","2-3",2,3,"1",1,5,-1,"D"
"12674",1978-04-25,1977,"RC Lens","AS Nancy","1-0",1,0,"1",1,1,1,"H"
"12675",1978-04-25,1977,"Stade Laval","Girondins Bordeaux","2-1",2,1,"1",1,3,1,"H"
"12676",1978-04-25,1977,"FC Metz","US Valenciennes-Anzin","1-1",1,1,"1",1,2,0,"D"
"12677",1978-04-28,1977,"AS Monaco","FC Metz","4-0",4,0,"1",1,4,4,"H"
"12678",1978-04-28,1977,"FC Rouen","FC Nantes","0-0",0,0,"1",1,0,0,"D"
"12679",1978-04-28,1977,"RC Strasbourg","FC Sochaux","1-1",1,1,"1",1,2,0,"D"
"12680",1978-04-28,1977,"Olympique Marseille","Troyes AF","0-1",0,1,"1",1,1,-1,"D"
"12681",1978-04-28,1977,"AS Nancy","AS Saint-Etienne","2-1",2,1,"1",1,3,1,"H"
"12682",1978-04-28,1977,"Olympique Lyon","OGC Nice","1-1",1,1,"1",1,2,0,"D"
"12683",1978-04-28,1977,"Stade Reims","Stade Laval","3-1",3,1,"1",1,4,2,"H"
"12684",1978-04-28,1977,"US Valenciennes-Anzin","Nimes Olympique","1-1",1,1,"1",1,2,0,"D"
"12685",1978-04-28,1977,"Girondins Bordeaux","RC Lens","0-1",0,1,"1",1,1,-1,"D"
"12686",1978-05-01,1977,"AS Saint-Etienne","SC Bastia","0-4",0,4,"1",1,4,-4,"D"
"12687",1978-05-02,1977,"AS Monaco","SC Bastia","2-1",2,1,"1",1,3,1,"H"
"12688",1978-05-02,1977,"FC Nantes","OGC Nice","6-1",6,1,"1",1,7,5,"H"
"12689",1978-05-02,1977,"Stade Laval","RC Strasbourg","2-3",2,3,"1",1,5,-1,"D"
"12690",1978-05-02,1977,"FC Sochaux","Olympique Marseille","1-2",1,2,"1",1,3,-1,"D"
"12691",1978-05-02,1977,"Paris Saint-Germain","AS Nancy","1-2",1,2,"1",1,3,-1,"D"
"12692",1978-05-02,1977,"AS Saint-Etienne","Girondins Bordeaux","5-0",5,0,"1",1,5,5,"H"
"12693",1978-05-02,1977,"FC Metz","FC Rouen","4-1",4,1,"1",1,5,3,"H"
"12694",1978-05-02,1977,"Nimes Olympique","Olympique Lyon","3-0",3,0,"1",1,3,3,"H"
"12695",1978-05-02,1977,"Troyes AF","US Valenciennes-Anzin","2-1",2,1,"1",1,3,1,"H"
"12696",1978-05-02,1977,"RC Lens","Stade Reims","3-1",3,1,"1",1,4,2,"H"
"12697",1978-05-04,1977,"SC Bastia","Paris Saint-Germain","5-3",5,3,"1",1,8,2,"H"
"12698",1978-05-12,1977,"FC Rouen","SC Bastia","0-0",0,0,"1",1,0,0,"D"
"12699",1978-07-19,1978,"OGC Nice","Angers SCO","3-1",3,1,"1",1,4,2,"H"
"12700",1978-07-19,1978,"Stade Reims","Paris Saint-Germain","2-0",2,0,"1",1,2,2,"H"
"12701",1978-07-19,1978,"Lille OSC","AS Nancy","4-3",4,3,"1",1,7,1,"H"
"12702",1978-07-19,1978,"FC Nantes","Stade Laval","2-1",2,1,"1",1,3,1,"H"
"12703",1978-07-19,1978,"FC Metz","Olympique Marseille","2-1",2,1,"1",1,3,1,"H"
"12704",1978-07-19,1978,"AS Saint-Etienne","SC Bastia","2-1",2,1,"1",1,3,1,"H"
"12705",1978-07-19,1978,"RC Strasbourg","Olympique Lyon","1-0",1,0,"1",1,1,1,"H"
"12706",1978-07-19,1978,"Nimes Olympique","AS Monaco","1-0",1,0,"1",1,1,1,"H"
"12707",1978-07-19,1978,"Girondins Bordeaux","FC Sochaux","1-1",1,1,"1",1,2,0,"D"
"12708",1978-07-19,1978,"Paris FC","US Valenciennes-Anzin","0-2",0,2,"1",1,2,-2,"D"
"12709",1978-07-25,1978,"Olympique Lyon","Stade Reims","1-1",1,1,"1",1,2,0,"D"
"12710",1978-07-25,1978,"US Valenciennes-Anzin","Lille OSC","4-2",4,2,"1",1,6,2,"H"
"12711",1978-07-25,1978,"Paris Saint-Germain","FC Metz","0-2",0,2,"1",1,2,-2,"D"
"12712",1978-07-25,1978,"Stade Laval","RC Strasbourg","2-2",2,2,"1",1,4,0,"D"
"12713",1978-07-25,1978,"FC Sochaux","OGC Nice","2-1",2,1,"1",1,3,1,"H"
"12714",1978-07-25,1978,"SC Bastia","Paris FC","5-1",5,1,"1",1,6,4,"H"
"12715",1978-07-25,1978,"AS Nancy","Nimes Olympique","3-0",3,0,"1",1,3,3,"H"
"12716",1978-07-25,1978,"Olympique Marseille","AS Saint-Etienne","2-0",2,0,"1",1,2,2,"H"
"12717",1978-07-25,1978,"AS Monaco","FC Nantes","2-1",2,1,"1",1,3,1,"H"
"12718",1978-07-25,1978,"Angers SCO","Girondins Bordeaux","0-0",0,0,"1",1,0,0,"D"
"12719",1978-07-28,1978,"FC Metz","US Valenciennes-Anzin","1-0",1,0,"1",1,1,1,"H"
"12720",1978-07-28,1978,"RC Strasbourg","FC Nantes","2-1",2,1,"1",1,3,1,"H"
"12721",1978-07-28,1978,"OGC Nice","Olympique Marseille","4-2",4,2,"1",1,6,2,"H"
"12722",1978-07-28,1978,"Stade Reims","Stade Laval","1-1",1,1,"1",1,2,0,"D"
"12723",1978-07-28,1978,"Girondins Bordeaux","SC Bastia","2-0",2,0,"1",1,2,2,"H"
"12724",1978-07-28,1978,"Lille OSC","AS Monaco","4-2",4,2,"1",1,6,2,"H"
"12725",1978-07-28,1978,"AS Saint-Etienne","FC Sochaux","3-1",3,1,"1",1,4,2,"H"
"12726",1978-07-28,1978,"Angers SCO","AS Nancy","2-1",2,1,"1",1,3,1,"H"
"12727",1978-07-28,1978,"Paris FC","Olympique Lyon","0-0",0,0,"1",1,0,0,"D"
"12728",1978-07-28,1978,"Nimes Olympique","Paris Saint-Germain","1-2",1,2,"1",1,3,-1,"D"
"12729",1978-08-02,1978,"Stade Laval","FC Metz","0-1",0,1,"1",1,1,-1,"D"
"12730",1978-08-02,1978,"AS Monaco","RC Strasbourg","0-2",0,2,"1",1,2,-2,"D"
"12731",1978-08-02,1978,"FC Sochaux","Angers SCO","4-0",4,0,"1",1,4,4,"H"
"12732",1978-08-02,1978,"US Valenciennes-Anzin","AS Saint-Etienne","0-0",0,0,"1",1,0,0,"D"
"12733",1978-08-02,1978,"Olympique Marseille","Girondins Bordeaux","0-0",0,0,"1",1,0,0,"D"
"12734",1978-08-02,1978,"Paris Saint-Germain","Lille OSC","0-0",0,0,"1",1,0,0,"D"
"12735",1978-08-02,1978,"AS Nancy","Paris FC","5-1",5,1,"1",1,6,4,"H"
"12736",1978-08-02,1978,"SC Bastia","OGC Nice","5-2",5,2,"1",1,7,3,"H"
"12737",1978-08-02,1978,"FC Nantes","Stade Reims","2-0",2,0,"1",1,2,2,"H"
"12738",1978-08-02,1978,"Olympique Lyon","Nimes Olympique","3-1",3,1,"1",1,4,2,"H"
"12739",1978-08-08,1978,"Stade Reims","RC Strasbourg","1-1",1,1,"1",1,2,0,"D"
"12740",1978-08-08,1978,"FC Metz","Olympique Lyon","1-2",1,2,"1",1,3,-1,"D"
"12741",1978-08-08,1978,"OGC Nice","US Valenciennes-Anzin","3-4",3,4,"1",1,7,-1,"D"
"12742",1978-08-08,1978,"Girondins Bordeaux","Paris Saint-Germain","2-0",2,0,"1",1,2,2,"H"
"12743",1978-08-08,1978,"Lille OSC","Stade Laval","5-3",5,3,"1",1,8,2,"H"
"12744",1978-08-08,1978,"AS Saint-Etienne","AS Nancy","3-2",3,2,"1",1,5,1,"H"
"12745",1978-08-08,1978,"Angers SCO","SC Bastia","0-2",0,2,"1",1,2,-2,"D"
"12746",1978-08-08,1978,"FC Sochaux","AS Monaco","1-2",1,2,"1",1,3,-1,"D"
"12747",1978-08-08,1978,"Nimes Olympique","FC Nantes","4-2",4,2,"1",1,6,2,"H"
"12748",1978-08-08,1978,"Paris FC","Olympique Marseille","2-1",2,1,"1",1,3,1,"H"
"12749",1978-08-18,1978,"RC Strasbourg","FC Metz","3-0",3,0,"1",1,3,3,"H"
"12750",1978-08-18,1978,"US Valenciennes-Anzin","Girondins Bordeaux","0-1",0,1,"1",1,1,-1,"D"
"12751",1978-08-18,1978,"SC Bastia","FC Sochaux","3-0",3,0,"1",1,3,3,"H"
"12752",1978-08-18,1978,"Olympique Lyon","AS Saint-Etienne","2-0",2,0,"1",1,2,2,"H"
"12753",1978-08-18,1978,"FC Nantes","Lille OSC","0-0",0,0,"1",1,0,0,"D"
"12754",1978-08-18,1978,"AS Nancy","OGC Nice","3-1",3,1,"1",1,4,2,"H"
"12755",1978-08-18,1978,"AS Monaco","Stade Reims","3-0",3,0,"1",1,3,3,"H"
"12756",1978-08-18,1978,"Stade Laval","Nimes Olympique","2-2",2,2,"1",1,4,0,"D"
"12757",1978-08-18,1978,"Olympique Marseille","Angers SCO","0-3",0,3,"1",1,3,-3,"D"
"12758",1978-08-18,1978,"Paris Saint-Germain","Paris FC","2-2",2,2,"1",1,4,0,"D"
"12759",1978-08-22,1978,"Lille OSC","RC Strasbourg","1-2",1,2,"1",1,3,-1,"D"
"12760",1978-08-22,1978,"Girondins Bordeaux","AS Nancy","0-0",0,0,"1",1,0,0,"D"
"12761",1978-08-22,1978,"AS Saint-Etienne","FC Nantes","3-1",3,1,"1",1,4,2,"H"
"12762",1978-08-22,1978,"FC Metz","AS Monaco","1-1",1,1,"1",1,2,0,"D"
"12763",1978-08-22,1978,"SC Bastia","Olympique Marseille","1-3",1,3,"1",1,4,-2,"D"
"12764",1978-08-22,1978,"FC Sochaux","Olympique Lyon","5-1",5,1,"1",1,6,4,"H"
"12765",1978-08-22,1978,"Angers SCO","US Valenciennes-Anzin","1-0",1,0,"1",1,1,1,"H"
"12766",1978-08-22,1978,"Nimes Olympique","Stade Reims","4-0",4,0,"1",1,4,4,"H"
"12767",1978-08-22,1978,"OGC Nice","Paris Saint-Germain","1-3",1,3,"1",1,4,-2,"D"
"12768",1978-08-22,1978,"Paris FC","Stade Laval","2-2",2,2,"1",1,4,0,"D"
"12769",1978-08-25,1978,"RC Strasbourg","Nimes Olympique","0-0",0,0,"1",1,0,0,"D"
"12770",1978-08-25,1978,"Olympique Lyon","OGC Nice","4-0",4,0,"1",1,4,4,"H"
"12771",1978-08-25,1978,"Stade Laval","Girondins Bordeaux","3-1",3,1,"1",1,4,2,"H"
"12772",1978-08-25,1978,"Paris Saint-Germain","AS Saint-Etienne","1-1",1,1,"1",1,2,0,"D"
"12773",1978-08-25,1978,"AS Nancy","FC Metz","1-1",1,1,"1",1,2,0,"D"
"12774",1978-08-25,1978,"US Valenciennes-Anzin","SC Bastia","3-0",3,0,"1",1,3,3,"H"
"12775",1978-08-25,1978,"Stade Reims","Lille OSC","0-0",0,0,"1",1,0,0,"D"
"12776",1978-08-25,1978,"AS Monaco","Paris FC","2-1",2,1,"1",1,3,1,"H"
"12777",1978-08-25,1978,"Olympique Marseille","FC Sochaux","2-2",2,2,"1",1,4,0,"D"
"12778",1978-08-25,1978,"FC Nantes","Angers SCO","5-0",5,0,"1",1,5,5,"H"
"12779",1978-09-03,1978,"Lille OSC","Nimes Olympique","1-1",1,1,"1",1,2,0,"D"
"12780",1978-09-03,1978,"Angers SCO","Paris Saint-Germain","2-2",2,2,"1",1,4,0,"D"
"12781",1978-09-05,1978,"Paris FC","RC Strasbourg","0-1",0,1,"1",1,1,-1,"D"
"12782",1978-09-05,1978,"Girondins Bordeaux","Olympique Lyon","4-1",4,1,"1",1,5,3,"H"
"12783",1978-09-05,1978,"AS Saint-Etienne","AS Monaco","4-1",4,1,"1",1,5,3,"H"
"12784",1978-09-05,1978,"FC Metz","Stade Reims","4-1",4,1,"1",1,5,3,"H"
"12785",1978-09-05,1978,"SC Bastia","AS Nancy","5-1",5,1,"1",1,6,4,"H"
"12786",1978-09-05,1978,"FC Sochaux","US Valenciennes-Anzin","3-0",3,0,"1",1,3,3,"H"
"12787",1978-09-05,1978,"Olympique Marseille","FC Nantes","1-1",1,1,"1",1,2,0,"D"
"12788",1978-09-05,1978,"OGC Nice","Stade Laval","2-1",2,1,"1",1,3,1,"H"
"12789",1978-09-08,1978,"RC Strasbourg","Angers SCO","6-0",6,0,"1",1,6,6,"H"
"12790",1978-09-08,1978,"Stade Reims","Girondins Bordeaux","0-0",0,0,"1",1,0,0,"D"
"12791",1978-09-08,1978,"AS Nancy","FC Sochaux","1-2",1,2,"1",1,3,-1,"D"
"12792",1978-09-08,1978,"Olympique Lyon","Lille OSC","4-0",4,0,"1",1,4,4,"H"
"12793",1978-09-08,1978,"Stade Laval","AS Saint-Etienne","2-1",2,1,"1",1,3,1,"H"
"12794",1978-09-08,1978,"Nimes Olympique","FC Metz","2-0",2,0,"1",1,2,2,"H"
"12795",1978-09-08,1978,"AS Monaco","OGC Nice","6-1",6,1,"1",1,7,5,"H"
"12796",1978-09-08,1978,"Paris Saint-Germain","SC Bastia","4-0",4,0,"1",1,4,4,"H"
"12797",1978-09-08,1978,"FC Nantes","Paris FC","2-0",2,0,"1",1,2,2,"H"
"12798",1978-09-08,1978,"US Valenciennes-Anzin","Olympique Marseille","0-2",0,2,"1",1,2,-2,"D"
"12799",1978-09-19,1978,"OGC Nice","RC Strasbourg","0-0",0,0,"1",1,0,0,"D"
"12800",1978-09-19,1978,"FC Sochaux","Paris Saint-Germain","2-1",2,1,"1",1,3,1,"H"
"12801",1978-09-19,1978,"AS Saint-Etienne","Stade Reims","2-0",2,0,"1",1,2,2,"H"
"12802",1978-09-19,1978,"Girondins Bordeaux","FC Nantes","1-1",1,1,"1",1,2,0,"D"
"12803",1978-09-19,1978,"Olympique Marseille","AS Monaco","1-2",1,2,"1",1,3,-1,"D"
"12804",1978-09-19,1978,"FC Metz","Lille OSC","4-4",4,4,"1",1,8,0,"D"
"12805",1978-09-19,1978,"SC Bastia","Olympique Lyon","1-0",1,0,"1",1,1,1,"H"
"12806",1978-09-19,1978,"Paris FC","Nimes Olympique","1-0",1,0,"1",1,1,1,"H"
"12807",1978-09-19,1978,"US Valenciennes-Anzin","AS Nancy","1-0",1,0,"1",1,1,1,"H"
"12808",1978-09-19,1978,"Angers SCO","Stade Laval","1-1",1,1,"1",1,2,0,"D"
"12809",1978-09-22,1978,"RC Strasbourg","AS Saint-Etienne","2-1",2,1,"1",1,3,1,"H"
"12810",1978-09-22,1978,"AS Monaco","SC Bastia","6-0",6,0,"1",1,6,6,"H"
"12811",1978-09-22,1978,"Stade Laval","FC Sochaux","1-1",1,1,"1",1,2,0,"D"
"12812",1978-09-22,1978,"Olympique Lyon","Angers SCO","3-0",3,0,"1",1,3,3,"H"
"12813",1978-09-22,1978,"Nimes Olympique","Girondins Bordeaux","4-2",4,2,"1",1,6,2,"H"
"12814",1978-09-22,1978,"FC Nantes","FC Metz","1-0",1,0,"1",1,1,1,"H"
"12815",1978-09-22,1978,"Lille OSC","Paris FC","4-2",4,2,"1",1,6,2,"H"
"12816",1978-09-22,1978,"Paris Saint-Germain","US Valenciennes-Anzin","2-0",2,0,"1",1,2,2,"H"
"12817",1978-09-22,1978,"AS Nancy","Olympique Marseille","5-0",5,0,"1",1,5,5,"H"
"12818",1978-09-22,1978,"Stade Reims","OGC Nice","2-2",2,2,"1",1,4,0,"D"
"12819",1978-09-30,1978,"Girondins Bordeaux","RC Strasbourg","1-1",1,1,"1",1,2,0,"D"
"12820",1978-09-30,1978,"FC Sochaux","FC Nantes","3-1",3,1,"1",1,4,2,"H"
"12821",1978-09-30,1978,"US Valenciennes-Anzin","AS Monaco","0-0",0,0,"1",1,0,0,"D"
"12822",1978-09-30,1978,"AS Saint-Etienne","Lille OSC","5-1",5,1,"1",1,6,4,"H"
"12823",1978-09-30,1978,"AS Nancy","Olympique Lyon","1-1",1,1,"1",1,2,0,"D"
"12824",1978-09-30,1978,"OGC Nice","Nimes Olympique","1-2",1,2,"1",1,3,-1,"D"
"12825",1978-09-30,1978,"Paris FC","FC Metz","1-2",1,2,"1",1,3,-1,"D"
"12826",1978-09-30,1978,"SC Bastia","Stade Laval","2-2",2,2,"1",1,4,0,"D"
"12827",1978-09-30,1978,"Olympique Marseille","Paris Saint-Germain","4-1",4,1,"1",1,5,3,"H"
"12828",1978-09-30,1978,"Angers SCO","Stade Reims","3-0",3,0,"1",1,3,3,"H"
"12829",1978-10-11,1978,"AS Monaco","Angers SCO","3-0",3,0,"1",1,3,3,"H"
"12830",1978-10-11,1978,"Olympique Lyon","US Valenciennes-Anzin","3-0",3,0,"1",1,3,3,"H"
"12831",1978-10-11,1978,"Nimes Olympique","AS Saint-Etienne","2-2",2,2,"1",1,4,0,"D"
"12832",1978-10-11,1978,"FC Metz","Girondins Bordeaux","1-0",1,0,"1",1,1,1,"H"
"12833",1978-10-11,1978,"FC Nantes","SC Bastia","1-0",1,0,"1",1,1,1,"H"
"12834",1978-10-11,1978,"Lille OSC","OGC Nice","4-0",4,0,"1",1,4,4,"H"
"12835",1978-10-11,1978,"Paris Saint-Germain","AS Nancy","2-1",2,1,"1",1,3,1,"H"
"12836",1978-10-11,1978,"Stade Laval","Olympique Marseille","2-1",2,1,"1",1,3,1,"H"
"12837",1978-10-11,1978,"Stade Reims","Paris FC","0-2",0,2,"1",1,2,-2,"D"
"12838",1978-10-14,1978,"SC Bastia","RC Strasbourg","1-1",1,1,"1",1,2,0,"D"
"12839",1978-10-14,1978,"AS Nancy","AS Monaco","1-2",1,2,"1",1,3,-1,"D"
"12840",1978-10-14,1978,"AS Saint-Etienne","Paris FC","6-0",6,0,"1",1,6,6,"H"
"12841",1978-10-14,1978,"FC Sochaux","Stade Reims","2-1",2,1,"1",1,3,1,"H"
"12842",1978-10-14,1978,"Olympique Marseille","Olympique Lyon","2-2",2,2,"1",1,4,0,"D"
"12843",1978-10-14,1978,"OGC Nice","FC Metz","5-0",5,0,"1",1,5,5,"H"
"12844",1978-10-14,1978,"Angers SCO","Nimes Olympique","2-1",2,1,"1",1,3,1,"H"
"12845",1978-10-14,1978,"Paris Saint-Germain","FC Nantes","1-1",1,1,"1",1,2,0,"D"
"12846",1978-10-14,1978,"Girondins Bordeaux","Lille OSC","1-1",1,1,"1",1,2,0,"D"
"12847",1978-10-14,1978,"US Valenciennes-Anzin","Stade Laval","1-1",1,1,"1",1,2,0,"D"
"12848",1978-10-20,1978,"FC Metz","AS Saint-Etienne","0-1",0,1,"1",1,1,-1,"D"
"12849",1978-10-21,1978,"RC Strasbourg","Olympique Marseille","4-1",4,1,"1",1,5,3,"H"
"12850",1978-10-21,1978,"AS Monaco","Girondins Bordeaux","2-2",2,2,"1",1,4,0,"D"
"12851",1978-10-21,1978,"Olympique Lyon","Paris Saint-Germain","4-2",4,2,"1",1,6,2,"H"
"12852",1978-10-21,1978,"Nimes Olympique","FC Sochaux","2-1",2,1,"1",1,3,1,"H"
"12853",1978-10-21,1978,"FC Nantes","US Valenciennes-Anzin","4-0",4,0,"1",1,4,4,"H"
"12854",1978-10-21,1978,"Lille OSC","Angers SCO","0-0",0,0,"1",1,0,0,"D"
"12855",1978-10-21,1978,"Stade Reims","SC Bastia","1-1",1,1,"1",1,2,0,"D"
"12856",1978-10-21,1978,"Stade Laval","AS Nancy","1-4",1,4,"1",1,5,-3,"D"
"12857",1978-10-21,1978,"Paris FC","OGC Nice","3-0",3,0,"1",1,3,3,"H"
"12858",1978-10-27,1978,"US Valenciennes-Anzin","RC Strasbourg","2-2",2,2,"1",1,4,0,"D"
"12859",1978-10-27,1978,"OGC Nice","AS Saint-Etienne","1-1",1,1,"1",1,2,0,"D"
"12860",1978-10-27,1978,"Olympique Lyon","AS Monaco","0-0",0,0,"1",1,0,0,"D"
"12861",1978-10-27,1978,"FC Sochaux","Lille OSC","1-1",1,1,"1",1,2,0,"D"
"12862",1978-10-27,1978,"AS Nancy","FC Nantes","3-2",3,2,"1",1,5,1,"H"
"12863",1978-10-27,1978,"SC Bastia","Nimes Olympique","1-0",1,0,"1",1,1,1,"H"
"12864",1978-10-27,1978,"Girondins Bordeaux","Paris FC","1-2",1,2,"1",1,3,-1,"D"
"12865",1978-10-27,1978,"Angers SCO","FC Metz","3-1",3,1,"1",1,4,2,"H"
"12866",1978-10-27,1978,"Paris Saint-Germain","Stade Laval","1-2",1,2,"1",1,3,-1,"D"
"12867",1978-10-28,1978,"Olympique Marseille","Stade Reims","0-0",0,0,"1",1,0,0,"D"
"12868",1978-11-04,1978,"RC Strasbourg","AS Nancy","3-0",3,0,"1",1,3,3,"H"
"12869",1978-11-04,1978,"AS Monaco","Paris Saint-Germain","2-1",2,1,"1",1,3,1,"H"
"12870",1978-11-04,1978,"AS Saint-Etienne","Girondins Bordeaux","1-3",1,3,"1",1,4,-2,"D"
"12871",1978-11-04,1978,"Stade Laval","Olympique Lyon","3-1",3,1,"1",1,4,2,"H"
"12872",1978-11-04,1978,"FC Metz","FC Sochaux","0-0",0,0,"1",1,0,0,"D"
"12873",1978-11-04,1978,"FC Nantes","OGC Nice","5-0",5,0,"1",1,5,5,"H"
"12874",1978-11-04,1978,"Lille OSC","SC Bastia","2-2",2,2,"1",1,4,0,"D"
"12875",1978-11-04,1978,"Nimes Olympique","Olympique Marseille","1-2",1,2,"1",1,3,-1,"D"
"12876",1978-11-04,1978,"Paris FC","Angers SCO","3-0",3,0,"1",1,3,3,"H"
"12877",1978-11-04,1978,"Stade Reims","US Valenciennes-Anzin","2-1",2,1,"1",1,3,1,"H"
"12878",1978-11-14,1978,"Paris Saint-Germain","RC Strasbourg","2-1",2,1,"1",1,3,1,"H"
"12879",1978-11-14,1978,"Stade Laval","AS Monaco","0-3",0,3,"1",1,3,-3,"D"
"12880",1978-11-14,1978,"Angers SCO","AS Saint-Etienne","1-3",1,3,"1",1,4,-2,"D"
"12881",1978-11-14,1978,"FC Sochaux","Paris FC","1-0",1,0,"1",1,1,1,"H"
"12882",1978-11-14,1978,"Olympique Lyon","FC Nantes","0-3",0,3,"1",1,3,-3,"D"
"12883",1978-11-14,1978,"Girondins Bordeaux","OGC Nice","2-0",2,0,"1",1,2,2,"H"
"12884",1978-11-14,1978,"Olympique Marseille","Lille OSC","1-1",1,1,"1",1,2,0,"D"
"12885",1978-11-14,1978,"SC Bastia","FC Metz","1-3",1,3,"1",1,4,-2,"D"
"12886",1978-11-14,1978,"US Valenciennes-Anzin","Nimes Olympique","2-0",2,0,"1",1,2,2,"H"
"12887",1978-11-14,1978,"AS Nancy","Stade Reims","4-0",4,0,"1",1,4,4,"H"
"12888",1978-11-17,1978,"RC Strasbourg","Stade Laval","1-1",1,1,"1",1,2,0,"D"
"12889",1978-11-17,1978,"AS Saint-Etienne","Olympique Marseille","1-0",1,0,"1",1,1,1,"H"
"12890",1978-11-17,1978,"FC Nantes","AS Monaco","3-0",3,0,"1",1,3,3,"H"
"12891",1978-11-17,1978,"OGC Nice","FC Sochaux","2-1",2,1,"1",1,3,1,"H"
"12892",1978-11-17,1978,"Stade Reims","Olympique Lyon","1-2",1,2,"1",1,3,-1,"D"
"12893",1978-11-17,1978,"Girondins Bordeaux","Angers SCO","2-0",2,0,"1",1,2,2,"H"
"12894",1978-11-17,1978,"Lille OSC","US Valenciennes-Anzin","2-1",2,1,"1",1,3,1,"H"
"12895",1978-11-17,1978,"FC Metz","Paris Saint-Germain","2-1",2,1,"1",1,3,1,"H"
"12896",1978-11-17,1978,"Paris FC","SC Bastia","1-1",1,1,"1",1,2,0,"D"
"12897",1978-11-18,1978,"Nimes Olympique","AS Nancy","3-0",3,0,"1",1,3,3,"H"
"12898",1978-11-25,1978,"FC Nantes","RC Strasbourg","3-0",3,0,"1",1,3,3,"H"
"12899",1978-11-25,1978,"AS Monaco","Lille OSC","2-1",2,1,"1",1,3,1,"H"
"12900",1978-11-25,1978,"SC Bastia","Girondins Bordeaux","1-1",1,1,"1",1,2,0,"D"
"12901",1978-11-25,1978,"US Valenciennes-Anzin","FC Metz","2-2",2,2,"1",1,4,0,"D"
"12902",1978-11-25,1978,"Stade Laval","Stade Reims","1-0",1,0,"1",1,1,1,"H"
"12903",1978-11-25,1978,"Paris Saint-Germain","Nimes Olympique","3-2",3,2,"1",1,5,1,"H"
"12904",1978-11-26,1978,"FC Sochaux","AS Saint-Etienne","0-0",0,0,"1",1,0,0,"D"
"12905",1978-11-26,1978,"Olympique Lyon","Paris FC","2-1",2,1,"1",1,3,1,"H"
"12906",1978-11-26,1978,"AS Nancy","Angers SCO","2-2",2,2,"1",1,4,0,"D"
"12907",1978-11-26,1978,"Olympique Marseille","OGC Nice","0-0",0,0,"1",1,0,0,"D"
"12908",1978-12-01,1978,"RC Strasbourg","AS Monaco","2-1",2,1,"1",1,3,1,"H"
"12909",1978-12-02,1978,"Girondins Bordeaux","Olympique Marseille","2-1",2,1,"1",1,3,1,"H"
"12910",1978-12-02,1978,"FC Metz","Stade Laval","5-1",5,1,"1",1,6,4,"H"
"12911",1978-12-02,1978,"Angers SCO","FC Sochaux","3-2",3,2,"1",1,5,1,"H"
"12912",1978-12-02,1978,"Lille OSC","Paris Saint-Germain","3-1",3,1,"1",1,4,2,"H"
"12913",1978-12-02,1978,"OGC Nice","SC Bastia","2-2",2,2,"1",1,4,0,"D"
"12914",1978-12-03,1978,"AS Saint-Etienne","US Valenciennes-Anzin","5-0",5,0,"1",1,5,5,"H"
"12915",1978-12-03,1978,"Stade Reims","FC Nantes","1-4",1,4,"1",1,5,-3,"D"
"12916",1978-12-03,1978,"Nimes Olympique","Olympique Lyon","2-2",2,2,"1",1,4,0,"D"
"12917",1978-12-03,1978,"Paris FC","AS Nancy","1-1",1,1,"1",1,2,0,"D"
"12918",1978-12-09,1978,"FC Nantes","Nimes Olympique","4-0",4,0,"1",1,4,4,"H"
"12919",1978-12-09,1978,"Stade Laval","Lille OSC","3-3",3,3,"1",1,6,0,"D"
"12920",1978-12-09,1978,"SC Bastia","Angers SCO","1-0",1,0,"1",1,1,1,"H"
"12921",1978-12-09,1978,"US Valenciennes-Anzin","OGC Nice","0-3",0,3,"1",1,3,-3,"D"
"12922",1978-12-10,1978,"RC Strasbourg","Stade Reims","2-2",2,2,"1",1,4,0,"D"
"12923",1978-12-10,1978,"AS Nancy","AS Saint-Etienne","1-1",1,1,"1",1,2,0,"D"
"12924",1978-12-10,1978,"AS Monaco","FC Sochaux","1-1",1,1,"1",1,2,0,"D"
"12925",1978-12-10,1978,"Paris Saint-Germain","Girondins Bordeaux","2-5",2,5,"1",1,7,-3,"D"
"12926",1978-12-10,1978,"Olympique Lyon","FC Metz","3-1",3,1,"1",1,4,2,"H"
"12927",1978-12-10,1978,"Olympique Marseille","Paris FC","1-1",1,1,"1",1,2,0,"D"
"12928",1978-12-16,1978,"FC Metz","RC Strasbourg","1-2",1,2,"1",1,3,-1,"D"
"12929",1978-12-16,1978,"Lille OSC","FC Nantes","1-3",1,3,"1",1,4,-2,"D"
"12930",1978-12-16,1978,"Stade Reims","AS Monaco","0-2",0,2,"1",1,2,-2,"D"
"12931",1978-12-16,1978,"Girondins Bordeaux","US Valenciennes-Anzin","1-0",1,0,"1",1,1,1,"H"
"12932",1978-12-16,1978,"Nimes Olympique","Stade Laval","4-0",4,0,"1",1,4,4,"H"
"12933",1978-12-16,1978,"OGC Nice","AS Nancy","2-2",2,2,"1",1,4,0,"D"
"12934",1978-12-16,1978,"Angers SCO","Olympique Marseille","1-1",1,1,"1",1,2,0,"D"
"12935",1978-12-17,1978,"AS Saint-Etienne","Olympique Lyon","3-0",3,0,"1",1,3,3,"H"
"12936",1978-12-17,1978,"FC Sochaux","SC Bastia","5-0",5,0,"1",1,5,5,"H"
"12937",1978-12-17,1978,"Paris FC","Paris Saint-Germain","1-1",1,1,"1",1,2,0,"D"
"12938",1979-01-27,1978,"RC Strasbourg","Lille OSC","3-0",3,0,"1",1,3,3,"H"
"12939",1979-01-27,1978,"FC Nantes","AS Saint-Etienne","3-1",3,1,"1",1,4,2,"H"
"12940",1979-01-27,1978,"Stade Reims","Nimes Olympique","0-0",0,0,"1",1,0,0,"D"
"12941",1979-01-27,1978,"Stade Laval","Paris FC","5-1",5,1,"1",1,6,4,"H"
"12942",1979-01-27,1978,"US Valenciennes-Anzin","Angers SCO","1-1",1,1,"1",1,2,0,"D"
"12943",1979-01-28,1978,"AS Monaco","FC Metz","4-1",4,1,"1",1,5,3,"H"
"12944",1979-01-28,1978,"Olympique Marseille","SC Bastia","1-0",1,0,"1",1,1,1,"H"
"12945",1979-01-28,1978,"Paris Saint-Germain","OGC Nice","1-1",1,1,"1",1,2,0,"D"
"12946",1979-02-03,1978,"Angers SCO","FC Nantes","1-1",1,1,"1",1,2,0,"D"
"12947",1979-02-03,1978,"Girondins Bordeaux","Stade Laval","1-1",1,1,"1",1,2,0,"D"
"12948",1979-02-03,1978,"Lille OSC","Stade Reims","4-0",4,0,"1",1,4,4,"H"
"12949",1979-02-03,1978,"SC Bastia","US Valenciennes-Anzin","2-0",2,0,"1",1,2,2,"H"
"12950",1979-02-04,1978,"Nimes Olympique","RC Strasbourg","0-0",0,0,"1",1,0,0,"D"
"12951",1979-02-04,1978,"Paris FC","AS Monaco","1-7",1,7,"1",1,8,-6,"D"
"12952",1979-02-04,1978,"AS Saint-Etienne","Paris Saint-Germain","4-1",4,1,"1",1,5,3,"H"
"12953",1979-02-04,1978,"FC Sochaux","Olympique Marseille","2-2",2,2,"1",1,4,0,"D"
"12954",1979-02-04,1978,"OGC Nice","Olympique Lyon","4-0",4,0,"1",1,4,4,"H"
"12955",1979-02-14,1978,"RC Strasbourg","FC Sochaux","2-1",2,1,"1",1,3,1,"H"
"12956",1979-02-17,1978,"FC Nantes","Olympique Marseille","2-2",2,2,"1",1,4,0,"D"
"12957",1979-02-17,1978,"AS Monaco","AS Saint-Etienne","0-1",0,1,"1",1,1,-1,"D"
"12958",1979-02-17,1978,"Stade Laval","OGC Nice","1-2",1,2,"1",1,3,-1,"D"
"12959",1979-02-18,1978,"RC Strasbourg","Paris FC","3-0",3,0,"1",1,3,3,"H"
"12960",1979-02-18,1978,"Olympique Lyon","Girondins Bordeaux","0-1",0,1,"1",1,1,-1,"D"
"12961",1979-02-18,1978,"Nimes Olympique","Lille OSC","3-2",3,2,"1",1,5,1,"H"
"12962",1979-02-18,1978,"Stade Reims","FC Metz","1-2",1,2,"1",1,3,-1,"D"
"12963",1979-02-18,1978,"Paris Saint-Germain","Angers SCO","1-1",1,1,"1",1,2,0,"D"
"12964",1979-03-02,1978,"Angers SCO","RC Strasbourg","1-2",1,2,"1",1,3,-1,"D"
"12965",1979-03-02,1978,"Paris FC","FC Nantes","1-2",1,2,"1",1,3,-1,"D"
"12966",1979-03-02,1978,"AS Saint-Etienne","Stade Laval","3-0",3,0,"1",1,3,3,"H"
"12967",1979-03-02,1978,"OGC Nice","AS Monaco","1-2",1,2,"1",1,3,-1,"D"
"12968",1979-03-02,1978,"Girondins Bordeaux","Stade Reims","0-0",0,0,"1",1,0,0,"D"
"12969",1979-03-02,1978,"Lille OSC","Olympique Lyon","1-1",1,1,"1",1,2,0,"D"
"12970",1979-03-02,1978,"FC Metz","Nimes Olympique","2-0",2,0,"1",1,2,2,"H"
"12971",1979-03-02,1978,"FC Sochaux","AS Nancy","1-2",1,2,"1",1,3,-1,"D"
"12972",1979-03-02,1978,"SC Bastia","Paris Saint-Germain","1-2",1,2,"1",1,3,-1,"D"
"12973",1979-03-02,1978,"Olympique Marseille","US Valenciennes-Anzin","1-0",1,0,"1",1,1,1,"H"
"12974",1979-03-06,1978,"AS Nancy","Girondins Bordeaux","4-1",4,1,"1",1,5,3,"H"
"12975",1979-03-06,1978,"Olympique Lyon","FC Sochaux","1-0",1,0,"1",1,1,1,"H"
"12976",1979-03-16,1978,"RC Strasbourg","OGC Nice","1-0",1,0,"1",1,1,1,"H"
"12977",1979-03-16,1978,"FC Nantes","Girondins Bordeaux","1-0",1,0,"1",1,1,1,"H"
"12978",1979-03-16,1978,"Stade Reims","AS Saint-Etienne","0-1",0,1,"1",1,1,-1,"D"
"12979",1979-03-16,1978,"AS Monaco","Olympique Marseille","1-2",1,2,"1",1,3,-1,"D"
"12980",1979-03-16,1978,"Olympique Lyon","SC Bastia","1-1",1,1,"1",1,2,0,"D"
"12981",1979-03-16,1978,"Lille OSC","FC Metz","1-1",1,1,"1",1,2,0,"D"
"12982",1979-03-16,1978,"Nimes Olympique","Paris FC","2-0",2,0,"1",1,2,2,"H"
"12983",1979-03-16,1978,"AS Nancy","US Valenciennes-Anzin","4-0",4,0,"1",1,4,4,"H"
"12984",1979-03-16,1978,"Stade Laval","Angers SCO","1-2",1,2,"1",1,3,-1,"D"
"12985",1979-03-16,1978,"Paris Saint-Germain","FC Sochaux","3-1",3,1,"1",1,4,2,"H"
"12986",1979-03-28,1978,"AS Saint-Etienne","RC Strasbourg","2-0",2,0,"1",1,2,2,"H"
"12987",1979-03-28,1978,"FC Metz","FC Nantes","1-3",1,3,"1",1,4,-2,"D"
"12988",1979-03-28,1978,"SC Bastia","AS Monaco","4-1",4,1,"1",1,5,3,"H"
"12989",1979-03-28,1978,"Girondins Bordeaux","Nimes Olympique","0-0",0,0,"1",1,0,0,"D"
"12990",1979-03-28,1978,"Angers SCO","Olympique Lyon","1-1",1,1,"1",1,2,0,"D"
"12991",1979-03-28,1978,"FC Sochaux","Stade Laval","2-1",2,1,"1",1,3,1,"H"
"12992",1979-03-28,1978,"Paris FC","Lille OSC","1-1",1,1,"1",1,2,0,"D"
"12993",1979-03-28,1978,"Olympique Marseille","AS Nancy","3-2",3,2,"1",1,5,1,"H"
"12994",1979-03-28,1978,"US Valenciennes-Anzin","Paris Saint-Germain","1-0",1,0,"1",1,1,1,"H"
"12995",1979-03-28,1978,"OGC Nice","Stade Reims","2-0",2,0,"1",1,2,2,"H"
"12996",1979-04-07,1978,"RC Strasbourg","Girondins Bordeaux","1-1",1,1,"1",1,2,0,"D"
"12997",1979-04-07,1978,"FC Nantes","FC Sochaux","4-0",4,0,"1",1,4,4,"H"
"12998",1979-04-07,1978,"Lille OSC","AS Saint-Etienne","3-0",3,0,"1",1,3,3,"H"
"12999",1979-04-07,1978,"AS Monaco","US Valenciennes-Anzin","2-2",2,2,"1",1,4,0,"D"
"13000",1979-04-07,1978,"Olympique Lyon","AS Nancy","2-1",2,1,"1",1,3,1,"H"
"13001",1979-04-07,1978,"Nimes Olympique","OGC Nice","4-1",4,1,"1",1,5,3,"H"
"13002",1979-04-07,1978,"FC Metz","Paris FC","5-1",5,1,"1",1,6,4,"H"
"13003",1979-04-07,1978,"Stade Laval","SC Bastia","0-1",0,1,"1",1,1,-1,"D"
"13004",1979-04-07,1978,"Paris Saint-Germain","Olympique Marseille","4-3",4,3,"1",1,7,1,"H"
"13005",1979-04-07,1978,"Stade Reims","Angers SCO","3-1",3,1,"1",1,4,2,"H"
"13006",1979-04-12,1978,"US Valenciennes-Anzin","FC Sochaux","0-1",0,1,"1",1,1,-1,"D"
"13007",1979-04-20,1978,"FC Sochaux","RC Strasbourg","1-2",1,2,"1",1,3,-1,"D"
"13008",1979-04-20,1978,"SC Bastia","FC Nantes","1-0",1,0,"1",1,1,1,"H"
"13009",1979-04-20,1978,"AS Saint-Etienne","Nimes Olympique","2-0",2,0,"1",1,2,2,"H"
"13010",1979-04-20,1978,"Angers SCO","AS Monaco","2-2",2,2,"1",1,4,0,"D"
"13011",1979-04-20,1978,"Girondins Bordeaux","FC Metz","1-2",1,2,"1",1,3,-1,"D"
"13012",1979-04-20,1978,"US Valenciennes-Anzin","Olympique Lyon","3-1",3,1,"1",1,4,2,"H"
"13013",1979-04-20,1978,"OGC Nice","Lille OSC","1-1",1,1,"1",1,2,0,"D"
"13014",1979-04-20,1978,"Olympique Marseille","Stade Laval","0-0",0,0,"1",1,0,0,"D"
"13015",1979-04-20,1978,"AS Nancy","Paris Saint-Germain","2-1",2,1,"1",1,3,1,"H"
"13016",1979-04-20,1978,"Paris FC","Stade Reims","2-1",2,1,"1",1,3,1,"H"
"13017",1979-04-24,1978,"FC Metz","AS Nancy","3-1",3,1,"1",1,4,2,"H"
"13018",1979-04-27,1978,"RC Strasbourg","SC Bastia","2-0",2,0,"1",1,2,2,"H"
"13019",1979-04-27,1978,"FC Nantes","Paris Saint-Germain","1-0",1,0,"1",1,1,1,"H"
"13020",1979-04-27,1978,"Paris FC","AS Saint-Etienne","0-1",0,1,"1",1,1,-1,"D"
"13021",1979-04-27,1978,"AS Monaco","AS Nancy","1-3",1,3,"1",1,4,-2,"D"
"13022",1979-04-27,1978,"FC Metz","OGC Nice","2-0",2,0,"1",1,2,2,"H"
"13023",1979-04-27,1978,"Lille OSC","Girondins Bordeaux","1-1",1,1,"1",1,2,0,"D"
"13024",1979-04-27,1978,"Olympique Lyon","Olympique Marseille","1-1",1,1,"1",1,2,0,"D"
"13025",1979-04-27,1978,"Nimes Olympique","Angers SCO","3-0",3,0,"1",1,3,3,"H"
"13026",1979-04-27,1978,"Stade Laval","US Valenciennes-Anzin","1-1",1,1,"1",1,2,0,"D"
"13027",1979-04-28,1978,"Stade Reims","FC Sochaux","0-2",0,2,"1",1,2,-2,"D"
"13028",1979-05-05,1978,"Olympique Marseille","RC Strasbourg","1-0",1,0,"1",1,1,1,"H"
"13029",1979-05-05,1978,"AS Saint-Etienne","FC Metz","1-0",1,0,"1",1,1,1,"H"
"13030",1979-05-05,1978,"US Valenciennes-Anzin","FC Nantes","1-1",1,1,"1",1,2,0,"D"
"13031",1979-05-05,1978,"Girondins Bordeaux","AS Monaco","0-2",0,2,"1",1,2,-2,"D"
"13032",1979-05-05,1978,"Paris Saint-Germain","Olympique Lyon","2-1",2,1,"1",1,3,1,"H"
"13033",1979-05-05,1978,"FC Sochaux","Nimes Olympique","2-2",2,2,"1",1,4,0,"D"
"13034",1979-05-05,1978,"Angers SCO","Lille OSC","1-1",1,1,"1",1,2,0,"D"
"13035",1979-05-05,1978,"SC Bastia","Stade Reims","3-2",3,2,"1",1,5,1,"H"
"13036",1979-05-05,1978,"AS Nancy","Stade Laval","2-3",2,3,"1",1,5,-1,"D"
"13037",1979-05-05,1978,"OGC Nice","Paris FC","5-0",5,0,"1",1,5,5,"H"
"13038",1979-05-15,1978,"AS Nancy","SC Bastia","5-1",5,1,"1",1,6,4,"H"
"13039",1979-05-18,1978,"RC Strasbourg","US Valenciennes-Anzin","5-0",5,0,"1",1,5,5,"H"
"13040",1979-05-18,1978,"AS Saint-Etienne","OGC Nice","5-1",5,1,"1",1,6,4,"H"
"13041",1979-05-18,1978,"FC Nantes","AS Nancy","3-0",3,0,"1",1,3,3,"H"
"13042",1979-05-18,1978,"AS Monaco","Olympique Lyon","0-1",0,1,"1",1,1,-1,"D"
"13043",1979-05-18,1978,"FC Metz","Angers SCO","1-0",1,0,"1",1,1,1,"H"
"13044",1979-05-18,1978,"Nimes Olympique","SC Bastia","3-2",3,2,"1",1,5,1,"H"
"13045",1979-05-18,1978,"Lille OSC","FC Sochaux","4-2",4,2,"1",1,6,2,"H"
"13046",1979-05-18,1978,"Paris FC","Girondins Bordeaux","3-1",3,1,"1",1,4,2,"H"
"13047",1979-05-18,1978,"Stade Reims","Olympique Marseille","0-1",0,1,"1",1,1,-1,"D"
"13048",1979-05-18,1978,"Stade Laval","Paris Saint-Germain","2-3",2,3,"1",1,5,-1,"D"
"13049",1979-05-25,1978,"AS Nancy","RC Strasbourg","0-0",0,0,"1",1,0,0,"D"
"13050",1979-05-25,1978,"OGC Nice","FC Nantes","1-1",1,1,"1",1,2,0,"D"
"13051",1979-05-25,1978,"Girondins Bordeaux","AS Saint-Etienne","2-1",2,1,"1",1,3,1,"H"
"13052",1979-05-25,1978,"Paris Saint-Germain","AS Monaco","3-0",3,0,"1",1,3,3,"H"
"13053",1979-05-25,1978,"Olympique Lyon","Stade Laval","1-0",1,0,"1",1,1,1,"H"
"13054",1979-05-25,1978,"FC Sochaux","FC Metz","4-0",4,0,"1",1,4,4,"H"
"13055",1979-05-25,1978,"SC Bastia","Lille OSC","0-0",0,0,"1",1,0,0,"D"
"13056",1979-05-25,1978,"Olympique Marseille","Nimes Olympique","2-0",2,0,"1",1,2,2,"H"
"13057",1979-05-25,1978,"Angers SCO","Paris FC","0-0",0,0,"1",1,0,0,"D"
"13058",1979-05-25,1978,"US Valenciennes-Anzin","Stade Reims","3-0",3,0,"1",1,3,3,"H"
"13059",1979-05-29,1978,"RC Strasbourg","Paris Saint-Germain","3-0",3,0,"1",1,3,3,"H"
"13060",1979-05-29,1978,"FC Nantes","Olympique Lyon","5-1",5,1,"1",1,6,4,"H"
"13061",1979-05-29,1978,"AS Saint-Etienne","Angers SCO","4-0",4,0,"1",1,4,4,"H"
"13062",1979-05-29,1978,"AS Monaco","Stade Laval","2-2",2,2,"1",1,4,0,"D"
"13063",1979-05-29,1978,"FC Metz","SC Bastia","3-1",3,1,"1",1,4,2,"H"
"13064",1979-05-29,1978,"Lille OSC","Olympique Marseille","2-0",2,0,"1",1,2,2,"H"
"13065",1979-05-29,1978,"Nimes Olympique","US Valenciennes-Anzin","5-0",5,0,"1",1,5,5,"H"
"13066",1979-05-29,1978,"OGC Nice","Girondins Bordeaux","2-1",2,1,"1",1,3,1,"H"
"13067",1979-05-29,1978,"Paris FC","FC Sochaux","3-1",3,1,"1",1,4,2,"H"
"13068",1979-05-29,1978,"Stade Reims","AS Nancy","1-3",1,3,"1",1,4,-2,"D"
"13069",1979-06-01,1978,"Olympique Lyon","RC Strasbourg","0-3",0,3,"1",1,3,-3,"D"
"13070",1979-06-01,1978,"Stade Laval","FC Nantes","0-5",0,5,"1",1,5,-5,"D"
"13071",1979-06-01,1978,"SC Bastia","AS Saint-Etienne","0-2",0,2,"1",1,2,-2,"D"
"13072",1979-06-01,1978,"AS Monaco","Nimes Olympique","1-0",1,0,"1",1,1,1,"H"
"13073",1979-06-01,1978,"Olympique Marseille","FC Metz","2-3",2,3,"1",1,5,-1,"D"
"13074",1979-06-01,1978,"AS Nancy","Lille OSC","3-1",3,1,"1",1,4,2,"H"
"13075",1979-06-01,1978,"FC Sochaux","Girondins Bordeaux","2-0",2,0,"1",1,2,2,"H"
"13076",1979-06-01,1978,"Paris Saint-Germain","Stade Reims","3-2",3,2,"1",1,5,1,"H"
"13077",1979-06-01,1978,"Angers SCO","OGC Nice","1-1",1,1,"1",1,2,0,"D"
"13078",1979-06-01,1978,"US Valenciennes-Anzin","Paris FC","1-1",1,1,"1",1,2,0,"D"
"13079",1979-07-26,1979,"Olympique Marseille","Stade Brest","3-0",3,0,"1",1,3,3,"H"
"13080",1979-07-26,1979,"Girondins Bordeaux","RC Strasbourg","1-3",1,3,"1",1,4,-2,"D"
"13081",1979-07-26,1979,"Stade Laval","FC Nantes","0-2",0,2,"1",1,2,-2,"D"
"13082",1979-07-26,1979,"Lille OSC","AS Nancy","2-0",2,0,"1",1,2,2,"H"
"13083",1979-07-26,1979,"FC Sochaux","AS Monaco","1-2",1,2,"1",1,3,-1,"D"
"13084",1979-07-26,1979,"FC Metz","RC Lens","2-1",2,1,"1",1,3,1,"H"
"13085",1979-07-26,1979,"OGC Nice","Nimes Olympique","1-2",1,2,"1",1,3,-1,"D"
"13086",1979-07-26,1979,"US Valenciennes-Anzin","Angers SCO","2-1",2,1,"1",1,3,1,"H"
"13087",1979-07-26,1979,"SC Bastia","AS Saint-Etienne","0-1",0,1,"1",1,1,-1,"D"
"13088",1979-07-26,1979,"Olympique Lyon","Paris Saint-Germain","1-1",1,1,"1",1,2,0,"D"
"13089",1979-08-03,1979,"RC Lens","FC Nantes","1-3",1,3,"1",1,4,-2,"D"
"13090",1979-08-03,1979,"RC Strasbourg","FC Metz","3-2",3,2,"1",1,5,1,"H"
"13091",1979-08-03,1979,"Nimes Olympique","SC Bastia","2-0",2,0,"1",1,2,2,"H"
"13092",1979-08-03,1979,"AS Monaco","Stade Laval","2-1",2,1,"1",1,3,1,"H"
"13093",1979-08-03,1979,"US Valenciennes-Anzin","OGC Nice","1-0",1,0,"1",1,1,1,"H"
"13094",1979-08-03,1979,"AS Saint-Etienne","Lille OSC","0-0",0,0,"1",1,0,0,"D"
"13095",1979-08-03,1979,"Paris Saint-Germain","Olympique Marseille","2-1",2,1,"1",1,3,1,"H"
"13096",1979-08-03,1979,"Angers SCO","Girondins Bordeaux","3-0",3,0,"1",1,3,3,"H"
"13097",1979-08-03,1979,"Stade Brest","FC Sochaux","1-2",1,2,"1",1,3,-1,"D"
"13098",1979-08-03,1979,"AS Nancy","Olympique Lyon","1-0",1,0,"1",1,1,1,"H"
"13099",1979-08-10,1979,"Lille OSC","Nimes Olympique","4-0",4,0,"1",1,4,4,"H"
"13100",1979-08-10,1979,"FC Nantes","AS Monaco","0-0",0,0,"1",1,0,0,"D"
"13101",1979-08-10,1979,"Olympique Marseille","AS Saint-Etienne","3-5",3,5,"1",1,8,-2,"D"
"13102",1979-08-10,1979,"SC Bastia","RC Strasbourg","2-1",2,1,"1",1,3,1,"H"
"13103",1979-08-10,1979,"FC Metz","AS Nancy","2-1",2,1,"1",1,3,1,"H"
"13104",1979-08-10,1979,"FC Sochaux","Paris Saint-Germain","1-0",1,0,"1",1,1,1,"H"
"13105",1979-08-10,1979,"Girondins Bordeaux","US Valenciennes-Anzin","7-0",7,0,"1",1,7,7,"H"
"13106",1979-08-10,1979,"OGC Nice","Angers SCO","0-0",0,0,"1",1,0,0,"D"
"13107",1979-08-10,1979,"Stade Laval","Stade Brest","3-0",3,0,"1",1,3,3,"H"
"13108",1979-08-10,1979,"Olympique Lyon","RC Lens","1-1",1,1,"1",1,2,0,"D"
"13109",1979-08-17,1979,"AS Saint-Etienne","FC Metz","2-1",2,1,"1",1,3,1,"H"
"13110",1979-08-17,1979,"Stade Brest","AS Monaco","1-2",1,2,"1",1,3,-1,"D"
"13111",1979-08-17,1979,"US Valenciennes-Anzin","Lille OSC","0-0",0,0,"1",1,0,0,"D"
"13112",1979-08-17,1979,"RC Strasbourg","FC Nantes","2-2",2,2,"1",1,4,0,"D"
"13113",1979-08-17,1979,"Nimes Olympique","Girondins Bordeaux","2-0",2,0,"1",1,2,2,"H"
"13114",1979-08-17,1979,"Angers SCO","SC Bastia","3-1",3,1,"1",1,4,2,"H"
"13115",1979-08-17,1979,"Paris Saint-Germain","Stade Laval","3-1",3,1,"1",1,4,2,"H"
"13116",1979-08-17,1979,"AS Nancy","Olympique Marseille","5-0",5,0,"1",1,5,5,"H"
"13117",1979-08-17,1979,"RC Lens","FC Sochaux","2-0",2,0,"1",1,2,2,"H"
"13118",1979-08-17,1979,"OGC Nice","Olympique Lyon","3-1",3,1,"1",1,4,2,"H"
"13119",1979-08-24,1979,"Stade Laval","AS Saint-Etienne","2-3",2,3,"1",1,5,-1,"D"
"13120",1979-08-24,1979,"FC Nantes","Stade Brest","3-0",3,0,"1",1,3,3,"H"
"13121",1979-08-24,1979,"AS Monaco","Paris Saint-Germain","2-2",2,2,"1",1,4,0,"D"
"13122",1979-08-24,1979,"Lille OSC","Angers SCO","0-0",0,0,"1",1,0,0,"D"
"13123",1979-08-24,1979,"Olympique Lyon","RC Strasbourg","0-2",0,2,"1",1,2,-2,"D"
"13124",1979-08-24,1979,"FC Metz","Nimes Olympique","0-0",0,0,"1",1,0,0,"D"
"13125",1979-08-24,1979,"FC Sochaux","AS Nancy","5-1",5,1,"1",1,6,4,"H"
"13126",1979-08-24,1979,"SC Bastia","US Valenciennes-Anzin","2-1",2,1,"1",1,3,1,"H"
"13127",1979-08-24,1979,"Girondins Bordeaux","OGC Nice","3-1",3,1,"1",1,4,2,"H"
"13128",1979-08-24,1979,"Olympique Marseille","RC Lens","3-1",3,1,"1",1,4,2,"H"
"13129",1979-08-28,1979,"AS Saint-Etienne","FC Sochaux","2-1",2,1,"1",1,3,1,"H"
"13130",1979-08-28,1979,"Girondins Bordeaux","FC Nantes","1-3",1,3,"1",1,4,-2,"D"
"13131",1979-08-28,1979,"RC Lens","AS Monaco","0-3",0,3,"1",1,3,-3,"D"
"13132",1979-08-28,1979,"RC Strasbourg","Lille OSC","3-2",3,2,"1",1,5,1,"H"
"13133",1979-08-28,1979,"Nimes Olympique","Olympique Lyon","3-2",3,2,"1",1,5,1,"H"
"13134",1979-08-28,1979,"Angers SCO","Olympique Marseille","3-1",3,1,"1",1,4,2,"H"
"13135",1979-08-28,1979,"Paris Saint-Germain","Stade Brest","0-0",0,0,"1",1,0,0,"D"
"13136",1979-08-28,1979,"AS Nancy","Stade Laval","2-1",2,1,"1",1,3,1,"H"
"13137",1979-08-28,1979,"US Valenciennes-Anzin","FC Metz","2-2",2,2,"1",1,4,0,"D"
"13138",1979-08-28,1979,"OGC Nice","SC Bastia","2-1",2,1,"1",1,3,1,"H"
"13139",1979-09-11,1979,"Stade Brest","AS Saint-Etienne","0-2",0,2,"1",1,2,-2,"D"
"13140",1979-09-11,1979,"FC Nantes","Paris Saint-Germain","4-2",4,2,"1",1,6,2,"H"
"13141",1979-09-11,1979,"AS Monaco","AS Nancy","3-0",3,0,"1",1,3,3,"H"
"13142",1979-09-11,1979,"Olympique Marseille","Nimes Olympique","0-1",0,1,"1",1,1,-1,"D"
"13143",1979-09-11,1979,"FC Metz","Angers SCO","0-1",0,1,"1",1,1,-1,"D"
"13144",1979-09-11,1979,"FC Sochaux","RC Strasbourg","1-1",1,1,"1",1,2,0,"D"
"13145",1979-09-11,1979,"Lille OSC","OGC Nice","4-3",4,3,"1",1,7,1,"H"
"13146",1979-09-11,1979,"SC Bastia","Girondins Bordeaux","2-1",2,1,"1",1,3,1,"H"
"13147",1979-09-11,1979,"Olympique Lyon","US Valenciennes-Anzin","3-1",3,1,"1",1,4,2,"H"
"13148",1979-09-11,1979,"Stade Laval","RC Lens","0-0",0,0,"1",1,0,0,"D"
"13149",1979-09-14,1979,"AS Saint-Etienne","FC Nantes","4-2",4,2,"1",1,6,2,"H"
"13150",1979-09-14,1979,"Nimes Olympique","AS Monaco","1-1",1,1,"1",1,2,0,"D"
"13151",1979-09-14,1979,"Angers SCO","Olympique Lyon","1-1",1,1,"1",1,2,0,"D"
"13152",1979-09-14,1979,"Girondins Bordeaux","Lille OSC","1-1",1,1,"1",1,2,0,"D"
"13153",1979-09-14,1979,"RC Strasbourg","Stade Laval","0-3",0,3,"1",1,3,-3,"D"
"13154",1979-09-14,1979,"SC Bastia","FC Sochaux","0-1",0,1,"1",1,1,-1,"D"
"13155",1979-09-14,1979,"AS Nancy","Stade Brest","5-1",5,1,"1",1,6,4,"H"
"13156",1979-09-14,1979,"RC Lens","Paris Saint-Germain","1-1",1,1,"1",1,2,0,"D"
"13157",1979-09-14,1979,"US Valenciennes-Anzin","Olympique Marseille","1-0",1,0,"1",1,1,1,"H"
"13158",1979-09-14,1979,"OGC Nice","FC Metz","4-2",4,2,"1",1,6,2,"H"
"13159",1979-09-22,1979,"Olympique Lyon","AS Saint-Etienne","0-0",0,0,"1",1,0,0,"D"
"13160",1979-09-22,1979,"AS Monaco","OGC Nice","2-1",2,1,"1",1,3,1,"H"
"13161",1979-09-22,1979,"FC Nantes","US Valenciennes-Anzin","0-0",0,0,"1",1,0,0,"D"
"13162",1979-09-22,1979,"Lille OSC","SC Bastia","2-0",2,0,"1",1,2,2,"H"
"13163",1979-09-22,1979,"Olympique Marseille","RC Strasbourg","1-3",1,3,"1",1,4,-2,"D"
"13164",1979-09-22,1979,"FC Sochaux","Nimes Olympique","2-1",2,1,"1",1,3,1,"H"
"13165",1979-09-22,1979,"Stade Laval","Angers SCO","3-2",3,2,"1",1,5,1,"H"
"13166",1979-09-22,1979,"Paris Saint-Germain","AS Nancy","1-2",1,2,"1",1,3,-1,"D"
"13167",1979-09-22,1979,"FC Metz","Girondins Bordeaux","1-1",1,1,"1",1,2,0,"D"
"13168",1979-09-22,1979,"Stade Brest","RC Lens","0-0",0,0,"1",1,0,0,"D"
"13169",1979-09-28,1979,"AS Saint-Etienne","Paris Saint-Germain","2-0",2,0,"1",1,2,2,"H"
"13170",1979-09-28,1979,"Lille OSC","AS Monaco","3-1",3,1,"1",1,4,2,"H"
"13171",1979-09-28,1979,"RC Strasbourg","Stade Brest","2-1",2,1,"1",1,3,1,"H"
"13172",1979-09-28,1979,"Nimes Olympique","FC Nantes","2-1",2,1,"1",1,3,1,"H"
"13173",1979-09-28,1979,"Angers SCO","FC Sochaux","1-3",1,3,"1",1,4,-2,"D"
"13174",1979-09-28,1979,"AS Nancy","RC Lens","1-1",1,1,"1",1,2,0,"D"
"13175",1979-09-28,1979,"US Valenciennes-Anzin","Stade Laval","1-1",1,1,"1",1,2,0,"D"
"13176",1979-09-28,1979,"SC Bastia","FC Metz","0-1",0,1,"1",1,1,-1,"D"
"13177",1979-09-28,1979,"Girondins Bordeaux","Olympique Lyon","3-0",3,0,"1",1,3,3,"H"
"13178",1979-09-28,1979,"OGC Nice","Olympique Marseille","0-3",0,3,"1",1,3,-3,"D"
"13179",1979-10-06,1979,"RC Lens","AS Saint-Etienne","4-3",4,3,"1",1,7,1,"H"
"13180",1979-10-06,1979,"AS Monaco","RC Strasbourg","4-1",4,1,"1",1,5,3,"H"
"13181",1979-10-06,1979,"FC Nantes","AS Nancy","2-0",2,0,"1",1,2,2,"H"
"13182",1979-10-06,1979,"FC Metz","Lille OSC","2-0",2,0,"1",1,2,2,"H"
"13183",1979-10-06,1979,"Stade Laval","Nimes Olympique","3-1",3,1,"1",1,4,2,"H"
"13184",1979-10-06,1979,"FC Sochaux","US Valenciennes-Anzin","0-1",0,1,"1",1,1,-1,"D"
"13185",1979-10-06,1979,"Stade Brest","Angers SCO","0-1",0,1,"1",1,1,-1,"D"
"13186",1979-10-06,1979,"Olympique Marseille","Girondins Bordeaux","1-1",1,1,"1",1,2,0,"D"
"13187",1979-10-06,1979,"Paris Saint-Germain","OGC Nice","2-2",2,2,"1",1,4,0,"D"
"13188",1979-10-06,1979,"Olympique Lyon","SC Bastia","1-1",1,1,"1",1,2,0,"D"
"13189",1979-10-13,1979,"Angers SCO","AS Monaco","1-4",1,4,"1",1,5,-3,"D"
"13190",1979-10-13,1979,"AS Saint-Etienne","AS Nancy","2-2",2,2,"1",1,4,0,"D"
"13191",1979-10-13,1979,"Lille OSC","FC Nantes","1-1",1,1,"1",1,2,0,"D"
"13192",1979-10-13,1979,"Nimes Olympique","Paris Saint-Germain","2-0",2,0,"1",1,2,2,"H"
"13193",1979-10-13,1979,"Girondins Bordeaux","FC Sochaux","2-3",2,3,"1",1,5,-1,"D"
"13194",1979-10-13,1979,"RC Strasbourg","RC Lens","0-1",0,1,"1",1,1,-1,"D"
"13195",1979-10-13,1979,"US Valenciennes-Anzin","Stade Brest","2-1",2,1,"1",1,3,1,"H"
"13196",1979-10-13,1979,"FC Metz","Olympique Lyon","5-2",5,2,"1",1,7,3,"H"
"13197",1979-10-13,1979,"SC Bastia","Olympique Marseille","2-0",2,0,"1",1,2,2,"H"
"13198",1979-10-19,1979,"AS Monaco","AS Saint-Etienne","2-1",2,1,"1",1,3,1,"H"
"13199",1979-10-19,1979,"FC Nantes","SC Bastia","1-0",1,0,"1",1,1,1,"H"
"13200",1979-10-19,1979,"FC Sochaux","OGC Nice","2-1",2,1,"1",1,3,1,"H"
"13201",1979-10-19,1979,"Stade Brest","Nimes Olympique","2-2",2,2,"1",1,4,0,"D"
"13202",1979-10-19,1979,"AS Nancy","RC Strasbourg","3-4",3,4,"1",1,7,-1,"D"
"13203",1979-10-19,1979,"Olympique Lyon","Lille OSC","4-2",4,2,"1",1,6,2,"H"
"13204",1979-10-19,1979,"Paris Saint-Germain","US Valenciennes-Anzin","3-0",3,0,"1",1,3,3,"H"
"13205",1979-10-19,1979,"Olympique Marseille","FC Metz","1-0",1,0,"1",1,1,1,"H"
"13206",1979-10-19,1979,"RC Lens","Angers SCO","2-0",2,0,"1",1,2,2,"H"
"13207",1979-10-19,1979,"Stade Laval","Girondins Bordeaux","1-0",1,0,"1",1,1,1,"H"
"13208",1979-10-30,1979,"Girondins Bordeaux","AS Monaco","3-1",3,1,"1",1,4,2,"H"
"13209",1979-10-30,1979,"FC Metz","FC Nantes","0-0",0,0,"1",1,0,0,"D"
"13210",1979-10-30,1979,"RC Strasbourg","AS Saint-Etienne","1-0",1,0,"1",1,1,1,"H"
"13211",1979-10-30,1979,"Nimes Olympique","AS Nancy","4-2",4,2,"1",1,6,2,"H"
"13212",1979-10-30,1979,"Olympique Lyon","FC Sochaux","3-1",3,1,"1",1,4,2,"H"
"13213",1979-10-30,1979,"Lille OSC","Olympique Marseille","1-1",1,1,"1",1,2,0,"D"
"13214",1979-10-30,1979,"US Valenciennes-Anzin","RC Lens","3-1",3,1,"1",1,4,2,"H"
"13215",1979-10-30,1979,"Angers SCO","Paris Saint-Germain","1-2",1,2,"1",1,3,-1,"D"
"13216",1979-10-30,1979,"SC Bastia","Stade Laval","2-1",2,1,"1",1,3,1,"H"
"13217",1979-10-30,1979,"OGC Nice","Stade Brest","3-0",3,0,"1",1,3,3,"H"
"13218",1979-11-02,1979,"AS Monaco","SC Bastia","1-0",1,0,"1",1,1,1,"H"
"13219",1979-11-02,1979,"FC Nantes","OGC Nice","5-0",5,0,"1",1,5,5,"H"
"13220",1979-11-02,1979,"AS Saint-Etienne","Angers SCO","3-3",3,3,"1",1,6,0,"D"
"13221",1979-11-02,1979,"RC Lens","Nimes Olympique","1-0",1,0,"1",1,1,1,"H"
"13222",1979-11-02,1979,"Paris Saint-Germain","RC Strasbourg","1-0",1,0,"1",1,1,1,"H"
"13223",1979-11-02,1979,"Stade Laval","Lille OSC","2-0",2,0,"1",1,2,2,"H"
"13224",1979-11-02,1979,"AS Nancy","US Valenciennes-Anzin","1-0",1,0,"1",1,1,1,"H"
"13225",1979-11-02,1979,"Stade Brest","Girondins Bordeaux","0-1",0,1,"1",1,1,-1,"D"
"13226",1979-11-02,1979,"Olympique Marseille","Olympique Lyon","3-1",3,1,"1",1,4,2,"H"
"13227",1979-11-03,1979,"FC Sochaux","FC Metz","4-0",4,0,"1",1,4,4,"H"
"13228",1979-11-09,1979,"FC Metz","Stade Laval","1-4",1,4,"1",1,5,-3,"D"
"13229",1979-11-10,1979,"Olympique Marseille","AS Monaco","0-3",0,3,"1",1,3,-3,"D"
"13230",1979-11-10,1979,"Olympique Lyon","FC Nantes","1-2",1,2,"1",1,3,-1,"D"
"13231",1979-11-10,1979,"US Valenciennes-Anzin","AS Saint-Etienne","0-0",0,0,"1",1,0,0,"D"
"13232",1979-11-10,1979,"Lille OSC","FC Sochaux","1-1",1,1,"1",1,2,0,"D"
"13233",1979-11-10,1979,"Nimes Olympique","RC Strasbourg","0-0",0,0,"1",1,0,0,"D"
"13234",1979-11-10,1979,"Girondins Bordeaux","Paris Saint-Germain","0-1",0,1,"1",1,1,-1,"D"
"13235",1979-11-10,1979,"Angers SCO","AS Nancy","1-0",1,0,"1",1,1,1,"H"
"13236",1979-11-10,1979,"OGC Nice","RC Lens","1-0",1,0,"1",1,1,1,"H"
"13237",1979-11-10,1979,"SC Bastia","Stade Brest","1-0",1,0,"1",1,1,1,"H"
"13238",1979-11-21,1979,"AS Monaco","FC Metz","3-0",3,0,"1",1,3,3,"H"
"13239",1979-11-21,1979,"FC Nantes","Angers SCO","3-1",3,1,"1",1,4,2,"H"
"13240",1979-11-21,1979,"AS Saint-Etienne","Nimes Olympique","3-1",3,1,"1",1,4,2,"H"
"13241",1979-11-21,1979,"FC Sochaux","Olympique Marseille","3-0",3,0,"1",1,3,3,"H"
"13242",1979-11-21,1979,"RC Strasbourg","US Valenciennes-Anzin","2-1",2,1,"1",1,3,1,"H"
"13243",1979-11-21,1979,"Stade Brest","Lille OSC","1-1",1,1,"1",1,2,0,"D"
"13244",1979-11-21,1979,"Paris Saint-Germain","SC Bastia","1-1",1,1,"1",1,2,0,"D"
"13245",1979-11-21,1979,"RC Lens","Girondins Bordeaux","2-1",2,1,"1",1,3,1,"H"
"13246",1979-11-21,1979,"Stade Laval","Olympique Lyon","1-2",1,2,"1",1,3,-1,"D"
"13247",1979-11-21,1979,"AS Nancy","OGC Nice","1-2",1,2,"1",1,3,-1,"D"
"13248",1979-11-24,1979,"Olympique Lyon","AS Monaco","0-1",0,1,"1",1,1,-1,"D"
"13249",1979-11-24,1979,"OGC Nice","AS Saint-Etienne","2-4",2,4,"1",1,6,-2,"D"
"13250",1979-11-24,1979,"Angers SCO","RC Strasbourg","1-0",1,0,"1",1,1,1,"H"
"13251",1979-11-24,1979,"Lille OSC","Paris Saint-Germain","4-2",4,2,"1",1,6,2,"H"
"13252",1979-11-24,1979,"US Valenciennes-Anzin","Nimes Olympique","4-1",4,1,"1",1,5,3,"H"
"13253",1979-11-24,1979,"SC Bastia","RC Lens","1-2",1,2,"1",1,3,-1,"D"
"13254",1979-11-24,1979,"FC Metz","Stade Brest","0-0",0,0,"1",1,0,0,"D"
"13255",1979-11-25,1979,"FC Sochaux","FC Nantes","1-0",1,0,"1",1,1,1,"H"
"13256",1979-11-25,1979,"Olympique Marseille","Stade Laval","0-2",0,2,"1",1,2,-2,"D"
"13257",1979-12-01,1979,"AS Monaco","US Valenciennes-Anzin","0-1",0,1,"1",1,1,-1,"D"
"13258",1979-12-01,1979,"FC Nantes","Olympique Marseille","4-1",4,1,"1",1,5,3,"H"
"13259",1979-12-01,1979,"Stade Laval","FC Sochaux","3-3",3,3,"1",1,6,0,"D"
"13260",1979-12-01,1979,"RC Strasbourg","OGC Nice","2-3",2,3,"1",1,5,-1,"D"
"13261",1979-12-01,1979,"RC Lens","Lille OSC","5-3",5,3,"1",1,8,2,"H"
"13262",1979-12-01,1979,"Nimes Olympique","Angers SCO","1-1",1,1,"1",1,2,0,"D"
"13263",1979-12-01,1979,"Stade Brest","Olympique Lyon","5-1",5,1,"1",1,6,4,"H"
"13264",1979-12-02,1979,"AS Saint-Etienne","Girondins Bordeaux","3-3",3,3,"1",1,6,0,"D"
"13265",1979-12-02,1979,"Paris Saint-Germain","FC Metz","2-0",2,0,"1",1,2,2,"H"
"13266",1979-12-02,1979,"AS Nancy","SC Bastia","3-1",3,1,"1",1,4,2,"H"
"13267",1979-12-07,1979,"Lille OSC","AS Saint-Etienne","0-2",0,2,"1",1,2,-2,"D"
"13268",1979-12-07,1979,"Olympique Lyon","AS Nancy","2-1",2,1,"1",1,3,1,"H"
"13269",1979-12-08,1979,"Stade Laval","AS Monaco","0-2",0,2,"1",1,2,-2,"D"
"13270",1979-12-08,1979,"FC Nantes","RC Lens","3-0",3,0,"1",1,3,3,"H"
"13271",1979-12-08,1979,"Olympique Marseille","Paris Saint-Germain","0-2",0,2,"1",1,2,-2,"D"
"13272",1979-12-08,1979,"FC Metz","RC Strasbourg","0-0",0,0,"1",1,0,0,"D"
"13273",1979-12-08,1979,"SC Bastia","Nimes Olympique","2-0",2,0,"1",1,2,2,"H"
"13274",1979-12-08,1979,"OGC Nice","US Valenciennes-Anzin","2-0",2,0,"1",1,2,2,"H"
"13275",1979-12-09,1979,"FC Sochaux","Stade Brest","7-0",7,0,"1",1,7,7,"H"
"13276",1979-12-09,1979,"Girondins Bordeaux","Angers SCO","2-1",2,1,"1",1,3,1,"H"
"13277",1979-12-11,1979,"OGC Nice","Stade Laval","0-1",0,1,"1",1,1,-1,"D"
"13278",1979-12-12,1979,"Girondins Bordeaux","AS Nancy","4-1",4,1,"1",1,5,3,"H"
"13279",1979-12-14,1979,"RC Strasbourg","SC Bastia","1-0",1,0,"1",1,1,1,"H"
"13280",1979-12-15,1979,"AS Monaco","FC Nantes","2-1",2,1,"1",1,3,1,"H"
"13281",1979-12-15,1979,"Nimes Olympique","Lille OSC","3-2",3,2,"1",1,5,1,"H"
"13282",1979-12-15,1979,"Stade Brest","Stade Laval","2-2",2,2,"1",1,4,0,"D"
"13283",1979-12-15,1979,"RC Lens","Olympique Lyon","1-1",1,1,"1",1,2,0,"D"
"13284",1979-12-15,1979,"US Valenciennes-Anzin","Girondins Bordeaux","0-3",0,3,"1",1,3,-3,"D"
"13285",1979-12-15,1979,"Angers SCO","OGC Nice","2-3",2,3,"1",1,5,-1,"D"
"13286",1979-12-16,1979,"AS Saint-Etienne","Olympique Marseille","3-1",3,1,"1",1,4,2,"H"
"13287",1979-12-16,1979,"Paris Saint-Germain","FC Sochaux","3-1",3,1,"1",1,4,2,"H"
"13288",1979-12-16,1979,"AS Nancy","FC Metz","0-1",0,1,"1",1,1,-1,"D"
"13289",1980-01-19,1979,"AS Monaco","Stade Brest","4-0",4,0,"1",1,4,4,"H"
"13290",1980-01-19,1979,"FC Metz","AS Saint-Etienne","1-2",1,2,"1",1,3,-1,"D"
"13291",1980-01-19,1979,"FC Nantes","RC Strasbourg","2-1",2,1,"1",1,3,1,"H"
"13292",1980-01-19,1979,"Stade Laval","Paris Saint-Germain","3-1",3,1,"1",1,4,2,"H"
"13293",1980-01-19,1979,"Lille OSC","US Valenciennes-Anzin","0-1",0,1,"1",1,1,-1,"D"
"13294",1980-01-19,1979,"SC Bastia","Angers SCO","1-1",1,1,"1",1,2,0,"D"
"13295",1980-01-20,1979,"FC Sochaux","RC Lens","3-0",3,0,"1",1,3,3,"H"
"13296",1980-01-20,1979,"Girondins Bordeaux","Nimes Olympique","2-1",2,1,"1",1,3,1,"H"
"13297",1980-01-20,1979,"Olympique Lyon","OGC Nice","2-2",2,2,"1",1,4,0,"D"
"13298",1980-01-20,1979,"Olympique Marseille","AS Nancy","2-2",2,2,"1",1,4,0,"D"
"13299",1980-01-26,1979,"Stade Brest","FC Nantes","0-1",0,1,"1",1,1,-1,"D"
"13300",1980-01-26,1979,"AS Nancy","FC Sochaux","1-2",1,2,"1",1,3,-1,"D"
"13301",1980-01-26,1979,"RC Strasbourg","Olympique Lyon","3-1",3,1,"1",1,4,2,"H"
"13302",1980-01-26,1979,"US Valenciennes-Anzin","SC Bastia","5-0",5,0,"1",1,5,5,"H"
"13303",1980-01-26,1979,"RC Lens","Olympique Marseille","4-1",4,1,"1",1,5,3,"H"
"13304",1980-01-26,1979,"Angers SCO","Lille OSC","2-0",2,0,"1",1,2,2,"H"
"13305",1980-01-27,1979,"Paris Saint-Germain","AS Monaco","2-1",2,1,"1",1,3,1,"H"
"13306",1980-01-27,1979,"AS Saint-Etienne","Stade Laval","3-1",3,1,"1",1,4,2,"H"
"13307",1980-01-27,1979,"Nimes Olympique","FC Metz","2-1",2,1,"1",1,3,1,"H"
"13308",1980-01-27,1979,"OGC Nice","Girondins Bordeaux","0-0",0,0,"1",1,0,0,"D"
"13309",1980-02-02,1979,"AS Monaco","RC Lens","2-0",2,0,"1",1,2,2,"H"
"13310",1980-02-02,1979,"FC Nantes","Girondins Bordeaux","4-1",4,1,"1",1,5,3,"H"
"13311",1980-02-02,1979,"Stade Brest","Paris Saint-Germain","0-4",0,4,"1",1,4,-4,"D"
"13312",1980-02-02,1979,"Lille OSC","RC Strasbourg","2-0",2,0,"1",1,2,2,"H"
"13313",1980-02-02,1979,"FC Metz","US Valenciennes-Anzin","1-0",1,0,"1",1,1,1,"H"
"13314",1980-02-02,1979,"Stade Laval","AS Nancy","0-1",0,1,"1",1,1,-1,"D"
"13315",1980-02-02,1979,"SC Bastia","OGC Nice","3-0",3,0,"1",1,3,3,"H"
"13316",1980-02-03,1979,"FC Sochaux","AS Saint-Etienne","4-1",4,1,"1",1,5,3,"H"
"13317",1980-02-03,1979,"Olympique Lyon","Nimes Olympique","2-1",2,1,"1",1,3,1,"H"
"13318",1980-02-03,1979,"Olympique Marseille","Angers SCO","3-1",3,1,"1",1,4,2,"H"
"13319",1980-02-15,1979,"OGC Nice","Lille OSC","0-0",0,0,"1",1,0,0,"D"
"13320",1980-02-16,1979,"RC Strasbourg","FC Sochaux","0-1",0,1,"1",1,1,-1,"D"
"13321",1980-02-16,1979,"RC Lens","Stade Laval","1-0",1,0,"1",1,1,1,"H"
"13322",1980-02-16,1979,"US Valenciennes-Anzin","Olympique Lyon","1-1",1,1,"1",1,2,0,"D"
"13323",1980-02-16,1979,"Girondins Bordeaux","SC Bastia","2-1",2,1,"1",1,3,1,"H"
"13324",1980-02-16,1979,"Angers SCO","FC Metz","2-0",2,0,"1",1,2,2,"H"
"13325",1980-02-17,1979,"AS Nancy","AS Monaco","2-1",2,1,"1",1,3,1,"H"
"13326",1980-02-17,1979,"AS Saint-Etienne","Stade Brest","2-1",2,1,"1",1,3,1,"H"
"13327",1980-02-17,1979,"Paris Saint-Germain","FC Nantes","1-0",1,0,"1",1,1,1,"H"
"13328",1980-02-17,1979,"Nimes Olympique","Olympique Marseille","0-0",0,0,"1",1,0,0,"D"
"13329",1980-02-23,1979,"AS Monaco","Nimes Olympique","0-0",0,0,"1",1,0,0,"D"
"13330",1980-02-23,1979,"FC Nantes","AS Saint-Etienne","2-0",2,0,"1",1,2,2,"H"
"13331",1980-02-23,1979,"Lille OSC","Girondins Bordeaux","0-1",0,1,"1",1,1,-1,"D"
"13332",1980-02-23,1979,"Stade Laval","RC Strasbourg","0-0",0,0,"1",1,0,0,"D"
"13333",1980-02-23,1979,"FC Metz","OGC Nice","2-0",2,0,"1",1,2,2,"H"
"13334",1980-02-23,1979,"Stade Brest","AS Nancy","3-3",3,3,"1",1,6,0,"D"
"13335",1980-02-24,1979,"FC Sochaux","SC Bastia","3-0",3,0,"1",1,3,3,"H"
"13336",1980-02-24,1979,"Paris Saint-Germain","RC Lens","3-0",3,0,"1",1,3,3,"H"
"13337",1980-02-24,1979,"Olympique Marseille","US Valenciennes-Anzin","3-6",3,6,"1",1,9,-3,"D"
"13338",1980-02-24,1979,"Olympique Lyon","Angers SCO","0-1",0,1,"1",1,1,-1,"D"
"13339",1980-02-29,1979,"US Valenciennes-Anzin","FC Nantes","1-0",1,0,"1",1,1,1,"H"
"13340",1980-03-01,1979,"AS Saint-Etienne","Olympique Lyon","2-0",2,0,"1",1,2,2,"H"
"13341",1980-03-01,1979,"Nimes Olympique","FC Sochaux","2-0",2,0,"1",1,2,2,"H"
"13342",1980-03-01,1979,"AS Nancy","Paris Saint-Germain","3-2",3,2,"1",1,5,1,"H"
"13343",1980-03-01,1979,"Angers SCO","Stade Laval","3-1",3,1,"1",1,4,2,"H"
"13344",1980-03-01,1979,"RC Lens","Stade Brest","3-0",3,0,"1",1,3,3,"H"
"13345",1980-03-01,1979,"Girondins Bordeaux","FC Metz","1-3",1,3,"1",1,4,-2,"D"
"13346",1980-03-01,1979,"SC Bastia","Lille OSC","4-0",4,0,"1",1,4,4,"H"
"13347",1980-03-01,1979,"RC Strasbourg","Olympique Marseille","1-1",1,1,"1",1,2,0,"D"
"13348",1980-03-02,1979,"OGC Nice","AS Monaco","1-2",1,2,"1",1,3,-1,"D"
"13349",1980-03-12,1979,"AS Monaco","Lille OSC","0-1",0,1,"1",1,1,-1,"D"
"13350",1980-03-12,1979,"FC Sochaux","Angers SCO","4-0",4,0,"1",1,4,4,"H"
"13351",1980-03-12,1979,"FC Nantes","Nimes Olympique","4-1",4,1,"1",1,5,3,"H"
"13352",1980-03-12,1979,"Paris Saint-Germain","AS Saint-Etienne","2-2",2,2,"1",1,4,0,"D"
"13353",1980-03-12,1979,"Stade Brest","RC Strasbourg","2-5",2,5,"1",1,7,-3,"D"
"13354",1980-03-12,1979,"RC Lens","AS Nancy","4-0",4,0,"1",1,4,4,"H"
"13355",1980-03-12,1979,"Stade Laval","US Valenciennes-Anzin","3-0",3,0,"1",1,3,3,"H"
"13356",1980-03-12,1979,"Olympique Lyon","Girondins Bordeaux","1-1",1,1,"1",1,2,0,"D"
"13357",1980-03-12,1979,"FC Metz","SC Bastia","0-2",0,2,"1",1,2,-2,"D"
"13358",1980-03-12,1979,"Olympique Marseille","OGC Nice","3-1",3,1,"1",1,4,2,"H"
"13359",1980-03-22,1979,"AS Nancy","FC Nantes","0-2",0,2,"1",1,2,-2,"D"
"13360",1980-03-22,1979,"RC Strasbourg","AS Monaco","1-1",1,1,"1",1,2,0,"D"
"13361",1980-03-22,1979,"AS Saint-Etienne","RC Lens","3-1",3,1,"1",1,4,2,"H"
"13362",1980-03-22,1979,"US Valenciennes-Anzin","FC Sochaux","1-1",1,1,"1",1,2,0,"D"
"13363",1980-03-22,1979,"OGC Nice","Paris Saint-Germain","3-0",3,0,"1",1,3,3,"H"
"13364",1980-03-22,1979,"Nimes Olympique","Stade Laval","2-0",2,0,"1",1,2,2,"H"
"13365",1980-03-22,1979,"Girondins Bordeaux","Olympique Marseille","2-0",2,0,"1",1,2,2,"H"
"13366",1980-03-22,1979,"Angers SCO","Stade Brest","2-0",2,0,"1",1,2,2,"H"
"13367",1980-03-22,1979,"Lille OSC","FC Metz","3-0",3,0,"1",1,3,3,"H"
"13368",1980-03-22,1979,"SC Bastia","Olympique Lyon","2-0",2,0,"1",1,2,2,"H"
"13369",1980-03-29,1979,"FC Nantes","Lille OSC","1-0",1,0,"1",1,1,1,"H"
"13370",1980-03-29,1979,"AS Monaco","Angers SCO","3-0",3,0,"1",1,3,3,"H"
"13371",1980-03-29,1979,"FC Sochaux","Girondins Bordeaux","2-0",2,0,"1",1,2,2,"H"
"13372",1980-03-29,1979,"AS Nancy","AS Saint-Etienne","1-1",1,1,"1",1,2,0,"D"
"13373",1980-03-29,1979,"Paris Saint-Germain","Nimes Olympique","4-0",4,0,"1",1,4,4,"H"
"13374",1980-03-29,1979,"Stade Brest","US Valenciennes-Anzin","1-5",1,5,"1",1,6,-4,"D"
"13375",1980-03-29,1979,"RC Lens","RC Strasbourg","1-1",1,1,"1",1,2,0,"D"
"13376",1980-03-29,1979,"Stade Laval","OGC Nice","3-0",3,0,"1",1,3,3,"H"
"13377",1980-03-29,1979,"Olympique Marseille","SC Bastia","2-1",2,1,"1",1,3,1,"H"
"13378",1980-03-29,1979,"Olympique Lyon","FC Metz","1-0",1,0,"1",1,1,1,"H"
"13379",1980-04-02,1979,"OGC Nice","FC Sochaux","1-2",1,2,"1",1,3,-1,"D"
"13380",1980-04-02,1979,"AS Saint-Etienne","AS Monaco","2-1",2,1,"1",1,3,1,"H"
"13381",1980-04-02,1979,"SC Bastia","FC Nantes","1-0",1,0,"1",1,1,1,"H"
"13382",1980-04-02,1979,"US Valenciennes-Anzin","Paris Saint-Germain","1-1",1,1,"1",1,2,0,"D"
"13383",1980-04-02,1979,"Nimes Olympique","Stade Brest","2-0",2,0,"1",1,2,2,"H"
"13384",1980-04-02,1979,"Girondins Bordeaux","Stade Laval","4-1",4,1,"1",1,5,3,"H"
"13385",1980-04-02,1979,"Angers SCO","RC Lens","2-1",2,1,"1",1,3,1,"H"
"13386",1980-04-02,1979,"Lille OSC","Olympique Lyon","1-0",1,0,"1",1,1,1,"H"
"13387",1980-04-02,1979,"FC Metz","Olympique Marseille","3-2",3,2,"1",1,5,1,"H"
"13388",1980-04-03,1979,"RC Strasbourg","AS Nancy","1-0",1,0,"1",1,1,1,"H"
"13389",1980-04-08,1979,"FC Sochaux","Olympique Lyon","3-1",3,1,"1",1,4,2,"H"
"13390",1980-04-08,1979,"AS Saint-Etienne","RC Strasbourg","2-1",2,1,"1",1,3,1,"H"
"13391",1980-04-08,1979,"AS Monaco","Girondins Bordeaux","0-0",0,0,"1",1,0,0,"D"
"13392",1980-04-08,1979,"Paris Saint-Germain","Angers SCO","1-1",1,1,"1",1,2,0,"D"
"13393",1980-04-08,1979,"RC Lens","US Valenciennes-Anzin","1-1",1,1,"1",1,2,0,"D"
"13394",1980-04-08,1979,"AS Nancy","Nimes Olympique","1-0",1,0,"1",1,1,1,"H"
"13395",1980-04-08,1979,"Stade Laval","SC Bastia","3-0",3,0,"1",1,3,3,"H"
"13396",1980-04-08,1979,"Olympique Marseille","Lille OSC","2-0",2,0,"1",1,2,2,"H"
"13397",1980-04-08,1979,"Stade Brest","OGC Nice","1-0",1,0,"1",1,1,1,"H"
"13398",1980-04-18,1979,"Angers SCO","AS Saint-Etienne","0-2",0,2,"1",1,2,-2,"D"
"13399",1980-04-18,1979,"FC Metz","FC Sochaux","0-0",0,0,"1",1,0,0,"D"
"13400",1980-04-18,1979,"OGC Nice","FC Nantes","1-2",1,2,"1",1,3,-1,"D"
"13401",1980-04-18,1979,"SC Bastia","AS Monaco","2-0",2,0,"1",1,2,2,"H"
"13402",1980-04-18,1979,"RC Strasbourg","Paris Saint-Germain","2-1",2,1,"1",1,3,1,"H"
"13403",1980-04-18,1979,"Girondins Bordeaux","Stade Brest","4-1",4,1,"1",1,5,3,"H"
"13404",1980-04-18,1979,"US Valenciennes-Anzin","AS Nancy","0-1",0,1,"1",1,1,-1,"D"
"13405",1980-04-18,1979,"Nimes Olympique","RC Lens","3-1",3,1,"1",1,4,2,"H"
"13406",1980-04-18,1979,"Lille OSC","Stade Laval","2-0",2,0,"1",1,2,2,"H"
"13407",1980-04-18,1979,"Olympique Lyon","Olympique Marseille","1-0",1,0,"1",1,1,1,"H"
"13408",1980-04-25,1979,"AS Saint-Etienne","US Valenciennes-Anzin","0-1",0,1,"1",1,1,-1,"D"
"13409",1980-04-25,1979,"AS Monaco","Olympique Marseille","1-0",1,0,"1",1,1,1,"H"
"13410",1980-04-25,1979,"RC Strasbourg","Nimes Olympique","1-0",1,0,"1",1,1,1,"H"
"13411",1980-04-25,1979,"Paris Saint-Germain","Girondins Bordeaux","0-1",0,1,"1",1,1,-1,"D"
"13412",1980-04-25,1979,"Stade Laval","FC Metz","3-2",3,2,"1",1,5,1,"H"
"13413",1980-04-25,1979,"AS Nancy","Angers SCO","1-0",1,0,"1",1,1,1,"H"
"13414",1980-04-25,1979,"RC Lens","OGC Nice","0-1",0,1,"1",1,1,-1,"D"
"13415",1980-04-25,1979,"Stade Brest","SC Bastia","3-0",3,0,"1",1,3,3,"H"
"13416",1980-04-26,1979,"FC Sochaux","Lille OSC","3-0",3,0,"1",1,3,3,"H"
"13417",1980-04-26,1979,"FC Nantes","Olympique Lyon","3-0",3,0,"1",1,3,3,"H"
"13418",1980-04-29,1979,"FC Nantes","FC Metz","4-1",4,1,"1",1,5,3,"H"
"13419",1980-05-02,1979,"Angers SCO","FC Nantes","0-1",0,1,"1",1,1,-1,"D"
"13420",1980-05-02,1979,"Olympique Marseille","FC Sochaux","1-1",1,1,"1",1,2,0,"D"
"13421",1980-05-02,1979,"Nimes Olympique","AS Saint-Etienne","0-1",0,1,"1",1,1,-1,"D"
"13422",1980-05-02,1979,"FC Metz","AS Monaco","0-0",0,0,"1",1,0,0,"D"
"13423",1980-05-02,1979,"US Valenciennes-Anzin","RC Strasbourg","1-1",1,1,"1",1,2,0,"D"
"13424",1980-05-02,1979,"Girondins Bordeaux","RC Lens","1-1",1,1,"1",1,2,0,"D"
"13425",1980-05-02,1979,"SC Bastia","Paris Saint-Germain","1-0",1,0,"1",1,1,1,"H"
"13426",1980-05-02,1979,"Olympique Lyon","Stade Laval","2-0",2,0,"1",1,2,2,"H"
"13427",1980-05-02,1979,"Lille OSC","Stade Brest","1-0",1,0,"1",1,1,1,"H"
"13428",1980-05-02,1979,"OGC Nice","AS Nancy","1-1",1,1,"1",1,2,0,"D"
"13429",1980-05-06,1979,"FC Nantes","FC Sochaux","3-2",3,2,"1",1,5,1,"H"
"13430",1980-05-06,1979,"AS Saint-Etienne","OGC Nice","2-1",2,1,"1",1,3,1,"H"
"13431",1980-05-06,1979,"AS Monaco","Olympique Lyon","4-0",4,0,"1",1,4,4,"H"
"13432",1980-05-06,1979,"RC Strasbourg","Angers SCO","4-0",4,0,"1",1,4,4,"H"
"13433",1980-05-06,1979,"Nimes Olympique","US Valenciennes-Anzin","1-1",1,1,"1",1,2,0,"D"
"13434",1980-05-06,1979,"AS Nancy","Girondins Bordeaux","3-1",3,1,"1",1,4,2,"H"
"13435",1980-05-06,1979,"Paris Saint-Germain","Lille OSC","2-2",2,2,"1",1,4,0,"D"
"13436",1980-05-06,1979,"Stade Laval","Olympique Marseille","3-0",3,0,"1",1,3,3,"H"
"13437",1980-05-06,1979,"RC Lens","SC Bastia","2-0",2,0,"1",1,2,2,"H"
"13438",1980-05-06,1979,"Stade Brest","FC Metz","1-3",1,3,"1",1,4,-2,"D"
"13439",1980-05-17,1979,"Olympique Marseille","FC Nantes","0-1",0,1,"1",1,1,-1,"D"
"13440",1980-05-17,1979,"FC Sochaux","Stade Laval","2-0",2,0,"1",1,2,2,"H"
"13441",1980-05-17,1979,"Girondins Bordeaux","AS Saint-Etienne","5-1",5,1,"1",1,6,4,"H"
"13442",1980-05-17,1979,"US Valenciennes-Anzin","AS Monaco","0-0",0,0,"1",1,0,0,"D"
"13443",1980-05-17,1979,"OGC Nice","RC Strasbourg","6-1",6,1,"1",1,7,5,"H"
"13444",1980-05-17,1979,"FC Metz","Paris Saint-Germain","5-2",5,2,"1",1,7,3,"H"
"13445",1980-05-17,1979,"Angers SCO","Nimes Olympique","0-1",0,1,"1",1,1,-1,"D"
"13446",1980-05-17,1979,"Lille OSC","RC Lens","0-0",0,0,"1",1,0,0,"D"
"13447",1980-05-17,1979,"SC Bastia","AS Nancy","2-2",2,2,"1",1,4,0,"D"
"13448",1980-05-17,1979,"Olympique Lyon","Stade Brest","3-0",3,0,"1",1,3,3,"H"
"13449",1980-05-27,1979,"FC Nantes","Stade Laval","4-1",4,1,"1",1,5,3,"H"
"13450",1980-05-27,1979,"AS Monaco","FC Sochaux","0-1",0,1,"1",1,1,-1,"D"
"13451",1980-05-27,1979,"AS Saint-Etienne","SC Bastia","2-0",2,0,"1",1,2,2,"H"
"13452",1980-05-27,1979,"RC Strasbourg","Girondins Bordeaux","4-0",4,0,"1",1,4,4,"H"
"13453",1980-05-27,1979,"Paris Saint-Germain","Olympique Lyon","2-1",2,1,"1",1,3,1,"H"
"13454",1980-05-27,1979,"Angers SCO","US Valenciennes-Anzin","2-1",2,1,"1",1,3,1,"H"
"13455",1980-05-27,1979,"RC Lens","FC Metz","4-1",4,1,"1",1,5,3,"H"
"13456",1980-05-27,1979,"Nimes Olympique","OGC Nice","0-1",0,1,"1",1,1,-1,"D"
"13457",1980-05-27,1979,"AS Nancy","Lille OSC","1-0",1,0,"1",1,1,1,"H"
"13458",1980-05-27,1979,"Stade Brest","Olympique Marseille","7-2",7,2,"1",1,9,5,"H"
"13459",1980-07-24,1980,"Girondins Bordeaux","AS Saint-Etienne","3-0",3,0,"1",1,3,3,"H"
"13460",1980-07-24,1980,"Lille OSC","RC Strasbourg","3-0",3,0,"1",1,3,3,"H"
"13461",1980-07-24,1980,"SC Bastia","AJ Auxerre","2-0",2,0,"1",1,2,2,"H"
"13462",1980-07-24,1980,"AS Nancy","AS Monaco","2-3",2,3,"1",1,5,-1,"D"
"13463",1980-07-24,1980,"Nimes Olympique","FC Nantes","2-3",2,3,"1",1,5,-1,"D"
"13464",1980-07-24,1980,"Tours FC","Stade Laval","3-2",3,2,"1",1,5,1,"H"
"13465",1980-07-24,1980,"FC Sochaux","RC Lens","1-2",1,2,"1",1,3,-1,"D"
"13466",1980-07-24,1980,"Angers SCO","Paris Saint-Germain","1-1",1,1,"1",1,2,0,"D"
"13467",1980-07-24,1980,"Olympique Lyon","US Valenciennes-Anzin","1-1",1,1,"1",1,2,0,"D"
"13468",1980-07-24,1980,"OGC Nice","FC Metz","0-0",0,0,"1",1,0,0,"D"
"13469",1980-07-29,1980,"AS Monaco","Lille OSC","1-2",1,2,"1",1,3,-1,"D"
"13470",1980-07-29,1980,"FC Nantes","Girondins Bordeaux","1-0",1,0,"1",1,1,1,"H"
"13471",1980-07-29,1980,"US Valenciennes-Anzin","SC Bastia","1-1",1,1,"1",1,2,0,"D"
"13472",1980-07-29,1980,"FC Metz","Olympique Lyon","0-2",0,2,"1",1,2,-2,"D"
"13473",1980-07-29,1980,"RC Lens","Nimes Olympique","1-1",1,1,"1",1,2,0,"D"
"13474",1980-07-29,1980,"Paris Saint-Germain","RC Strasbourg","1-0",1,0,"1",1,1,1,"H"
"13475",1980-07-29,1980,"FC Sochaux","Tours FC","1-0",1,0,"1",1,1,1,"H"
"13476",1980-07-29,1980,"Stade Laval","AS Nancy","1-0",1,0,"1",1,1,1,"H"
"13477",1980-07-29,1980,"AJ Auxerre","Angers SCO","2-2",2,2,"1",1,4,0,"D"
"13478",1980-07-29,1980,"AS Saint-Etienne","OGC Nice","3-2",3,2,"1",1,5,1,"H"
"13479",1980-08-05,1980,"Lille OSC","Paris Saint-Germain","2-2",2,2,"1",1,4,0,"D"
"13480",1980-08-05,1980,"Olympique Lyon","AS Monaco","3-2",3,2,"1",1,5,1,"H"
"13481",1980-08-05,1980,"SC Bastia","AS Saint-Etienne","2-1",2,1,"1",1,3,1,"H"
"13482",1980-08-05,1980,"Girondins Bordeaux","Stade Laval","2-1",2,1,"1",1,3,1,"H"
"13483",1980-08-05,1980,"OGC Nice","FC Nantes","3-2",3,2,"1",1,5,1,"H"
"13484",1980-08-05,1980,"Tours FC","RC Lens","1-1",1,1,"1",1,2,0,"D"
"13485",1980-08-05,1980,"Angers SCO","US Valenciennes-Anzin","1-1",1,1,"1",1,2,0,"D"
"13486",1980-08-05,1980,"Nimes Olympique","FC Sochaux","0-0",0,0,"1",1,0,0,"D"
"13487",1980-08-05,1980,"AS Nancy","FC Metz","2-0",2,0,"1",1,2,2,"H"
"13488",1980-08-05,1980,"RC Strasbourg","AJ Auxerre","1-0",1,0,"1",1,1,1,"H"
"13489",1980-08-12,1980,"Nimes Olympique","Olympique Lyon","1-2",1,2,"1",1,3,-1,"D"
"13490",1980-08-12,1980,"RC Lens","OGC Nice","2-0",2,0,"1",1,2,2,"H"
"13491",1980-08-12,1980,"FC Nantes","Tours FC","4-3",4,3,"1",1,7,1,"H"
"13492",1980-08-12,1980,"AJ Auxerre","Paris Saint-Germain","0-1",0,1,"1",1,1,-1,"D"
"13493",1980-08-12,1980,"FC Sochaux","Girondins Bordeaux","0-0",0,0,"1",1,0,0,"D"
"13494",1980-08-12,1980,"Stade Laval","Lille OSC","4-2",4,2,"1",1,6,2,"H"
"13495",1980-08-12,1980,"FC Metz","SC Bastia","1-0",1,0,"1",1,1,1,"H"
"13496",1980-08-12,1980,"AS Monaco","Angers SCO","2-0",2,0,"1",1,2,2,"H"
"13497",1980-08-12,1980,"AS Saint-Etienne","AS Nancy","4-1",4,1,"1",1,5,3,"H"
"13498",1980-08-12,1980,"US Valenciennes-Anzin","RC Strasbourg","1-2",1,2,"1",1,3,-1,"D"
"13499",1980-08-19,1980,"Olympique Lyon","Stade Laval","1-0",1,0,"1",1,1,1,"H"
"13500",1980-08-19,1980,"Paris Saint-Germain","US Valenciennes-Anzin","3-2",3,2,"1",1,5,1,"H"
"13501",1980-08-19,1980,"Girondins Bordeaux","RC Lens","5-1",5,1,"1",1,6,4,"H"
"13502",1980-08-19,1980,"RC Strasbourg","AS Saint-Etienne","0-2",0,2,"1",1,2,-2,"D"
"13503",1980-08-19,1980,"SC Bastia","AS Monaco","1-1",1,1,"1",1,2,0,"D"
"13504",1980-08-19,1980,"AS Nancy","FC Nantes","1-0",1,0,"1",1,1,1,"H"
"13505",1980-08-19,1980,"Lille OSC","AJ Auxerre","2-3",2,3,"1",1,5,-1,"D"
"13506",1980-08-19,1980,"Tours FC","Nimes Olympique","4-3",4,3,"1",1,7,1,"H"
"13507",1980-08-19,1980,"OGC Nice","FC Sochaux","4-2",4,2,"1",1,6,2,"H"
"13508",1980-08-19,1980,"Angers SCO","FC Metz","0-0",0,0,"1",1,0,0,"D"
"13509",1980-08-22,1980,"Nimes Olympique","Girondins Bordeaux","0-2",0,2,"1",1,2,-2,"D"
"13510",1980-08-22,1980,"FC Nantes","Olympique Lyon","2-1",2,1,"1",1,3,1,"H"
"13511",1980-08-22,1980,"AS Saint-Etienne","Angers SCO","5-0",5,0,"1",1,5,5,"H"
"13512",1980-08-22,1980,"AS Monaco","Paris Saint-Germain","4-0",4,0,"1",1,4,4,"H"
"13513",1980-08-22,1980,"Stade Laval","OGC Nice","0-1",0,1,"1",1,1,-1,"D"
"13514",1980-08-22,1980,"RC Lens","AS Nancy","0-0",0,0,"1",1,0,0,"D"
"13515",1980-08-22,1980,"Tours FC","Lille OSC","3-3",3,3,"1",1,6,0,"D"
"13516",1980-08-22,1980,"FC Sochaux","SC Bastia","1-0",1,0,"1",1,1,1,"H"
"13517",1980-08-22,1980,"FC Metz","RC Strasbourg","4-1",4,1,"1",1,5,3,"H"
"13518",1980-08-22,1980,"US Valenciennes-Anzin","AJ Auxerre","2-0",2,0,"1",1,2,2,"H"
"13519",1980-08-26,1980,"AJ Auxerre","AS Saint-Etienne","0-2",0,2,"1",1,2,-2,"D"
"13520",1980-08-26,1980,"Girondins Bordeaux","Tours FC","1-1",1,1,"1",1,2,0,"D"
"13521",1980-08-26,1980,"Olympique Lyon","RC Lens","4-1",4,1,"1",1,5,3,"H"
"13522",1980-08-26,1980,"SC Bastia","FC Nantes","1-2",1,2,"1",1,3,-1,"D"
"13523",1980-08-26,1980,"Paris Saint-Germain","FC Metz","1-1",1,1,"1",1,2,0,"D"
"13524",1980-08-26,1980,"RC Strasbourg","AS Monaco","0-0",0,0,"1",1,0,0,"D"
"13525",1980-08-26,1980,"OGC Nice","Nimes Olympique","0-0",0,0,"1",1,0,0,"D"
"13526",1980-08-26,1980,"Lille OSC","US Valenciennes-Anzin","1-2",1,2,"1",1,3,-1,"D"
"13527",1980-08-26,1980,"AS Nancy","FC Sochaux","2-2",2,2,"1",1,4,0,"D"
"13528",1980-08-26,1980,"Angers SCO","Stade Laval","2-0",2,0,"1",1,2,2,"H"
"13529",1980-08-29,1980,"AS Saint-Etienne","Lille OSC","3-1",3,1,"1",1,4,2,"H"
"13530",1980-08-29,1980,"Girondins Bordeaux","Angers SCO","1-0",1,0,"1",1,1,1,"H"
"13531",1980-08-29,1980,"FC Sochaux","Olympique Lyon","2-2",2,2,"1",1,4,0,"D"
"13532",1980-08-29,1980,"FC Nantes","Paris Saint-Germain","1-1",1,1,"1",1,2,0,"D"
"13533",1980-08-29,1980,"AS Monaco","US Valenciennes-Anzin","5-1",5,1,"1",1,6,4,"H"
"13534",1980-08-29,1980,"Tours FC","OGC Nice","1-0",1,0,"1",1,1,1,"H"
"13535",1980-08-29,1980,"RC Lens","SC Bastia","5-0",5,0,"1",1,5,5,"H"
"13536",1980-08-29,1980,"FC Metz","AJ Auxerre","2-2",2,2,"1",1,4,0,"D"
"13537",1980-08-29,1980,"Nimes Olympique","AS Nancy","1-2",1,2,"1",1,3,-1,"D"
"13538",1980-08-29,1980,"Stade Laval","RC Strasbourg","3-1",3,1,"1",1,4,2,"H"
"13539",1980-09-09,1980,"Olympique Lyon","AS Saint-Etienne","1-1",1,1,"1",1,2,0,"D"
"13540",1980-09-09,1980,"OGC Nice","Girondins Bordeaux","1-1",1,1,"1",1,2,0,"D"
"13541",1980-09-09,1980,"Angers SCO","FC Nantes","0-3",0,3,"1",1,3,-3,"D"
"13542",1980-09-09,1980,"Paris Saint-Germain","Nimes Olympique","3-2",3,2,"1",1,5,1,"H"
"13543",1980-09-09,1980,"AJ Auxerre","AS Monaco","0-0",0,0,"1",1,0,0,"D"
"13544",1980-09-09,1980,"AS Nancy","Tours FC","1-3",1,3,"1",1,4,-2,"D"
"13545",1980-09-09,1980,"Lille OSC","RC Lens","2-1",2,1,"1",1,3,1,"H"
"13546",1980-09-09,1980,"US Valenciennes-Anzin","FC Metz","3-0",3,0,"1",1,3,3,"H"
"13547",1980-09-09,1980,"RC Strasbourg","FC Sochaux","2-0",2,0,"1",1,2,2,"H"
"13548",1980-09-09,1980,"SC Bastia","Stade Laval","2-2",2,2,"1",1,4,0,"D"
"13549",1980-09-12,1980,"AS Saint-Etienne","US Valenciennes-Anzin","4-0",4,0,"1",1,4,4,"H"
"13550",1980-09-12,1980,"Girondins Bordeaux","AS Nancy","2-0",2,0,"1",1,2,2,"H"
"13551",1980-09-12,1980,"FC Nantes","Lille OSC","4-1",4,1,"1",1,5,3,"H"
"13552",1980-09-12,1980,"Tours FC","Olympique Lyon","1-1",1,1,"1",1,2,0,"D"
"13553",1980-09-12,1980,"OGC Nice","Paris Saint-Germain","1-1",1,1,"1",1,2,0,"D"
"13554",1980-09-12,1980,"FC Metz","AS Monaco","1-1",1,1,"1",1,2,0,"D"
"13555",1980-09-12,1980,"FC Sochaux","Angers SCO","2-0",2,0,"1",1,2,2,"H"
"13556",1980-09-12,1980,"RC Lens","RC Strasbourg","1-2",1,2,"1",1,3,-1,"D"
"13557",1980-09-12,1980,"Stade Laval","AJ Auxerre","0-0",0,0,"1",1,0,0,"D"
"13558",1980-09-12,1980,"Nimes Olympique","SC Bastia","3-2",3,2,"1",1,5,1,"H"
"13559",1980-09-23,1980,"AS Monaco","AS Saint-Etienne","1-2",1,2,"1",1,3,-1,"D"
"13560",1980-09-23,1980,"RC Strasbourg","FC Nantes","1-2",1,2,"1",1,3,-1,"D"
"13561",1980-09-23,1980,"Olympique Lyon","Girondins Bordeaux","1-0",1,0,"1",1,1,1,"H"
"13562",1980-09-23,1980,"Paris Saint-Germain","Stade Laval","3-2",3,2,"1",1,5,1,"H"
"13563",1980-09-23,1980,"US Valenciennes-Anzin","Nimes Olympique","1-1",1,1,"1",1,2,0,"D"
"13564",1980-09-23,1980,"AS Nancy","OGC Nice","3-2",3,2,"1",1,5,1,"H"
"13565",1980-09-23,1980,"Lille OSC","FC Metz","0-1",0,1,"1",1,1,-1,"D"
"13566",1980-09-23,1980,"AJ Auxerre","FC Sochaux","1-1",1,1,"1",1,2,0,"D"
"13567",1980-09-23,1980,"Angers SCO","RC Lens","1-2",1,2,"1",1,3,-1,"D"
"13568",1980-09-23,1980,"SC Bastia","Tours FC","0-1",0,1,"1",1,1,-1,"D"
"13569",1980-09-26,1980,"AS Saint-Etienne","FC Metz","3-0",3,0,"1",1,3,3,"H"
"13570",1980-09-26,1980,"FC Nantes","US Valenciennes-Anzin","3-0",3,0,"1",1,3,3,"H"
"13571",1980-09-26,1980,"Girondins Bordeaux","SC Bastia","0-0",0,0,"1",1,0,0,"D"
"13572",1980-09-26,1980,"AS Nancy","Olympique Lyon","3-1",3,1,"1",1,4,2,"H"
"13573",1980-09-26,1980,"Tours FC","Angers SCO","2-2",2,2,"1",1,4,0,"D"
"13574",1980-09-26,1980,"FC Sochaux","Paris Saint-Germain","4-0",4,0,"1",1,4,4,"H"
"13575",1980-09-26,1980,"Stade Laval","AS Monaco","3-3",3,3,"1",1,6,0,"D"
"13576",1980-09-26,1980,"RC Lens","AJ Auxerre","1-1",1,1,"1",1,2,0,"D"
"13577",1980-09-26,1980,"OGC Nice","Lille OSC","1-2",1,2,"1",1,3,-1,"D"
"13578",1980-09-26,1980,"Nimes Olympique","RC Strasbourg","4-2",4,2,"1",1,6,2,"H"
"13579",1980-10-03,1980,"FC Metz","Stade Laval","3-2",3,2,"1",1,5,1,"H"
"13580",1980-10-04,1980,"Paris Saint-Germain","AS Saint-Etienne","1-1",1,1,"1",1,2,0,"D"
"13581",1980-10-04,1980,"AJ Auxerre","FC Nantes","0-0",0,0,"1",1,0,0,"D"
"13582",1980-10-04,1980,"Olympique Lyon","OGC Nice","5-1",5,1,"1",1,6,4,"H"
"13583",1980-10-04,1980,"Lille OSC","Girondins Bordeaux","2-2",2,2,"1",1,4,0,"D"
"13584",1980-10-04,1980,"AS Monaco","FC Sochaux","2-1",2,1,"1",1,3,1,"H"
"13585",1980-10-04,1980,"RC Strasbourg","Tours FC","4-1",4,1,"1",1,5,3,"H"
"13586",1980-10-04,1980,"US Valenciennes-Anzin","RC Lens","1-0",1,0,"1",1,1,1,"H"
"13587",1980-10-04,1980,"Angers SCO","Nimes Olympique","1-2",1,2,"1",1,3,-1,"D"
"13588",1980-10-04,1980,"SC Bastia","AS Nancy","2-1",2,1,"1",1,3,1,"H"
"13589",1980-10-14,1980,"FC Nantes","FC Metz","1-0",1,0,"1",1,1,1,"H"
"13590",1980-10-14,1980,"Stade Laval","AS Saint-Etienne","0-0",0,0,"1",1,0,0,"D"
"13591",1980-10-14,1980,"Olympique Lyon","Angers SCO","5-1",5,1,"1",1,6,4,"H"
"13592",1980-10-14,1980,"Girondins Bordeaux","RC Strasbourg","2-1",2,1,"1",1,3,1,"H"
"13593",1980-10-14,1980,"Tours FC","Paris Saint-Germain","0-2",0,2,"1",1,2,-2,"D"
"13594",1980-10-14,1980,"RC Lens","AS Monaco","0-0",0,0,"1",1,0,0,"D"
"13595",1980-10-14,1980,"FC Sochaux","US Valenciennes-Anzin","3-3",3,3,"1",1,6,0,"D"
"13596",1980-10-14,1980,"AS Nancy","Lille OSC","2-0",2,0,"1",1,2,2,"H"
"13597",1980-10-14,1980,"OGC Nice","SC Bastia","2-1",2,1,"1",1,3,1,"H"
"13598",1980-10-14,1980,"Nimes Olympique","AJ Auxerre","0-0",0,0,"1",1,0,0,"D"
"13599",1980-10-17,1980,"AS Saint-Etienne","FC Sochaux","3-0",3,0,"1",1,3,3,"H"
"13600",1980-10-17,1980,"AS Monaco","FC Nantes","2-1",2,1,"1",1,3,1,"H"
"13601",1980-10-17,1980,"SC Bastia","Olympique Lyon","2-0",2,0,"1",1,2,2,"H"
"13602",1980-10-17,1980,"Paris Saint-Germain","Girondins Bordeaux","4-0",4,0,"1",1,4,4,"H"
"13603",1980-10-17,1980,"FC Metz","RC Lens","0-2",0,2,"1",1,2,-2,"D"
"13604",1980-10-17,1980,"AJ Auxerre","Tours FC","3-2",3,2,"1",1,5,1,"H"
"13605",1980-10-17,1980,"US Valenciennes-Anzin","Stade Laval","4-2",4,2,"1",1,6,2,"H"
"13606",1980-10-17,1980,"Angers SCO","AS Nancy","2-0",2,0,"1",1,2,2,"H"
"13607",1980-10-17,1980,"RC Strasbourg","OGC Nice","2-1",2,1,"1",1,3,1,"H"
"13608",1980-10-17,1980,"Lille OSC","Nimes Olympique","0-0",0,0,"1",1,0,0,"D"
"13609",1980-10-31,1980,"RC Lens","AS Saint-Etienne","1-1",1,1,"1",1,2,0,"D"
"13610",1980-10-31,1980,"FC Nantes","Stade Laval","4-1",4,1,"1",1,5,3,"H"
"13611",1980-10-31,1980,"Olympique Lyon","Lille OSC","2-2",2,2,"1",1,4,0,"D"
"13612",1980-10-31,1980,"Girondins Bordeaux","AJ Auxerre","2-0",2,0,"1",1,2,2,"H"
"13613",1980-10-31,1980,"Nimes Olympique","AS Monaco","1-3",1,3,"1",1,4,-2,"D"
"13614",1980-10-31,1980,"SC Bastia","Paris Saint-Germain","2-0",2,0,"1",1,2,2,"H"
"13615",1980-10-31,1980,"Tours FC","US Valenciennes-Anzin","2-3",2,3,"1",1,5,-1,"D"
"13616",1980-10-31,1980,"FC Sochaux","FC Metz","3-0",3,0,"1",1,3,3,"H"
"13617",1980-10-31,1980,"AS Nancy","RC Strasbourg","2-0",2,0,"1",1,2,2,"H"
"13618",1980-10-31,1980,"OGC Nice","Angers SCO","2-2",2,2,"1",1,4,0,"D"
"13619",1980-11-07,1980,"FC Metz","Nimes Olympique","2-1",2,1,"1",1,3,1,"H"
"13620",1980-11-07,1980,"Paris Saint-Germain","AS Nancy","2-1",2,1,"1",1,3,1,"H"
"13621",1980-11-07,1980,"RC Strasbourg","Olympique Lyon","2-1",2,1,"1",1,3,1,"H"
"13622",1980-11-08,1980,"AS Saint-Etienne","FC Nantes","0-0",0,0,"1",1,0,0,"D"
"13623",1980-11-08,1980,"US Valenciennes-Anzin","Girondins Bordeaux","2-2",2,2,"1",1,4,0,"D"
"13624",1980-11-08,1980,"AS Monaco","Tours FC","1-1",1,1,"1",1,2,0,"D"
"13625",1980-11-08,1980,"Lille OSC","FC Sochaux","2-1",2,1,"1",1,3,1,"H"
"13626",1980-11-08,1980,"Stade Laval","RC Lens","3-0",3,0,"1",1,3,3,"H"
"13627",1980-11-08,1980,"Angers SCO","SC Bastia","1-0",1,0,"1",1,1,1,"H"
"13628",1980-11-08,1980,"AJ Auxerre","OGC Nice","3-1",3,1,"1",1,4,2,"H"
"13629",1980-11-12,1980,"Nimes Olympique","AS Saint-Etienne","0-1",0,1,"1",1,1,-1,"D"
"13630",1980-11-12,1980,"RC Lens","FC Nantes","0-0",0,0,"1",1,0,0,"D"
"13631",1980-11-12,1980,"Girondins Bordeaux","AS Monaco","1-0",1,0,"1",1,1,1,"H"
"13632",1980-11-12,1980,"FC Sochaux","Stade Laval","2-1",2,1,"1",1,3,1,"H"
"13633",1980-11-12,1980,"AS Nancy","AJ Auxerre","3-0",3,0,"1",1,3,3,"H"
"13634",1980-11-12,1980,"OGC Nice","US Valenciennes-Anzin","4-0",4,0,"1",1,4,4,"H"
"13635",1980-11-12,1980,"Tours FC","FC Metz","1-1",1,1,"1",1,2,0,"D"
"13636",1980-11-12,1980,"SC Bastia","RC Strasbourg","2-0",2,0,"1",1,2,2,"H"
"13637",1980-11-12,1980,"Angers SCO","Lille OSC","3-2",3,2,"1",1,5,1,"H"
"13638",1980-11-22,1980,"Lille OSC","SC Bastia","3-1",3,1,"1",1,4,2,"H"
"13639",1980-11-23,1980,"FC Nantes","FC Sochaux","2-1",2,1,"1",1,3,1,"H"
"13640",1980-11-23,1980,"AS Saint-Etienne","Tours FC","1-2",1,2,"1",1,3,-1,"D"
"13641",1980-11-23,1980,"FC Metz","Girondins Bordeaux","1-1",1,1,"1",1,2,0,"D"
"13642",1980-11-23,1980,"Paris Saint-Germain","RC Lens","3-0",3,0,"1",1,3,3,"H"
"13643",1980-11-23,1980,"AS Monaco","OGC Nice","1-0",1,0,"1",1,1,1,"H"
"13644",1980-11-23,1980,"AJ Auxerre","Olympique Lyon","2-2",2,2,"1",1,4,0,"D"
"13645",1980-11-23,1980,"US Valenciennes-Anzin","AS Nancy","3-0",3,0,"1",1,3,3,"H"
"13646",1980-11-23,1980,"RC Strasbourg","Angers SCO","2-0",2,0,"1",1,2,2,"H"
"13647",1980-11-23,1980,"Stade Laval","Nimes Olympique","4-0",4,0,"1",1,4,4,"H"
"13648",1980-11-28,1980,"RC Strasbourg","Paris Saint-Germain","1-0",1,0,"1",1,1,1,"H"
"13649",1980-11-28,1980,"Tours FC","FC Sochaux","0-1",0,1,"1",1,1,-1,"D"
"13650",1980-11-28,1980,"AS Nancy","Stade Laval","3-0",3,0,"1",1,3,3,"H"
"13651",1980-11-29,1980,"Girondins Bordeaux","FC Nantes","0-0",0,0,"1",1,0,0,"D"
"13652",1980-11-29,1980,"OGC Nice","AS Saint-Etienne","0-1",0,1,"1",1,1,-1,"D"
"13653",1980-11-29,1980,"Olympique Lyon","FC Metz","0-0",0,0,"1",1,0,0,"D"
"13654",1980-11-29,1980,"Lille OSC","AS Monaco","2-1",2,1,"1",1,3,1,"H"
"13655",1980-11-29,1980,"Nimes Olympique","RC Lens","1-1",1,1,"1",1,2,0,"D"
"13656",1980-11-29,1980,"Angers SCO","AJ Auxerre","4-1",4,1,"1",1,5,3,"H"
"13657",1980-11-30,1980,"SC Bastia","US Valenciennes-Anzin","1-1",1,1,"1",1,2,0,"D"
"13658",1980-12-05,1980,"AS Saint-Etienne","SC Bastia","3-0",3,0,"1",1,3,3,"H"
"13659",1980-12-06,1980,"FC Nantes","OGC Nice","4-1",4,1,"1",1,5,3,"H"
"13660",1980-12-06,1980,"Stade Laval","Girondins Bordeaux","2-4",2,4,"1",1,6,-2,"D"
"13661",1980-12-06,1980,"Paris Saint-Germain","Lille OSC","4-1",4,1,"1",1,5,3,"H"
"13662",1980-12-06,1980,"FC Sochaux","Nimes Olympique","2-1",2,1,"1",1,3,1,"H"
"13663",1980-12-06,1980,"FC Metz","AS Nancy","2-0",2,0,"1",1,2,2,"H"
"13664",1980-12-06,1980,"US Valenciennes-Anzin","Angers SCO","0-0",0,0,"1",1,0,0,"D"
"13665",1980-12-06,1980,"RC Lens","Tours FC","3-0",3,0,"1",1,3,3,"H"
"13666",1980-12-06,1980,"AJ Auxerre","RC Strasbourg","1-1",1,1,"1",1,2,0,"D"
"13667",1980-12-06,1980,"AS Monaco","Olympique Lyon","2-1",2,1,"1",1,3,1,"H"
"13668",1980-12-13,1980,"AS Nancy","AS Saint-Etienne","0-0",0,0,"1",1,0,0,"D"
"13669",1980-12-13,1980,"Tours FC","FC Nantes","2-3",2,3,"1",1,5,-1,"D"
"13670",1980-12-13,1980,"Angers SCO","AS Monaco","1-1",1,1,"1",1,2,0,"D"
"13671",1980-12-13,1980,"OGC Nice","RC Lens","1-1",1,1,"1",1,2,0,"D"
"13672",1980-12-13,1980,"SC Bastia","FC Metz","1-0",1,0,"1",1,1,1,"H"
"13673",1980-12-13,1980,"Lille OSC","Stade Laval","1-1",1,1,"1",1,2,0,"D"
"13674",1980-12-14,1980,"Girondins Bordeaux","FC Sochaux","0-0",0,0,"1",1,0,0,"D"
"13675",1980-12-14,1980,"Paris Saint-Germain","AJ Auxerre","2-3",2,3,"1",1,5,-1,"D"
"13676",1980-12-14,1980,"Olympique Lyon","Nimes Olympique","4-2",4,2,"1",1,6,2,"H"
"13677",1980-12-14,1980,"RC Strasbourg","US Valenciennes-Anzin","3-0",3,0,"1",1,3,3,"H"
"13678",1980-12-20,1980,"FC Nantes","AS Nancy","3-0",3,0,"1",1,3,3,"H"
"13679",1980-12-20,1980,"RC Lens","Girondins Bordeaux","0-1",0,1,"1",1,1,-1,"D"
"13680",1980-12-20,1980,"AS Monaco","SC Bastia","3-0",3,0,"1",1,3,3,"H"
"13681",1980-12-20,1980,"Stade Laval","Olympique Lyon","0-0",0,0,"1",1,0,0,"D"
"13682",1980-12-20,1980,"FC Metz","Angers SCO","1-0",1,0,"1",1,1,1,"H"
"13683",1980-12-20,1980,"AJ Auxerre","Lille OSC","2-2",2,2,"1",1,4,0,"D"
"13684",1980-12-20,1980,"Nimes Olympique","Tours FC","2-1",2,1,"1",1,3,1,"H"
"13685",1980-12-21,1980,"AS Saint-Etienne","RC Strasbourg","3-0",3,0,"1",1,3,3,"H"
"13686",1980-12-21,1980,"FC Sochaux","OGC Nice","1-1",1,1,"1",1,2,0,"D"
"13687",1980-12-21,1980,"US Valenciennes-Anzin","Paris Saint-Germain","2-0",2,0,"1",1,2,2,"H"
"13688",1981-01-24,1980,"Girondins Bordeaux","Nimes Olympique","1-1",1,1,"1",1,2,0,"D"
"13689",1981-01-24,1980,"Paris Saint-Germain","AS Monaco","0-0",0,0,"1",1,0,0,"D"
"13690",1981-01-24,1980,"AS Nancy","RC Lens","1-2",1,2,"1",1,3,-1,"D"
"13691",1981-01-24,1980,"OGC Nice","Stade Laval","2-1",2,1,"1",1,3,1,"H"
"13692",1981-01-24,1980,"SC Bastia","FC Sochaux","1-1",1,1,"1",1,2,0,"D"
"13693",1981-01-24,1980,"AJ Auxerre","US Valenciennes-Anzin","1-1",1,1,"1",1,2,0,"D"
"13694",1981-01-24,1980,"Lille OSC","Tours FC","1-1",1,1,"1",1,2,0,"D"
"13695",1981-01-24,1980,"RC Strasbourg","FC Metz","3-3",3,3,"1",1,6,0,"D"
"13696",1981-01-25,1980,"Olympique Lyon","FC Nantes","0-0",0,0,"1",1,0,0,"D"
"13697",1981-01-25,1980,"Angers SCO","AS Saint-Etienne","1-1",1,1,"1",1,2,0,"D"
"13698",1981-01-30,1980,"US Valenciennes-Anzin","Lille OSC","0-3",0,3,"1",1,3,-3,"D"
"13699",1981-01-31,1980,"FC Nantes","SC Bastia","2-1",2,1,"1",1,3,1,"H"
"13700",1981-01-31,1980,"Tours FC","Girondins Bordeaux","0-1",0,1,"1",1,1,-1,"D"
"13701",1981-01-31,1980,"AS Monaco","RC Strasbourg","3-1",3,1,"1",1,4,2,"H"
"13702",1981-01-31,1980,"RC Lens","Olympique Lyon","2-2",2,2,"1",1,4,0,"D"
"13703",1981-01-31,1980,"FC Metz","Paris Saint-Germain","0-0",0,0,"1",1,0,0,"D"
"13704",1981-01-31,1980,"Stade Laval","Angers SCO","2-0",2,0,"1",1,2,2,"H"
"13705",1981-02-01,1980,"AS Saint-Etienne","AJ Auxerre","2-0",2,0,"1",1,2,2,"H"
"13706",1981-02-01,1980,"FC Sochaux","AS Nancy","1-1",1,1,"1",1,2,0,"D"
"13707",1981-02-01,1980,"Nimes Olympique","OGC Nice","1-3",1,3,"1",1,4,-2,"D"
"13708",1981-02-04,1980,"Olympique Lyon","Paris Saint-Germain","2-0",2,0,"1",1,2,2,"H"
"13709",1981-02-06,1980,"Lille OSC","AS Saint-Etienne","1-3",1,3,"1",1,4,-2,"D"
"13710",1981-02-06,1980,"SC Bastia","RC Lens","3-1",3,1,"1",1,4,2,"H"
"13711",1981-02-07,1980,"Angers SCO","Girondins Bordeaux","0-3",0,3,"1",1,3,-3,"D"
"13712",1981-02-07,1980,"RC Strasbourg","Stade Laval","0-0",0,0,"1",1,0,0,"D"
"13713",1981-02-07,1980,"AJ Auxerre","FC Metz","4-2",4,2,"1",1,6,2,"H"
"13714",1981-02-08,1980,"Paris Saint-Germain","FC Nantes","0-2",0,2,"1",1,2,-2,"D"
"13715",1981-02-08,1980,"US Valenciennes-Anzin","AS Monaco","0-1",0,1,"1",1,1,-1,"D"
"13716",1981-02-08,1980,"Olympique Lyon","FC Sochaux","5-1",5,1,"1",1,6,4,"H"
"13717",1981-02-08,1980,"AS Nancy","Nimes Olympique","2-0",2,0,"1",1,2,2,"H"
"13718",1981-02-08,1980,"OGC Nice","Tours FC","2-2",2,2,"1",1,4,0,"D"
"13719",1981-02-21,1980,"FC Nantes","Angers SCO","3-1",3,1,"1",1,4,2,"H"
"13720",1981-02-21,1980,"AS Monaco","AJ Auxerre","2-1",2,1,"1",1,3,1,"H"
"13721",1981-02-21,1980,"FC Metz","US Valenciennes-Anzin","4-2",4,2,"1",1,6,2,"H"
"13722",1981-02-21,1980,"RC Lens","Lille OSC","0-0",0,0,"1",1,0,0,"D"
"13723",1981-02-21,1980,"Tours FC","AS Nancy","1-0",1,0,"1",1,1,1,"H"
"13724",1981-02-21,1980,"Stade Laval","SC Bastia","3-0",3,0,"1",1,3,3,"H"
"13725",1981-02-22,1980,"AS Saint-Etienne","Olympique Lyon","3-2",3,2,"1",1,5,1,"H"
"13726",1981-02-22,1980,"Girondins Bordeaux","OGC Nice","3-0",3,0,"1",1,3,3,"H"
"13727",1981-02-22,1980,"Nimes Olympique","Paris Saint-Germain","2-1",2,1,"1",1,3,1,"H"
"13728",1981-02-22,1980,"FC Sochaux","RC Strasbourg","1-1",1,1,"1",1,2,0,"D"
"13729",1981-02-27,1980,"Lille OSC","FC Nantes","0-3",0,3,"1",1,3,-3,"D"
"13730",1981-02-27,1980,"RC Strasbourg","RC Lens","1-0",1,0,"1",1,1,1,"H"
"13731",1981-02-27,1980,"SC Bastia","Nimes Olympique","3-2",3,2,"1",1,5,1,"H"
"13732",1981-02-28,1980,"US Valenciennes-Anzin","AS Saint-Etienne","0-1",0,1,"1",1,1,-1,"D"
"13733",1981-02-28,1980,"AS Monaco","FC Metz","2-1",2,1,"1",1,3,1,"H"
"13734",1981-02-28,1980,"Paris Saint-Germain","OGC Nice","3-1",3,1,"1",1,4,2,"H"
"13735",1981-02-28,1980,"Angers SCO","FC Sochaux","1-2",1,2,"1",1,3,-1,"D"
"13736",1981-02-28,1980,"AJ Auxerre","Stade Laval","1-0",1,0,"1",1,1,1,"H"
"13737",1981-03-01,1980,"AS Nancy","Girondins Bordeaux","2-0",2,0,"1",1,2,2,"H"
"13738",1981-03-01,1980,"Olympique Lyon","Tours FC","2-3",2,3,"1",1,5,-1,"D"
"13739",1981-03-14,1980,"AS Saint-Etienne","AS Monaco","5-1",5,1,"1",1,6,4,"H"
"13740",1981-03-14,1980,"FC Nantes","RC Strasbourg","1-1",1,1,"1",1,2,0,"D"
"13741",1981-03-14,1980,"Girondins Bordeaux","Olympique Lyon","3-2",3,2,"1",1,5,1,"H"
"13742",1981-03-14,1980,"Stade Laval","Paris Saint-Germain","0-0",0,0,"1",1,0,0,"D"
"13743",1981-03-14,1980,"FC Sochaux","AJ Auxerre","1-1",1,1,"1",1,2,0,"D"
"13744",1981-03-14,1980,"FC Metz","Lille OSC","3-0",3,0,"1",1,3,3,"H"
"13745",1981-03-14,1980,"OGC Nice","AS Nancy","2-2",2,2,"1",1,4,0,"D"
"13746",1981-03-14,1980,"RC Lens","Angers SCO","1-0",1,0,"1",1,1,1,"H"
"13747",1981-03-14,1980,"Tours FC","SC Bastia","2-2",2,2,"1",1,4,0,"D"
"13748",1981-03-14,1980,"Nimes Olympique","US Valenciennes-Anzin","1-1",1,1,"1",1,2,0,"D"
"13749",1981-03-28,1980,"FC Metz","AS Saint-Etienne","0-0",0,0,"1",1,0,0,"D"
"13750",1981-03-28,1980,"US Valenciennes-Anzin","FC Nantes","3-3",3,3,"1",1,6,0,"D"
"13751",1981-03-28,1980,"SC Bastia","Girondins Bordeaux","3-2",3,2,"1",1,5,1,"H"
"13752",1981-03-28,1980,"AS Monaco","Stade Laval","3-0",3,0,"1",1,3,3,"H"
"13753",1981-03-28,1980,"Olympique Lyon","AS Nancy","4-2",4,2,"1",1,6,2,"H"
"13754",1981-03-28,1980,"Paris Saint-Germain","FC Sochaux","3-2",3,2,"1",1,5,1,"H"
"13755",1981-03-28,1980,"RC Strasbourg","Nimes Olympique","1-0",1,0,"1",1,1,1,"H"
"13756",1981-03-28,1980,"AJ Auxerre","RC Lens","1-1",1,1,"1",1,2,0,"D"
"13757",1981-03-28,1980,"Angers SCO","Tours FC","2-2",2,2,"1",1,4,0,"D"
"13758",1981-03-28,1980,"Lille OSC","OGC Nice","3-1",3,1,"1",1,4,2,"H"
"13759",1981-04-07,1980,"AS Saint-Etienne","Paris Saint-Germain","0-2",0,2,"1",1,2,-2,"D"
"13760",1981-04-07,1980,"FC Nantes","AJ Auxerre","0-1",0,1,"1",1,1,-1,"D"
"13761",1981-04-07,1980,"Girondins Bordeaux","Lille OSC","2-0",2,0,"1",1,2,2,"H"
"13762",1981-04-07,1980,"OGC Nice","Olympique Lyon","3-2",3,2,"1",1,5,1,"H"
"13763",1981-04-07,1980,"Tours FC","RC Strasbourg","1-1",1,1,"1",1,2,0,"D"
"13764",1981-04-07,1980,"Stade Laval","FC Metz","1-1",1,1,"1",1,2,0,"D"
"13765",1981-04-07,1980,"AS Nancy","SC Bastia","3-0",3,0,"1",1,3,3,"H"
"13766",1981-04-07,1980,"RC Lens","US Valenciennes-Anzin","1-2",1,2,"1",1,3,-1,"D"
"13767",1981-04-07,1980,"Nimes Olympique","Angers SCO","0-0",0,0,"1",1,0,0,"D"
"13768",1981-04-15,1980,"AS Saint-Etienne","Stade Laval","1-0",1,0,"1",1,1,1,"H"
"13769",1981-04-15,1980,"FC Metz","FC Nantes","2-2",2,2,"1",1,4,0,"D"
"13770",1981-04-15,1980,"AS Monaco","RC Lens","1-0",1,0,"1",1,1,1,"H"
"13771",1981-04-15,1980,"Paris Saint-Germain","Tours FC","4-1",4,1,"1",1,5,3,"H"
"13772",1981-04-15,1980,"Angers SCO","Olympique Lyon","1-3",1,3,"1",1,4,-2,"D"
"13773",1981-04-15,1980,"US Valenciennes-Anzin","FC Sochaux","2-1",2,1,"1",1,3,1,"H"
"13774",1981-04-15,1980,"Lille OSC","AS Nancy","0-0",0,0,"1",1,0,0,"D"
"13775",1981-04-15,1980,"AJ Auxerre","Nimes Olympique","4-2",4,2,"1",1,6,2,"H"
"13776",1981-04-15,1980,"SC Bastia","OGC Nice","3-0",3,0,"1",1,3,3,"H"
"13777",1981-04-15,1980,"RC Strasbourg","Girondins Bordeaux","1-1",1,1,"1",1,2,0,"D"
"13778",1981-04-21,1980,"FC Nantes","AS Monaco","5-0",5,0,"1",1,5,5,"H"
"13779",1981-04-21,1980,"Girondins Bordeaux","Paris Saint-Germain","1-3",1,3,"1",1,4,-2,"D"
"13780",1981-04-21,1980,"Olympique Lyon","SC Bastia","2-1",2,1,"1",1,3,1,"H"
"13781",1981-04-21,1980,"OGC Nice","RC Strasbourg","0-0",0,0,"1",1,0,0,"D"
"13782",1981-04-21,1980,"AS Nancy","Angers SCO","2-0",2,0,"1",1,2,2,"H"
"13783",1981-04-21,1980,"Tours FC","AJ Auxerre","1-4",1,4,"1",1,5,-3,"D"
"13784",1981-04-21,1980,"RC Lens","FC Metz","2-2",2,2,"1",1,4,0,"D"
"13785",1981-04-21,1980,"Stade Laval","US Valenciennes-Anzin","2-1",2,1,"1",1,3,1,"H"
"13786",1981-04-21,1980,"Nimes Olympique","Lille OSC","2-1",2,1,"1",1,3,1,"H"
"13787",1981-05-02,1980,"FC Sochaux","AS Monaco","1-1",1,1,"1",1,2,0,"D"
"13788",1981-05-05,1980,"AS Saint-Etienne","RC Lens","0-0",0,0,"1",1,0,0,"D"
"13789",1981-05-05,1980,"Stade Laval","FC Nantes","2-0",2,0,"1",1,2,2,"H"
"13790",1981-05-05,1980,"AJ Auxerre","Girondins Bordeaux","1-2",1,2,"1",1,3,-1,"D"
"13791",1981-05-05,1980,"AS Monaco","Nimes Olympique","2-1",2,1,"1",1,3,1,"H"
"13792",1981-05-05,1980,"Paris Saint-Germain","SC Bastia","3-1",3,1,"1",1,4,2,"H"
"13793",1981-05-05,1980,"Lille OSC","Olympique Lyon","1-1",1,1,"1",1,2,0,"D"
"13794",1981-05-05,1980,"RC Strasbourg","AS Nancy","2-0",2,0,"1",1,2,2,"H"
"13795",1981-05-05,1980,"FC Metz","FC Sochaux","4-2",4,2,"1",1,6,2,"H"
"13796",1981-05-05,1980,"US Valenciennes-Anzin","Tours FC","1-1",1,1,"1",1,2,0,"D"
"13797",1981-05-05,1980,"Angers SCO","OGC Nice","1-1",1,1,"1",1,2,0,"D"
"13798",1981-05-12,1980,"FC Nantes","AS Saint-Etienne","1-1",1,1,"1",1,2,0,"D"
"13799",1981-05-12,1980,"Girondins Bordeaux","US Valenciennes-Anzin","4-0",4,0,"1",1,4,4,"H"
"13800",1981-05-12,1980,"Tours FC","AS Monaco","0-1",0,1,"1",1,1,-1,"D"
"13801",1981-05-12,1980,"AS Nancy","Paris Saint-Germain","2-2",2,2,"1",1,4,0,"D"
"13802",1981-05-12,1980,"Olympique Lyon","RC Strasbourg","0-0",0,0,"1",1,0,0,"D"
"13803",1981-05-12,1980,"Nimes Olympique","FC Metz","3-3",3,3,"1",1,6,0,"D"
"13804",1981-05-12,1980,"FC Sochaux","Lille OSC","3-0",3,0,"1",1,3,3,"H"
"13805",1981-05-12,1980,"OGC Nice","AJ Auxerre","0-0",0,0,"1",1,0,0,"D"
"13806",1981-05-12,1980,"RC Lens","Stade Laval","3-0",3,0,"1",1,3,3,"H"
"13807",1981-05-12,1980,"SC Bastia","Angers SCO","3-0",3,0,"1",1,3,3,"H"
"13808",1981-05-22,1980,"FC Nantes","RC Lens","2-0",2,0,"1",1,2,2,"H"
"13809",1981-05-22,1980,"AS Saint-Etienne","Nimes Olympique","0-0",0,0,"1",1,0,0,"D"
"13810",1981-05-22,1980,"AS Monaco","Girondins Bordeaux","0-0",0,0,"1",1,0,0,"D"
"13811",1981-05-22,1980,"Paris Saint-Germain","Olympique Lyon","1-1",1,1,"1",1,2,0,"D"
"13812",1981-05-22,1980,"RC Strasbourg","SC Bastia","1-1",1,1,"1",1,2,0,"D"
"13813",1981-05-22,1980,"AJ Auxerre","AS Nancy","0-2",0,2,"1",1,2,-2,"D"
"13814",1981-05-22,1980,"FC Metz","Tours FC","2-3",2,3,"1",1,5,-1,"D"
"13815",1981-05-22,1980,"Stade Laval","FC Sochaux","0-0",0,0,"1",1,0,0,"D"
"13816",1981-05-22,1980,"US Valenciennes-Anzin","OGC Nice","1-0",1,0,"1",1,1,1,"H"
"13817",1981-05-22,1980,"Lille OSC","Angers SCO","4-0",4,0,"1",1,4,4,"H"
"13818",1981-05-26,1980,"FC Sochaux","AS Saint-Etienne","1-2",1,2,"1",1,3,-1,"D"
"13819",1981-05-29,1980,"Tours FC","AS Saint-Etienne","1-3",1,3,"1",1,4,-2,"D"
"13820",1981-05-29,1980,"FC Sochaux","FC Nantes","2-4",2,4,"1",1,6,-2,"D"
"13821",1981-05-29,1980,"Girondins Bordeaux","FC Metz","1-1",1,1,"1",1,2,0,"D"
"13822",1981-05-29,1980,"OGC Nice","AS Monaco","2-1",2,1,"1",1,3,1,"H"
"13823",1981-05-29,1980,"RC Lens","Paris Saint-Germain","2-3",2,3,"1",1,5,-1,"D"
"13824",1981-05-29,1980,"Olympique Lyon","AJ Auxerre","1-3",1,3,"1",1,4,-2,"D"
"13825",1981-05-29,1980,"Angers SCO","RC Strasbourg","0-0",0,0,"1",1,0,0,"D"
"13826",1981-05-29,1980,"AS Nancy","US Valenciennes-Anzin","7-1",7,1,"1",1,8,6,"H"
"13827",1981-05-29,1980,"SC Bastia","Lille OSC","5-1",5,1,"1",1,6,4,"H"
"13828",1981-05-29,1980,"Nimes Olympique","Stade Laval","2-2",2,2,"1",1,4,0,"D"
"13829",1981-06-02,1980,"AS Saint-Etienne","Girondins Bordeaux","2-1",2,1,"1",1,3,1,"H"
"13830",1981-06-02,1980,"FC Nantes","Nimes Olympique","1-1",1,1,"1",1,2,0,"D"
"13831",1981-06-02,1980,"AS Monaco","AS Nancy","1-0",1,0,"1",1,1,1,"H"
"13832",1981-06-02,1980,"Paris Saint-Germain","Angers SCO","2-2",2,2,"1",1,4,0,"D"
"13833",1981-06-02,1980,"US Valenciennes-Anzin","Olympique Lyon","2-1",2,1,"1",1,3,1,"H"
"13834",1981-06-02,1980,"RC Strasbourg","Lille OSC","3-2",3,2,"1",1,5,1,"H"
"13835",1981-06-02,1980,"FC Metz","OGC Nice","0-1",0,1,"1",1,1,-1,"D"
"13836",1981-06-02,1980,"AJ Auxerre","SC Bastia","0-0",0,0,"1",1,0,0,"D"
"13837",1981-06-02,1980,"RC Lens","FC Sochaux","5-1",5,1,"1",1,6,4,"H"
"13838",1981-06-02,1980,"Stade Laval","Tours FC","2-0",2,0,"1",1,2,2,"H"
"13839",1981-07-24,1981,"Olympique Lyon","AS Nancy","2-0",2,0,"1",1,2,2,"H"
"13840",1981-07-24,1981,"Girondins Bordeaux","FC Nantes","3-2",3,2,"1",1,5,1,"H"
"13841",1981-07-24,1981,"Tours FC","Paris Saint-Germain","1-2",1,2,"1",1,3,-1,"D"
"13842",1981-07-24,1981,"OGC Nice","US Valenciennes-Anzin","1-2",1,2,"1",1,3,-1,"D"
"13843",1981-07-24,1981,"RC Strasbourg","AS Monaco","0-1",0,1,"1",1,1,-1,"D"
"13844",1981-07-24,1981,"SC Bastia","RC Lens","1-0",1,0,"1",1,1,1,"H"
"13845",1981-07-24,1981,"Stade Laval","FC Sochaux","1-1",1,1,"1",1,2,0,"D"
"13846",1981-07-24,1981,"Lille OSC","Stade Brest","1-1",1,1,"1",1,2,0,"D"
"13847",1981-07-24,1981,"FC Metz","AS Saint-Etienne","0-0",0,0,"1",1,0,0,"D"
"13848",1981-07-24,1981,"Montpellier La Paillade SC","AJ Auxerre","0-0",0,0,"1",1,0,0,"D"
"13849",1981-07-28,1981,"US Valenciennes-Anzin","Olympique Lyon","0-1",0,1,"1",1,1,-1,"D"
"13850",1981-07-28,1981,"Paris Saint-Germain","Stade Laval","2-1",2,1,"1",1,3,1,"H"
"13851",1981-07-28,1981,"AS Saint-Etienne","AS Monaco","2-0",2,0,"1",1,2,2,"H"
"13852",1981-07-28,1981,"OGC Nice","Girondins Bordeaux","2-2",2,2,"1",1,4,0,"D"
"13853",1981-07-28,1981,"FC Sochaux","FC Metz","2-1",2,1,"1",1,3,1,"H"
"13854",1981-07-28,1981,"AJ Auxerre","Lille OSC","1-2",1,2,"1",1,3,-1,"D"
"13855",1981-07-28,1981,"Stade Brest","Tours FC","2-1",2,1,"1",1,3,1,"H"
"13856",1981-07-28,1981,"FC Nantes","SC Bastia","1-0",1,0,"1",1,1,1,"H"
"13857",1981-07-28,1981,"AS Nancy","Montpellier La Paillade SC","3-2",3,2,"1",1,5,1,"H"
"13858",1981-07-28,1981,"RC Lens","RC Strasbourg","0-1",0,1,"1",1,1,-1,"D"
"13859",1981-08-04,1981,"Olympique Lyon","OGC Nice","1-0",1,0,"1",1,1,1,"H"
"13860",1981-08-04,1981,"Girondins Bordeaux","US Valenciennes-Anzin","2-0",2,0,"1",1,2,2,"H"
"13861",1981-08-04,1981,"AS Monaco","FC Sochaux","2-3",2,3,"1",1,5,-1,"D"
"13862",1981-08-04,1981,"FC Metz","Paris Saint-Germain","1-1",1,1,"1",1,2,0,"D"
"13863",1981-08-04,1981,"SC Bastia","Stade Brest","3-1",3,1,"1",1,4,2,"H"
"13864",1981-08-04,1981,"RC Strasbourg","AS Saint-Etienne","2-0",2,0,"1",1,2,2,"H"
"13865",1981-08-04,1981,"Lille OSC","AS Nancy","1-2",1,2,"1",1,3,-1,"D"
"13866",1981-08-04,1981,"Stade Laval","AJ Auxerre","2-0",2,0,"1",1,2,2,"H"
"13867",1981-08-04,1981,"Montpellier La Paillade SC","FC Nantes","2-0",2,0,"1",1,2,2,"H"
"13868",1981-08-04,1981,"Tours FC","RC Lens","1-0",1,0,"1",1,1,1,"H"
"13869",1981-08-07,1981,"Olympique Lyon","Tours FC","2-1",2,1,"1",1,3,1,"H"
"13870",1981-08-07,1981,"FC Sochaux","AS Saint-Etienne","2-1",2,1,"1",1,3,1,"H"
"13871",1981-08-07,1981,"AS Nancy","Girondins Bordeaux","0-0",0,0,"1",1,0,0,"D"
"13872",1981-08-07,1981,"AJ Auxerre","SC Bastia","2-2",2,2,"1",1,4,0,"D"
"13873",1981-08-07,1981,"Paris Saint-Germain","AS Monaco","1-2",1,2,"1",1,3,-1,"D"
"13874",1981-08-07,1981,"US Valenciennes-Anzin","Lille OSC","4-0",4,0,"1",1,4,4,"H"
"13875",1981-08-07,1981,"Stade Brest","Stade Laval","2-2",2,2,"1",1,4,0,"D"
"13876",1981-08-07,1981,"FC Nantes","RC Strasbourg","2-0",2,0,"1",1,2,2,"H"
"13877",1981-08-07,1981,"OGC Nice","Montpellier La Paillade SC","1-0",1,0,"1",1,1,1,"H"
"13878",1981-08-07,1981,"RC Lens","FC Metz","2-0",2,0,"1",1,2,2,"H"
"13879",1981-08-11,1981,"RC Strasbourg","FC Sochaux","2-3",2,3,"1",1,5,-1,"D"
"13880",1981-08-11,1981,"Girondins Bordeaux","Olympique Lyon","3-0",3,0,"1",1,3,3,"H"
"13881",1981-08-11,1981,"AS Monaco","AJ Auxerre","7-1",7,1,"1",1,8,6,"H"
"13882",1981-08-11,1981,"SC Bastia","AS Nancy","3-3",3,3,"1",1,6,0,"D"
"13883",1981-08-11,1981,"Stade Laval","RC Lens","1-0",1,0,"1",1,1,1,"H"
"13884",1981-08-11,1981,"AS Saint-Etienne","Paris Saint-Germain","0-0",0,0,"1",1,0,0,"D"
"13885",1981-08-11,1981,"Montpellier La Paillade SC","US Valenciennes-Anzin","0-0",0,0,"1",1,0,0,"D"
"13886",1981-08-11,1981,"Lille OSC","OGC Nice","5-0",5,0,"1",1,5,5,"H"
"13887",1981-08-11,1981,"Tours FC","FC Nantes","1-1",1,1,"1",1,2,0,"D"
"13888",1981-08-11,1981,"FC Metz","Stade Brest","1-1",1,1,"1",1,2,0,"D"
"13889",1981-08-21,1981,"Olympique Lyon","Montpellier La Paillade SC","2-0",2,0,"1",1,2,2,"H"
"13890",1981-08-21,1981,"Girondins Bordeaux","RC Strasbourg","1-1",1,1,"1",1,2,0,"D"
"13891",1981-08-21,1981,"Paris Saint-Germain","FC Sochaux","1-0",1,0,"1",1,1,1,"H"
"13892",1981-08-21,1981,"US Valenciennes-Anzin","SC Bastia","1-2",1,2,"1",1,3,-1,"D"
"13893",1981-08-21,1981,"OGC Nice","Stade Laval","1-2",1,2,"1",1,3,-1,"D"
"13894",1981-08-21,1981,"AS Nancy","Tours FC","2-0",2,0,"1",1,2,2,"H"
"13895",1981-08-21,1981,"Stade Brest","AS Monaco","2-2",2,2,"1",1,4,0,"D"
"13896",1981-08-21,1981,"FC Nantes","Lille OSC","1-2",1,2,"1",1,3,-1,"D"
"13897",1981-08-21,1981,"RC Lens","AS Saint-Etienne","2-5",2,5,"1",1,7,-3,"D"
"13898",1981-08-21,1981,"AJ Auxerre","FC Metz","0-0",0,0,"1",1,0,0,"D"
"13899",1981-08-28,1981,"Montpellier La Paillade SC","Girondins Bordeaux","1-2",1,2,"1",1,3,-1,"D"
"13900",1981-08-28,1981,"Stade Laval","AS Nancy","2-1",2,1,"1",1,3,1,"H"
"13901",1981-08-28,1981,"FC Sochaux","Stade Brest","0-0",0,0,"1",1,0,0,"D"
"13902",1981-08-28,1981,"Lille OSC","Olympique Lyon","1-0",1,0,"1",1,1,1,"H"
"13903",1981-08-28,1981,"AS Monaco","RC Lens","4-1",4,1,"1",1,5,3,"H"
"13904",1981-08-28,1981,"SC Bastia","OGC Nice","1-1",1,1,"1",1,2,0,"D"
"13905",1981-08-28,1981,"RC Strasbourg","Paris Saint-Germain","2-0",2,0,"1",1,2,2,"H"
"13906",1981-08-28,1981,"FC Metz","FC Nantes","0-0",0,0,"1",1,0,0,"D"
"13907",1981-08-28,1981,"Tours FC","US Valenciennes-Anzin","2-1",2,1,"1",1,3,1,"H"
"13908",1981-09-01,1981,"Girondins Bordeaux","Lille OSC","1-1",1,1,"1",1,2,0,"D"
"13909",1981-09-01,1981,"Olympique Lyon","SC Bastia","4-1",4,1,"1",1,5,3,"H"
"13910",1981-09-01,1981,"AS Nancy","FC Sochaux","0-0",0,0,"1",1,0,0,"D"
"13911",1981-09-01,1981,"Stade Brest","AS Saint-Etienne","1-1",1,1,"1",1,2,0,"D"
"13912",1981-09-01,1981,"US Valenciennes-Anzin","Stade Laval","3-1",3,1,"1",1,4,2,"H"
"13913",1981-09-01,1981,"FC Nantes","AS Monaco","3-1",3,1,"1",1,4,2,"H"
"13914",1981-09-01,1981,"RC Lens","Paris Saint-Germain","1-1",1,1,"1",1,2,0,"D"
"13915",1981-09-01,1981,"AJ Auxerre","RC Strasbourg","3-0",3,0,"1",1,3,3,"H"
"13916",1981-09-01,1981,"OGC Nice","Tours FC","0-1",0,1,"1",1,1,-1,"D"
"13917",1981-09-01,1981,"Montpellier La Paillade SC","FC Metz","1-1",1,1,"1",1,2,0,"D"
"13918",1981-09-11,1981,"Lille OSC","Montpellier La Paillade SC","6-1",6,1,"1",1,7,5,"H"
"13919",1981-09-12,1981,"SC Bastia","Girondins Bordeaux","4-4",4,4,"1",1,8,0,"D"
"13920",1981-09-12,1981,"FC Sochaux","RC Lens","1-0",1,0,"1",1,1,1,"H"
"13921",1981-09-12,1981,"AS Saint-Etienne","Olympique Lyon","4-0",4,0,"1",1,4,4,"H"
"13922",1981-09-12,1981,"AS Monaco","OGC Nice","1-0",1,0,"1",1,1,1,"H"
"13923",1981-09-12,1981,"Stade Laval","FC Nantes","1-1",1,1,"1",1,2,0,"D"
"13924",1981-09-12,1981,"FC Metz","AS Nancy","1-2",1,2,"1",1,3,-1,"D"
"13925",1981-09-12,1981,"RC Strasbourg","US Valenciennes-Anzin","4-0",4,0,"1",1,4,4,"H"
"13926",1981-09-12,1981,"Paris Saint-Germain","Stade Brest","1-2",1,2,"1",1,3,-1,"D"
"13927",1981-09-12,1981,"Tours FC","AJ Auxerre","2-0",2,0,"1",1,2,2,"H"
"13928",1981-09-17,1981,"AS Saint-Etienne","AJ Auxerre","3-0",3,0,"1",1,3,3,"H"
"13929",1981-09-22,1981,"Girondins Bordeaux","Tours FC","2-1",2,1,"1",1,3,1,"H"
"13930",1981-09-22,1981,"FC Nantes","FC Sochaux","1-1",1,1,"1",1,2,0,"D"
"13931",1981-09-22,1981,"Lille OSC","AS Saint-Etienne","3-4",3,4,"1",1,7,-1,"D"
"13932",1981-09-22,1981,"US Valenciennes-Anzin","AS Monaco","0-0",0,0,"1",1,0,0,"D"
"13933",1981-09-22,1981,"Stade Brest","RC Lens","2-0",2,0,"1",1,2,2,"H"
"13934",1981-09-22,1981,"Montpellier La Paillade SC","SC Bastia","3-2",3,2,"1",1,5,1,"H"
"13935",1981-09-22,1981,"AJ Auxerre","Paris Saint-Germain","1-0",1,0,"1",1,1,1,"H"
"13936",1981-09-22,1981,"OGC Nice","FC Metz","3-1",3,1,"1",1,4,2,"H"
"13937",1981-09-25,1981,"FC Sochaux","OGC Nice","2-1",2,1,"1",1,3,1,"H"
"13938",1981-09-25,1981,"Stade Laval","Girondins Bordeaux","1-0",1,0,"1",1,1,1,"H"
"13939",1981-09-25,1981,"AS Monaco","AS Nancy","5-1",5,1,"1",1,6,4,"H"
"13940",1981-09-25,1981,"AS Saint-Etienne","FC Nantes","1-0",1,0,"1",1,1,1,"H"
"13941",1981-09-25,1981,"RC Strasbourg","Stade Brest","2-3",2,3,"1",1,5,-1,"D"
"13942",1981-09-25,1981,"SC Bastia","Lille OSC","3-2",3,2,"1",1,5,1,"H"
"13943",1981-09-25,1981,"Paris Saint-Germain","Olympique Lyon","2-0",2,0,"1",1,2,2,"H"
"13944",1981-09-25,1981,"Tours FC","Montpellier La Paillade SC","1-0",1,0,"1",1,1,1,"H"
"13945",1981-09-25,1981,"FC Metz","US Valenciennes-Anzin","1-1",1,1,"1",1,2,0,"D"
"13946",1981-09-25,1981,"RC Lens","AJ Auxerre","5-2",5,2,"1",1,7,3,"H"
"13947",1981-10-02,1981,"AS Nancy","Paris Saint-Germain","0-0",0,0,"1",1,0,0,"D"
"13948",1981-10-03,1981,"Girondins Bordeaux","FC Metz","2-1",2,1,"1",1,3,1,"H"
"13949",1981-10-03,1981,"Olympique Lyon","AS Monaco","0-2",0,2,"1",1,2,-2,"D"
"13950",1981-10-03,1981,"US Valenciennes-Anzin","FC Sochaux","3-0",3,0,"1",1,3,3,"H"
"13951",1981-10-03,1981,"AJ Auxerre","Stade Brest","1-1",1,1,"1",1,2,0,"D"
"13952",1981-10-03,1981,"Lille OSC","Tours FC","2-0",2,0,"1",1,2,2,"H"
"13953",1981-10-03,1981,"SC Bastia","RC Strasbourg","1-0",1,0,"1",1,1,1,"H"
"13954",1981-10-03,1981,"Montpellier La Paillade SC","Stade Laval","2-1",2,1,"1",1,3,1,"H"
"13955",1981-10-03,1981,"FC Nantes","RC Lens","4-0",4,0,"1",1,4,4,"H"
"13956",1981-10-06,1981,"AS Monaco","Girondins Bordeaux","0-1",0,1,"1",1,1,-1,"D"
"13957",1981-10-06,1981,"FC Sochaux","AJ Auxerre","5-0",5,0,"1",1,5,5,"H"
"13958",1981-10-06,1981,"AS Saint-Etienne","AS Nancy","2-1",2,1,"1",1,3,1,"H"
"13959",1981-10-06,1981,"Stade Laval","Lille OSC","2-0",2,0,"1",1,2,2,"H"
"13960",1981-10-06,1981,"Stade Brest","FC Nantes","1-2",1,2,"1",1,3,-1,"D"
"13961",1981-10-06,1981,"Paris Saint-Germain","US Valenciennes-Anzin","4-0",4,0,"1",1,4,4,"H"
"13962",1981-10-06,1981,"Tours FC","SC Bastia","4-0",4,0,"1",1,4,4,"H"
"13963",1981-10-06,1981,"FC Metz","Olympique Lyon","1-0",1,0,"1",1,1,1,"H"
"13964",1981-10-06,1981,"RC Strasbourg","Montpellier La Paillade SC","0-0",0,0,"1",1,0,0,"D"
"13965",1981-10-06,1981,"RC Lens","OGC Nice","1-0",1,0,"1",1,1,1,"H"
"13966",1981-10-16,1981,"SC Bastia","Stade Laval","2-2",2,2,"1",1,4,0,"D"
"13967",1981-10-17,1981,"Girondins Bordeaux","AS Saint-Etienne","1-1",1,1,"1",1,2,0,"D"
"13968",1981-10-17,1981,"Montpellier La Paillade SC","AS Monaco","1-2",1,2,"1",1,3,-1,"D"
"13969",1981-10-17,1981,"Olympique Lyon","FC Sochaux","1-0",1,0,"1",1,1,1,"H"
"13970",1981-10-17,1981,"FC Nantes","AJ Auxerre","2-0",2,0,"1",1,2,2,"H"
"13971",1981-10-17,1981,"Lille OSC","RC Strasbourg","1-1",1,1,"1",1,2,0,"D"
"13972",1981-10-17,1981,"OGC Nice","Paris Saint-Germain","2-2",2,2,"1",1,4,0,"D"
"13973",1981-10-17,1981,"AS Nancy","Stade Brest","5-0",5,0,"1",1,5,5,"H"
"13974",1981-10-17,1981,"Tours FC","FC Metz","2-2",2,2,"1",1,4,0,"D"
"13975",1981-10-17,1981,"US Valenciennes-Anzin","RC Lens","1-1",1,1,"1",1,2,0,"D"
"13976",1981-10-20,1981,"Olympique Lyon","Stade Laval","0-0",0,0,"1",1,0,0,"D"
"13977",1981-10-23,1981,"AS Nancy","RC Strasbourg","3-0",3,0,"1",1,3,3,"H"
"13978",1981-10-27,1981,"AS Monaco","Lille OSC","4-0",4,0,"1",1,4,4,"H"
"13979",1981-10-27,1981,"AS Saint-Etienne","Montpellier La Paillade SC","4-0",4,0,"1",1,4,4,"H"
"13980",1981-10-27,1981,"FC Sochaux","Girondins Bordeaux","2-1",2,1,"1",1,3,1,"H"
"13981",1981-10-27,1981,"Stade Laval","Tours FC","0-0",0,0,"1",1,0,0,"D"
"13982",1981-10-27,1981,"Paris Saint-Germain","FC Nantes","4-0",4,0,"1",1,4,4,"H"
"13983",1981-10-27,1981,"RC Lens","AS Nancy","2-2",2,2,"1",1,4,0,"D"
"13984",1981-10-27,1981,"Stade Brest","US Valenciennes-Anzin","3-0",3,0,"1",1,3,3,"H"
"13985",1981-10-27,1981,"RC Strasbourg","Olympique Lyon","2-0",2,0,"1",1,2,2,"H"
"13986",1981-10-27,1981,"FC Metz","SC Bastia","2-0",2,0,"1",1,2,2,"H"
"13987",1981-10-27,1981,"AJ Auxerre","OGC Nice","0-0",0,0,"1",1,0,0,"D"
"13988",1981-10-30,1981,"Girondins Bordeaux","Paris Saint-Germain","2-0",2,0,"1",1,2,2,"H"
"13989",1981-10-30,1981,"Montpellier La Paillade SC","FC Sochaux","1-3",1,3,"1",1,4,-2,"D"
"13990",1981-10-30,1981,"Stade Laval","AS Saint-Etienne","0-0",0,0,"1",1,0,0,"D"
"13991",1981-10-30,1981,"SC Bastia","AS Monaco","1-0",1,0,"1",1,1,1,"H"
"13992",1981-10-30,1981,"AS Nancy","FC Nantes","1-0",1,0,"1",1,1,1,"H"
"13993",1981-10-30,1981,"OGC Nice","Stade Brest","2-4",2,4,"1",1,6,-2,"D"
"13994",1981-10-30,1981,"Lille OSC","FC Metz","1-0",1,0,"1",1,1,1,"H"
"13995",1981-10-30,1981,"Tours FC","RC Strasbourg","2-1",2,1,"1",1,3,1,"H"
"13996",1981-10-30,1981,"Olympique Lyon","RC Lens","3-0",3,0,"1",1,3,3,"H"
"13997",1981-10-30,1981,"US Valenciennes-Anzin","AJ Auxerre","3-1",3,1,"1",1,4,2,"H"
"13998",1981-11-03,1981,"OGC Nice","AS Saint-Etienne","1-3",1,3,"1",1,4,-2,"D"
"13999",1981-11-06,1981,"FC Metz","Stade Laval","1-1",1,1,"1",1,2,0,"D"
"14000",1981-11-06,1981,"AJ Auxerre","AS Nancy","1-0",1,0,"1",1,1,1,"H"
"14001",1981-11-07,1981,"AS Saint-Etienne","SC Bastia","3-0",3,0,"1",1,3,3,"H"
"14002",1981-11-07,1981,"RC Lens","Girondins Bordeaux","1-2",1,2,"1",1,3,-1,"D"
"14003",1981-11-07,1981,"FC Sochaux","Lille OSC","1-1",1,1,"1",1,2,0,"D"
"14004",1981-11-07,1981,"AS Monaco","Tours FC","3-1",3,1,"1",1,4,2,"H"
"14005",1981-11-07,1981,"Stade Brest","Olympique Lyon","1-0",1,0,"1",1,1,1,"H"
"14006",1981-11-07,1981,"Paris Saint-Germain","Montpellier La Paillade SC","1-0",1,0,"1",1,1,1,"H"
"14007",1981-11-07,1981,"FC Nantes","US Valenciennes-Anzin","4-1",4,1,"1",1,5,3,"H"
"14008",1981-11-07,1981,"RC Strasbourg","OGC Nice","1-1",1,1,"1",1,2,0,"D"
"14009",1981-11-10,1981,"Tours FC","AS Saint-Etienne","3-4",3,4,"1",1,7,-1,"D"
"14010",1981-11-10,1981,"Girondins Bordeaux","Stade Brest","1-1",1,1,"1",1,2,0,"D"
"14011",1981-11-10,1981,"Stade Laval","AS Monaco","2-3",2,3,"1",1,5,-1,"D"
"14012",1981-11-10,1981,"SC Bastia","FC Sochaux","1-1",1,1,"1",1,2,0,"D"
"14013",1981-11-10,1981,"Lille OSC","Paris Saint-Germain","2-1",2,1,"1",1,3,1,"H"
"14014",1981-11-10,1981,"US Valenciennes-Anzin","AS Nancy","2-1",2,1,"1",1,3,1,"H"
"14015",1981-11-10,1981,"OGC Nice","FC Nantes","3-0",3,0,"1",1,3,3,"H"
"14016",1981-11-10,1981,"Olympique Lyon","AJ Auxerre","0-1",0,1,"1",1,1,-1,"D"
"14017",1981-11-10,1981,"FC Metz","RC Strasbourg","0-0",0,0,"1",1,0,0,"D"
"14018",1981-11-10,1981,"Montpellier La Paillade SC","RC Lens","1-1",1,1,"1",1,2,0,"D"
"14019",1981-11-21,1981,"AS Saint-Etienne","US Valenciennes-Anzin","5-1",5,1,"1",1,6,4,"H"
"14020",1981-11-21,1981,"AS Monaco","FC Metz","2-1",2,1,"1",1,3,1,"H"
"14021",1981-11-21,1981,"FC Sochaux","Tours FC","4-1",4,1,"1",1,5,3,"H"
"14022",1981-11-21,1981,"AJ Auxerre","Girondins Bordeaux","3-2",3,2,"1",1,5,1,"H"
"14023",1981-11-21,1981,"RC Strasbourg","Stade Laval","1-2",1,2,"1",1,3,-1,"D"
"14024",1981-11-21,1981,"Stade Brest","Montpellier La Paillade SC","0-1",0,1,"1",1,1,-1,"D"
"14025",1981-11-21,1981,"AS Nancy","OGC Nice","4-0",4,0,"1",1,4,4,"H"
"14026",1981-11-21,1981,"RC Lens","Lille OSC","1-0",1,0,"1",1,1,1,"H"
"14027",1981-11-21,1981,"FC Nantes","Olympique Lyon","0-0",0,0,"1",1,0,0,"D"
"14028",1981-11-24,1981,"Paris Saint-Germain","SC Bastia","3-1",3,1,"1",1,4,2,"H"
"14029",1981-11-28,1981,"AS Monaco","AS Saint-Etienne","1-0",1,0,"1",1,1,1,"H"
"14030",1981-11-28,1981,"Stade Laval","Paris Saint-Germain","0-3",0,3,"1",1,3,-3,"D"
"14031",1981-11-28,1981,"Tours FC","Stade Brest","5-0",5,0,"1",1,5,5,"H"
"14032",1981-11-28,1981,"Lille OSC","AJ Auxerre","1-1",1,1,"1",1,2,0,"D"
"14033",1981-11-28,1981,"SC Bastia","FC Nantes","1-0",1,0,"1",1,1,1,"H"
"14034",1981-11-28,1981,"RC Strasbourg","RC Lens","2-1",2,1,"1",1,3,1,"H"
"14035",1981-11-29,1981,"FC Metz","FC Sochaux","1-1",1,1,"1",1,2,0,"D"
"14036",1981-11-29,1981,"Girondins Bordeaux","OGC Nice","1-0",1,0,"1",1,1,1,"H"
"14037",1981-11-29,1981,"Montpellier La Paillade SC","AS Nancy","3-0",3,0,"1",1,3,3,"H"
"14038",1981-11-29,1981,"Olympique Lyon","US Valenciennes-Anzin","3-0",3,0,"1",1,3,3,"H"
"14039",1981-12-12,1981,"AJ Auxerre","Stade Laval","0-1",0,1,"1",1,1,-1,"D"
"14040",1981-12-12,1981,"Stade Brest","SC Bastia","2-0",2,0,"1",1,2,2,"H"
"14041",1981-12-12,1981,"FC Nantes","Montpellier La Paillade SC","7-0",7,0,"1",1,7,7,"H"
"14042",1981-12-12,1981,"OGC Nice","Olympique Lyon","0-0",0,0,"1",1,0,0,"D"
"14043",1981-12-12,1981,"RC Lens","Tours FC","4-2",4,2,"1",1,6,2,"H"
"14044",1981-12-13,1981,"AS Saint-Etienne","RC Strasbourg","2-0",2,0,"1",1,2,2,"H"
"14045",1981-12-13,1981,"FC Sochaux","AS Monaco","1-4",1,4,"1",1,5,-3,"D"
"14046",1981-12-13,1981,"US Valenciennes-Anzin","Girondins Bordeaux","0-1",0,1,"1",1,1,-1,"D"
"14047",1981-12-13,1981,"Paris Saint-Germain","FC Metz","2-0",2,0,"1",1,2,2,"H"
"14048",1981-12-13,1981,"AS Nancy","Lille OSC","1-1",1,1,"1",1,2,0,"D"
"14049",1981-12-19,1981,"AS Monaco","Paris Saint-Germain","0-0",0,0,"1",1,0,0,"D"
"14050",1981-12-19,1981,"Stade Laval","Stade Brest","1-0",1,0,"1",1,1,1,"H"
"14051",1981-12-19,1981,"Lille OSC","US Valenciennes-Anzin","2-0",2,0,"1",1,2,2,"H"
"14052",1981-12-19,1981,"Tours FC","Olympique Lyon","3-0",3,0,"1",1,3,3,"H"
"14053",1981-12-19,1981,"SC Bastia","AJ Auxerre","0-1",0,1,"1",1,1,-1,"D"
"14054",1981-12-20,1981,"AS Saint-Etienne","FC Sochaux","0-1",0,1,"1",1,1,-1,"D"
"14055",1981-12-20,1981,"Girondins Bordeaux","AS Nancy","1-1",1,1,"1",1,2,0,"D"
"14056",1981-12-20,1981,"Montpellier La Paillade SC","OGC Nice","2-1",2,1,"1",1,3,1,"H"
"14057",1982-01-16,1981,"Paris Saint-Germain","AS Saint-Etienne","0-0",0,0,"1",1,0,0,"D"
"14058",1982-01-16,1981,"AJ Auxerre","AS Monaco","2-0",2,0,"1",1,2,2,"H"
"14059",1982-01-16,1981,"RC Lens","Stade Laval","0-1",0,1,"1",1,1,-1,"D"
"14060",1982-01-16,1981,"Brest Armorique FC","FC Metz","2-0",2,0,"1",1,2,2,"H"
"14061",1982-01-16,1981,"OGC Nice","Lille OSC","2-0",2,0,"1",1,2,2,"H"
"14062",1982-01-16,1981,"FC Nantes","Tours FC","3-1",3,1,"1",1,4,2,"H"
"14063",1982-01-17,1981,"Olympique Lyon","Girondins Bordeaux","0-1",0,1,"1",1,1,-1,"D"
"14064",1982-01-23,1981,"AS Monaco","Brest Armorique FC","0-0",0,0,"1",1,0,0,"D"
"14065",1982-01-23,1981,"Stade Laval","OGC Nice","5-0",5,0,"1",1,5,5,"H"
"14066",1982-01-23,1981,"Lille OSC","FC Nantes","1-0",1,0,"1",1,1,1,"H"
"14067",1982-01-23,1981,"Tours FC","AS Nancy","1-1",1,1,"1",1,2,0,"D"
"14068",1982-01-23,1981,"SC Bastia","US Valenciennes-Anzin","1-0",1,0,"1",1,1,1,"H"
"14069",1982-01-24,1981,"AS Saint-Etienne","RC Lens","3-1",3,1,"1",1,4,2,"H"
"14070",1982-01-24,1981,"Montpellier La Paillade SC","Olympique Lyon","0-0",0,0,"1",1,0,0,"D"
"14071",1982-01-27,1981,"US Valenciennes-Anzin","Montpellier La Paillade SC","1-0",1,0,"1",1,1,1,"H"
"14072",1982-01-30,1981,"AJ Auxerre","AS Saint-Etienne","3-1",3,1,"1",1,4,2,"H"
"14073",1982-01-30,1981,"RC Lens","AS Monaco","0-0",0,0,"1",1,0,0,"D"
"14074",1982-01-30,1981,"Paris Saint-Germain","RC Strasbourg","2-1",2,1,"1",1,3,1,"H"
"14075",1982-01-30,1981,"Brest Armorique FC","FC Sochaux","2-1",2,1,"1",1,3,1,"H"
"14076",1982-01-30,1981,"FC Nantes","FC Metz","2-0",2,0,"1",1,2,2,"H"
"14077",1982-01-30,1981,"OGC Nice","SC Bastia","1-1",1,1,"1",1,2,0,"D"
"14078",1982-01-31,1981,"Girondins Bordeaux","Montpellier La Paillade SC","4-1",4,1,"1",1,5,3,"H"
"14079",1982-01-31,1981,"AS Nancy","Stade Laval","2-2",2,2,"1",1,4,0,"D"
"14080",1982-01-31,1981,"Olympique Lyon","Lille OSC","4-1",4,1,"1",1,5,3,"H"
"14081",1982-01-31,1981,"US Valenciennes-Anzin","Tours FC","1-1",1,1,"1",1,2,0,"D"
"14082",1982-02-03,1981,"RC Strasbourg","Girondins Bordeaux","1-0",1,0,"1",1,1,1,"H"
"14083",1982-02-06,1981,"Lille OSC","Girondins Bordeaux","0-1",0,1,"1",1,1,-1,"D"
"14084",1982-02-06,1981,"AS Monaco","FC Nantes","1-0",1,0,"1",1,1,1,"H"
"14085",1982-02-06,1981,"Stade Laval","US Valenciennes-Anzin","0-0",0,0,"1",1,0,0,"D"
"14086",1982-02-06,1981,"Paris Saint-Germain","RC Lens","2-1",2,1,"1",1,3,1,"H"
"14087",1982-02-06,1981,"FC Sochaux","AS Nancy","1-0",1,0,"1",1,1,1,"H"
"14088",1982-02-06,1981,"Tours FC","OGC Nice","2-1",2,1,"1",1,3,1,"H"
"14089",1982-02-06,1981,"SC Bastia","Olympique Lyon","1-0",1,0,"1",1,1,1,"H"
"14090",1982-02-07,1981,"AS Saint-Etienne","Brest Armorique FC","1-0",1,0,"1",1,1,1,"H"
"14091",1982-02-07,1981,"RC Strasbourg","AJ Auxerre","2-2",2,2,"1",1,4,0,"D"
"14092",1982-02-07,1981,"FC Metz","Montpellier La Paillade SC","4-0",4,0,"1",1,4,4,"H"
"14093",1982-02-10,1981,"FC Sochaux","RC Strasbourg","2-2",2,2,"1",1,4,0,"D"
"14094",1982-02-10,1981,"AS Nancy","SC Bastia","2-1",2,1,"1",1,3,1,"H"
"14095",1982-02-17,1981,"FC Metz","AJ Auxerre","1-0",1,0,"1",1,1,1,"H"
"14096",1982-02-17,1981,"FC Sochaux","Paris Saint-Germain","2-1",2,1,"1",1,3,1,"H"
"14097",1982-02-19,1981,"OGC Nice","AS Monaco","0-2",0,2,"1",1,2,-2,"D"
"14098",1982-02-19,1981,"Montpellier La Paillade SC","Lille OSC","2-1",2,1,"1",1,3,1,"H"
"14099",1982-02-20,1981,"Olympique Lyon","AS Saint-Etienne","0-1",0,1,"1",1,1,-1,"D"
"14100",1982-02-20,1981,"Girondins Bordeaux","SC Bastia","4-0",4,0,"1",1,4,4,"H"
"14101",1982-02-20,1981,"RC Lens","FC Sochaux","3-2",3,2,"1",1,5,1,"H"
"14102",1982-02-20,1981,"Brest Armorique FC","Paris Saint-Germain","0-3",0,3,"1",1,3,-3,"D"
"14103",1982-02-20,1981,"FC Nantes","Stade Laval","1-0",1,0,"1",1,1,1,"H"
"14104",1982-02-20,1981,"AS Nancy","FC Metz","2-2",2,2,"1",1,4,0,"D"
"14105",1982-02-20,1981,"AJ Auxerre","Tours FC","1-2",1,2,"1",1,3,-1,"D"
"14106",1982-02-20,1981,"US Valenciennes-Anzin","RC Strasbourg","0-0",0,0,"1",1,0,0,"D"
"14107",1982-02-24,1981,"FC Metz","RC Lens","0-0",0,0,"1",1,0,0,"D"
"14108",1982-02-27,1981,"Tours FC","Girondins Bordeaux","1-2",1,2,"1",1,3,-1,"D"
"14109",1982-02-27,1981,"AS Monaco","US Valenciennes-Anzin","3-1",3,1,"1",1,4,2,"H"
"14110",1982-02-27,1981,"Paris Saint-Germain","AJ Auxerre","2-1",2,1,"1",1,3,1,"H"
"14111",1982-02-27,1981,"Stade Laval","Olympique Lyon","3-1",3,1,"1",1,4,2,"H"
"14112",1982-02-27,1981,"RC Lens","Brest Armorique FC","4-0",4,0,"1",1,4,4,"H"
"14113",1982-02-27,1981,"SC Bastia","Montpellier La Paillade SC","1-0",1,0,"1",1,1,1,"H"
"14114",1982-02-28,1981,"AS Saint-Etienne","Lille OSC","1-1",1,1,"1",1,2,0,"D"
"14115",1982-02-28,1981,"FC Sochaux","FC Nantes","2-1",2,1,"1",1,3,1,"H"
"14116",1982-02-28,1981,"FC Metz","OGC Nice","1-0",1,0,"1",1,1,1,"H"
"14117",1982-03-03,1981,"AS Nancy","AS Monaco","0-3",0,3,"1",1,3,-3,"D"
"14118",1982-03-03,1981,"Girondins Bordeaux","Stade Laval","0-0",0,0,"1",1,0,0,"D"
"14119",1982-03-03,1981,"FC Nantes","AS Saint-Etienne","3-0",3,0,"1",1,3,3,"H"
"14120",1982-03-03,1981,"Olympique Lyon","Paris Saint-Germain","2-3",2,3,"1",1,5,-1,"D"
"14121",1982-03-03,1981,"OGC Nice","FC Sochaux","1-0",1,0,"1",1,1,1,"H"
"14122",1982-03-03,1981,"Montpellier La Paillade SC","Tours FC","1-3",1,3,"1",1,4,-2,"D"
"14123",1982-03-03,1981,"Lille OSC","SC Bastia","4-0",4,0,"1",1,4,4,"H"
"14124",1982-03-03,1981,"Brest Armorique FC","RC Strasbourg","1-2",1,2,"1",1,3,-1,"D"
"14125",1982-03-03,1981,"AJ Auxerre","RC Lens","1-1",1,1,"1",1,2,0,"D"
"14126",1982-03-03,1981,"US Valenciennes-Anzin","FC Metz","2-0",2,0,"1",1,2,2,"H"
"14127",1982-03-13,1981,"AS Monaco","Olympique Lyon","3-1",3,1,"1",1,4,2,"H"
"14128",1982-03-13,1981,"FC Metz","Girondins Bordeaux","1-1",1,1,"1",1,2,0,"D"
"14129",1982-03-13,1981,"AS Saint-Etienne","OGC Nice","2-0",2,0,"1",1,2,2,"H"
"14130",1982-03-13,1981,"FC Sochaux","US Valenciennes-Anzin","2-0",2,0,"1",1,2,2,"H"
"14131",1982-03-13,1981,"Paris Saint-Germain","AS Nancy","1-2",1,2,"1",1,3,-1,"D"
"14132",1982-03-13,1981,"Stade Laval","Montpellier La Paillade SC","2-1",2,1,"1",1,3,1,"H"
"14133",1982-03-13,1981,"Tours FC","Lille OSC","4-1",4,1,"1",1,5,3,"H"
"14134",1982-03-13,1981,"Brest Armorique FC","AJ Auxerre","2-2",2,2,"1",1,4,0,"D"
"14135",1982-03-13,1981,"RC Lens","FC Nantes","1-0",1,0,"1",1,1,1,"H"
"14136",1982-03-13,1981,"RC Strasbourg","SC Bastia","0-0",0,0,"1",1,0,0,"D"
"14137",1982-03-16,1981,"RC Strasbourg","FC Nantes","1-0",1,0,"1",1,1,1,"H"
"14138",1982-03-20,1981,"Girondins Bordeaux","AS Monaco","1-0",1,0,"1",1,1,1,"H"
"14139",1982-03-20,1981,"AS Nancy","AS Saint-Etienne","0-0",0,0,"1",1,0,0,"D"
"14140",1982-03-20,1981,"US Valenciennes-Anzin","Paris Saint-Germain","2-2",2,2,"1",1,4,0,"D"
"14141",1982-03-20,1981,"AJ Auxerre","FC Sochaux","3-0",3,0,"1",1,3,3,"H"
"14142",1982-03-20,1981,"Lille OSC","Stade Laval","1-0",1,0,"1",1,1,1,"H"
"14143",1982-03-20,1981,"FC Nantes","Brest Armorique FC","3-1",3,1,"1",1,4,2,"H"
"14144",1982-03-20,1981,"SC Bastia","Tours FC","2-1",2,1,"1",1,3,1,"H"
"14145",1982-03-20,1981,"Montpellier La Paillade SC","RC Strasbourg","0-0",0,0,"1",1,0,0,"D"
"14146",1982-03-20,1981,"Olympique Lyon","FC Metz","3-1",3,1,"1",1,4,2,"H"
"14147",1982-03-20,1981,"OGC Nice","RC Lens","3-1",3,1,"1",1,4,2,"H"
"14148",1982-03-27,1981,"AS Monaco","Montpellier La Paillade SC","1-0",1,0,"1",1,1,1,"H"
"14149",1982-03-27,1981,"AS Saint-Etienne","Girondins Bordeaux","5-0",5,0,"1",1,5,5,"H"
"14150",1982-03-27,1981,"FC Sochaux","Olympique Lyon","3-1",3,1,"1",1,4,2,"H"
"14151",1982-03-27,1981,"Paris Saint-Germain","OGC Nice","1-1",1,1,"1",1,2,0,"D"
"14152",1982-03-27,1981,"Stade Laval","SC Bastia","2-0",2,0,"1",1,2,2,"H"
"14153",1982-03-27,1981,"AJ Auxerre","FC Nantes","0-1",0,1,"1",1,1,-1,"D"
"14154",1982-03-27,1981,"Brest Armorique FC","AS Nancy","0-1",0,1,"1",1,1,-1,"D"
"14155",1982-03-27,1981,"FC Metz","Tours FC","4-2",4,2,"1",1,6,2,"H"
"14156",1982-03-27,1981,"RC Strasbourg","Lille OSC","3-0",3,0,"1",1,3,3,"H"
"14157",1982-03-27,1981,"RC Lens","US Valenciennes-Anzin","1-1",1,1,"1",1,2,0,"D"
"14158",1982-04-02,1981,"Lille OSC","AS Monaco","0-2",0,2,"1",1,2,-2,"D"
"14159",1982-04-02,1981,"Montpellier La Paillade SC","AS Saint-Etienne","0-1",0,1,"1",1,1,-1,"D"
"14160",1982-04-02,1981,"Girondins Bordeaux","FC Sochaux","3-1",3,1,"1",1,4,2,"H"
"14161",1982-04-02,1981,"FC Nantes","Paris Saint-Germain","4-0",4,0,"1",1,4,4,"H"
"14162",1982-04-02,1981,"Tours FC","Stade Laval","2-1",2,1,"1",1,3,1,"H"
"14163",1982-04-02,1981,"AS Nancy","RC Lens","0-0",0,0,"1",1,0,0,"D"
"14164",1982-04-02,1981,"Olympique Lyon","RC Strasbourg","1-1",1,1,"1",1,2,0,"D"
"14165",1982-04-02,1981,"SC Bastia","FC Metz","1-1",1,1,"1",1,2,0,"D"
"14166",1982-04-02,1981,"US Valenciennes-Anzin","Brest Armorique FC","5-2",5,2,"1",1,7,3,"H"
"14167",1982-04-02,1981,"OGC Nice","AJ Auxerre","4-0",4,0,"1",1,4,4,"H"
"14168",1982-04-09,1981,"AS Monaco","SC Bastia","4-1",4,1,"1",1,5,3,"H"
"14169",1982-04-09,1981,"Paris Saint-Germain","Girondins Bordeaux","0-2",0,2,"1",1,2,-2,"D"
"14170",1982-04-09,1981,"AS Saint-Etienne","Stade Laval","1-1",1,1,"1",1,2,0,"D"
"14171",1982-04-09,1981,"FC Sochaux","Montpellier La Paillade SC","1-0",1,0,"1",1,1,1,"H"
"14172",1982-04-09,1981,"FC Nantes","AS Nancy","5-1",5,1,"1",1,6,4,"H"
"14173",1982-04-09,1981,"RC Strasbourg","Tours FC","1-1",1,1,"1",1,2,0,"D"
"14174",1982-04-09,1981,"Brest Armorique FC","OGC Nice","1-0",1,0,"1",1,1,1,"H"
"14175",1982-04-09,1981,"FC Metz","Lille OSC","1-0",1,0,"1",1,1,1,"H"
"14176",1982-04-09,1981,"AJ Auxerre","US Valenciennes-Anzin","3-0",3,0,"1",1,3,3,"H"
"14177",1982-04-09,1981,"RC Lens","Olympique Lyon","2-1",2,1,"1",1,3,1,"H"
"14178",1982-04-13,1981,"Tours FC","AS Monaco","1-1",1,1,"1",1,2,0,"D"
"14179",1982-04-13,1981,"SC Bastia","AS Saint-Etienne","1-1",1,1,"1",1,2,0,"D"
"14180",1982-04-13,1981,"Girondins Bordeaux","RC Lens","0-1",0,1,"1",1,1,-1,"D"
"14181",1982-04-13,1981,"Lille OSC","FC Sochaux","0-0",0,0,"1",1,0,0,"D"
"14182",1982-04-13,1981,"Stade Laval","FC Metz","1-0",1,0,"1",1,1,1,"H"
"14183",1982-04-13,1981,"Montpellier La Paillade SC","Paris Saint-Germain","2-5",2,5,"1",1,7,-3,"D"
"14184",1982-04-13,1981,"US Valenciennes-Anzin","FC Nantes","1-2",1,2,"1",1,3,-1,"D"
"14185",1982-04-13,1981,"AS Nancy","AJ Auxerre","1-1",1,1,"1",1,2,0,"D"
"14186",1982-04-13,1981,"OGC Nice","RC Strasbourg","0-1",0,1,"1",1,1,-1,"D"
"14187",1982-04-13,1981,"Olympique Lyon","Brest Armorique FC","1-0",1,0,"1",1,1,1,"H"
"14188",1982-04-16,1981,"RC Strasbourg","AS Nancy","2-0",2,0,"1",1,2,2,"H"
"14189",1982-04-23,1981,"AS Monaco","Stade Laval","3-0",3,0,"1",1,3,3,"H"
"14190",1982-04-23,1981,"AS Saint-Etienne","Tours FC","1-0",1,0,"1",1,1,1,"H"
"14191",1982-04-23,1981,"Brest Armorique FC","Girondins Bordeaux","3-1",3,1,"1",1,4,2,"H"
"14192",1982-04-23,1981,"FC Sochaux","SC Bastia","3-0",3,0,"1",1,3,3,"H"
"14193",1982-04-23,1981,"FC Nantes","OGC Nice","2-0",2,0,"1",1,2,2,"H"
"14194",1982-04-23,1981,"Paris Saint-Germain","Lille OSC","0-1",0,1,"1",1,1,-1,"D"
"14195",1982-04-23,1981,"RC Strasbourg","FC Metz","0-1",0,1,"1",1,1,-1,"D"
"14196",1982-04-23,1981,"AS Nancy","US Valenciennes-Anzin","1-3",1,3,"1",1,4,-2,"D"
"14197",1982-04-23,1981,"RC Lens","Montpellier La Paillade SC","1-0",1,0,"1",1,1,1,"H"
"14198",1982-04-23,1981,"AJ Auxerre","Olympique Lyon","2-2",2,2,"1",1,4,0,"D"
"14199",1982-05-04,1981,"FC Metz","AS Monaco","0-0",0,0,"1",1,0,0,"D"
"14200",1982-05-04,1981,"US Valenciennes-Anzin","AS Saint-Etienne","0-2",0,2,"1",1,2,-2,"D"
"14201",1982-05-04,1981,"Girondins Bordeaux","AJ Auxerre","0-2",0,2,"1",1,2,-2,"D"
"14202",1982-05-04,1981,"Tours FC","FC Sochaux","1-2",1,2,"1",1,3,-1,"D"
"14203",1982-05-04,1981,"Stade Laval","RC Strasbourg","4-2",4,2,"1",1,6,2,"H"
"14204",1982-05-04,1981,"Olympique Lyon","FC Nantes","1-0",1,0,"1",1,1,1,"H"
"14205",1982-05-04,1981,"SC Bastia","Paris Saint-Germain","3-1",3,1,"1",1,4,2,"H"
"14206",1982-05-04,1981,"OGC Nice","AS Nancy","1-2",1,2,"1",1,3,-1,"D"
"14207",1982-05-04,1981,"Montpellier La Paillade SC","Brest Armorique FC","1-3",1,3,"1",1,4,-2,"D"
"14208",1982-05-04,1981,"Lille OSC","RC Lens","0-3",0,3,"1",1,3,-3,"D"
"14209",1982-05-07,1981,"AS Monaco","RC Strasbourg","1-0",1,0,"1",1,1,1,"H"
"14210",1982-05-07,1981,"AS Saint-Etienne","FC Metz","9-2",9,2,"1",1,11,7,"H"
"14211",1982-05-07,1981,"FC Sochaux","Stade Laval","3-1",3,1,"1",1,4,2,"H"
"14212",1982-05-07,1981,"FC Nantes","Girondins Bordeaux","6-0",6,0,"1",1,6,6,"H"
"14213",1982-05-07,1981,"Paris Saint-Germain","Tours FC","4-3",4,3,"1",1,7,1,"H"
"14214",1982-05-07,1981,"AS Nancy","Olympique Lyon","2-1",2,1,"1",1,3,1,"H"
"14215",1982-05-07,1981,"Brest Armorique FC","Lille OSC","1-0",1,0,"1",1,1,1,"H"
"14216",1982-05-07,1981,"RC Lens","SC Bastia","1-1",1,1,"1",1,2,0,"D"
"14217",1982-05-07,1981,"AJ Auxerre","Montpellier La Paillade SC","1-1",1,1,"1",1,2,0,"D"
"14218",1982-05-07,1981,"US Valenciennes-Anzin","OGC Nice","0-0",0,0,"1",1,0,0,"D"
"14219",1982-08-10,1982,"Brest Armorique FC","Tours FC","4-2",4,2,"1",1,6,2,"H"
"14220",1982-08-10,1982,"Stade Laval","FC Sochaux","3-1",3,1,"1",1,4,2,"H"
"14221",1982-08-10,1982,"Girondins Bordeaux","AS Monaco","3-1",3,1,"1",1,4,2,"H"
"14222",1982-08-10,1982,"Toulouse FC","RC Strasbourg","3-1",3,1,"1",1,4,2,"H"
"14223",1982-08-10,1982,"FC Metz","Lille OSC","2-0",2,0,"1",1,2,2,"H"
"14224",1982-08-10,1982,"RC Lens","AS Nancy","2-1",2,1,"1",1,3,1,"H"
"14225",1982-08-10,1982,"SC Bastia","AS Saint-Etienne","2-1",2,1,"1",1,3,1,"H"
"14226",1982-08-10,1982,"Paris Saint-Germain","FC Rouen","1-0",1,0,"1",1,1,1,"H"
"14227",1982-08-10,1982,"FC Mulhouse","FC Nantes","1-1",1,1,"1",1,2,0,"D"
"14228",1982-08-10,1982,"Olympique Lyon","AJ Auxerre","1-1",1,1,"1",1,2,0,"D"
"14229",1982-08-17,1982,"FC Sochaux","Toulouse FC","2-3",2,3,"1",1,5,-1,"D"
"14230",1982-08-17,1982,"AJ Auxerre","Stade Laval","0-1",0,1,"1",1,1,-1,"D"
"14231",1982-08-17,1982,"FC Nantes","SC Bastia","3-0",3,0,"1",1,3,3,"H"
"14232",1982-08-17,1982,"RC Lens","Girondins Bordeaux","2-2",2,2,"1",1,4,0,"D"
"14233",1982-08-17,1982,"AS Saint-Etienne","Brest Armorique FC","0-0",0,0,"1",1,0,0,"D"
"14234",1982-08-17,1982,"AS Monaco","Paris Saint-Germain","1-1",1,1,"1",1,2,0,"D"
"14235",1982-08-17,1982,"Tours FC","FC Metz","3-2",3,2,"1",1,5,1,"H"
"14236",1982-08-17,1982,"FC Rouen","Olympique Lyon","2-1",2,1,"1",1,3,1,"H"
"14237",1982-08-17,1982,"RC Strasbourg","Lille OSC","1-0",1,0,"1",1,1,1,"H"
"14238",1982-08-17,1982,"AS Nancy","FC Mulhouse","6-0",6,0,"1",1,6,6,"H"
"14239",1982-08-24,1982,"Toulouse FC","AJ Auxerre","2-1",2,1,"1",1,3,1,"H"
"14240",1982-08-24,1982,"Brest Armorique FC","FC Rouen","4-2",4,2,"1",1,6,2,"H"
"14241",1982-08-24,1982,"Girondins Bordeaux","FC Nantes","1-2",1,2,"1",1,3,-1,"D"
"14242",1982-08-24,1982,"FC Mulhouse","RC Lens","1-3",1,3,"1",1,4,-2,"D"
"14243",1982-08-24,1982,"Stade Laval","AS Saint-Etienne","0-0",0,0,"1",1,0,0,"D"
"14244",1982-08-24,1982,"Paris Saint-Germain","AS Nancy","2-3",2,3,"1",1,5,-1,"D"
"14245",1982-08-24,1982,"SC Bastia","AS Monaco","2-0",2,0,"1",1,2,2,"H"
"14246",1982-08-24,1982,"FC Metz","RC Strasbourg","1-1",1,1,"1",1,2,0,"D"
"14247",1982-08-24,1982,"Olympique Lyon","Tours FC","2-0",2,0,"1",1,2,2,"H"
"14248",1982-08-24,1982,"Lille OSC","FC Sochaux","1-0",1,0,"1",1,1,1,"H"
"14249",1982-08-27,1982,"FC Nantes","Brest Armorique FC","5-1",5,1,"1",1,6,4,"H"
"14250",1982-08-27,1982,"RC Lens","SC Bastia","2-1",2,1,"1",1,3,1,"H"
"14251",1982-08-27,1982,"AS Nancy","Girondins Bordeaux","2-1",2,1,"1",1,3,1,"H"
"14252",1982-08-27,1982,"Tours FC","Toulouse FC","2-0",2,0,"1",1,2,2,"H"
"14253",1982-08-27,1982,"AS Monaco","Stade Laval","4-1",4,1,"1",1,5,3,"H"
"14254",1982-08-27,1982,"FC Rouen","FC Metz","0-0",0,0,"1",1,0,0,"D"
"14255",1982-08-27,1982,"AS Saint-Etienne","Paris Saint-Germain","1-1",1,1,"1",1,2,0,"D"
"14256",1982-08-27,1982,"FC Sochaux","RC Strasbourg","2-2",2,2,"1",1,4,0,"D"
"14257",1982-08-27,1982,"AJ Auxerre","Lille OSC","3-0",3,0,"1",1,3,3,"H"
"14258",1982-08-28,1982,"FC Mulhouse","Olympique Lyon","1-1",1,1,"1",1,2,0,"D"
"14259",1982-09-03,1982,"Lille OSC","RC Lens","1-1",1,1,"1",1,2,0,"D"
"14260",1982-09-03,1982,"Toulouse FC","FC Rouen","2-1",2,1,"1",1,3,1,"H"
"14261",1982-09-03,1982,"Paris Saint-Germain","FC Nantes","2-1",2,1,"1",1,3,1,"H"
"14262",1982-09-03,1982,"Stade Laval","Tours FC","3-0",3,0,"1",1,3,3,"H"
"14263",1982-09-03,1982,"SC Bastia","AS Nancy","3-2",3,2,"1",1,5,1,"H"
"14264",1982-09-03,1982,"Olympique Lyon","AS Saint-Etienne","2-1",2,1,"1",1,3,1,"H"
"14265",1982-09-03,1982,"Brest Armorique FC","AS Monaco","1-1",1,1,"1",1,2,0,"D"
"14266",1982-09-03,1982,"RC Strasbourg","AJ Auxerre","0-2",0,2,"1",1,2,-2,"D"
"14267",1982-09-03,1982,"Girondins Bordeaux","FC Mulhouse","2-0",2,0,"1",1,2,2,"H"
"14268",1982-09-04,1982,"FC Metz","FC Sochaux","1-1",1,1,"1",1,2,0,"D"
"14269",1982-09-10,1982,"RC Lens","Paris Saint-Germain","4-0",4,0,"1",1,4,4,"H"
"14270",1982-09-10,1982,"FC Nantes","Olympique Lyon","1-0",1,0,"1",1,1,1,"H"
"14271",1982-09-10,1982,"AS Saint-Etienne","Toulouse FC","2-1",2,1,"1",1,3,1,"H"
"14272",1982-09-10,1982,"AS Nancy","Brest Armorique FC","1-1",1,1,"1",1,2,0,"D"
"14273",1982-09-10,1982,"Girondins Bordeaux","Stade Laval","4-1",4,1,"1",1,5,3,"H"
"14274",1982-09-10,1982,"AJ Auxerre","FC Sochaux","2-2",2,2,"1",1,4,0,"D"
"14275",1982-09-10,1982,"AS Monaco","FC Metz","2-1",2,1,"1",1,3,1,"H"
"14276",1982-09-10,1982,"Tours FC","RC Strasbourg","2-0",2,0,"1",1,2,2,"H"
"14277",1982-09-10,1982,"FC Mulhouse","SC Bastia","4-1",4,1,"1",1,5,3,"H"
"14278",1982-09-10,1982,"FC Rouen","Lille OSC","2-0",2,0,"1",1,2,2,"H"
"14279",1982-09-21,1982,"Stade Laval","FC Nantes","1-3",1,3,"1",1,4,-2,"D"
"14280",1982-09-21,1982,"Brest Armorique FC","RC Lens","2-1",2,1,"1",1,3,1,"H"
"14281",1982-09-21,1982,"Toulouse FC","AS Monaco","2-1",2,1,"1",1,3,1,"H"
"14282",1982-09-21,1982,"Olympique Lyon","AS Nancy","1-2",1,2,"1",1,3,-1,"D"
"14283",1982-09-21,1982,"SC Bastia","Girondins Bordeaux","1-2",1,2,"1",1,3,-1,"D"
"14284",1982-09-21,1982,"Paris Saint-Germain","FC Mulhouse","5-1",5,1,"1",1,6,4,"H"
"14285",1982-09-21,1982,"FC Metz","AJ Auxerre","1-1",1,1,"1",1,2,0,"D"
"14286",1982-09-21,1982,"Lille OSC","Tours FC","2-0",2,0,"1",1,2,2,"H"
"14287",1982-09-21,1982,"RC Strasbourg","FC Rouen","1-0",1,0,"1",1,1,1,"H"
"14288",1982-09-21,1982,"FC Sochaux","AS Saint-Etienne","3-0",3,0,"1",1,3,3,"H"
"14289",1982-09-24,1982,"FC Nantes","RC Strasbourg","3-0",3,0,"1",1,3,3,"H"
"14290",1982-09-24,1982,"RC Lens","Olympique Lyon","1-0",1,0,"1",1,1,1,"H"
"14291",1982-09-24,1982,"Girondins Bordeaux","Paris Saint-Germain","2-1",2,1,"1",1,3,1,"H"
"14292",1982-09-24,1982,"SC Bastia","Toulouse FC","1-1",1,1,"1",1,2,0,"D"
"14293",1982-09-24,1982,"AS Nancy","Stade Laval","1-1",1,1,"1",1,2,0,"D"
"14294",1982-09-24,1982,"FC Mulhouse","Brest Armorique FC","1-1",1,1,"1",1,2,0,"D"
"14295",1982-09-24,1982,"Tours FC","AJ Auxerre","3-2",3,2,"1",1,5,1,"H"
"14296",1982-09-24,1982,"AS Monaco","Lille OSC","0-0",0,0,"1",1,0,0,"D"
"14297",1982-09-24,1982,"AS Saint-Etienne","FC Metz","3-1",3,1,"1",1,4,2,"H"
"14298",1982-09-24,1982,"FC Rouen","FC Sochaux","1-1",1,1,"1",1,2,0,"D"
"14299",1982-10-02,1982,"Toulouse FC","FC Nantes","0-1",0,1,"1",1,1,-1,"D"
"14300",1982-10-02,1982,"Brest Armorique FC","Girondins Bordeaux","0-1",0,1,"1",1,1,-1,"D"
"14301",1982-10-02,1982,"Stade Laval","RC Lens","0-0",0,0,"1",1,0,0,"D"
"14302",1982-10-02,1982,"FC Metz","AS Nancy","2-3",2,3,"1",1,5,-1,"D"
"14303",1982-10-02,1982,"Paris Saint-Germain","SC Bastia","1-0",1,0,"1",1,1,1,"H"
"14304",1982-10-02,1982,"AJ Auxerre","FC Rouen","2-0",2,0,"1",1,2,2,"H"
"14305",1982-10-02,1982,"FC Sochaux","Tours FC","1-1",1,1,"1",1,2,0,"D"
"14306",1982-10-02,1982,"Olympique Lyon","AS Monaco","1-1",1,1,"1",1,2,0,"D"
"14307",1982-10-02,1982,"Lille OSC","AS Saint-Etienne","1-1",1,1,"1",1,2,0,"D"
"14308",1982-10-02,1982,"RC Strasbourg","FC Mulhouse","2-1",2,1,"1",1,3,1,"H"
"14309",1982-10-12,1982,"FC Nantes","FC Metz","2-3",2,3,"1",1,5,-1,"D"
"14310",1982-10-12,1982,"Girondins Bordeaux","Olympique Lyon","5-1",5,1,"1",1,6,4,"H"
"14311",1982-10-12,1982,"RC Lens","Toulouse FC","3-1",3,1,"1",1,4,2,"H"
"14312",1982-10-12,1982,"AS Nancy","Lille OSC","2-2",2,2,"1",1,4,0,"D"
"14313",1982-10-12,1982,"Paris Saint-Germain","FC Sochaux","1-0",1,0,"1",1,1,1,"H"
"14314",1982-10-12,1982,"SC Bastia","Brest Armorique FC","1-1",1,1,"1",1,2,0,"D"
"14315",1982-10-12,1982,"AS Monaco","RC Strasbourg","3-0",3,0,"1",1,3,3,"H"
"14316",1982-10-12,1982,"AS Saint-Etienne","AJ Auxerre","1-0",1,0,"1",1,1,1,"H"
"14317",1982-10-12,1982,"FC Mulhouse","Stade Laval","2-1",2,1,"1",1,3,1,"H"
"14318",1982-10-12,1982,"FC Rouen","Tours FC","4-2",4,2,"1",1,6,2,"H"
"14319",1982-10-15,1982,"Lille OSC","FC Nantes","0-2",0,2,"1",1,2,-2,"D"
"14320",1982-10-15,1982,"FC Metz","Girondins Bordeaux","2-1",2,1,"1",1,3,1,"H"
"14321",1982-10-15,1982,"RC Strasbourg","RC Lens","2-1",2,1,"1",1,3,1,"H"
"14322",1982-10-15,1982,"Toulouse FC","AS Nancy","2-1",2,1,"1",1,3,1,"H"
"14323",1982-10-15,1982,"Brest Armorique FC","Paris Saint-Germain","3-1",3,1,"1",1,4,2,"H"
"14324",1982-10-15,1982,"Tours FC","AS Saint-Etienne","0-2",0,2,"1",1,2,-2,"D"
"14325",1982-10-15,1982,"AJ Auxerre","FC Mulhouse","2-1",2,1,"1",1,3,1,"H"
"14326",1982-10-15,1982,"FC Sochaux","AS Monaco","1-1",1,1,"1",1,2,0,"D"
"14327",1982-10-15,1982,"Stade Laval","FC Rouen","3-1",3,1,"1",1,4,2,"H"
"14328",1982-10-15,1982,"Olympique Lyon","SC Bastia","3-1",3,1,"1",1,4,2,"H"
"14329",1982-10-26,1982,"FC Nantes","AJ Auxerre","1-0",1,0,"1",1,1,1,"H"
"14330",1982-10-26,1982,"Girondins Bordeaux","Toulouse FC","1-0",1,0,"1",1,1,1,"H"
"14331",1982-10-26,1982,"RC Lens","FC Metz","4-2",4,2,"1",1,6,2,"H"
"14332",1982-10-26,1982,"Brest Armorique FC","Olympique Lyon","2-1",2,1,"1",1,3,1,"H"
"14333",1982-10-26,1982,"AS Saint-Etienne","FC Rouen","1-0",1,0,"1",1,1,1,"H"
"14334",1982-10-26,1982,"Paris Saint-Germain","RC Strasbourg","4-3",4,3,"1",1,7,1,"H"
"14335",1982-10-26,1982,"AS Nancy","FC Sochaux","1-3",1,3,"1",1,4,-2,"D"
"14336",1982-10-26,1982,"AS Monaco","Tours FC","3-0",3,0,"1",1,3,3,"H"
"14337",1982-10-26,1982,"SC Bastia","Stade Laval","1-1",1,1,"1",1,2,0,"D"
"14338",1982-10-26,1982,"FC Mulhouse","Lille OSC","1-0",1,0,"1",1,1,1,"H"
"14339",1982-10-29,1982,"FC Sochaux","FC Nantes","1-1",1,1,"1",1,2,0,"D"
"14340",1982-10-29,1982,"Lille OSC","Girondins Bordeaux","2-1",2,1,"1",1,3,1,"H"
"14341",1982-10-29,1982,"Tours FC","RC Lens","5-1",5,1,"1",1,6,4,"H"
"14342",1982-10-29,1982,"Olympique Lyon","Paris Saint-Germain","1-3",1,3,"1",1,4,-2,"D"
"14343",1982-10-29,1982,"Stade Laval","Brest Armorique FC","1-1",1,1,"1",1,2,0,"D"
"14344",1982-10-29,1982,"AJ Auxerre","AS Nancy","2-3",2,3,"1",1,5,-1,"D"
"14345",1982-10-29,1982,"Toulouse FC","FC Mulhouse","2-1",2,1,"1",1,3,1,"H"
"14346",1982-10-29,1982,"FC Rouen","AS Monaco","1-1",1,1,"1",1,2,0,"D"
"14347",1982-10-29,1982,"RC Strasbourg","AS Saint-Etienne","2-0",2,0,"1",1,2,2,"H"
"14348",1982-10-29,1982,"FC Metz","SC Bastia","0-0",0,0,"1",1,0,0,"D"
"14349",1982-11-06,1982,"FC Nantes","FC Rouen","1-0",1,0,"1",1,1,1,"H"
"14350",1982-11-06,1982,"Girondins Bordeaux","RC Strasbourg","1-1",1,1,"1",1,2,0,"D"
"14351",1982-11-06,1982,"RC Lens","AJ Auxerre","0-0",0,0,"1",1,0,0,"D"
"14352",1982-11-06,1982,"Paris Saint-Germain","Stade Laval","0-0",0,0,"1",1,0,0,"D"
"14353",1982-11-06,1982,"Brest Armorique FC","FC Metz","1-1",1,1,"1",1,2,0,"D"
"14354",1982-11-06,1982,"AS Nancy","Tours FC","3-3",3,3,"1",1,6,0,"D"
"14355",1982-11-06,1982,"AS Monaco","AS Saint-Etienne","2-2",2,2,"1",1,4,0,"D"
"14356",1982-11-06,1982,"Olympique Lyon","Toulouse FC","4-1",4,1,"1",1,5,3,"H"
"14357",1982-11-06,1982,"FC Mulhouse","FC Sochaux","1-0",1,0,"1",1,1,1,"H"
"14358",1982-11-06,1982,"SC Bastia","Lille OSC","0-0",0,0,"1",1,0,0,"D"
"14359",1982-11-16,1982,"Tours FC","FC Nantes","0-4",0,4,"1",1,4,-4,"D"
"14360",1982-11-16,1982,"FC Sochaux","Girondins Bordeaux","0-2",0,2,"1",1,2,-2,"D"
"14361",1982-11-16,1982,"AS Saint-Etienne","RC Lens","0-1",0,1,"1",1,1,-1,"D"
"14362",1982-11-16,1982,"Toulouse FC","Brest Armorique FC","2-2",2,2,"1",1,4,0,"D"
"14363",1982-11-16,1982,"Lille OSC","Paris Saint-Germain","1-0",1,0,"1",1,1,1,"H"
"14364",1982-11-16,1982,"FC Rouen","AS Nancy","1-0",1,0,"1",1,1,1,"H"
"14365",1982-11-16,1982,"AJ Auxerre","AS Monaco","1-0",1,0,"1",1,1,1,"H"
"14366",1982-11-16,1982,"Stade Laval","Olympique Lyon","1-1",1,1,"1",1,2,0,"D"
"14367",1982-11-16,1982,"RC Strasbourg","SC Bastia","2-1",2,1,"1",1,3,1,"H"
"14368",1982-11-16,1982,"FC Metz","FC Mulhouse","3-0",3,0,"1",1,3,3,"H"
"14369",1982-11-20,1982,"FC Nantes","AS Monaco","0-0",0,0,"1",1,0,0,"D"
"14370",1982-11-20,1982,"Girondins Bordeaux","AJ Auxerre","3-0",3,0,"1",1,3,3,"H"
"14371",1982-11-20,1982,"RC Lens","FC Rouen","2-0",2,0,"1",1,2,2,"H"
"14372",1982-11-20,1982,"Brest Armorique FC","Lille OSC","0-1",0,1,"1",1,1,-1,"D"
"14373",1982-11-20,1982,"Stade Laval","RC Strasbourg","2-1",2,1,"1",1,3,1,"H"
"14374",1982-11-20,1982,"FC Mulhouse","Tours FC","1-0",1,0,"1",1,1,1,"H"
"14375",1982-11-20,1982,"SC Bastia","FC Sochaux","0-0",0,0,"1",1,0,0,"D"
"14376",1982-11-21,1982,"AS Nancy","AS Saint-Etienne","3-1",3,1,"1",1,4,2,"H"
"14377",1982-11-21,1982,"Olympique Lyon","FC Metz","3-3",3,3,"1",1,6,0,"D"
"14378",1982-11-23,1982,"Paris Saint-Germain","Toulouse FC","2-1",2,1,"1",1,3,1,"H"
"14379",1982-11-27,1982,"Tours FC","Girondins Bordeaux","1-2",1,2,"1",1,3,-1,"D"
"14380",1982-11-27,1982,"FC Sochaux","RC Lens","1-1",1,1,"1",1,2,0,"D"
"14381",1982-11-27,1982,"FC Metz","Paris Saint-Germain","1-2",1,2,"1",1,3,-1,"D"
"14382",1982-11-27,1982,"RC Strasbourg","Brest Armorique FC","0-0",0,0,"1",1,0,0,"D"
"14383",1982-11-27,1982,"Toulouse FC","Stade Laval","0-1",0,1,"1",1,1,-1,"D"
"14384",1982-11-27,1982,"AS Monaco","AS Nancy","1-0",1,0,"1",1,1,1,"H"
"14385",1982-11-27,1982,"Lille OSC","Olympique Lyon","1-0",1,0,"1",1,1,1,"H"
"14386",1982-11-27,1982,"AJ Auxerre","SC Bastia","1-1",1,1,"1",1,2,0,"D"
"14387",1982-11-27,1982,"FC Rouen","FC Mulhouse","4-2",4,2,"1",1,6,2,"H"
"14388",1982-12-04,1982,"AS Nancy","FC Nantes","2-2",2,2,"1",1,4,0,"D"
"14389",1982-12-04,1982,"Girondins Bordeaux","FC Rouen","3-2",3,2,"1",1,5,1,"H"
"14390",1982-12-04,1982,"RC Lens","AS Monaco","2-0",2,0,"1",1,2,2,"H"
"14391",1982-12-04,1982,"Paris Saint-Germain","AJ Auxerre","0-0",0,0,"1",1,0,0,"D"
"14392",1982-12-04,1982,"Stade Laval","Lille OSC","2-0",2,0,"1",1,2,2,"H"
"14393",1982-12-04,1982,"Brest Armorique FC","FC Sochaux","2-2",2,2,"1",1,4,0,"D"
"14394",1982-12-04,1982,"Toulouse FC","FC Metz","2-1",2,1,"1",1,3,1,"H"
"14395",1982-12-04,1982,"Olympique Lyon","RC Strasbourg","4-2",4,2,"1",1,6,2,"H"
"14396",1982-12-04,1982,"FC Mulhouse","AS Saint-Etienne","1-0",1,0,"1",1,1,1,"H"
"14397",1982-12-04,1982,"SC Bastia","Tours FC","4-1",4,1,"1",1,5,3,"H"
"14398",1982-12-11,1982,"FC Nantes","RC Lens","5-1",5,1,"1",1,6,4,"H"
"14399",1982-12-11,1982,"AS Saint-Etienne","Girondins Bordeaux","3-1",3,1,"1",1,4,2,"H"
"14400",1982-12-11,1982,"Tours FC","Paris Saint-Germain","3-1",3,1,"1",1,4,2,"H"
"14401",1982-12-11,1982,"FC Metz","Stade Laval","3-2",3,2,"1",1,5,1,"H"
"14402",1982-12-11,1982,"AS Monaco","FC Mulhouse","1-0",1,0,"1",1,1,1,"H"
"14403",1982-12-11,1982,"AJ Auxerre","Brest Armorique FC","4-2",4,2,"1",1,6,2,"H"
"14404",1982-12-11,1982,"RC Strasbourg","AS Nancy","2-0",2,0,"1",1,2,2,"H"
"14405",1982-12-11,1982,"Lille OSC","Toulouse FC","3-0",3,0,"1",1,3,3,"H"
"14406",1982-12-11,1982,"FC Sochaux","Olympique Lyon","1-1",1,1,"1",1,2,0,"D"
"14407",1982-12-11,1982,"FC Rouen","SC Bastia","2-1",2,1,"1",1,3,1,"H"
"14408",1982-12-15,1982,"AS Saint-Etienne","FC Nantes","0-1",0,1,"1",1,1,-1,"D"
"14409",1982-12-18,1982,"SC Bastia","FC Nantes","1-1",1,1,"1",1,2,0,"D"
"14410",1982-12-18,1982,"Girondins Bordeaux","RC Lens","3-0",3,0,"1",1,3,3,"H"
"14411",1982-12-18,1982,"Stade Laval","AJ Auxerre","1-0",1,0,"1",1,1,1,"H"
"14412",1982-12-18,1982,"Paris Saint-Germain","AS Monaco","0-1",0,1,"1",1,1,-1,"D"
"14413",1982-12-18,1982,"Brest Armorique FC","AS Saint-Etienne","4-2",4,2,"1",1,6,2,"H"
"14414",1982-12-18,1982,"Lille OSC","RC Strasbourg","1-0",1,0,"1",1,1,1,"H"
"14415",1982-12-18,1982,"FC Metz","Tours FC","5-1",5,1,"1",1,6,4,"H"
"14416",1982-12-18,1982,"FC Mulhouse","AS Nancy","3-1",3,1,"1",1,4,2,"H"
"14417",1982-12-18,1982,"Toulouse FC","FC Sochaux","2-6",2,6,"1",1,8,-4,"D"
"14418",1982-12-18,1982,"Olympique Lyon","FC Rouen","0-4",0,4,"1",1,4,-4,"D"
"14419",1983-01-15,1982,"FC Nantes","Girondins Bordeaux","4-0",4,0,"1",1,4,4,"H"
"14420",1983-01-15,1982,"RC Lens","FC Mulhouse","4-2",4,2,"1",1,6,2,"H"
"14421",1983-01-15,1982,"AS Monaco","SC Bastia","3-0",3,0,"1",1,3,3,"H"
"14422",1983-01-15,1982,"AS Saint-Etienne","Stade Laval","1-1",1,1,"1",1,2,0,"D"
"14423",1983-01-15,1982,"AS Nancy","Paris Saint-Germain","2-3",2,3,"1",1,5,-1,"D"
"14424",1983-01-15,1982,"FC Rouen","Brest Armorique FC","1-1",1,1,"1",1,2,0,"D"
"14425",1983-01-15,1982,"FC Sochaux","Lille OSC","2-0",2,0,"1",1,2,2,"H"
"14426",1983-01-15,1982,"AJ Auxerre","Toulouse FC","5-1",5,1,"1",1,6,4,"H"
"14427",1983-01-15,1982,"RC Strasbourg","FC Metz","2-1",2,1,"1",1,3,1,"H"
"14428",1983-01-15,1982,"Tours FC","Olympique Lyon","3-0",3,0,"1",1,3,3,"H"
"14429",1983-01-22,1982,"Brest Armorique FC","FC Nantes","1-1",1,1,"1",1,2,0,"D"
"14430",1983-01-22,1982,"Girondins Bordeaux","AS Nancy","3-2",3,2,"1",1,5,1,"H"
"14431",1983-01-22,1982,"SC Bastia","RC Lens","4-0",4,0,"1",1,4,4,"H"
"14432",1983-01-22,1982,"Paris Saint-Germain","AS Saint-Etienne","4-1",4,1,"1",1,5,3,"H"
"14433",1983-01-22,1982,"Stade Laval","AS Monaco","1-0",1,0,"1",1,1,1,"H"
"14434",1983-01-22,1982,"Lille OSC","AJ Auxerre","1-2",1,2,"1",1,3,-1,"D"
"14435",1983-01-23,1982,"FC Metz","FC Rouen","3-2",3,2,"1",1,5,1,"H"
"14436",1983-01-23,1982,"RC Strasbourg","FC Sochaux","1-1",1,1,"1",1,2,0,"D"
"14437",1983-01-23,1982,"Toulouse FC","Tours FC","1-1",1,1,"1",1,2,0,"D"
"14438",1983-01-23,1982,"Olympique Lyon","FC Mulhouse","7-3",7,3,"1",1,10,4,"H"
"14439",1983-01-29,1982,"FC Nantes","Paris Saint-Germain","2-0",2,0,"1",1,2,2,"H"
"14440",1983-01-29,1982,"RC Lens","Lille OSC","2-0",2,0,"1",1,2,2,"H"
"14441",1983-01-29,1982,"AS Monaco","Brest Armorique FC","5-0",5,0,"1",1,5,5,"H"
"14442",1983-01-29,1982,"Tours FC","Stade Laval","4-1",4,1,"1",1,5,3,"H"
"14443",1983-01-29,1982,"AJ Auxerre","RC Strasbourg","0-0",0,0,"1",1,0,0,"D"
"14444",1983-01-29,1982,"FC Rouen","Toulouse FC","3-0",3,0,"1",1,3,3,"H"
"14445",1983-01-30,1982,"FC Mulhouse","Girondins Bordeaux","4-4",4,4,"1",1,8,0,"D"
"14446",1983-01-30,1982,"FC Sochaux","FC Metz","4-3",4,3,"1",1,7,1,"H"
"14447",1983-01-30,1982,"AS Nancy","SC Bastia","2-2",2,2,"1",1,4,0,"D"
"14448",1983-01-30,1982,"AS Saint-Etienne","Olympique Lyon","1-0",1,0,"1",1,1,1,"H"
"14449",1983-02-05,1982,"Stade Laval","Girondins Bordeaux","2-0",2,0,"1",1,2,2,"H"
"14450",1983-02-05,1982,"Brest Armorique FC","AS Nancy","0-3",0,3,"1",1,3,-3,"D"
"14451",1983-02-05,1982,"Lille OSC","FC Rouen","5-0",5,0,"1",1,5,5,"H"
"14452",1983-02-05,1982,"SC Bastia","FC Mulhouse","2-0",2,0,"1",1,2,2,"H"
"14453",1983-02-05,1982,"Toulouse FC","AS Saint-Etienne","1-1",1,1,"1",1,2,0,"D"
"14454",1983-02-06,1982,"Olympique Lyon","FC Nantes","1-2",1,2,"1",1,3,-1,"D"
"14455",1983-02-06,1982,"FC Metz","AS Monaco","1-1",1,1,"1",1,2,0,"D"
"14456",1983-02-06,1982,"FC Sochaux","AJ Auxerre","2-0",2,0,"1",1,2,2,"H"
"14457",1983-02-06,1982,"RC Strasbourg","Tours FC","1-1",1,1,"1",1,2,0,"D"
"14458",1983-02-08,1982,"Paris Saint-Germain","RC Lens","4-3",4,3,"1",1,7,1,"H"
"14459",1983-02-19,1982,"FC Nantes","Stade Laval","0-0",0,0,"1",1,0,0,"D"
"14460",1983-02-19,1982,"Girondins Bordeaux","SC Bastia","0-0",0,0,"1",1,0,0,"D"
"14461",1983-02-19,1982,"RC Lens","Brest Armorique FC","2-3",2,3,"1",1,5,-1,"D"
"14462",1983-02-19,1982,"AS Monaco","Toulouse FC","0-0",0,0,"1",1,0,0,"D"
"14463",1983-02-19,1982,"AJ Auxerre","FC Metz","2-2",2,2,"1",1,4,0,"D"
"14464",1983-02-19,1982,"Tours FC","Lille OSC","5-0",5,0,"1",1,5,5,"H"
"14465",1983-02-19,1982,"FC Rouen","RC Strasbourg","2-1",2,1,"1",1,3,1,"H"
"14466",1983-02-20,1982,"FC Mulhouse","Paris Saint-Germain","1-1",1,1,"1",1,2,0,"D"
"14467",1983-02-20,1982,"AS Saint-Etienne","FC Sochaux","0-1",0,1,"1",1,1,-1,"D"
"14468",1983-02-20,1982,"AS Nancy","Olympique Lyon","5-2",5,2,"1",1,7,3,"H"
"14469",1983-02-25,1982,"Paris Saint-Germain","Girondins Bordeaux","2-0",2,0,"1",1,2,2,"H"
"14470",1983-02-25,1982,"Olympique Lyon","RC Lens","2-1",2,1,"1",1,3,1,"H"
"14471",1983-02-26,1982,"Stade Laval","AS Nancy","0-0",0,0,"1",1,0,0,"D"
"14472",1983-02-26,1982,"Lille OSC","AS Monaco","1-1",1,1,"1",1,2,0,"D"
"14473",1983-02-26,1982,"Brest Armorique FC","FC Mulhouse","4-0",4,0,"1",1,4,4,"H"
"14474",1983-02-26,1982,"AJ Auxerre","Tours FC","3-1",3,1,"1",1,4,2,"H"
"14475",1983-02-26,1982,"FC Metz","AS Saint-Etienne","1-1",1,1,"1",1,2,0,"D"
"14476",1983-02-26,1982,"Toulouse FC","SC Bastia","3-1",3,1,"1",1,4,2,"H"
"14477",1983-02-27,1982,"RC Strasbourg","FC Nantes","2-0",2,0,"1",1,2,2,"H"
"14478",1983-02-27,1982,"FC Sochaux","FC Rouen","2-2",2,2,"1",1,4,0,"D"
"14479",1983-03-09,1982,"FC Nantes","Toulouse FC","3-0",3,0,"1",1,3,3,"H"
"14480",1983-03-09,1982,"Girondins Bordeaux","Brest Armorique FC","0-0",0,0,"1",1,0,0,"D"
"14481",1983-03-09,1982,"SC Bastia","Paris Saint-Germain","1-1",1,1,"1",1,2,0,"D"
"14482",1983-03-09,1982,"AS Monaco","Olympique Lyon","3-0",3,0,"1",1,3,3,"H"
"14483",1983-03-09,1982,"RC Lens","Stade Laval","2-0",2,0,"1",1,2,2,"H"
"14484",1983-03-09,1982,"Tours FC","FC Sochaux","1-1",1,1,"1",1,2,0,"D"
"14485",1983-03-09,1982,"AS Nancy","FC Metz","4-0",4,0,"1",1,4,4,"H"
"14486",1983-03-09,1982,"FC Rouen","AJ Auxerre","1-1",1,1,"1",1,2,0,"D"
"14487",1983-03-09,1982,"FC Mulhouse","RC Strasbourg","2-0",2,0,"1",1,2,2,"H"
"14488",1983-03-09,1982,"AS Saint-Etienne","Lille OSC","1-0",1,0,"1",1,1,1,"H"
"14489",1983-03-19,1982,"FC Metz","FC Nantes","0-4",0,4,"1",1,4,-4,"D"
"14490",1983-03-19,1982,"Olympique Lyon","Girondins Bordeaux","3-5",3,5,"1",1,8,-2,"D"
"14491",1983-03-19,1982,"FC Sochaux","Paris Saint-Germain","1-2",1,2,"1",1,3,-1,"D"
"14492",1983-03-19,1982,"RC Strasbourg","AS Monaco","0-4",0,4,"1",1,4,-4,"D"
"14493",1983-03-19,1982,"Toulouse FC","RC Lens","1-0",1,0,"1",1,1,1,"H"
"14494",1983-03-19,1982,"Brest Armorique FC","SC Bastia","4-2",4,2,"1",1,6,2,"H"
"14495",1983-03-19,1982,"Stade Laval","FC Mulhouse","0-0",0,0,"1",1,0,0,"D"
"14496",1983-03-19,1982,"AJ Auxerre","AS Saint-Etienne","4-1",4,1,"1",1,5,3,"H"
"14497",1983-03-19,1982,"Lille OSC","AS Nancy","2-0",2,0,"1",1,2,2,"H"
"14498",1983-03-19,1982,"Tours FC","FC Rouen","3-1",3,1,"1",1,4,2,"H"
"14499",1983-03-29,1982,"FC Nantes","Lille OSC","1-0",1,0,"1",1,1,1,"H"
"14500",1983-03-29,1982,"Girondins Bordeaux","FC Metz","2-0",2,0,"1",1,2,2,"H"
"14501",1983-03-29,1982,"Paris Saint-Germain","Brest Armorique FC","2-0",2,0,"1",1,2,2,"H"
"14502",1983-03-29,1982,"AS Monaco","FC Sochaux","0-0",0,0,"1",1,0,0,"D"
"14503",1983-03-29,1982,"RC Lens","RC Strasbourg","2-1",2,1,"1",1,3,1,"H"
"14504",1983-03-29,1982,"FC Rouen","Stade Laval","2-2",2,2,"1",1,4,0,"D"
"14505",1983-03-29,1982,"FC Mulhouse","AJ Auxerre","3-2",3,2,"1",1,5,1,"H"
"14506",1983-03-29,1982,"AS Nancy","Toulouse FC","1-2",1,2,"1",1,3,-1,"D"
"14507",1983-03-29,1982,"AS Saint-Etienne","Tours FC","0-0",0,0,"1",1,0,0,"D"
"14508",1983-03-29,1982,"SC Bastia","Olympique Lyon","2-1",2,1,"1",1,3,1,"H"
"14509",1983-04-01,1982,"AJ Auxerre","FC Nantes","1-1",1,1,"1",1,2,0,"D"
"14510",1983-04-01,1982,"Toulouse FC","Girondins Bordeaux","0-1",0,1,"1",1,1,-1,"D"
"14511",1983-04-01,1982,"RC Strasbourg","Paris Saint-Germain","1-1",1,1,"1",1,2,0,"D"
"14512",1983-04-01,1982,"Tours FC","AS Monaco","2-2",2,2,"1",1,4,0,"D"
"14513",1983-04-01,1982,"Stade Laval","SC Bastia","1-0",1,0,"1",1,1,1,"H"
"14514",1983-04-01,1982,"FC Metz","RC Lens","2-1",2,1,"1",1,3,1,"H"
"14515",1983-04-01,1982,"Olympique Lyon","Brest Armorique FC","2-0",2,0,"1",1,2,2,"H"
"14516",1983-04-01,1982,"FC Sochaux","AS Nancy","0-1",0,1,"1",1,1,-1,"D"
"14517",1983-04-01,1982,"Lille OSC","FC Mulhouse","4-0",4,0,"1",1,4,4,"H"
"14518",1983-04-01,1982,"FC Rouen","AS Saint-Etienne","0-1",0,1,"1",1,1,-1,"D"
"14519",1983-04-08,1982,"FC Nantes","FC Sochaux","4-0",4,0,"1",1,4,4,"H"
"14520",1983-04-08,1982,"Girondins Bordeaux","Lille OSC","2-0",2,0,"1",1,2,2,"H"
"14521",1983-04-08,1982,"Paris Saint-Germain","Olympique Lyon","3-0",3,0,"1",1,3,3,"H"
"14522",1983-04-08,1982,"AS Monaco","FC Rouen","2-0",2,0,"1",1,2,2,"H"
"14523",1983-04-08,1982,"RC Lens","Tours FC","2-1",2,1,"1",1,3,1,"H"
"14524",1983-04-08,1982,"Brest Armorique FC","Stade Laval","3-0",3,0,"1",1,3,3,"H"
"14525",1983-04-08,1982,"AS Nancy","AJ Auxerre","3-1",3,1,"1",1,4,2,"H"
"14526",1983-04-08,1982,"FC Mulhouse","Toulouse FC","1-2",1,2,"1",1,3,-1,"D"
"14527",1983-04-08,1982,"SC Bastia","FC Metz","0-3",0,3,"1",1,3,-3,"D"
"14528",1983-04-08,1982,"AS Saint-Etienne","RC Strasbourg","0-0",0,0,"1",1,0,0,"D"
"14529",1983-04-19,1982,"FC Rouen","FC Nantes","1-0",1,0,"1",1,1,1,"H"
"14530",1983-04-19,1982,"RC Strasbourg","Girondins Bordeaux","0-0",0,0,"1",1,0,0,"D"
"14531",1983-04-19,1982,"Stade Laval","Paris Saint-Germain","1-0",1,0,"1",1,1,1,"H"
"14532",1983-04-19,1982,"AS Saint-Etienne","AS Monaco","2-0",2,0,"1",1,2,2,"H"
"14533",1983-04-19,1982,"AJ Auxerre","RC Lens","0-0",0,0,"1",1,0,0,"D"
"14534",1983-04-19,1982,"Tours FC","AS Nancy","1-2",1,2,"1",1,3,-1,"D"
"14535",1983-04-19,1982,"FC Metz","Brest Armorique FC","1-0",1,0,"1",1,1,1,"H"
"14536",1983-04-19,1982,"Toulouse FC","Olympique Lyon","4-1",4,1,"1",1,5,3,"H"
"14537",1983-04-19,1982,"FC Sochaux","FC Mulhouse","1-1",1,1,"1",1,2,0,"D"
"14538",1983-04-19,1982,"Lille OSC","SC Bastia","2-0",2,0,"1",1,2,2,"H"
"14539",1983-04-29,1982,"FC Nantes","Tours FC","2-1",2,1,"1",1,3,1,"H"
"14540",1983-04-29,1982,"Girondins Bordeaux","FC Sochaux","3-1",3,1,"1",1,4,2,"H"
"14541",1983-04-29,1982,"Paris Saint-Germain","Lille OSC","4-1",4,1,"1",1,5,3,"H"
"14542",1983-04-29,1982,"AS Monaco","AJ Auxerre","1-1",1,1,"1",1,2,0,"D"
"14543",1983-04-29,1982,"RC Lens","AS Saint-Etienne","4-2",4,2,"1",1,6,2,"H"
"14544",1983-04-29,1982,"Olympique Lyon","Stade Laval","2-0",2,0,"1",1,2,2,"H"
"14545",1983-04-29,1982,"AS Nancy","FC Rouen","2-0",2,0,"1",1,2,2,"H"
"14546",1983-04-29,1982,"Brest Armorique FC","Toulouse FC","2-2",2,2,"1",1,4,0,"D"
"14547",1983-04-29,1982,"FC Mulhouse","FC Metz","3-4",3,4,"1",1,7,-1,"D"
"14548",1983-04-29,1982,"SC Bastia","RC Strasbourg","1-1",1,1,"1",1,2,0,"D"
"14549",1983-05-06,1982,"AS Monaco","FC Nantes","2-2",2,2,"1",1,4,0,"D"
"14550",1983-05-06,1982,"AJ Auxerre","Girondins Bordeaux","2-2",2,2,"1",1,4,0,"D"
"14551",1983-05-06,1982,"Toulouse FC","Paris Saint-Germain","2-1",2,1,"1",1,3,1,"H"
"14552",1983-05-06,1982,"FC Rouen","RC Lens","1-1",1,1,"1",1,2,0,"D"
"14553",1983-05-06,1982,"RC Strasbourg","Stade Laval","1-2",1,2,"1",1,3,-1,"D"
"14554",1983-05-06,1982,"AS Saint-Etienne","AS Nancy","3-4",3,4,"1",1,7,-1,"D"
"14555",1983-05-06,1982,"FC Metz","Olympique Lyon","4-1",4,1,"1",1,5,3,"H"
"14556",1983-05-06,1982,"Lille OSC","Brest Armorique FC","4-0",4,0,"1",1,4,4,"H"
"14557",1983-05-06,1982,"FC Sochaux","SC Bastia","2-1",2,1,"1",1,3,1,"H"
"14558",1983-05-06,1982,"Tours FC","FC Mulhouse","1-0",1,0,"1",1,1,1,"H"
"14559",1983-05-13,1982,"FC Nantes","AS Saint-Etienne","4-2",4,2,"1",1,6,2,"H"
"14560",1983-05-13,1982,"Girondins Bordeaux","Tours FC","1-0",1,0,"1",1,1,1,"H"
"14561",1983-05-13,1982,"Paris Saint-Germain","FC Metz","3-1",3,1,"1",1,4,2,"H"
"14562",1983-05-13,1982,"RC Lens","FC Sochaux","3-0",3,0,"1",1,3,3,"H"
"14563",1983-05-13,1982,"Stade Laval","Toulouse FC","2-1",2,1,"1",1,3,1,"H"
"14564",1983-05-13,1982,"AS Nancy","AS Monaco","2-1",2,1,"1",1,3,1,"H"
"14565",1983-05-13,1982,"Brest Armorique FC","RC Strasbourg","1-0",1,0,"1",1,1,1,"H"
"14566",1983-05-13,1982,"SC Bastia","AJ Auxerre","1-0",1,0,"1",1,1,1,"H"
"14567",1983-05-13,1982,"Olympique Lyon","Lille OSC","3-1",3,1,"1",1,4,2,"H"
"14568",1983-05-13,1982,"FC Mulhouse","FC Rouen","0-0",0,0,"1",1,0,0,"D"
"14569",1983-05-20,1982,"FC Nantes","AS Nancy","3-1",3,1,"1",1,4,2,"H"
"14570",1983-05-20,1982,"FC Rouen","Girondins Bordeaux","2-1",2,1,"1",1,3,1,"H"
"14571",1983-05-20,1982,"AJ Auxerre","Paris Saint-Germain","3-2",3,2,"1",1,5,1,"H"
"14572",1983-05-20,1982,"AS Monaco","RC Lens","2-1",2,1,"1",1,3,1,"H"
"14573",1983-05-20,1982,"Lille OSC","Stade Laval","0-0",0,0,"1",1,0,0,"D"
"14574",1983-05-20,1982,"FC Metz","Toulouse FC","3-2",3,2,"1",1,5,1,"H"
"14575",1983-05-20,1982,"FC Sochaux","Brest Armorique FC","4-0",4,0,"1",1,4,4,"H"
"14576",1983-05-20,1982,"AS Saint-Etienne","FC Mulhouse","1-0",1,0,"1",1,1,1,"H"
"14577",1983-05-20,1982,"RC Strasbourg","Olympique Lyon","2-0",2,0,"1",1,2,2,"H"
"14578",1983-05-20,1982,"Tours FC","SC Bastia","0-1",0,1,"1",1,1,-1,"D"
"14579",1983-05-24,1982,"RC Lens","FC Nantes","2-2",2,2,"1",1,4,0,"D"
"14580",1983-05-24,1982,"Girondins Bordeaux","AS Saint-Etienne","1-1",1,1,"1",1,2,0,"D"
"14581",1983-05-24,1982,"Paris Saint-Germain","Tours FC","4-2",4,2,"1",1,6,2,"H"
"14582",1983-05-24,1982,"Stade Laval","FC Metz","2-1",2,1,"1",1,3,1,"H"
"14583",1983-05-24,1982,"Brest Armorique FC","AJ Auxerre","2-2",2,2,"1",1,4,0,"D"
"14584",1983-05-24,1982,"Toulouse FC","Lille OSC","3-0",3,0,"1",1,3,3,"H"
"14585",1983-05-24,1982,"Olympique Lyon","FC Sochaux","3-1",3,1,"1",1,4,2,"H"
"14586",1983-05-24,1982,"SC Bastia","FC Rouen","0-0",0,0,"1",1,0,0,"D"
"14587",1983-05-29,1982,"FC Mulhouse","AS Monaco","2-1",2,1,"1",1,3,1,"H"
"14588",1983-05-29,1982,"AS Nancy","RC Strasbourg","2-1",2,1,"1",1,3,1,"H"
"14589",1983-06-03,1982,"FC Nantes","FC Mulhouse","2-1",2,1,"1",1,3,1,"H"
"14590",1983-06-03,1982,"AS Monaco","Girondins Bordeaux","3-1",3,1,"1",1,4,2,"H"
"14591",1983-06-03,1982,"FC Rouen","Paris Saint-Germain","0-1",0,1,"1",1,1,-1,"D"
"14592",1983-06-03,1982,"AS Nancy","RC Lens","1-2",1,2,"1",1,3,-1,"D"
"14593",1983-06-03,1982,"FC Sochaux","Stade Laval","1-1",1,1,"1",1,2,0,"D"
"14594",1983-06-03,1982,"AJ Auxerre","Olympique Lyon","3-1",3,1,"1",1,4,2,"H"
"14595",1983-06-03,1982,"Lille OSC","FC Metz","1-1",1,1,"1",1,2,0,"D"
"14596",1983-06-03,1982,"Tours FC","Brest Armorique FC","2-0",2,0,"1",1,2,2,"H"
"14597",1983-06-03,1982,"RC Strasbourg","Toulouse FC","3-0",3,0,"1",1,3,3,"H"
"14598",1983-06-03,1982,"AS Saint-Etienne","SC Bastia","1-1",1,1,"1",1,2,0,"D"
"14599",1983-07-20,1983,"Girondins Bordeaux","Stade Rennes","4-1",4,1,"1",1,5,3,"H"
"14600",1983-07-20,1983,"FC Sochaux","Nimes Olympique","4-1",4,1,"1",1,5,3,"H"
"14601",1983-07-20,1983,"FC Rouen","AJ Auxerre","2-0",2,0,"1",1,2,2,"H"
"14602",1983-07-20,1983,"RC Lens","FC Metz","3-2",3,2,"1",1,5,1,"H"
"14603",1983-07-20,1983,"AS Nancy","Lille OSC","1-2",1,2,"1",1,3,-1,"D"
"14604",1983-07-20,1983,"Toulouse FC","Paris Saint-Germain","1-1",1,1,"1",1,2,0,"D"
"14605",1983-07-20,1983,"Stade Laval","AS Saint-Etienne","1-1",1,1,"1",1,2,0,"D"
"14606",1983-07-20,1983,"Sporting Toulon Var","Brest Armorique FC","0-0",0,0,"1",1,0,0,"D"
"14607",1983-07-20,1983,"RC Strasbourg","SC Bastia","0-0",0,0,"1",1,0,0,"D"
"14608",1983-07-20,1983,"FC Nantes","AS Monaco","0-0",0,0,"1",1,0,0,"D"
"14609",1983-07-27,1983,"FC Sochaux","Girondins Bordeaux","3-1",3,1,"1",1,4,2,"H"
"14610",1983-07-27,1983,"AS Saint-Etienne","RC Lens","0-4",0,4,"1",1,4,-4,"D"
"14611",1983-07-27,1983,"Stade Rennes","Toulouse FC","1-5",1,5,"1",1,6,-4,"D"
"14612",1983-07-27,1983,"Paris Saint-Germain","Sporting Toulon Var","5-1",5,1,"1",1,6,4,"H"
"14613",1983-07-27,1983,"AS Monaco","Stade Laval","3-0",3,0,"1",1,3,3,"H"
"14614",1983-07-27,1983,"SC Bastia","FC Rouen","0-0",0,0,"1",1,0,0,"D"
"14615",1983-07-27,1983,"Lille OSC","RC Strasbourg","1-1",1,1,"1",1,2,0,"D"
"14616",1983-07-27,1983,"FC Metz","Brest Armorique FC","1-0",1,0,"1",1,1,1,"H"
"14617",1983-07-27,1983,"AJ Auxerre","FC Nantes","1-0",1,0,"1",1,1,1,"H"
"14618",1983-07-27,1983,"Nimes Olympique","AS Nancy","1-1",1,1,"1",1,2,0,"D"
"14619",1983-08-03,1983,"RC Lens","AS Monaco","3-1",3,1,"1",1,4,2,"H"
"14620",1983-08-03,1983,"AS Nancy","FC Sochaux","0-0",0,0,"1",1,0,0,"D"
"14621",1983-08-03,1983,"FC Rouen","Lille OSC","3-1",3,1,"1",1,4,2,"H"
"14622",1983-08-03,1983,"Girondins Bordeaux","Nimes Olympique","4-0",4,0,"1",1,4,4,"H"
"14623",1983-08-03,1983,"Toulouse FC","AJ Auxerre","0-2",0,2,"1",1,2,-2,"D"
"14624",1983-08-03,1983,"FC Nantes","Paris Saint-Germain","3-1",3,1,"1",1,4,2,"H"
"14625",1983-08-03,1983,"Sporting Toulon Var","FC Metz","0-0",0,0,"1",1,0,0,"D"
"14626",1983-08-03,1983,"Brest Armorique FC","AS Saint-Etienne","3-2",3,2,"1",1,5,1,"H"
"14627",1983-08-03,1983,"RC Strasbourg","Stade Rennes","1-1",1,1,"1",1,2,0,"D"
"14628",1983-08-03,1983,"Stade Laval","SC Bastia","1-0",1,0,"1",1,1,1,"H"
"14629",1983-08-10,1983,"FC Sochaux","RC Strasbourg","0-0",0,0,"1",1,0,0,"D"
"14630",1983-08-10,1983,"Paris Saint-Germain","RC Lens","3-0",3,0,"1",1,3,3,"H"
"14631",1983-08-10,1983,"AJ Auxerre","Stade Laval","3-0",3,0,"1",1,3,3,"H"
"14632",1983-08-10,1983,"Lille OSC","Girondins Bordeaux","1-1",1,1,"1",1,2,0,"D"
"14633",1983-08-10,1983,"Nimes Olympique","FC Rouen","2-1",2,1,"1",1,3,1,"H"
"14634",1983-08-10,1983,"AS Monaco","Brest Armorique FC","2-0",2,0,"1",1,2,2,"H"
"14635",1983-08-10,1983,"AS Nancy","FC Nantes","0-1",0,1,"1",1,1,-1,"D"
"14636",1983-08-10,1983,"AS Saint-Etienne","FC Metz","2-2",2,2,"1",1,4,0,"D"
"14637",1983-08-10,1983,"SC Bastia","Toulouse FC","3-2",3,2,"1",1,5,1,"H"
"14638",1983-08-10,1983,"Stade Rennes","Sporting Toulon Var","1-2",1,2,"1",1,3,-1,"D"
"14639",1983-08-17,1983,"RC Lens","AJ Auxerre","1-3",1,3,"1",1,4,-2,"D"
"14640",1983-08-17,1983,"FC Metz","AS Monaco","0-4",0,4,"1",1,4,-4,"D"
"14641",1983-08-17,1983,"Girondins Bordeaux","AS Nancy","2-1",2,1,"1",1,3,1,"H"
"14642",1983-08-17,1983,"FC Rouen","FC Sochaux","1-0",1,0,"1",1,1,1,"H"
"14643",1983-08-17,1983,"FC Nantes","Stade Rennes","3-1",3,1,"1",1,4,2,"H"
"14644",1983-08-17,1983,"RC Strasbourg","Nimes Olympique","1-0",1,0,"1",1,1,1,"H"
"14645",1983-08-17,1983,"Stade Laval","Paris Saint-Germain","2-0",2,0,"1",1,2,2,"H"
"14646",1983-08-17,1983,"Toulouse FC","Lille OSC","2-1",2,1,"1",1,3,1,"H"
"14647",1983-08-17,1983,"Brest Armorique FC","SC Bastia","3-0",3,0,"1",1,3,3,"H"
"14648",1983-08-17,1983,"Sporting Toulon Var","AS Saint-Etienne","0-1",0,1,"1",1,1,-1,"D"
"14649",1983-08-20,1983,"AJ Auxerre","Brest Armorique FC","5-0",5,0,"1",1,5,5,"H"
"14650",1983-08-20,1983,"AS Monaco","AS Saint-Etienne","3-1",3,1,"1",1,4,2,"H"
"14651",1983-08-20,1983,"Girondins Bordeaux","Sporting Toulon Var","1-0",1,0,"1",1,1,1,"H"
"14652",1983-08-20,1983,"Paris Saint-Germain","FC Metz","2-0",2,0,"1",1,2,2,"H"
"14653",1983-08-20,1983,"Stade Rennes","FC Rouen","2-1",2,1,"1",1,3,1,"H"
"14654",1983-08-20,1983,"SC Bastia","RC Lens","2-2",2,2,"1",1,4,0,"D"
"14655",1983-08-20,1983,"Lille OSC","FC Nantes","2-0",2,0,"1",1,2,2,"H"
"14656",1983-08-20,1983,"FC Sochaux","Stade Laval","0-1",0,1,"1",1,1,-1,"D"
"14657",1983-08-20,1983,"AS Nancy","RC Strasbourg","3-2",3,2,"1",1,5,1,"H"
"14658",1983-08-20,1983,"Nimes Olympique","Toulouse FC","3-0",3,0,"1",1,3,3,"H"
"14659",1983-08-31,1983,"FC Metz","AJ Auxerre","1-2",1,2,"1",1,3,-1,"D"
"14660",1983-08-31,1983,"Sporting Toulon Var","AS Monaco","1-3",1,3,"1",1,4,-2,"D"
"14661",1983-08-31,1983,"RC Strasbourg","Girondins Bordeaux","2-2",2,2,"1",1,4,0,"D"
"14662",1983-08-31,1983,"FC Rouen","AS Nancy","7-1",7,1,"1",1,8,6,"H"
"14663",1983-08-31,1983,"FC Nantes","Nimes Olympique","4-0",4,0,"1",1,4,4,"H"
"14664",1983-08-31,1983,"Stade Laval","Lille OSC","3-1",3,1,"1",1,4,2,"H"
"14665",1983-08-31,1983,"Brest Armorique FC","Paris Saint-Germain","2-2",2,2,"1",1,4,0,"D"
"14666",1983-08-31,1983,"Toulouse FC","FC Sochaux","0-0",0,0,"1",1,0,0,"D"
"14667",1983-08-31,1983,"RC Lens","Stade Rennes","0-1",0,1,"1",1,1,-1,"D"
"14668",1983-08-31,1983,"AS Saint-Etienne","SC Bastia","0-2",0,2,"1",1,2,-2,"D"
"14669",1983-09-10,1983,"AJ Auxerre","AS Saint-Etienne","1-0",1,0,"1",1,1,1,"H"
"14670",1983-09-10,1983,"Paris Saint-Germain","AS Monaco","0-1",0,1,"1",1,1,-1,"D"
"14671",1983-09-10,1983,"Girondins Bordeaux","FC Rouen","3-1",3,1,"1",1,4,2,"H"
"14672",1983-09-10,1983,"FC Sochaux","FC Nantes","0-1",0,1,"1",1,1,-1,"D"
"14673",1983-09-10,1983,"RC Strasbourg","RC Lens","2-1",2,1,"1",1,3,1,"H"
"14674",1983-09-10,1983,"SC Bastia","Sporting Toulon Var","1-0",1,0,"1",1,1,1,"H"
"14675",1983-09-10,1983,"Lille OSC","FC Metz","2-0",2,0,"1",1,2,2,"H"
"14676",1983-09-10,1983,"Stade Rennes","Brest Armorique FC","1-1",1,1,"1",1,2,0,"D"
"14677",1983-09-10,1983,"AS Nancy","Toulouse FC","2-0",2,0,"1",1,2,2,"H"
"14678",1983-09-11,1983,"Nimes Olympique","Stade Laval","3-0",3,0,"1",1,3,3,"H"
"14679",1983-09-17,1983,"AS Monaco","AJ Auxerre","0-1",0,1,"1",1,1,-1,"D"
"14680",1983-09-17,1983,"Toulouse FC","Girondins Bordeaux","1-3",1,3,"1",1,4,-2,"D"
"14681",1983-09-17,1983,"FC Nantes","SC Bastia","1-0",1,0,"1",1,1,1,"H"
"14682",1983-09-17,1983,"Stade Laval","Stade Rennes","2-0",2,0,"1",1,2,2,"H"
"14683",1983-09-17,1983,"FC Rouen","RC Strasbourg","2-2",2,2,"1",1,4,0,"D"
"14684",1983-09-17,1983,"AS Saint-Etienne","Paris Saint-Germain","2-3",2,3,"1",1,5,-1,"D"
"14685",1983-09-17,1983,"RC Lens","Lille OSC","4-2",4,2,"1",1,6,2,"H"
"14686",1983-09-17,1983,"Brest Armorique FC","AS Nancy","1-1",1,1,"1",1,2,0,"D"
"14687",1983-09-17,1983,"FC Metz","FC Sochaux","3-1",3,1,"1",1,4,2,"H"
"14688",1983-09-17,1983,"Sporting Toulon Var","Nimes Olympique","3-1",3,1,"1",1,4,2,"H"
"14689",1983-09-21,1983,"AJ Auxerre","Paris Saint-Germain","1-2",1,2,"1",1,3,-1,"D"
"14690",1983-09-21,1983,"Girondins Bordeaux","FC Nantes","1-0",1,0,"1",1,1,1,"H"
"14691",1983-09-21,1983,"SC Bastia","AS Monaco","0-1",0,1,"1",1,1,-1,"D"
"14692",1983-09-21,1983,"FC Rouen","FC Metz","3-0",3,0,"1",1,3,3,"H"
"14693",1983-09-21,1983,"AS Nancy","Stade Laval","0-0",0,0,"1",1,0,0,"D"
"14694",1983-09-21,1983,"FC Sochaux","RC Lens","2-2",2,2,"1",1,4,0,"D"
"14695",1983-09-21,1983,"Lille OSC","Sporting Toulon Var","4-2",4,2,"1",1,6,2,"H"
"14696",1983-09-21,1983,"RC Strasbourg","Toulouse FC","1-3",1,3,"1",1,4,-2,"D"
"14697",1983-09-21,1983,"Nimes Olympique","Brest Armorique FC","2-2",2,2,"1",1,4,0,"D"
"14698",1983-09-21,1983,"Stade Rennes","AS Saint-Etienne","1-2",1,2,"1",1,3,-1,"D"
"14699",1983-09-24,1983,"Stade Laval","Girondins Bordeaux","0-1",0,1,"1",1,1,-1,"D"
"14700",1983-09-24,1983,"Sporting Toulon Var","AJ Auxerre","1-0",1,0,"1",1,1,1,"H"
"14701",1983-09-24,1983,"AS Monaco","AS Nancy","1-1",1,1,"1",1,2,0,"D"
"14702",1983-09-24,1983,"Paris Saint-Germain","SC Bastia","1-0",1,0,"1",1,1,1,"H"
"14703",1983-09-24,1983,"FC Nantes","RC Strasbourg","1-1",1,1,"1",1,2,0,"D"
"14704",1983-09-24,1983,"Toulouse FC","FC Rouen","2-0",2,0,"1",1,2,2,"H"
"14705",1983-09-24,1983,"RC Lens","Nimes Olympique","0-0",0,0,"1",1,0,0,"D"
"14706",1983-09-24,1983,"Brest Armorique FC","Lille OSC","1-1",1,1,"1",1,2,0,"D"
"14707",1983-09-24,1983,"AS Saint-Etienne","FC Sochaux","1-0",1,0,"1",1,1,1,"H"
"14708",1983-09-24,1983,"FC Metz","Stade Rennes","6-0",6,0,"1",1,6,6,"H"
"14709",1983-10-01,1983,"Girondins Bordeaux","RC Lens","3-2",3,2,"1",1,5,1,"H"
"14710",1983-10-01,1983,"Lille OSC","AS Monaco","1-1",1,1,"1",1,2,0,"D"
"14711",1983-10-01,1983,"SC Bastia","AJ Auxerre","1-0",1,0,"1",1,1,1,"H"
"14712",1983-10-01,1983,"Stade Rennes","Paris Saint-Germain","0-1",0,1,"1",1,1,-1,"D"
"14713",1983-10-01,1983,"Toulouse FC","FC Nantes","3-1",3,1,"1",1,4,2,"H"
"14714",1983-10-01,1983,"FC Rouen","Sporting Toulon Var","1-1",1,1,"1",1,2,0,"D"
"14715",1983-10-01,1983,"RC Strasbourg","Stade Laval","1-0",1,0,"1",1,1,1,"H"
"14716",1983-10-01,1983,"AS Nancy","FC Metz","2-1",2,1,"1",1,3,1,"H"
"14717",1983-10-01,1983,"FC Sochaux","Brest Armorique FC","2-0",2,0,"1",1,2,2,"H"
"14718",1983-10-01,1983,"Nimes Olympique","AS Saint-Etienne","1-1",1,1,"1",1,2,0,"D"
"14719",1983-10-08,1983,"Brest Armorique FC","Girondins Bordeaux","0-0",0,0,"1",1,0,0,"D"
"14720",1983-10-08,1983,"AS Monaco","Nimes Olympique","5-1",5,1,"1",1,6,4,"H"
"14721",1983-10-08,1983,"AJ Auxerre","Stade Rennes","1-0",1,0,"1",1,1,1,"H"
"14722",1983-10-08,1983,"Paris Saint-Germain","FC Sochaux","3-1",3,1,"1",1,4,2,"H"
"14723",1983-10-08,1983,"FC Nantes","FC Rouen","3-0",3,0,"1",1,3,3,"H"
"14724",1983-10-08,1983,"Sporting Toulon Var","RC Strasbourg","1-3",1,3,"1",1,4,-2,"D"
"14725",1983-10-08,1983,"Stade Laval","Toulouse FC","1-0",1,0,"1",1,1,1,"H"
"14726",1983-10-08,1983,"RC Lens","AS Nancy","3-1",3,1,"1",1,4,2,"H"
"14727",1983-10-08,1983,"AS Saint-Etienne","Lille OSC","2-0",2,0,"1",1,2,2,"H"
"14728",1983-10-08,1983,"FC Metz","SC Bastia","1-0",1,0,"1",1,1,1,"H"
"14729",1983-10-14,1983,"Nimes Olympique","Paris Saint-Germain","1-1",1,1,"1",1,2,0,"D"
"14730",1983-10-14,1983,"FC Nantes","RC Lens","0-0",0,0,"1",1,0,0,"D"
"14731",1983-10-14,1983,"FC Rouen","Stade Laval","2-0",2,0,"1",1,2,2,"H"
"14732",1983-10-15,1983,"Girondins Bordeaux","FC Metz","1-1",1,1,"1",1,2,0,"D"
"14733",1983-10-15,1983,"FC Sochaux","AS Monaco","1-1",1,1,"1",1,2,0,"D"
"14734",1983-10-15,1983,"Lille OSC","AJ Auxerre","1-2",1,2,"1",1,3,-1,"D"
"14735",1983-10-15,1983,"RC Strasbourg","Brest Armorique FC","1-0",1,0,"1",1,1,1,"H"
"14736",1983-10-15,1983,"AS Nancy","AS Saint-Etienne","2-0",2,0,"1",1,2,2,"H"
"14737",1983-10-15,1983,"Toulouse FC","Sporting Toulon Var","1-3",1,3,"1",1,4,-2,"D"
"14738",1983-10-15,1983,"Stade Rennes","SC Bastia","4-1",4,1,"1",1,5,3,"H"
"14739",1983-10-22,1983,"AS Saint-Etienne","Girondins Bordeaux","0-2",0,2,"1",1,2,-2,"D"
"14740",1983-10-22,1983,"AS Monaco","Stade Rennes","3-2",3,2,"1",1,5,1,"H"
"14741",1983-10-22,1983,"AJ Auxerre","Nimes Olympique","0-0",0,0,"1",1,0,0,"D"
"14742",1983-10-22,1983,"Paris Saint-Germain","Lille OSC","4-5",4,5,"1",1,9,-1,"D"
"14743",1983-10-22,1983,"Stade Laval","FC Nantes","0-1",0,1,"1",1,1,-1,"D"
"14744",1983-10-22,1983,"FC Metz","RC Strasbourg","0-1",0,1,"1",1,1,-1,"D"
"14745",1983-10-22,1983,"Brest Armorique FC","FC Rouen","1-0",1,0,"1",1,1,1,"H"
"14746",1983-10-22,1983,"RC Lens","Toulouse FC","0-1",0,1,"1",1,1,-1,"D"
"14747",1983-10-22,1983,"Sporting Toulon Var","AS Nancy","0-0",0,0,"1",1,0,0,"D"
"14748",1983-10-22,1983,"SC Bastia","FC Sochaux","0-2",0,2,"1",1,2,-2,"D"
"14749",1983-10-28,1983,"FC Rouen","RC Lens","0-2",0,2,"1",1,2,-2,"D"
"14750",1983-10-28,1983,"Stade Laval","FC Metz","1-0",1,0,"1",1,1,1,"H"
"14751",1983-10-28,1983,"AS Nancy","Paris Saint-Germain","1-2",1,2,"1",1,3,-1,"D"
"14752",1983-10-29,1983,"Girondins Bordeaux","AS Monaco","0-2",0,2,"1",1,2,-2,"D"
"14753",1983-10-29,1983,"FC Sochaux","AJ Auxerre","3-0",3,0,"1",1,3,3,"H"
"14754",1983-10-29,1983,"FC Nantes","Sporting Toulon Var","1-0",1,0,"1",1,1,1,"H"
"14755",1983-10-29,1983,"Lille OSC","Stade Rennes","2-0",2,0,"1",1,2,2,"H"
"14756",1983-10-29,1983,"Toulouse FC","Brest Armorique FC","1-0",1,0,"1",1,1,1,"H"
"14757",1983-10-29,1983,"Nimes Olympique","SC Bastia","0-0",0,0,"1",1,0,0,"D"
"14758",1983-11-01,1983,"RC Strasbourg","AS Saint-Etienne","2-0",2,0,"1",1,2,2,"H"
"14759",1983-11-05,1983,"AS Monaco","RC Strasbourg","1-0",1,0,"1",1,1,1,"H"
"14760",1983-11-05,1983,"Paris Saint-Germain","Girondins Bordeaux","2-1",2,1,"1",1,3,1,"H"
"14761",1983-11-05,1983,"AJ Auxerre","AS Nancy","4-0",4,0,"1",1,4,4,"H"
"14762",1983-11-05,1983,"Brest Armorique FC","FC Nantes","0-1",0,1,"1",1,1,-1,"D"
"14763",1983-11-05,1983,"RC Lens","Stade Laval","2-1",2,1,"1",1,3,1,"H"
"14764",1983-11-05,1983,"SC Bastia","Lille OSC","1-0",1,0,"1",1,1,1,"H"
"14765",1983-11-05,1983,"AS Saint-Etienne","FC Rouen","1-0",1,0,"1",1,1,1,"H"
"14766",1983-11-05,1983,"Sporting Toulon Var","FC Sochaux","1-0",1,0,"1",1,1,1,"H"
"14767",1983-11-05,1983,"Stade Rennes","Nimes Olympique","2-1",2,1,"1",1,3,1,"H"
"14768",1983-11-11,1983,"FC Metz","Toulouse FC","1-3",1,3,"1",1,4,-2,"D"
"14769",1983-11-15,1983,"RC Lens","Sporting Toulon Var","5-1",5,1,"1",1,6,4,"H"
"14770",1983-11-15,1983,"Stade Laval","Brest Armorique FC","2-1",2,1,"1",1,3,1,"H"
"14771",1983-11-16,1983,"FC Rouen","AS Monaco","1-0",1,0,"1",1,1,1,"H"
"14772",1983-11-16,1983,"Girondins Bordeaux","AJ Auxerre","4-1",4,1,"1",1,5,3,"H"
"14773",1983-11-16,1983,"FC Nantes","FC Metz","2-1",2,1,"1",1,3,1,"H"
"14774",1983-11-16,1983,"RC Strasbourg","Paris Saint-Germain","0-0",0,0,"1",1,0,0,"D"
"14775",1983-11-16,1983,"Toulouse FC","AS Saint-Etienne","2-1",2,1,"1",1,3,1,"H"
"14776",1983-11-16,1983,"FC Sochaux","Stade Rennes","1-0",1,0,"1",1,1,1,"H"
"14777",1983-11-16,1983,"Nimes Olympique","Lille OSC","2-2",2,2,"1",1,4,0,"D"
"14778",1983-11-16,1983,"AS Nancy","SC Bastia","1-3",1,3,"1",1,4,-2,"D"
"14779",1983-11-18,1983,"Brest Armorique FC","RC Lens","2-1",2,1,"1",1,3,1,"H"
"14780",1983-11-19,1983,"SC Bastia","Girondins Bordeaux","1-3",1,3,"1",1,4,-2,"D"
"14781",1983-11-19,1983,"AS Monaco","Toulouse FC","2-3",2,3,"1",1,5,-1,"D"
"14782",1983-11-19,1983,"AS Saint-Etienne","FC Nantes","0-0",0,0,"1",1,0,0,"D"
"14783",1983-11-19,1983,"AJ Auxerre","RC Strasbourg","3-0",3,0,"1",1,3,3,"H"
"14784",1983-11-19,1983,"Lille OSC","FC Sochaux","1-2",1,2,"1",1,3,-1,"D"
"14785",1983-11-19,1983,"Sporting Toulon Var","Stade Laval","2-2",2,2,"1",1,4,0,"D"
"14786",1983-11-19,1983,"FC Metz","Nimes Olympique","2-1",2,1,"1",1,3,1,"H"
"14787",1983-11-19,1983,"Stade Rennes","AS Nancy","2-1",2,1,"1",1,3,1,"H"
"14788",1983-11-22,1983,"Paris Saint-Germain","FC Rouen","2-0",2,0,"1",1,2,2,"H"
"14789",1983-11-26,1983,"Girondins Bordeaux","FC Sochaux","3-0",3,0,"1",1,3,3,"H"
"14790",1983-11-26,1983,"FC Nantes","AJ Auxerre","1-2",1,2,"1",1,3,-1,"D"
"14791",1983-11-26,1983,"Stade Laval","AS Monaco","2-0",2,0,"1",1,2,2,"H"
"14792",1983-11-26,1983,"Sporting Toulon Var","Paris Saint-Germain","1-0",1,0,"1",1,1,1,"H"
"14793",1983-11-26,1983,"Toulouse FC","Stade Rennes","3-1",3,1,"1",1,4,2,"H"
"14794",1983-11-26,1983,"RC Strasbourg","Lille OSC","1-1",1,1,"1",1,2,0,"D"
"14795",1983-11-26,1983,"RC Lens","AS Saint-Etienne","2-1",2,1,"1",1,3,1,"H"
"14796",1983-11-26,1983,"FC Rouen","SC Bastia","1-2",1,2,"1",1,3,-1,"D"
"14797",1983-11-26,1983,"Brest Armorique FC","FC Metz","0-2",0,2,"1",1,2,-2,"D"
"14798",1983-11-27,1983,"AS Nancy","Nimes Olympique","2-1",2,1,"1",1,3,1,"H"
"14799",1983-12-02,1983,"AS Monaco","RC Lens","3-1",3,1,"1",1,4,2,"H"
"14800",1983-12-03,1983,"Nimes Olympique","Girondins Bordeaux","1-2",1,2,"1",1,3,-1,"D"
"14801",1983-12-03,1983,"AJ Auxerre","Toulouse FC","1-1",1,1,"1",1,2,0,"D"
"14802",1983-12-03,1983,"Paris Saint-Germain","FC Nantes","0-0",0,0,"1",1,0,0,"D"
"14803",1983-12-03,1983,"Stade Rennes","RC Strasbourg","3-0",3,0,"1",1,3,3,"H"
"14804",1983-12-03,1983,"SC Bastia","Stade Laval","3-0",3,0,"1",1,3,3,"H"
"14805",1983-12-03,1983,"Lille OSC","FC Rouen","0-1",0,1,"1",1,1,-1,"D"
"14806",1983-12-03,1983,"FC Sochaux","AS Nancy","0-1",0,1,"1",1,1,-1,"D"
"14807",1983-12-03,1983,"FC Metz","Sporting Toulon Var","2-0",2,0,"1",1,2,2,"H"
"14808",1983-12-03,1983,"AS Saint-Etienne","Brest Armorique FC","1-0",1,0,"1",1,1,1,"H"
"14809",1983-12-10,1983,"Girondins Bordeaux","Lille OSC","5-2",5,2,"1",1,7,3,"H"
"14810",1983-12-10,1983,"Brest Armorique FC","AS Monaco","0-1",0,1,"1",1,1,-1,"D"
"14811",1983-12-10,1983,"RC Lens","Paris Saint-Germain","0-3",0,3,"1",1,3,-3,"D"
"14812",1983-12-10,1983,"FC Nantes","AS Nancy","2-1",2,1,"1",1,3,1,"H"
"14813",1983-12-10,1983,"Stade Laval","AJ Auxerre","1-0",1,0,"1",1,1,1,"H"
"14814",1983-12-10,1983,"Toulouse FC","SC Bastia","4-0",4,0,"1",1,4,4,"H"
"14815",1983-12-10,1983,"RC Strasbourg","FC Sochaux","0-0",0,0,"1",1,0,0,"D"
"14816",1983-12-10,1983,"FC Rouen","Nimes Olympique","3-0",3,0,"1",1,3,3,"H"
"14817",1983-12-10,1983,"FC Metz","AS Saint-Etienne","1-0",1,0,"1",1,1,1,"H"
"14818",1983-12-10,1983,"Sporting Toulon Var","Stade Rennes","0-1",0,1,"1",1,1,-1,"D"
"14819",1983-12-17,1983,"AS Monaco","FC Metz","2-2",2,2,"1",1,4,0,"D"
"14820",1983-12-17,1983,"Stade Rennes","FC Nantes","1-2",1,2,"1",1,3,-1,"D"
"14821",1983-12-17,1983,"AJ Auxerre","RC Lens","4-0",4,0,"1",1,4,4,"H"
"14822",1983-12-17,1983,"Paris Saint-Germain","Stade Laval","0-0",0,0,"1",1,0,0,"D"
"14823",1983-12-17,1983,"Lille OSC","Toulouse FC","0-0",0,0,"1",1,0,0,"D"
"14824",1983-12-17,1983,"Nimes Olympique","RC Strasbourg","0-3",0,3,"1",1,3,-3,"D"
"14825",1983-12-17,1983,"SC Bastia","Brest Armorique FC","2-1",2,1,"1",1,3,1,"H"
"14826",1983-12-18,1983,"AS Nancy","Girondins Bordeaux","0-2",0,2,"1",1,2,-2,"D"
"14827",1983-12-18,1983,"FC Sochaux","FC Rouen","1-1",1,1,"1",1,2,0,"D"
"14828",1983-12-18,1983,"AS Saint-Etienne","Sporting Toulon Var","1-0",1,0,"1",1,1,1,"H"
"14829",1984-01-14,1983,"Sporting Toulon Var","Girondins Bordeaux","1-0",1,0,"1",1,1,1,"H"
"14830",1984-01-14,1983,"FC Nantes","Lille OSC","2-1",2,1,"1",1,3,1,"H"
"14831",1984-01-14,1983,"FC Metz","Paris Saint-Germain","1-1",1,1,"1",1,2,0,"D"
"14832",1984-01-14,1983,"Brest Armorique FC","AJ Auxerre","2-0",2,0,"1",1,2,2,"H"
"14833",1984-01-14,1983,"Toulouse FC","Nimes Olympique","5-0",5,0,"1",1,5,5,"H"
"14834",1984-01-14,1983,"RC Strasbourg","AS Nancy","1-1",1,1,"1",1,2,0,"D"
"14835",1984-01-14,1983,"Stade Laval","FC Sochaux","1-1",1,1,"1",1,2,0,"D"
"14836",1984-01-14,1983,"FC Rouen","Stade Rennes","1-0",1,0,"1",1,1,1,"H"
"14837",1984-01-14,1983,"RC Lens","SC Bastia","1-0",1,0,"1",1,1,1,"H"
"14838",1984-01-15,1983,"AS Saint-Etienne","AS Monaco","0-1",0,1,"1",1,1,-1,"D"
"14839",1984-01-21,1983,"Girondins Bordeaux","RC Strasbourg","2-0",2,0,"1",1,2,2,"H"
"14840",1984-01-21,1983,"AS Monaco","Sporting Toulon Var","1-0",1,0,"1",1,1,1,"H"
"14841",1984-01-21,1983,"Nimes Olympique","FC Nantes","1-0",1,0,"1",1,1,1,"H"
"14842",1984-01-21,1983,"AJ Auxerre","FC Metz","6-1",6,1,"1",1,7,5,"H"
"14843",1984-01-21,1983,"Stade Rennes","RC Lens","1-1",1,1,"1",1,2,0,"D"
"14844",1984-01-21,1983,"Lille OSC","Stade Laval","1-0",1,0,"1",1,1,1,"H"
"14845",1984-01-21,1983,"AS Nancy","FC Rouen","2-0",2,0,"1",1,2,2,"H"
"14846",1984-01-21,1983,"SC Bastia","AS Saint-Etienne","2-1",2,1,"1",1,3,1,"H"
"14847",1984-01-24,1983,"Paris Saint-Germain","Brest Armorique FC","1-1",1,1,"1",1,2,0,"D"
"14848",1984-02-04,1983,"FC Rouen","Girondins Bordeaux","1-0",1,0,"1",1,1,1,"H"
"14849",1984-02-04,1983,"AS Monaco","Paris Saint-Germain","0-1",0,1,"1",1,1,-1,"D"
"14850",1984-02-04,1983,"FC Nantes","FC Sochaux","1-1",1,1,"1",1,2,0,"D"
"14851",1984-02-04,1983,"AS Saint-Etienne","AJ Auxerre","0-0",0,0,"1",1,0,0,"D"
"14852",1984-02-04,1983,"Toulouse FC","AS Nancy","1-0",1,0,"1",1,1,1,"H"
"14853",1984-02-04,1983,"RC Lens","RC Strasbourg","2-2",2,2,"1",1,4,0,"D"
"14854",1984-02-04,1983,"Stade Laval","Nimes Olympique","1-0",1,0,"1",1,1,1,"H"
"14855",1984-02-04,1983,"Sporting Toulon Var","SC Bastia","1-0",1,0,"1",1,1,1,"H"
"14856",1984-02-04,1983,"FC Metz","Lille OSC","1-0",1,0,"1",1,1,1,"H"
"14857",1984-02-04,1983,"Brest Armorique FC","Stade Rennes","1-1",1,1,"1",1,2,0,"D"
"14858",1984-02-11,1983,"Girondins Bordeaux","Toulouse FC","0-0",0,0,"1",1,0,0,"D"
"14859",1984-02-11,1983,"AJ Auxerre","AS Monaco","0-0",0,0,"1",1,0,0,"D"
"14860",1984-02-11,1983,"Paris Saint-Germain","AS Saint-Etienne","3-1",3,1,"1",1,4,2,"H"
"14861",1984-02-11,1983,"SC Bastia","FC Nantes","1-0",1,0,"1",1,1,1,"H"
"14862",1984-02-11,1983,"Stade Rennes","Stade Laval","1-1",1,1,"1",1,2,0,"D"
"14863",1984-02-11,1983,"Lille OSC","RC Lens","3-1",3,1,"1",1,4,2,"H"
"14864",1984-02-11,1983,"FC Sochaux","FC Metz","2-0",2,0,"1",1,2,2,"H"
"14865",1984-02-11,1983,"Nimes Olympique","Sporting Toulon Var","1-0",1,0,"1",1,1,1,"H"
"14866",1984-02-12,1983,"AS Nancy","Brest Armorique FC","1-1",1,1,"1",1,2,0,"D"
"14867",1984-02-25,1983,"FC Nantes","Girondins Bordeaux","0-1",0,1,"1",1,1,-1,"D"
"14868",1984-02-25,1983,"AS Monaco","SC Bastia","1-0",1,0,"1",1,1,1,"H"
"14869",1984-02-25,1983,"Paris Saint-Germain","AJ Auxerre","1-2",1,2,"1",1,3,-1,"D"
"14870",1984-02-25,1983,"Toulouse FC","RC Strasbourg","1-0",1,0,"1",1,1,1,"H"
"14871",1984-02-25,1983,"Stade Laval","AS Nancy","1-1",1,1,"1",1,2,0,"D"
"14872",1984-02-25,1983,"RC Lens","FC Sochaux","1-0",1,0,"1",1,1,1,"H"
"14873",1984-02-25,1983,"FC Metz","FC Rouen","1-1",1,1,"1",1,2,0,"D"
"14874",1984-02-25,1983,"Sporting Toulon Var","Lille OSC","0-3",0,3,"1",1,3,-3,"D"
"14875",1984-02-25,1983,"Brest Armorique FC","Nimes Olympique","2-0",2,0,"1",1,2,2,"H"
"14876",1984-02-25,1983,"AS Saint-Etienne","Stade Rennes","1-0",1,0,"1",1,1,1,"H"
"14877",1984-03-03,1983,"Girondins Bordeaux","Stade Laval","0-0",0,0,"1",1,0,0,"D"
"14878",1984-03-03,1983,"AS Nancy","AS Monaco","1-1",1,1,"1",1,2,0,"D"
"14879",1984-03-03,1983,"AJ Auxerre","Sporting Toulon Var","1-1",1,1,"1",1,2,0,"D"
"14880",1984-03-03,1983,"SC Bastia","Paris Saint-Germain","1-1",1,1,"1",1,2,0,"D"
"14881",1984-03-03,1983,"FC Rouen","Toulouse FC","3-1",3,1,"1",1,4,2,"H"
"14882",1984-03-03,1983,"Nimes Olympique","RC Lens","2-1",2,1,"1",1,3,1,"H"
"14883",1984-03-03,1983,"Lille OSC","Brest Armorique FC","2-1",2,1,"1",1,3,1,"H"
"14884",1984-03-03,1983,"Stade Rennes","FC Metz","1-2",1,2,"1",1,3,-1,"D"
"14885",1984-03-07,1983,"FC Sochaux","Toulouse FC","1-0",1,0,"1",1,1,1,"H"
"14886",1984-03-10,1983,"RC Lens","Girondins Bordeaux","3-1",3,1,"1",1,4,2,"H"
"14887",1984-03-10,1983,"AS Monaco","Lille OSC","1-1",1,1,"1",1,2,0,"D"
"14888",1984-03-10,1983,"Paris Saint-Germain","Stade Rennes","3-2",3,2,"1",1,5,1,"H"
"14889",1984-03-10,1983,"AJ Auxerre","SC Bastia","1-1",1,1,"1",1,2,0,"D"
"14890",1984-03-10,1983,"FC Nantes","Toulouse FC","3-1",3,1,"1",1,4,2,"H"
"14891",1984-03-10,1983,"Stade Laval","RC Strasbourg","1-1",1,1,"1",1,2,0,"D"
"14892",1984-03-10,1983,"Sporting Toulon Var","FC Rouen","1-0",1,0,"1",1,1,1,"H"
"14893",1984-03-10,1983,"Brest Armorique FC","FC Sochaux","0-0",0,0,"1",1,0,0,"D"
"14894",1984-03-10,1983,"FC Metz","AS Nancy","1-2",1,2,"1",1,3,-1,"D"
"14895",1984-03-10,1983,"AS Saint-Etienne","Nimes Olympique","3-1",3,1,"1",1,4,2,"H"
"14896",1984-03-14,1983,"Girondins Bordeaux","Brest Armorique FC","1-1",1,1,"1",1,2,0,"D"
"14897",1984-03-14,1983,"Nimes Olympique","AS Monaco","1-2",1,2,"1",1,3,-1,"D"
"14898",1984-03-14,1983,"Stade Rennes","AJ Auxerre","1-3",1,3,"1",1,4,-2,"D"
"14899",1984-03-14,1983,"FC Sochaux","Paris Saint-Germain","2-1",2,1,"1",1,3,1,"H"
"14900",1984-03-14,1983,"Toulouse FC","Stade Laval","0-0",0,0,"1",1,0,0,"D"
"14901",1984-03-14,1983,"FC Rouen","FC Nantes","2-0",2,0,"1",1,2,2,"H"
"14902",1984-03-14,1983,"RC Strasbourg","Sporting Toulon Var","2-0",2,0,"1",1,2,2,"H"
"14903",1984-03-14,1983,"AS Nancy","RC Lens","2-0",2,0,"1",1,2,2,"H"
"14904",1984-03-14,1983,"SC Bastia","FC Metz","1-0",1,0,"1",1,1,1,"H"
"14905",1984-03-14,1983,"Lille OSC","AS Saint-Etienne","1-1",1,1,"1",1,2,0,"D"
"14906",1984-03-24,1983,"FC Metz","Girondins Bordeaux","0-0",0,0,"1",1,0,0,"D"
"14907",1984-03-24,1983,"AS Monaco","FC Sochaux","1-1",1,1,"1",1,2,0,"D"
"14908",1984-03-24,1983,"AJ Auxerre","Lille OSC","2-0",2,0,"1",1,2,2,"H"
"14909",1984-03-24,1983,"Paris Saint-Germain","Nimes Olympique","0-0",0,0,"1",1,0,0,"D"
"14910",1984-03-24,1983,"RC Lens","FC Nantes","2-2",2,2,"1",1,4,0,"D"
"14911",1984-03-24,1983,"Sporting Toulon Var","Toulouse FC","3-2",3,2,"1",1,5,1,"H"
"14912",1984-03-24,1983,"Stade Laval","FC Rouen","0-0",0,0,"1",1,0,0,"D"
"14913",1984-03-24,1983,"Brest Armorique FC","RC Strasbourg","0-0",0,0,"1",1,0,0,"D"
"14914",1984-03-24,1983,"SC Bastia","Stade Rennes","2-1",2,1,"1",1,3,1,"H"
"14915",1984-03-24,1983,"AS Saint-Etienne","AS Nancy","1-0",1,0,"1",1,1,1,"H"
"14916",1984-03-27,1983,"RC Strasbourg","FC Rouen","0-0",0,0,"1",1,0,0,"D"
"14917",1984-03-27,1983,"FC Sochaux","AS Saint-Etienne","1-1",1,1,"1",1,2,0,"D"
"14918",1984-03-31,1983,"Girondins Bordeaux","AS Saint-Etienne","7-0",7,0,"1",1,7,7,"H"
"14919",1984-03-31,1983,"Stade Rennes","AS Monaco","1-2",1,2,"1",1,3,-1,"D"
"14920",1984-03-31,1983,"Nimes Olympique","AJ Auxerre","1-1",1,1,"1",1,2,0,"D"
"14921",1984-03-31,1983,"Lille OSC","Paris Saint-Germain","1-0",1,0,"1",1,1,1,"H"
"14922",1984-03-31,1983,"FC Nantes","Stade Laval","3-1",3,1,"1",1,4,2,"H"
"14923",1984-03-31,1983,"Toulouse FC","RC Lens","2-0",2,0,"1",1,2,2,"H"
"14924",1984-03-31,1983,"FC Sochaux","SC Bastia","2-0",2,0,"1",1,2,2,"H"
"14925",1984-03-31,1983,"RC Strasbourg","FC Metz","0-0",0,0,"1",1,0,0,"D"
"14926",1984-03-31,1983,"FC Rouen","Brest Armorique FC","0-1",0,1,"1",1,1,-1,"D"
"14927",1984-03-31,1983,"AS Nancy","Sporting Toulon Var","2-2",2,2,"1",1,4,0,"D"
"14928",1984-04-06,1983,"AS Saint-Etienne","RC Strasbourg","0-1",0,1,"1",1,1,-1,"D"
"14929",1984-04-07,1983,"AS Monaco","Girondins Bordeaux","2-1",2,1,"1",1,3,1,"H"
"14930",1984-04-07,1983,"AJ Auxerre","FC Sochaux","2-0",2,0,"1",1,2,2,"H"
"14931",1984-04-07,1983,"Paris Saint-Germain","AS Nancy","1-1",1,1,"1",1,2,0,"D"
"14932",1984-04-07,1983,"Brest Armorique FC","Toulouse FC","0-1",0,1,"1",1,1,-1,"D"
"14933",1984-04-07,1983,"Sporting Toulon Var","FC Nantes","1-1",1,1,"1",1,2,0,"D"
"14934",1984-04-07,1983,"Stade Rennes","Lille OSC","0-0",0,0,"1",1,0,0,"D"
"14935",1984-04-07,1983,"FC Metz","Stade Laval","0-0",0,0,"1",1,0,0,"D"
"14936",1984-04-07,1983,"RC Lens","FC Rouen","4-2",4,2,"1",1,6,2,"H"
"14937",1984-04-07,1983,"SC Bastia","Nimes Olympique","1-1",1,1,"1",1,2,0,"D"
"14938",1984-04-14,1983,"RC Strasbourg","AS Monaco","0-1",0,1,"1",1,1,-1,"D"
"14939",1984-04-14,1983,"Girondins Bordeaux","Paris Saint-Germain","2-1",2,1,"1",1,3,1,"H"
"14940",1984-04-14,1983,"AS Nancy","AJ Auxerre","0-1",0,1,"1",1,1,-1,"D"
"14941",1984-04-14,1983,"FC Nantes","Brest Armorique FC","4-0",4,0,"1",1,4,4,"H"
"14942",1984-04-14,1983,"Toulouse FC","FC Metz","3-1",3,1,"1",1,4,2,"H"
"14943",1984-04-14,1983,"FC Sochaux","Sporting Toulon Var","8-2",8,2,"1",1,10,6,"H"
"14944",1984-04-14,1983,"Stade Laval","RC Lens","3-0",3,0,"1",1,3,3,"H"
"14945",1984-04-14,1983,"FC Rouen","AS Saint-Etienne","1-1",1,1,"1",1,2,0,"D"
"14946",1984-04-14,1983,"Lille OSC","SC Bastia","0-0",0,0,"1",1,0,0,"D"
"14947",1984-04-14,1983,"Nimes Olympique","Stade Rennes","1-1",1,1,"1",1,2,0,"D"
"14948",1984-04-19,1983,"FC Metz","FC Nantes","2-1",2,1,"1",1,3,1,"H"
"14949",1984-04-21,1983,"AS Monaco","FC Rouen","1-0",1,0,"1",1,1,1,"H"
"14950",1984-04-21,1983,"AJ Auxerre","Girondins Bordeaux","1-4",1,4,"1",1,5,-3,"D"
"14951",1984-04-21,1983,"AS Saint-Etienne","Toulouse FC","0-1",0,1,"1",1,1,-1,"D"
"14952",1984-04-21,1983,"Stade Rennes","FC Sochaux","0-1",0,1,"1",1,1,-1,"D"
"14953",1984-04-21,1983,"Brest Armorique FC","Stade Laval","1-0",1,0,"1",1,1,1,"H"
"14954",1984-04-21,1983,"Lille OSC","Nimes Olympique","1-0",1,0,"1",1,1,1,"H"
"14955",1984-04-21,1983,"SC Bastia","AS Nancy","0-1",0,1,"1",1,1,-1,"D"
"14956",1984-04-21,1983,"Sporting Toulon Var","RC Lens","3-0",3,0,"1",1,3,3,"H"
"14957",1984-04-22,1983,"RC Strasbourg","FC Nantes","0-0",0,0,"1",1,0,0,"D"
"14958",1984-04-25,1983,"Paris Saint-Germain","RC Strasbourg","2-0",2,0,"1",1,2,2,"H"
"14959",1984-04-28,1983,"Girondins Bordeaux","SC Bastia","2-1",2,1,"1",1,3,1,"H"
"14960",1984-04-28,1983,"Toulouse FC","AS Monaco","1-1",1,1,"1",1,2,0,"D"
"14961",1984-04-28,1983,"RC Strasbourg","AJ Auxerre","2-1",2,1,"1",1,3,1,"H"
"14962",1984-04-28,1983,"FC Rouen","Paris Saint-Germain","0-1",0,1,"1",1,1,-1,"D"
"14963",1984-04-28,1983,"FC Nantes","AS Saint-Etienne","1-0",1,0,"1",1,1,1,"H"
"14964",1984-04-28,1983,"FC Sochaux","Lille OSC","1-0",1,0,"1",1,1,1,"H"
"14965",1984-04-28,1983,"Stade Laval","Sporting Toulon Var","0-2",0,2,"1",1,2,-2,"D"
"14966",1984-04-28,1983,"RC Lens","Brest Armorique FC","3-2",3,2,"1",1,5,1,"H"
"14967",1984-04-28,1983,"Nimes Olympique","FC Metz","3-7",3,7,"1",1,10,-4,"D"
"14968",1984-04-28,1983,"AS Nancy","Stade Rennes","1-3",1,3,"1",1,4,-2,"D"
"14969",1984-05-02,1983,"Stade Rennes","Girondins Bordeaux","0-2",0,2,"1",1,2,-2,"D"
"14970",1984-05-02,1983,"AS Monaco","FC Nantes","3-0",3,0,"1",1,3,3,"H"
"14971",1984-05-02,1983,"AJ Auxerre","FC Rouen","1-0",1,0,"1",1,1,1,"H"
"14972",1984-05-02,1983,"Paris Saint-Germain","Toulouse FC","1-0",1,0,"1",1,1,1,"H"
"14973",1984-05-02,1983,"Nimes Olympique","FC Sochaux","2-2",2,2,"1",1,4,0,"D"
"14974",1984-05-02,1983,"SC Bastia","RC Strasbourg","4-2",4,2,"1",1,6,2,"H"
"14975",1984-05-02,1983,"Lille OSC","AS Nancy","2-0",2,0,"1",1,2,2,"H"
"14976",1984-05-02,1983,"AS Saint-Etienne","Stade Laval","1-0",1,0,"1",1,1,1,"H"
"14977",1984-05-02,1983,"FC Metz","RC Lens","3-0",3,0,"1",1,3,3,"H"
"14978",1984-05-02,1983,"Brest Armorique FC","Sporting Toulon Var","5-2",5,2,"1",1,7,3,"H"
"14979",1984-08-17,1984,"Paris Saint-Germain","AS Nancy","2-4",2,4,"1",1,6,-2,"D"
"14980",1984-08-17,1984,"Olympique Marseille","FC Sochaux","3-1",3,1,"1",1,4,2,"H"
"14981",1984-08-17,1984,"FC Nantes","Sporting Toulon Var","3-1",3,1,"1",1,4,2,"H"
"14982",1984-08-17,1984,"AJ Auxerre","RC Strasbourg","2-0",2,0,"1",1,2,2,"H"
"14983",1984-08-17,1984,"FC Metz","Racing Club de France","2-0",2,0,"1",1,2,2,"H"
"14984",1984-08-17,1984,"Girondins Bordeaux","Toulouse FC","2-1",2,1,"1",1,3,1,"H"
"14985",1984-08-17,1984,"RC Lens","FC Rouen","1-0",1,0,"1",1,1,1,"H"
"14986",1984-08-17,1984,"SC Bastia","AS Monaco","1-0",1,0,"1",1,1,1,"H"
"14987",1984-08-17,1984,"Tours FC","Stade Laval","1-1",1,1,"1",1,2,0,"D"
"14988",1984-08-17,1984,"Brest Armorique FC","Lille OSC","0-0",0,0,"1",1,0,0,"D"
"14989",1984-08-21,1984,"FC Nantes","Olympique Marseille","3-0",3,0,"1",1,3,3,"H"
"14990",1984-08-21,1984,"AS Nancy","Girondins Bordeaux","0-1",0,1,"1",1,1,-1,"D"
"14991",1984-08-21,1984,"Lille OSC","Paris Saint-Germain","3-1",3,1,"1",1,4,2,"H"
"14992",1984-08-21,1984,"Stade Laval","AJ Auxerre","2-1",2,1,"1",1,3,1,"H"
"14993",1984-08-21,1984,"AS Monaco","Tours FC","4-0",4,0,"1",1,4,4,"H"
"14994",1984-08-21,1984,"Toulouse FC","SC Bastia","3-0",3,0,"1",1,3,3,"H"
"14995",1984-08-21,1984,"RC Strasbourg","FC Metz","4-1",4,1,"1",1,5,3,"H"
"14996",1984-08-21,1984,"Racing Club de France","RC Lens","2-1",2,1,"1",1,3,1,"H"
"14997",1984-08-21,1984,"Sporting Toulon Var","Brest Armorique FC","2-1",2,1,"1",1,3,1,"H"
"14998",1984-08-21,1984,"FC Rouen","FC Sochaux","1-1",1,1,"1",1,2,0,"D"
"14999",1984-08-24,1984,"Girondins Bordeaux","Lille OSC","2-0",2,0,"1",1,2,2,"H"
"15000",1984-08-24,1984,"FC Metz","Stade Laval","0-2",0,2,"1",1,2,-2,"D"
"15001",1984-08-24,1984,"Brest Armorique FC","FC Nantes","4-2",4,2,"1",1,6,2,"H"
"15002",1984-08-24,1984,"AJ Auxerre","AS Monaco","2-0",2,0,"1",1,2,2,"H"
"15003",1984-08-24,1984,"Olympique Marseille","FC Rouen","3-2",3,2,"1",1,5,1,"H"
"15004",1984-08-24,1984,"FC Sochaux","Racing Club de France","6-1",6,1,"1",1,7,5,"H"
"15005",1984-08-24,1984,"Tours FC","Toulouse FC","2-2",2,2,"1",1,4,0,"D"
"15006",1984-08-24,1984,"SC Bastia","AS Nancy","1-1",1,1,"1",1,2,0,"D"
"15007",1984-08-24,1984,"RC Lens","RC Strasbourg","0-0",0,0,"1",1,0,0,"D"
"15008",1984-08-24,1984,"Paris Saint-Germain","Sporting Toulon Var","0-0",0,0,"1",1,0,0,"D"
"15009",1984-08-28,1984,"Sporting Toulon Var","Girondins Bordeaux","1-2",1,2,"1",1,3,-1,"D"
"15010",1984-08-28,1984,"FC Nantes","Paris Saint-Germain","2-0",2,0,"1",1,2,2,"H"
"15011",1984-08-28,1984,"Toulouse FC","AJ Auxerre","1-3",1,3,"1",1,4,-2,"D"
"15012",1984-08-28,1984,"Brest Armorique FC","Olympique Marseille","3-0",3,0,"1",1,3,3,"H"
"15013",1984-08-28,1984,"RC Strasbourg","FC Sochaux","4-2",4,2,"1",1,6,2,"H"
"15014",1984-08-28,1984,"AS Nancy","Tours FC","1-0",1,0,"1",1,1,1,"H"
"15015",1984-08-28,1984,"Stade Laval","RC Lens","1-3",1,3,"1",1,4,-2,"D"
"15016",1984-08-28,1984,"Lille OSC","SC Bastia","1-2",1,2,"1",1,3,-1,"D"
"15017",1984-08-28,1984,"AS Monaco","FC Metz","7-0",7,0,"1",1,7,7,"H"
"15018",1984-08-28,1984,"Racing Club de France","FC Rouen","1-0",1,0,"1",1,1,1,"H"
"15019",1984-08-31,1984,"Girondins Bordeaux","FC Nantes","2-1",2,1,"1",1,3,1,"H"
"15020",1984-08-31,1984,"AJ Auxerre","AS Nancy","1-0",1,0,"1",1,1,1,"H"
"15021",1984-08-31,1984,"SC Bastia","Sporting Toulon Var","3-2",3,2,"1",1,5,1,"H"
"15022",1984-08-31,1984,"Paris Saint-Germain","Brest Armorique FC","1-1",1,1,"1",1,2,0,"D"
"15023",1984-08-31,1984,"RC Lens","AS Monaco","2-2",2,2,"1",1,4,0,"D"
"15024",1984-08-31,1984,"Olympique Marseille","Racing Club de France","0-2",0,2,"1",1,2,-2,"D"
"15025",1984-08-31,1984,"FC Sochaux","Stade Laval","2-0",2,0,"1",1,2,2,"H"
"15026",1984-08-31,1984,"FC Rouen","RC Strasbourg","1-0",1,0,"1",1,1,1,"H"
"15027",1984-08-31,1984,"Tours FC","Lille OSC","2-0",2,0,"1",1,2,2,"H"
"15028",1984-08-31,1984,"FC Metz","Toulouse FC","2-1",2,1,"1",1,3,1,"H"
"15029",1984-09-07,1984,"RC Strasbourg","Racing Club de France","3-0",3,0,"1",1,3,3,"H"
"15030",1984-09-07,1984,"AS Nancy","FC Metz","2-1",2,1,"1",1,3,1,"H"
"15031",1984-09-07,1984,"Sporting Toulon Var","Tours FC","2-0",2,0,"1",1,2,2,"H"
"15032",1984-09-08,1984,"Brest Armorique FC","Girondins Bordeaux","0-0",0,0,"1",1,0,0,"D"
"15033",1984-09-08,1984,"Lille OSC","AJ Auxerre","1-1",1,1,"1",1,2,0,"D"
"15034",1984-09-08,1984,"FC Nantes","SC Bastia","3-0",3,0,"1",1,3,3,"H"
"15035",1984-09-08,1984,"AS Monaco","FC Sochaux","2-0",2,0,"1",1,2,2,"H"
"15036",1984-09-08,1984,"Stade Laval","FC Rouen","2-0",2,0,"1",1,2,2,"H"
"15037",1984-09-08,1984,"Paris Saint-Germain","Olympique Marseille","2-1",2,1,"1",1,3,1,"H"
"15038",1984-09-11,1984,"Toulouse FC","RC Lens","1-0",1,0,"1",1,1,1,"H"
"15039",1984-09-11,1984,"Girondins Bordeaux","Paris Saint-Germain","3-1",3,1,"1",1,4,2,"H"
"15040",1984-09-11,1984,"AJ Auxerre","Sporting Toulon Var","1-1",1,1,"1",1,2,0,"D"
"15041",1984-09-11,1984,"SC Bastia","Brest Armorique FC","2-0",2,0,"1",1,2,2,"H"
"15042",1984-09-11,1984,"Racing Club de France","Stade Laval","2-0",2,0,"1",1,2,2,"H"
"15043",1984-09-11,1984,"FC Rouen","AS Monaco","2-1",2,1,"1",1,3,1,"H"
"15044",1984-09-11,1984,"Olympique Marseille","RC Strasbourg","2-1",2,1,"1",1,3,1,"H"
"15045",1984-09-11,1984,"FC Metz","Lille OSC","2-0",2,0,"1",1,2,2,"H"
"15046",1984-09-14,1984,"Tours FC","FC Nantes","0-1",0,1,"1",1,1,-1,"D"
"15047",1984-09-14,1984,"RC Lens","AS Nancy","3-0",3,0,"1",1,3,3,"H"
"15048",1984-09-14,1984,"FC Sochaux","Toulouse FC","0-1",0,1,"1",1,1,-1,"D"
"15049",1984-09-21,1984,"Stade Laval","RC Strasbourg","2-1",2,1,"1",1,3,1,"H"
"15050",1984-09-21,1984,"Brest Armorique FC","Tours FC","3-3",3,3,"1",1,6,0,"D"
"15051",1984-09-21,1984,"Lille OSC","RC Lens","2-0",2,0,"1",1,2,2,"H"
"15052",1984-09-21,1984,"Toulouse FC","FC Rouen","1-1",1,1,"1",1,2,0,"D"
"15053",1984-09-21,1984,"AS Nancy","FC Sochaux","2-2",2,2,"1",1,4,0,"D"
"15054",1984-09-22,1984,"Girondins Bordeaux","Olympique Marseille","4-1",4,1,"1",1,5,3,"H"
"15055",1984-09-22,1984,"FC Nantes","AJ Auxerre","2-1",2,1,"1",1,3,1,"H"
"15056",1984-09-22,1984,"AS Monaco","Racing Club de France","3-0",3,0,"1",1,3,3,"H"
"15057",1984-09-22,1984,"Paris Saint-Germain","SC Bastia","7-1",7,1,"1",1,8,6,"H"
"15058",1984-09-22,1984,"Sporting Toulon Var","FC Metz","0-2",0,2,"1",1,2,-2,"D"
"15059",1984-09-25,1984,"SC Bastia","Girondins Bordeaux","0-0",0,0,"1",1,0,0,"D"
"15060",1984-09-25,1984,"FC Metz","FC Nantes","1-1",1,1,"1",1,2,0,"D"
"15061",1984-09-25,1984,"AJ Auxerre","Brest Armorique FC","3-1",3,1,"1",1,4,2,"H"
"15062",1984-09-25,1984,"RC Strasbourg","AS Monaco","3-3",3,3,"1",1,6,0,"D"
"15063",1984-09-25,1984,"RC Lens","Sporting Toulon Var","3-0",3,0,"1",1,3,3,"H"
"15064",1984-09-25,1984,"FC Rouen","AS Nancy","0-1",0,1,"1",1,1,-1,"D"
"15065",1984-09-25,1984,"Olympique Marseille","Stade Laval","0-0",0,0,"1",1,0,0,"D"
"15066",1984-09-25,1984,"Racing Club de France","Toulouse FC","3-1",3,1,"1",1,4,2,"H"
"15067",1984-09-25,1984,"FC Sochaux","Lille OSC","1-0",1,0,"1",1,1,1,"H"
"15068",1984-09-25,1984,"Tours FC","Paris Saint-Germain","2-3",2,3,"1",1,5,-1,"D"
"15069",1984-09-28,1984,"Girondins Bordeaux","Tours FC","2-1",2,1,"1",1,3,1,"H"
"15070",1984-09-28,1984,"FC Nantes","RC Lens","2-0",2,0,"1",1,2,2,"H"
"15071",1984-09-28,1984,"Paris Saint-Germain","AJ Auxerre","0-0",0,0,"1",1,0,0,"D"
"15072",1984-09-28,1984,"AS Nancy","Racing Club de France","4-0",4,0,"1",1,4,4,"H"
"15073",1984-09-28,1984,"SC Bastia","Olympique Marseille","1-0",1,0,"1",1,1,1,"H"
"15074",1984-09-28,1984,"AS Monaco","Stade Laval","0-0",0,0,"1",1,0,0,"D"
"15075",1984-09-28,1984,"Brest Armorique FC","FC Metz","0-1",0,1,"1",1,1,-1,"D"
"15076",1984-09-28,1984,"Toulouse FC","RC Strasbourg","2-1",2,1,"1",1,3,1,"H"
"15077",1984-09-28,1984,"Sporting Toulon Var","FC Sochaux","1-0",1,0,"1",1,1,1,"H"
"15078",1984-09-28,1984,"Lille OSC","FC Rouen","0-0",0,0,"1",1,0,0,"D"
"15079",1984-10-05,1984,"FC Sochaux","FC Nantes","0-1",0,1,"1",1,1,-1,"D"
"15080",1984-10-05,1984,"RC Strasbourg","AS Nancy","2-1",2,1,"1",1,3,1,"H"
"15081",1984-10-05,1984,"Stade Laval","Toulouse FC","3-3",3,3,"1",1,6,0,"D"
"15082",1984-10-05,1984,"Tours FC","SC Bastia","2-0",2,0,"1",1,2,2,"H"
"15083",1984-10-05,1984,"RC Lens","Brest Armorique FC","1-1",1,1,"1",1,2,0,"D"
"15084",1984-10-05,1984,"Racing Club de France","Lille OSC","2-2",2,2,"1",1,4,0,"D"
"15085",1984-10-05,1984,"FC Rouen","Sporting Toulon Var","1-0",1,0,"1",1,1,1,"H"
"15086",1984-10-06,1984,"AJ Auxerre","Girondins Bordeaux","1-1",1,1,"1",1,2,0,"D"
"15087",1984-10-06,1984,"FC Metz","Paris Saint-Germain","2-1",2,1,"1",1,3,1,"H"
"15088",1984-10-06,1984,"Olympique Marseille","AS Monaco","3-0",3,0,"1",1,3,3,"H"
"15089",1984-10-16,1984,"Girondins Bordeaux","FC Metz","6-0",6,0,"1",1,6,6,"H"
"15090",1984-10-16,1984,"FC Nantes","FC Rouen","2-1",2,1,"1",1,3,1,"H"
"15091",1984-10-16,1984,"SC Bastia","AJ Auxerre","2-2",2,2,"1",1,4,0,"D"
"15092",1984-10-16,1984,"AS Nancy","Stade Laval","2-3",2,3,"1",1,5,-1,"D"
"15093",1984-10-16,1984,"Toulouse FC","AS Monaco","1-2",1,2,"1",1,3,-1,"D"
"15094",1984-10-16,1984,"Paris Saint-Germain","RC Lens","4-3",4,3,"1",1,7,1,"H"
"15095",1984-10-16,1984,"Brest Armorique FC","FC Sochaux","1-0",1,0,"1",1,1,1,"H"
"15096",1984-10-16,1984,"Sporting Toulon Var","Racing Club de France","1-0",1,0,"1",1,1,1,"H"
"15097",1984-10-16,1984,"Lille OSC","RC Strasbourg","3-0",3,0,"1",1,3,3,"H"
"15098",1984-10-16,1984,"Tours FC","Olympique Marseille","2-2",2,2,"1",1,4,0,"D"
"15099",1984-10-19,1984,"RC Lens","Girondins Bordeaux","2-1",2,1,"1",1,3,1,"H"
"15100",1984-10-19,1984,"AJ Auxerre","Tours FC","1-0",1,0,"1",1,1,1,"H"
"15101",1984-10-19,1984,"AS Monaco","AS Nancy","1-0",1,0,"1",1,1,1,"H"
"15102",1984-10-19,1984,"Stade Laval","Lille OSC","1-1",1,1,"1",1,2,0,"D"
"15103",1984-10-19,1984,"FC Metz","SC Bastia","1-0",1,0,"1",1,1,1,"H"
"15104",1984-10-19,1984,"FC Rouen","Brest Armorique FC","2-2",2,2,"1",1,4,0,"D"
"15105",1984-10-19,1984,"RC Strasbourg","Sporting Toulon Var","0-1",0,1,"1",1,1,-1,"D"
"15106",1984-10-19,1984,"Olympique Marseille","Toulouse FC","2-1",2,1,"1",1,3,1,"H"
"15107",1984-10-19,1984,"FC Sochaux","Paris Saint-Germain","4-1",4,1,"1",1,5,3,"H"
"15108",1984-10-20,1984,"Racing Club de France","FC Nantes","1-2",1,2,"1",1,3,-1,"D"
"15109",1984-10-26,1984,"FC Nantes","RC Strasbourg","2-2",2,2,"1",1,4,0,"D"
"15110",1984-10-26,1984,"AJ Auxerre","Olympique Marseille","4-2",4,2,"1",1,6,2,"H"
"15111",1984-10-26,1984,"Lille OSC","AS Monaco","1-1",1,1,"1",1,2,0,"D"
"15112",1984-10-26,1984,"Sporting Toulon Var","Stade Laval","1-1",1,1,"1",1,2,0,"D"
"15113",1984-10-26,1984,"SC Bastia","RC Lens","2-1",2,1,"1",1,3,1,"H"
"15114",1984-10-26,1984,"Brest Armorique FC","Racing Club de France","3-0",3,0,"1",1,3,3,"H"
"15115",1984-10-26,1984,"AS Nancy","Toulouse FC","1-1",1,1,"1",1,2,0,"D"
"15116",1984-10-27,1984,"Paris Saint-Germain","FC Rouen","3-2",3,2,"1",1,5,1,"H"
"15117",1984-10-27,1984,"Girondins Bordeaux","FC Sochaux","1-0",1,0,"1",1,1,1,"H"
"15118",1984-10-27,1984,"Tours FC","FC Metz","2-1",2,1,"1",1,3,1,"H"
"15119",1984-11-01,1984,"RC Strasbourg","Brest Armorique FC","1-1",1,1,"1",1,2,0,"D"
"15120",1984-11-02,1984,"FC Rouen","Girondins Bordeaux","0-0",0,0,"1",1,0,0,"D"
"15121",1984-11-02,1984,"Stade Laval","FC Nantes","0-1",0,1,"1",1,1,-1,"D"
"15122",1984-11-02,1984,"FC Metz","AJ Auxerre","2-1",2,1,"1",1,3,1,"H"
"15123",1984-11-02,1984,"AS Monaco","Sporting Toulon Var","0-2",0,2,"1",1,2,-2,"D"
"15124",1984-11-02,1984,"RC Lens","Tours FC","6-1",6,1,"1",1,7,5,"H"
"15125",1984-11-02,1984,"Olympique Marseille","AS Nancy","0-1",0,1,"1",1,1,-1,"D"
"15126",1984-11-02,1984,"Racing Club de France","Paris Saint-Germain","0-1",0,1,"1",1,1,-1,"D"
"15127",1984-11-02,1984,"FC Sochaux","SC Bastia","4-0",4,0,"1",1,4,4,"H"
"15128",1984-11-02,1984,"Toulouse FC","Lille OSC","1-0",1,0,"1",1,1,1,"H"
"15129",1984-11-09,1984,"FC Nantes","AS Monaco","1-0",1,0,"1",1,1,1,"H"
"15130",1984-11-09,1984,"AJ Auxerre","RC Lens","0-0",0,0,"1",1,0,0,"D"
"15131",1984-11-09,1984,"Brest Armorique FC","Stade Laval","3-0",3,0,"1",1,3,3,"H"
"15132",1984-11-09,1984,"Sporting Toulon Var","Toulouse FC","2-1",2,1,"1",1,3,1,"H"
"15133",1984-11-09,1984,"SC Bastia","FC Rouen","3-0",3,0,"1",1,3,3,"H"
"15134",1984-11-09,1984,"Lille OSC","AS Nancy","4-0",4,0,"1",1,4,4,"H"
"15135",1984-11-09,1984,"Tours FC","FC Sochaux","2-2",2,2,"1",1,4,0,"D"
"15136",1984-11-10,1984,"Girondins Bordeaux","Racing Club de France","1-0",1,0,"1",1,1,1,"H"
"15137",1984-11-10,1984,"FC Metz","Olympique Marseille","3-0",3,0,"1",1,3,3,"H"
"15138",1984-11-13,1984,"Toulouse FC","FC Nantes","1-3",1,3,"1",1,4,-2,"D"
"15139",1984-11-13,1984,"RC Strasbourg","Girondins Bordeaux","2-2",2,2,"1",1,4,0,"D"
"15140",1984-11-13,1984,"FC Sochaux","AJ Auxerre","2-1",2,1,"1",1,3,1,"H"
"15141",1984-11-13,1984,"RC Lens","FC Metz","0-0",0,0,"1",1,0,0,"D"
"15142",1984-11-13,1984,"AS Nancy","Sporting Toulon Var","0-2",0,2,"1",1,2,-2,"D"
"15143",1984-11-13,1984,"AS Monaco","Brest Armorique FC","0-0",0,0,"1",1,0,0,"D"
"15144",1984-11-13,1984,"Racing Club de France","SC Bastia","0-0",0,0,"1",1,0,0,"D"
"15145",1984-11-13,1984,"Stade Laval","Paris Saint-Germain","0-0",0,0,"1",1,0,0,"D"
"15146",1984-11-13,1984,"Olympique Marseille","Lille OSC","2-0",2,0,"1",1,2,2,"H"
"15147",1984-11-13,1984,"FC Rouen","Tours FC","0-0",0,0,"1",1,0,0,"D"
"15148",1984-11-24,1984,"FC Nantes","AS Nancy","2-1",2,1,"1",1,3,1,"H"
"15149",1984-11-24,1984,"Girondins Bordeaux","Stade Laval","5-2",5,2,"1",1,7,3,"H"
"15150",1984-11-24,1984,"AJ Auxerre","FC Rouen","2-0",2,0,"1",1,2,2,"H"
"15151",1984-11-24,1984,"Sporting Toulon Var","Lille OSC","2-1",2,1,"1",1,3,1,"H"
"15152",1984-11-24,1984,"FC Metz","FC Sochaux","1-1",1,1,"1",1,2,0,"D"
"15153",1984-11-24,1984,"SC Bastia","RC Strasbourg","2-1",2,1,"1",1,3,1,"H"
"15154",1984-11-24,1984,"RC Lens","Olympique Marseille","3-0",3,0,"1",1,3,3,"H"
"15155",1984-11-24,1984,"Brest Armorique FC","Toulouse FC","2-2",2,2,"1",1,4,0,"D"
"15156",1984-11-24,1984,"Paris Saint-Germain","AS Monaco","2-1",2,1,"1",1,3,1,"H"
"15157",1984-11-24,1984,"Tours FC","Racing Club de France","2-0",2,0,"1",1,2,2,"H"
"15158",1984-11-27,1984,"Paris Saint-Germain","RC Strasbourg","2-0",2,0,"1",1,2,2,"H"
"15159",1984-12-01,1984,"Lille OSC","FC Nantes","1-1",1,1,"1",1,2,0,"D"
"15160",1984-12-01,1984,"AS Monaco","Girondins Bordeaux","3-0",3,0,"1",1,3,3,"H"
"15161",1984-12-01,1984,"Racing Club de France","AJ Auxerre","1-3",1,3,"1",1,4,-2,"D"
"15162",1984-12-01,1984,"Toulouse FC","Paris Saint-Germain","0-1",0,1,"1",1,1,-1,"D"
"15163",1984-12-01,1984,"FC Rouen","FC Metz","1-0",1,0,"1",1,1,1,"H"
"15164",1984-12-01,1984,"Stade Laval","SC Bastia","2-1",2,1,"1",1,3,1,"H"
"15165",1984-12-02,1984,"FC Sochaux","RC Lens","1-2",1,2,"1",1,3,-1,"D"
"15166",1984-12-02,1984,"AS Nancy","Brest Armorique FC","0-2",0,2,"1",1,2,-2,"D"
"15167",1984-12-02,1984,"Olympique Marseille","Sporting Toulon Var","4-2",4,2,"1",1,6,2,"H"
"15168",1984-12-02,1984,"RC Strasbourg","Tours FC","1-0",1,0,"1",1,1,1,"H"
"15169",1984-12-14,1984,"Olympique Marseille","FC Nantes","0-2",0,2,"1",1,2,-2,"D"
"15170",1984-12-14,1984,"Girondins Bordeaux","AS Nancy","3-1",3,1,"1",1,4,2,"H"
"15171",1984-12-14,1984,"AJ Auxerre","Stade Laval","2-1",2,1,"1",1,3,1,"H"
"15172",1984-12-14,1984,"RC Lens","Racing Club de France","1-0",1,0,"1",1,1,1,"H"
"15173",1984-12-14,1984,"Brest Armorique FC","Sporting Toulon Var","0-1",0,1,"1",1,1,-1,"D"
"15174",1984-12-14,1984,"FC Metz","RC Strasbourg","1-0",1,0,"1",1,1,1,"H"
"15175",1984-12-14,1984,"Paris Saint-Germain","Lille OSC","2-3",2,3,"1",1,5,-1,"D"
"15176",1984-12-14,1984,"SC Bastia","Toulouse FC","4-0",4,0,"1",1,4,4,"H"
"15177",1984-12-14,1984,"Tours FC","AS Monaco","2-1",2,1,"1",1,3,1,"H"
"15178",1984-12-16,1984,"FC Sochaux","FC Rouen","4-0",4,0,"1",1,4,4,"H"
"15179",1984-12-21,1984,"Lille OSC","Girondins Bordeaux","0-1",0,1,"1",1,1,-1,"D"
"15180",1984-12-21,1984,"FC Nantes","Brest Armorique FC","0-2",0,2,"1",1,2,-2,"D"
"15181",1984-12-21,1984,"AS Monaco","AJ Auxerre","0-0",0,0,"1",1,0,0,"D"
"15182",1984-12-21,1984,"Sporting Toulon Var","Paris Saint-Germain","5-1",5,1,"1",1,6,4,"H"
"15183",1984-12-21,1984,"Stade Laval","FC Metz","1-4",1,4,"1",1,5,-3,"D"
"15184",1984-12-21,1984,"RC Strasbourg","RC Lens","1-1",1,1,"1",1,2,0,"D"
"15185",1984-12-21,1984,"AS Nancy","SC Bastia","2-0",2,0,"1",1,2,2,"H"
"15186",1984-12-21,1984,"Racing Club de France","FC Sochaux","0-2",0,2,"1",1,2,-2,"D"
"15187",1984-12-21,1984,"Toulouse FC","Tours FC","3-1",3,1,"1",1,4,2,"H"
"15188",1984-12-21,1984,"FC Rouen","Olympique Marseille","1-1",1,1,"1",1,2,0,"D"
"15189",1985-01-26,1984,"FC Nantes","Girondins Bordeaux","0-1",0,1,"1",1,1,-1,"D"
"15190",1985-01-26,1984,"Sporting Toulon Var","SC Bastia","1-0",1,0,"1",1,1,1,"H"
"15191",1985-01-26,1984,"Toulouse FC","FC Metz","1-1",1,1,"1",1,2,0,"D"
"15192",1985-01-26,1984,"Brest Armorique FC","Paris Saint-Germain","3-1",3,1,"1",1,4,2,"H"
"15193",1985-01-26,1984,"AS Monaco","RC Lens","3-0",3,0,"1",1,3,3,"H"
"15194",1985-01-26,1984,"Stade Laval","FC Sochaux","2-1",2,1,"1",1,3,1,"H"
"15195",1985-01-26,1984,"Lille OSC","Tours FC","3-0",3,0,"1",1,3,3,"H"
"15196",1985-01-26,1984,"Racing Club de France","Olympique Marseille","0-2",0,2,"1",1,2,-2,"D"
"15197",1985-01-27,1984,"AS Nancy","AJ Auxerre","1-1",1,1,"1",1,2,0,"D"
"15198",1985-02-02,1984,"Girondins Bordeaux","Brest Armorique FC","3-0",3,0,"1",1,3,3,"H"
"15199",1985-02-02,1984,"SC Bastia","FC Nantes","1-1",1,1,"1",1,2,0,"D"
"15200",1985-02-02,1984,"AJ Auxerre","Lille OSC","3-0",3,0,"1",1,3,3,"H"
"15201",1985-02-02,1984,"Tours FC","Sporting Toulon Var","0-1",0,1,"1",1,1,-1,"D"
"15202",1985-02-02,1984,"RC Lens","Toulouse FC","0-0",0,0,"1",1,0,0,"D"
"15203",1985-02-02,1984,"FC Rouen","Stade Laval","2-0",2,0,"1",1,2,2,"H"
"15204",1985-02-02,1984,"Racing Club de France","RC Strasbourg","2-2",2,2,"1",1,4,0,"D"
"15205",1985-02-03,1984,"FC Metz","AS Nancy","2-2",2,2,"1",1,4,0,"D"
"15206",1985-02-03,1984,"FC Sochaux","AS Monaco","1-2",1,2,"1",1,3,-1,"D"
"15207",1985-02-03,1984,"Olympique Marseille","Paris Saint-Germain","3-1",3,1,"1",1,4,2,"H"
"15208",1985-02-12,1984,"Girondins Bordeaux","Sporting Toulon Var","2-0",2,0,"1",1,2,2,"H"
"15209",1985-02-16,1984,"FC Nantes","Tours FC","4-0",4,0,"1",1,4,4,"H"
"15210",1985-02-16,1984,"Sporting Toulon Var","AJ Auxerre","2-0",2,0,"1",1,2,2,"H"
"15211",1985-02-16,1984,"Brest Armorique FC","SC Bastia","4-2",4,2,"1",1,6,2,"H"
"15212",1985-02-16,1984,"Lille OSC","FC Metz","1-0",1,0,"1",1,1,1,"H"
"15213",1985-02-16,1984,"AS Monaco","FC Rouen","2-0",2,0,"1",1,2,2,"H"
"15214",1985-02-16,1984,"Toulouse FC","FC Sochaux","0-0",0,0,"1",1,0,0,"D"
"15215",1985-02-17,1984,"AS Nancy","RC Lens","2-1",2,1,"1",1,3,1,"H"
"15216",1985-02-19,1984,"Paris Saint-Germain","Girondins Bordeaux","1-2",1,2,"1",1,3,-1,"D"
"15217",1985-02-19,1984,"Stade Laval","Racing Club de France","1-0",1,0,"1",1,1,1,"H"
"15218",1985-02-23,1984,"Olympique Marseille","Girondins Bordeaux","0-1",0,1,"1",1,1,-1,"D"
"15219",1985-02-23,1984,"FC Metz","Sporting Toulon Var","1-0",1,0,"1",1,1,1,"H"
"15220",1985-02-23,1984,"Racing Club de France","AS Monaco","0-1",0,1,"1",1,1,-1,"D"
"15221",1985-02-23,1984,"Tours FC","Brest Armorique FC","1-1",1,1,"1",1,2,0,"D"
"15222",1985-02-23,1984,"RC Lens","Lille OSC","2-0",2,0,"1",1,2,2,"H"
"15223",1985-02-23,1984,"SC Bastia","Paris Saint-Germain","1-2",1,2,"1",1,3,-1,"D"
"15224",1985-02-23,1984,"FC Rouen","Toulouse FC","0-2",0,2,"1",1,2,-2,"D"
"15225",1985-02-24,1984,"AJ Auxerre","FC Nantes","1-0",1,0,"1",1,1,1,"H"
"15226",1985-02-27,1984,"Girondins Bordeaux","SC Bastia","4-0",4,0,"1",1,4,4,"H"
"15227",1985-03-01,1984,"FC Nantes","FC Metz","1-0",1,0,"1",1,1,1,"H"
"15228",1985-03-01,1984,"Sporting Toulon Var","RC Lens","1-0",1,0,"1",1,1,1,"H"
"15229",1985-03-01,1984,"Brest Armorique FC","AJ Auxerre","2-0",2,0,"1",1,2,2,"H"
"15230",1985-03-01,1984,"AS Monaco","RC Strasbourg","3-0",3,0,"1",1,3,3,"H"
"15231",1985-03-01,1984,"Paris Saint-Germain","Tours FC","2-0",2,0,"1",1,2,2,"H"
"15232",1985-03-01,1984,"Stade Laval","Olympique Marseille","4-2",4,2,"1",1,6,2,"H"
"15233",1985-03-01,1984,"Lille OSC","FC Sochaux","1-1",1,1,"1",1,2,0,"D"
"15234",1985-03-01,1984,"AS Nancy","FC Rouen","2-2",2,2,"1",1,4,0,"D"
"15235",1985-03-01,1984,"Toulouse FC","Racing Club de France","1-3",1,3,"1",1,4,-2,"D"
"15236",1985-03-05,1984,"Paris Saint-Germain","FC Nantes","2-3",2,3,"1",1,5,-1,"D"
"15237",1985-03-05,1984,"AJ Auxerre","Toulouse FC","2-0",2,0,"1",1,2,2,"H"
"15238",1985-03-05,1984,"FC Metz","AS Monaco","1-1",1,1,"1",1,2,0,"D"
"15239",1985-03-05,1984,"Olympique Marseille","Brest Armorique FC","3-2",3,2,"1",1,5,1,"H"
"15240",1985-03-05,1984,"RC Lens","Stade Laval","3-0",3,0,"1",1,3,3,"H"
"15241",1985-03-05,1984,"SC Bastia","Lille OSC","2-1",2,1,"1",1,3,1,"H"
"15242",1985-03-05,1984,"FC Sochaux","RC Strasbourg","3-1",3,1,"1",1,4,2,"H"
"15243",1985-03-05,1984,"Tours FC","AS Nancy","1-3",1,3,"1",1,4,-2,"D"
"15244",1985-03-05,1984,"FC Rouen","Racing Club de France","1-1",1,1,"1",1,2,0,"D"
"15245",1985-03-08,1984,"RC Strasbourg","Stade Laval","2-0",2,0,"1",1,2,2,"H"
"15246",1985-03-15,1984,"Tours FC","Girondins Bordeaux","1-0",1,0,"1",1,1,1,"H"
"15247",1985-03-15,1984,"RC Lens","FC Nantes","0-1",0,1,"1",1,1,-1,"D"
"15248",1985-03-15,1984,"AJ Auxerre","Paris Saint-Germain","2-1",2,1,"1",1,3,1,"H"
"15249",1985-03-15,1984,"FC Sochaux","Sporting Toulon Var","0-0",0,0,"1",1,0,0,"D"
"15250",1985-03-15,1984,"Stade Laval","AS Monaco","0-0",0,0,"1",1,0,0,"D"
"15251",1985-03-15,1984,"FC Metz","Brest Armorique FC","2-0",2,0,"1",1,2,2,"H"
"15252",1985-03-15,1984,"Olympique Marseille","SC Bastia","5-0",5,0,"1",1,5,5,"H"
"15253",1985-03-15,1984,"FC Rouen","Lille OSC","0-0",0,0,"1",1,0,0,"D"
"15254",1985-03-15,1984,"RC Strasbourg","Toulouse FC","1-0",1,0,"1",1,1,1,"H"
"15255",1985-03-16,1984,"Racing Club de France","AS Nancy","1-0",1,0,"1",1,1,1,"H"
"15256",1985-03-19,1984,"RC Strasbourg","FC Rouen","1-1",1,1,"1",1,2,0,"D"
"15257",1985-03-22,1984,"FC Nantes","FC Sochaux","1-1",1,1,"1",1,2,0,"D"
"15258",1985-03-22,1984,"Sporting Toulon Var","FC Rouen","1-1",1,1,"1",1,2,0,"D"
"15259",1985-03-22,1984,"AS Monaco","Olympique Marseille","3-0",3,0,"1",1,3,3,"H"
"15260",1985-03-22,1984,"Paris Saint-Germain","FC Metz","1-2",1,2,"1",1,3,-1,"D"
"15261",1985-03-22,1984,"Brest Armorique FC","RC Lens","3-2",3,2,"1",1,5,1,"H"
"15262",1985-03-22,1984,"SC Bastia","Tours FC","2-2",2,2,"1",1,4,0,"D"
"15263",1985-03-22,1984,"Lille OSC","Racing Club de France","2-1",2,1,"1",1,3,1,"H"
"15264",1985-03-22,1984,"AS Nancy","RC Strasbourg","1-1",1,1,"1",1,2,0,"D"
"15265",1985-03-22,1984,"Toulouse FC","Stade Laval","1-1",1,1,"1",1,2,0,"D"
"15266",1985-03-23,1984,"Girondins Bordeaux","AJ Auxerre","6-1",6,1,"1",1,7,5,"H"
"15267",1985-03-26,1984,"FC Metz","Girondins Bordeaux","1-1",1,1,"1",1,2,0,"D"
"15268",1985-03-26,1984,"FC Rouen","FC Nantes","1-0",1,0,"1",1,1,1,"H"
"15269",1985-03-26,1984,"Racing Club de France","Sporting Toulon Var","0-1",0,1,"1",1,1,-1,"D"
"15270",1985-03-26,1984,"AS Monaco","Toulouse FC","0-0",0,0,"1",1,0,0,"D"
"15271",1985-03-26,1984,"FC Sochaux","Brest Armorique FC","4-2",4,2,"1",1,6,2,"H"
"15272",1985-03-26,1984,"RC Lens","Paris Saint-Germain","4-2",4,2,"1",1,6,2,"H"
"15273",1985-03-26,1984,"Olympique Marseille","Tours FC","3-2",3,2,"1",1,5,1,"H"
"15274",1985-03-26,1984,"Stade Laval","AS Nancy","2-2",2,2,"1",1,4,0,"D"
"15275",1985-03-26,1984,"RC Strasbourg","Lille OSC","2-1",2,1,"1",1,3,1,"H"
"15276",1985-03-27,1984,"AJ Auxerre","SC Bastia","3-1",3,1,"1",1,4,2,"H"
"15277",1985-03-29,1984,"FC Sochaux","AS Nancy","1-0",1,0,"1",1,1,1,"H"
"15278",1985-04-05,1984,"Sporting Toulon Var","RC Strasbourg","3-1",3,1,"1",1,4,2,"H"
"15279",1985-04-05,1984,"Tours FC","AJ Auxerre","3-1",3,1,"1",1,4,2,"H"
"15280",1985-04-05,1984,"SC Bastia","FC Metz","1-3",1,3,"1",1,4,-2,"D"
"15281",1985-04-05,1984,"Brest Armorique FC","FC Rouen","0-2",0,2,"1",1,2,-2,"D"
"15282",1985-04-05,1984,"Paris Saint-Germain","FC Sochaux","1-1",1,1,"1",1,2,0,"D"
"15283",1985-04-05,1984,"Lille OSC","Stade Laval","0-0",0,0,"1",1,0,0,"D"
"15284",1985-04-05,1984,"Toulouse FC","Olympique Marseille","2-0",2,0,"1",1,2,2,"H"
"15285",1985-04-06,1984,"Girondins Bordeaux","RC Lens","2-1",2,1,"1",1,3,1,"H"
"15286",1985-04-06,1984,"FC Nantes","Racing Club de France","1-1",1,1,"1",1,2,0,"D"
"15287",1985-04-06,1984,"AS Nancy","AS Monaco","1-1",1,1,"1",1,2,0,"D"
"15288",1985-04-12,1984,"RC Strasbourg","FC Nantes","1-3",1,3,"1",1,4,-2,"D"
"15289",1985-04-12,1984,"Olympique Marseille","AJ Auxerre","1-1",1,1,"1",1,2,0,"D"
"15290",1985-04-12,1984,"Stade Laval","Sporting Toulon Var","1-0",1,0,"1",1,1,1,"H"
"15291",1985-04-12,1984,"AS Monaco","Lille OSC","6-1",6,1,"1",1,7,5,"H"
"15292",1985-04-12,1984,"FC Metz","Tours FC","1-1",1,1,"1",1,2,0,"D"
"15293",1985-04-12,1984,"RC Lens","SC Bastia","3-0",3,0,"1",1,3,3,"H"
"15294",1985-04-12,1984,"Racing Club de France","Brest Armorique FC","3-0",3,0,"1",1,3,3,"H"
"15295",1985-04-12,1984,"FC Rouen","Paris Saint-Germain","0-1",0,1,"1",1,1,-1,"D"
"15296",1985-04-12,1984,"Toulouse FC","AS Nancy","1-0",1,0,"1",1,1,1,"H"
"15297",1985-04-13,1984,"FC Sochaux","Girondins Bordeaux","1-1",1,1,"1",1,2,0,"D"
"15298",1985-04-16,1984,"RC Strasbourg","Olympique Marseille","2-1",2,1,"1",1,3,1,"H"
"15299",1985-04-19,1984,"Girondins Bordeaux","FC Rouen","2-0",2,0,"1",1,2,2,"H"
"15300",1985-04-19,1984,"FC Nantes","Stade Laval","2-0",2,0,"1",1,2,2,"H"
"15301",1985-04-19,1984,"AJ Auxerre","FC Metz","2-0",2,0,"1",1,2,2,"H"
"15302",1985-04-19,1984,"Sporting Toulon Var","AS Monaco","0-1",0,1,"1",1,1,-1,"D"
"15303",1985-04-19,1984,"Tours FC","RC Lens","1-1",1,1,"1",1,2,0,"D"
"15304",1985-04-19,1984,"SC Bastia","FC Sochaux","1-1",1,1,"1",1,2,0,"D"
"15305",1985-04-19,1984,"Brest Armorique FC","RC Strasbourg","1-1",1,1,"1",1,2,0,"D"
"15306",1985-04-19,1984,"Paris Saint-Germain","Racing Club de France","2-2",2,2,"1",1,4,0,"D"
"15307",1985-04-19,1984,"AS Nancy","Olympique Marseille","3-1",3,1,"1",1,4,2,"H"
"15308",1985-04-19,1984,"Lille OSC","Toulouse FC","0-0",0,0,"1",1,0,0,"D"
"15309",1985-04-23,1984,"AS Monaco","FC Nantes","1-1",1,1,"1",1,2,0,"D"
"15310",1985-04-23,1984,"RC Lens","AJ Auxerre","1-0",1,0,"1",1,1,1,"H"
"15311",1985-04-23,1984,"Toulouse FC","Sporting Toulon Var","2-0",2,0,"1",1,2,2,"H"
"15312",1985-04-23,1984,"Olympique Marseille","FC Metz","2-1",2,1,"1",1,3,1,"H"
"15313",1985-04-23,1984,"FC Sochaux","Tours FC","2-2",2,2,"1",1,4,0,"D"
"15314",1985-04-23,1984,"Stade Laval","Brest Armorique FC","0-0",0,0,"1",1,0,0,"D"
"15315",1985-04-23,1984,"AS Nancy","Lille OSC","1-0",1,0,"1",1,1,1,"H"
"15316",1985-04-23,1984,"RC Strasbourg","Paris Saint-Germain","1-1",1,1,"1",1,2,0,"D"
"15317",1985-04-23,1984,"FC Rouen","SC Bastia","1-1",1,1,"1",1,2,0,"D"
"15318",1985-04-27,1984,"Racing Club de France","Girondins Bordeaux","0-0",0,0,"1",1,0,0,"D"
"15319",1985-05-07,1984,"Girondins Bordeaux","RC Strasbourg","3-2",3,2,"1",1,5,1,"H"
"15320",1985-05-07,1984,"FC Nantes","Toulouse FC","2-2",2,2,"1",1,4,0,"D"
"15321",1985-05-07,1984,"Brest Armorique FC","AS Monaco","0-2",0,2,"1",1,2,-2,"D"
"15322",1985-05-07,1984,"AJ Auxerre","FC Sochaux","0-0",0,0,"1",1,0,0,"D"
"15323",1985-05-07,1984,"Sporting Toulon Var","AS Nancy","3-1",3,1,"1",1,4,2,"H"
"15324",1985-05-07,1984,"FC Metz","RC Lens","4-1",4,1,"1",1,5,3,"H"
"15325",1985-05-07,1984,"Paris Saint-Germain","Stade Laval","0-1",0,1,"1",1,1,-1,"D"
"15326",1985-05-07,1984,"Lille OSC","Olympique Marseille","1-1",1,1,"1",1,2,0,"D"
"15327",1985-05-07,1984,"SC Bastia","Racing Club de France","0-0",0,0,"1",1,0,0,"D"
"15328",1985-05-07,1984,"Tours FC","FC Rouen","2-0",2,0,"1",1,2,2,"H"
"15329",1985-05-14,1984,"Stade Laval","Girondins Bordeaux","0-2",0,2,"1",1,2,-2,"D"
"15330",1985-05-14,1984,"AS Nancy","FC Nantes","1-2",1,2,"1",1,3,-1,"D"
"15331",1985-05-14,1984,"AS Monaco","Paris Saint-Germain","4-1",4,1,"1",1,5,3,"H"
"15332",1985-05-14,1984,"FC Rouen","AJ Auxerre","1-2",1,2,"1",1,3,-1,"D"
"15333",1985-05-14,1984,"Lille OSC","Sporting Toulon Var","1-1",1,1,"1",1,2,0,"D"
"15334",1985-05-14,1984,"FC Sochaux","FC Metz","1-1",1,1,"1",1,2,0,"D"
"15335",1985-05-14,1984,"Olympique Marseille","RC Lens","1-2",1,2,"1",1,3,-1,"D"
"15336",1985-05-14,1984,"Toulouse FC","Brest Armorique FC","0-0",0,0,"1",1,0,0,"D"
"15337",1985-05-14,1984,"RC Strasbourg","SC Bastia","1-1",1,1,"1",1,2,0,"D"
"15338",1985-05-14,1984,"Racing Club de France","Tours FC","3-1",3,1,"1",1,4,2,"H"
"15339",1985-05-24,1984,"Girondins Bordeaux","AS Monaco","0-0",0,0,"1",1,0,0,"D"
"15340",1985-05-24,1984,"FC Nantes","Lille OSC","1-0",1,0,"1",1,1,1,"H"
"15341",1985-05-24,1984,"AJ Auxerre","Racing Club de France","1-0",1,0,"1",1,1,1,"H"
"15342",1985-05-24,1984,"Sporting Toulon Var","Olympique Marseille","2-0",2,0,"1",1,2,2,"H"
"15343",1985-05-24,1984,"FC Metz","FC Rouen","1-0",1,0,"1",1,1,1,"H"
"15344",1985-05-24,1984,"RC Lens","FC Sochaux","3-1",3,1,"1",1,4,2,"H"
"15345",1985-05-24,1984,"Brest Armorique FC","AS Nancy","2-2",2,2,"1",1,4,0,"D"
"15346",1985-05-24,1984,"SC Bastia","Stade Laval","1-0",1,0,"1",1,1,1,"H"
"15347",1985-05-24,1984,"Paris Saint-Germain","Toulouse FC","3-1",3,1,"1",1,4,2,"H"
"15348",1985-05-24,1984,"Tours FC","RC Strasbourg","1-0",1,0,"1",1,1,1,"H"
"15349",1985-05-28,1984,"Toulouse FC","Girondins Bordeaux","2-1",2,1,"1",1,3,1,"H"
"15350",1985-05-28,1984,"Sporting Toulon Var","FC Nantes","1-2",1,2,"1",1,3,-1,"D"
"15351",1985-05-28,1984,"AS Monaco","SC Bastia","4-0",4,0,"1",1,4,4,"H"
"15352",1985-05-28,1984,"RC Strasbourg","AJ Auxerre","1-1",1,1,"1",1,2,0,"D"
"15353",1985-05-28,1984,"Racing Club de France","FC Metz","0-2",0,2,"1",1,2,-2,"D"
"15354",1985-05-28,1984,"FC Rouen","RC Lens","1-0",1,0,"1",1,1,1,"H"
"15355",1985-05-28,1984,"FC Sochaux","Olympique Marseille","2-0",2,0,"1",1,2,2,"H"
"15356",1985-05-28,1984,"Lille OSC","Brest Armorique FC","2-0",2,0,"1",1,2,2,"H"
"15357",1985-05-28,1984,"Stade Laval","Tours FC","3-1",3,1,"1",1,4,2,"H"
"15358",1985-05-28,1984,"AS Nancy","Paris Saint-Germain","6-1",6,1,"1",1,7,5,"H"
"15359",1985-07-16,1985,"Toulouse FC","AS Nancy","4-1",4,1,"1",1,5,3,"H"
"15360",1985-07-16,1985,"SC Bastia","Paris Saint-Germain","2-4",2,4,"1",1,6,-2,"D"
"15361",1985-07-16,1985,"Lille OSC","Brest Armorique FC","3-1",3,1,"1",1,4,2,"H"
"15362",1985-07-16,1985,"FC Metz","RC Lens","2-3",2,3,"1",1,5,-1,"D"
"15363",1985-07-16,1985,"Le Havre AC","Olympique Marseille","1-0",1,0,"1",1,1,1,"H"
"15364",1985-07-16,1985,"Girondins Bordeaux","OGC Nice","1-0",1,0,"1",1,1,1,"H"
"15365",1985-07-16,1985,"RC Strasbourg","Stade Rennes","1-1",1,1,"1",1,2,0,"D"
"15366",1985-07-16,1985,"AS Monaco","FC Sochaux","1-1",1,1,"1",1,2,0,"D"
"15367",1985-07-16,1985,"Sporting Toulon Var","FC Nantes","0-0",0,0,"1",1,0,0,"D"
"15368",1985-07-16,1985,"Stade Laval","AJ Auxerre","0-0",0,0,"1",1,0,0,"D"
"15369",1985-07-19,1985,"RC Lens","SC Bastia","6-0",6,0,"1",1,6,6,"H"
"15370",1985-07-19,1985,"Paris Saint-Germain","Lille OSC","3-0",3,0,"1",1,3,3,"H"
"15371",1985-07-19,1985,"Brest Armorique FC","Girondins Bordeaux","0-1",0,1,"1",1,1,-1,"D"
"15372",1985-07-19,1985,"FC Sochaux","Toulouse FC","4-1",4,1,"1",1,5,3,"H"
"15373",1985-07-19,1985,"AJ Auxerre","Olympique Marseille","2-0",2,0,"1",1,2,2,"H"
"15374",1985-07-19,1985,"Sporting Toulon Var","RC Strasbourg","1-0",1,0,"1",1,1,1,"H"
"15375",1985-07-19,1985,"AS Nancy","Le Havre AC","3-0",3,0,"1",1,3,3,"H"
"15376",1985-07-19,1985,"FC Nantes","AS Monaco","1-1",1,1,"1",1,2,0,"D"
"15377",1985-07-19,1985,"Stade Rennes","FC Metz","0-0",0,0,"1",1,0,0,"D"
"15378",1985-07-19,1985,"OGC Nice","Stade Laval","0-0",0,0,"1",1,0,0,"D"
"15379",1985-07-26,1985,"Toulouse FC","Paris Saint-Germain","1-3",1,3,"1",1,4,-2,"D"
"15380",1985-07-26,1985,"Girondins Bordeaux","RC Lens","2-1",2,1,"1",1,3,1,"H"
"15381",1985-07-26,1985,"AS Monaco","Sporting Toulon Var","0-2",0,2,"1",1,2,-2,"D"
"15382",1985-07-26,1985,"Le Havre AC","AJ Auxerre","3-3",3,3,"1",1,6,0,"D"
"15383",1985-07-26,1985,"SC Bastia","Stade Rennes","0-2",0,2,"1",1,2,-2,"D"
"15384",1985-07-26,1985,"Lille OSC","AS Nancy","3-1",3,1,"1",1,4,2,"H"
"15385",1985-07-26,1985,"RC Strasbourg","FC Nantes","1-2",1,2,"1",1,3,-1,"D"
"15386",1985-07-26,1985,"FC Metz","FC Sochaux","2-0",2,0,"1",1,2,2,"H"
"15387",1985-07-26,1985,"Stade Laval","Brest Armorique FC","0-0",0,0,"1",1,0,0,"D"
"15388",1985-07-26,1985,"Olympique Marseille","OGC Nice","2-1",2,1,"1",1,3,1,"H"
"15389",1985-07-30,1985,"Paris Saint-Germain","Girondins Bordeaux","1-0",1,0,"1",1,1,1,"H"
"15390",1985-07-30,1985,"Sporting Toulon Var","FC Metz","2-1",2,1,"1",1,3,1,"H"
"15391",1985-07-30,1985,"RC Lens","Toulouse FC","2-0",2,0,"1",1,2,2,"H"
"15392",1985-07-30,1985,"FC Nantes","SC Bastia","2-0",2,0,"1",1,2,2,"H"
"15393",1985-07-30,1985,"OGC Nice","AJ Auxerre","1-1",1,1,"1",1,2,0,"D"
"15394",1985-07-30,1985,"FC Sochaux","Le Havre AC","1-1",1,1,"1",1,2,0,"D"
"15395",1985-07-30,1985,"Stade Rennes","AS Monaco","0-1",0,1,"1",1,1,-1,"D"
"15396",1985-07-30,1985,"RC Strasbourg","Lille OSC","2-1",2,1,"1",1,3,1,"H"
"15397",1985-07-30,1985,"AS Nancy","Stade Laval","1-0",1,0,"1",1,1,1,"H"
"15398",1985-07-30,1985,"Brest Armorique FC","Olympique Marseille","2-1",2,1,"1",1,3,1,"H"
"15399",1985-08-02,1985,"Stade Laval","Paris Saint-Germain","2-2",2,2,"1",1,4,0,"D"
"15400",1985-08-02,1985,"Girondins Bordeaux","AS Nancy","1-0",1,0,"1",1,1,1,"H"
"15401",1985-08-02,1985,"Olympique Marseille","RC Lens","3-3",3,3,"1",1,6,0,"D"
"15402",1985-08-02,1985,"SC Bastia","Sporting Toulon Var","2-1",2,1,"1",1,3,1,"H"
"15403",1985-08-02,1985,"FC Metz","FC Nantes","0-0",0,0,"1",1,0,0,"D"
"15404",1985-08-02,1985,"Lille OSC","FC Sochaux","2-1",2,1,"1",1,3,1,"H"
"15405",1985-08-02,1985,"AS Monaco","RC Strasbourg","2-0",2,0,"1",1,2,2,"H"
"15406",1985-08-02,1985,"AJ Auxerre","Brest Armorique FC","1-2",1,2,"1",1,3,-1,"D"
"15407",1985-08-02,1985,"Toulouse FC","Stade Rennes","4-1",4,1,"1",1,5,3,"H"
"15408",1985-08-02,1985,"Le Havre AC","OGC Nice","1-2",1,2,"1",1,3,-1,"D"
"15409",1985-08-06,1985,"FC Sochaux","SC Bastia","2-0",2,0,"1",1,2,2,"H"
"15410",1985-08-09,1985,"Paris Saint-Germain","Olympique Marseille","2-0",2,0,"1",1,2,2,"H"
"15411",1985-08-09,1985,"RC Lens","Stade Laval","3-1",3,1,"1",1,4,2,"H"
"15412",1985-08-09,1985,"FC Nantes","Toulouse FC","1-0",1,0,"1",1,1,1,"H"
"15413",1985-08-09,1985,"Sporting Toulon Var","Girondins Bordeaux","1-1",1,1,"1",1,2,0,"D"
"15414",1985-08-09,1985,"AS Monaco","FC Metz","0-0",0,0,"1",1,0,0,"D"
"15415",1985-08-09,1985,"RC Strasbourg","Le Havre AC","2-1",2,1,"1",1,3,1,"H"
"15416",1985-08-09,1985,"Stade Rennes","Lille OSC","2-0",2,0,"1",1,2,2,"H"
"15417",1985-08-09,1985,"AS Nancy","AJ Auxerre","1-0",1,0,"1",1,1,1,"H"
"15418",1985-08-09,1985,"Brest Armorique FC","OGC Nice","1-1",1,1,"1",1,2,0,"D"
"15419",1985-08-15,1985,"FC Metz","RC Strasbourg","0-0",0,0,"1",1,0,0,"D"
"15420",1985-08-16,1985,"AJ Auxerre","Paris Saint-Germain","0-1",0,1,"1",1,1,-1,"D"
"15421",1985-08-16,1985,"Lille OSC","FC Nantes","0-1",0,1,"1",1,1,-1,"D"
"15422",1985-08-16,1985,"Girondins Bordeaux","Stade Rennes","3-2",3,2,"1",1,5,1,"H"
"15423",1985-08-16,1985,"OGC Nice","RC Lens","1-1",1,1,"1",1,2,0,"D"
"15424",1985-08-16,1985,"SC Bastia","AS Monaco","0-0",0,0,"1",1,0,0,"D"
"15425",1985-08-16,1985,"Olympique Marseille","AS Nancy","2-3",2,3,"1",1,5,-1,"D"
"15426",1985-08-16,1985,"Toulouse FC","Sporting Toulon Var","4-0",4,0,"1",1,4,4,"H"
"15427",1985-08-16,1985,"Stade Laval","FC Sochaux","3-1",3,1,"1",1,4,2,"H"
"15428",1985-08-16,1985,"Le Havre AC","Brest Armorique FC","2-0",2,0,"1",1,2,2,"H"
"15429",1985-08-23,1985,"AS Nancy","OGC Nice","3-0",3,0,"1",1,3,3,"H"
"15430",1985-08-24,1985,"Paris Saint-Germain","Brest Armorique FC","2-0",2,0,"1",1,2,2,"H"
"15431",1985-08-24,1985,"FC Nantes","Stade Laval","1-0",1,0,"1",1,1,1,"H"
"15432",1985-08-24,1985,"RC Lens","Le Havre AC","4-1",4,1,"1",1,5,3,"H"
"15433",1985-08-24,1985,"RC Strasbourg","Girondins Bordeaux","3-2",3,2,"1",1,5,1,"H"
"15434",1985-08-24,1985,"AS Monaco","Toulouse FC","3-0",3,0,"1",1,3,3,"H"
"15435",1985-08-24,1985,"Sporting Toulon Var","Lille OSC","1-1",1,1,"1",1,2,0,"D"
"15436",1985-08-24,1985,"FC Metz","SC Bastia","3-0",3,0,"1",1,3,3,"H"
"15437",1985-08-24,1985,"Stade Rennes","AJ Auxerre","4-1",4,1,"1",1,5,3,"H"
"15438",1985-08-24,1985,"FC Sochaux","Olympique Marseille","1-1",1,1,"1",1,2,0,"D"
"15439",1985-08-27,1985,"Stade Laval","Sporting Toulon Var","2-0",2,0,"1",1,2,2,"H"
"15440",1985-08-30,1985,"OGC Nice","Paris Saint-Germain","0-0",0,0,"1",1,0,0,"D"
"15441",1985-08-30,1985,"Girondins Bordeaux","AS Monaco","5-1",5,1,"1",1,6,4,"H"
"15442",1985-08-30,1985,"Olympique Marseille","FC Nantes","1-0",1,0,"1",1,1,1,"H"
"15443",1985-08-30,1985,"Lille OSC","RC Lens","1-0",1,0,"1",1,1,1,"H"
"15444",1985-08-30,1985,"Brest Armorique FC","AS Nancy","0-2",0,2,"1",1,2,-2,"D"
"15445",1985-08-30,1985,"Toulouse FC","FC Metz","2-0",2,0,"1",1,2,2,"H"
"15446",1985-08-30,1985,"Le Havre AC","Stade Rennes","1-0",1,0,"1",1,1,1,"H"
"15447",1985-08-30,1985,"SC Bastia","RC Strasbourg","2-0",2,0,"1",1,2,2,"H"
"15448",1985-08-30,1985,"AJ Auxerre","FC Sochaux","3-2",3,2,"1",1,5,1,"H"
"15449",1985-09-03,1985,"Paris Saint-Germain","AS Nancy","2-0",2,0,"1",1,2,2,"H"
"15450",1985-09-03,1985,"FC Nantes","Le Havre AC","2-1",2,1,"1",1,3,1,"H"
"15451",1985-09-03,1985,"RC Lens","Brest Armorique FC","1-0",1,0,"1",1,1,1,"H"
"15452",1985-09-03,1985,"FC Sochaux","Girondins Bordeaux","2-1",2,1,"1",1,3,1,"H"
"15453",1985-09-03,1985,"FC Metz","Lille OSC","4-0",4,0,"1",1,4,4,"H"
"15454",1985-09-03,1985,"RC Strasbourg","Toulouse FC","0-3",0,3,"1",1,3,-3,"D"
"15455",1985-09-03,1985,"Stade Rennes","Stade Laval","1-0",1,0,"1",1,1,1,"H"
"15456",1985-09-03,1985,"AS Monaco","OGC Nice","0-1",0,1,"1",1,1,-1,"D"
"15457",1985-09-03,1985,"Sporting Toulon Var","Olympique Marseille","0-0",0,0,"1",1,0,0,"D"
"15458",1985-09-03,1985,"SC Bastia","AJ Auxerre","0-0",0,0,"1",1,0,0,"D"
"15459",1985-09-13,1985,"Stade Laval","FC Metz","1-1",1,1,"1",1,2,0,"D"
"15460",1985-09-13,1985,"AJ Auxerre","RC Strasbourg","2-0",2,0,"1",1,2,2,"H"
"15461",1985-09-13,1985,"Brest Armorique FC","Sporting Toulon Var","2-1",2,1,"1",1,3,1,"H"
"15462",1985-09-13,1985,"Olympique Marseille","Stade Rennes","1-2",1,2,"1",1,3,-1,"D"
"15463",1985-09-13,1985,"AS Nancy","RC Lens","2-1",2,1,"1",1,3,1,"H"
"15464",1985-09-14,1985,"Le Havre AC","Paris Saint-Germain","1-2",1,2,"1",1,3,-1,"D"
"15465",1985-09-14,1985,"Girondins Bordeaux","FC Nantes","2-1",2,1,"1",1,3,1,"H"
"15466",1985-09-14,1985,"Toulouse FC","SC Bastia","3-1",3,1,"1",1,4,2,"H"
"15467",1985-09-14,1985,"Lille OSC","AS Monaco","2-2",2,2,"1",1,4,0,"D"
"15468",1985-09-14,1985,"OGC Nice","FC Sochaux","2-0",2,0,"1",1,2,2,"H"
"15469",1985-09-20,1985,"RC Lens","Paris Saint-Germain","2-3",2,3,"1",1,5,-1,"D"
"15470",1985-09-20,1985,"FC Sochaux","AS Nancy","1-1",1,1,"1",1,2,0,"D"
"15471",1985-09-20,1985,"Toulouse FC","Le Havre AC","1-0",1,0,"1",1,1,1,"H"
"15472",1985-09-20,1985,"Stade Rennes","Brest Armorique FC","0-4",0,4,"1",1,4,-4,"D"
"15473",1985-09-20,1985,"SC Bastia","Lille OSC","2-0",2,0,"1",1,2,2,"H"
"15474",1985-09-20,1985,"RC Strasbourg","Olympique Marseille","0-0",0,0,"1",1,0,0,"D"
"15475",1985-09-21,1985,"FC Metz","Girondins Bordeaux","2-3",2,3,"1",1,5,-1,"D"
"15476",1985-09-21,1985,"FC Nantes","OGC Nice","1-1",1,1,"1",1,2,0,"D"
"15477",1985-09-21,1985,"Sporting Toulon Var","AJ Auxerre","0-1",0,1,"1",1,1,-1,"D"
"15478",1985-09-21,1985,"AS Monaco","Stade Laval","1-1",1,1,"1",1,2,0,"D"
"15479",1985-09-27,1985,"Paris Saint-Germain","FC Sochaux","4-1",4,1,"1",1,5,3,"H"
"15480",1985-09-27,1985,"Girondins Bordeaux","SC Bastia","2-2",2,2,"1",1,4,0,"D"
"15481",1985-09-27,1985,"Brest Armorique FC","FC Nantes","1-3",1,3,"1",1,4,-2,"D"
"15482",1985-09-27,1985,"AS Nancy","Sporting Toulon Var","5-3",5,3,"1",1,8,2,"H"
"15483",1985-09-27,1985,"AJ Auxerre","RC Lens","0-0",0,0,"1",1,0,0,"D"
"15484",1985-09-27,1985,"Lille OSC","Toulouse FC","2-0",2,0,"1",1,2,2,"H"
"15485",1985-09-27,1985,"OGC Nice","Stade Rennes","2-1",2,1,"1",1,3,1,"H"
"15486",1985-09-27,1985,"Olympique Marseille","AS Monaco","2-2",2,2,"1",1,4,0,"D"
"15487",1985-09-27,1985,"Le Havre AC","FC Metz","0-0",0,0,"1",1,0,0,"D"
"15488",1985-09-27,1985,"Stade Laval","RC Strasbourg","4-1",4,1,"1",1,5,3,"H"
"15489",1985-10-04,1985,"Stade Rennes","Paris Saint-Germain","2-3",2,3,"1",1,5,-1,"D"
"15490",1985-10-04,1985,"FC Sochaux","RC Lens","1-3",1,3,"1",1,4,-2,"D"
"15491",1985-10-04,1985,"Lille OSC","Stade Laval","1-3",1,3,"1",1,4,-2,"D"
"15492",1985-10-04,1985,"Sporting Toulon Var","OGC Nice","4-0",4,0,"1",1,4,4,"H"
"15493",1985-10-04,1985,"RC Strasbourg","Brest Armorique FC","0-1",0,1,"1",1,1,-1,"D"
"15494",1985-10-04,1985,"SC Bastia","Le Havre AC","2-1",2,1,"1",1,3,1,"H"
"15495",1985-10-05,1985,"Toulouse FC","Girondins Bordeaux","1-2",1,2,"1",1,3,-1,"D"
"15496",1985-10-05,1985,"FC Nantes","AS Nancy","2-0",2,0,"1",1,2,2,"H"
"15497",1985-10-05,1985,"AS Monaco","AJ Auxerre","1-0",1,0,"1",1,1,1,"H"
"15498",1985-10-05,1985,"FC Metz","Olympique Marseille","3-0",3,0,"1",1,3,3,"H"
"15499",1985-10-11,1985,"Paris Saint-Germain","FC Nantes","2-1",2,1,"1",1,3,1,"H"
"15500",1985-10-11,1985,"Girondins Bordeaux","Lille OSC","1-1",1,1,"1",1,2,0,"D"
"15501",1985-10-11,1985,"RC Lens","Sporting Toulon Var","1-1",1,1,"1",1,2,0,"D"
"15502",1985-10-11,1985,"AS Nancy","Stade Rennes","0-0",0,0,"1",1,0,0,"D"
"15503",1985-10-11,1985,"OGC Nice","RC Strasbourg","5-1",5,1,"1",1,6,4,"H"
"15504",1985-10-11,1985,"Le Havre AC","AS Monaco","1-1",1,1,"1",1,2,0,"D"
"15505",1985-10-11,1985,"AJ Auxerre","FC Metz","2-1",2,1,"1",1,3,1,"H"
"15506",1985-10-11,1985,"Brest Armorique FC","FC Sochaux","3-1",3,1,"1",1,4,2,"H"
"15507",1985-10-11,1985,"Olympique Marseille","SC Bastia","0-0",0,0,"1",1,0,0,"D"
"15508",1985-10-12,1985,"Stade Laval","Toulouse FC","3-2",3,2,"1",1,5,1,"H"
"15509",1985-10-18,1985,"Sporting Toulon Var","Paris Saint-Germain","1-1",1,1,"1",1,2,0,"D"
"15510",1985-10-18,1985,"FC Nantes","RC Lens","4-0",4,0,"1",1,4,4,"H"
"15511",1985-10-18,1985,"Girondins Bordeaux","AJ Auxerre","0-0",0,0,"1",1,0,0,"D"
"15512",1985-10-18,1985,"RC Strasbourg","AS Nancy","1-0",1,0,"1",1,1,1,"H"
"15513",1985-10-18,1985,"AS Monaco","Brest Armorique FC","3-1",3,1,"1",1,4,2,"H"
"15514",1985-10-18,1985,"SC Bastia","Stade Laval","0-0",0,0,"1",1,0,0,"D"
"15515",1985-10-18,1985,"FC Metz","OGC Nice","3-0",3,0,"1",1,3,3,"H"
"15516",1985-10-18,1985,"Toulouse FC","Olympique Marseille","1-0",1,0,"1",1,1,1,"H"
"15517",1985-10-18,1985,"Stade Rennes","FC Sochaux","0-0",0,0,"1",1,0,0,"D"
"15518",1985-10-18,1985,"Lille OSC","Le Havre AC","0-0",0,0,"1",1,0,0,"D"
"15519",1985-10-25,1985,"Paris Saint-Germain","RC Strasbourg","1-1",1,1,"1",1,2,0,"D"
"15520",1985-10-25,1985,"RC Lens","Stade Rennes","0-0",0,0,"1",1,0,0,"D"
"15521",1985-10-25,1985,"AS Nancy","AS Monaco","1-1",1,1,"1",1,2,0,"D"
"15522",1985-10-25,1985,"AJ Auxerre","Toulouse FC","2-1",2,1,"1",1,3,1,"H"
"15523",1985-10-25,1985,"OGC Nice","SC Bastia","1-0",1,0,"1",1,1,1,"H"
"15524",1985-10-25,1985,"Brest Armorique FC","FC Metz","1-1",1,1,"1",1,2,0,"D"
"15525",1985-10-25,1985,"Le Havre AC","Sporting Toulon Var","4-3",4,3,"1",1,7,1,"H"
"15526",1985-10-25,1985,"Olympique Marseille","Lille OSC","1-0",1,0,"1",1,1,1,"H"
"15527",1985-10-25,1985,"FC Sochaux","FC Nantes","1-1",1,1,"1",1,2,0,"D"
"15528",1985-10-25,1985,"Stade Laval","Girondins Bordeaux","0-0",0,0,"1",1,0,0,"D"
"15529",1985-11-02,1985,"AS Monaco","Paris Saint-Germain","1-1",1,1,"1",1,2,0,"D"
"15530",1985-11-02,1985,"FC Nantes","Stade Rennes","1-0",1,0,"1",1,1,1,"H"
"15531",1985-11-02,1985,"Girondins Bordeaux","Olympique Marseille","2-1",2,1,"1",1,3,1,"H"
"15532",1985-11-02,1985,"RC Strasbourg","RC Lens","0-0",0,0,"1",1,0,0,"D"
"15533",1985-11-02,1985,"Lille OSC","AJ Auxerre","0-1",0,1,"1",1,1,-1,"D"
"15534",1985-11-02,1985,"FC Metz","AS Nancy","3-1",3,1,"1",1,4,2,"H"
"15535",1985-11-02,1985,"Stade Laval","Le Havre AC","2-2",2,2,"1",1,4,0,"D"
"15536",1985-11-02,1985,"Toulouse FC","OGC Nice","0-0",0,0,"1",1,0,0,"D"
"15537",1985-11-02,1985,"Sporting Toulon Var","FC Sochaux","2-2",2,2,"1",1,4,0,"D"
"15538",1985-11-02,1985,"SC Bastia","Brest Armorique FC","3-2",3,2,"1",1,5,1,"H"
"15539",1985-11-08,1985,"Paris Saint-Germain","FC Metz","2-1",2,1,"1",1,3,1,"H"
"15540",1985-11-08,1985,"Le Havre AC","Girondins Bordeaux","0-1",0,1,"1",1,1,-1,"D"
"15541",1985-11-08,1985,"RC Lens","AS Monaco","1-1",1,1,"1",1,2,0,"D"
"15542",1985-11-08,1985,"AS Nancy","SC Bastia","4-1",4,1,"1",1,5,3,"H"
"15543",1985-11-08,1985,"OGC Nice","Lille OSC","0-0",0,0,"1",1,0,0,"D"
"15544",1985-11-08,1985,"Olympique Marseille","Stade Laval","4-0",4,0,"1",1,4,4,"H"
"15545",1985-11-08,1985,"Brest Armorique FC","Toulouse FC","2-2",2,2,"1",1,4,0,"D"
"15546",1985-11-08,1985,"Stade Rennes","Sporting Toulon Var","1-0",1,0,"1",1,1,1,"H"
"15547",1985-11-08,1985,"FC Sochaux","RC Strasbourg","3-1",3,1,"1",1,4,2,"H"
"15548",1985-11-09,1985,"AJ Auxerre","FC Nantes","0-0",0,0,"1",1,0,0,"D"
"15549",1985-11-19,1985,"Girondins Bordeaux","Brest Armorique FC","4-0",4,0,"1",1,4,4,"H"
"15550",1985-11-19,1985,"SC Bastia","RC Lens","0-1",0,1,"1",1,1,-1,"D"
"15551",1985-11-19,1985,"FC Metz","Stade Rennes","4-1",4,1,"1",1,5,3,"H"
"15552",1985-11-19,1985,"Le Havre AC","AS Nancy","2-0",2,0,"1",1,2,2,"H"
"15553",1985-11-19,1985,"Stade Laval","OGC Nice","2-1",2,1,"1",1,3,1,"H"
"15554",1985-11-19,1985,"Olympique Marseille","AJ Auxerre","2-1",2,1,"1",1,3,1,"H"
"15555",1985-11-19,1985,"Toulouse FC","FC Sochaux","3-0",3,0,"1",1,3,3,"H"
"15556",1985-11-19,1985,"RC Strasbourg","Sporting Toulon Var","1-1",1,1,"1",1,2,0,"D"
"15557",1985-11-20,1985,"AS Monaco","FC Nantes","1-1",1,1,"1",1,2,0,"D"
"15558",1985-11-22,1985,"Paris Saint-Germain","Toulouse FC","3-0",3,0,"1",1,3,3,"H"
"15559",1985-11-22,1985,"RC Lens","Girondins Bordeaux","1-0",1,0,"1",1,1,1,"H"
"15560",1985-11-22,1985,"FC Sochaux","FC Metz","1-2",1,2,"1",1,3,-1,"D"
"15561",1985-11-22,1985,"AS Nancy","Lille OSC","3-0",3,0,"1",1,3,3,"H"
"15562",1985-11-22,1985,"AJ Auxerre","Le Havre AC","3-0",3,0,"1",1,3,3,"H"
"15563",1985-11-22,1985,"OGC Nice","Olympique Marseille","1-0",1,0,"1",1,1,1,"H"
"15564",1985-11-22,1985,"Brest Armorique FC","Stade Laval","2-1",2,1,"1",1,3,1,"H"
"15565",1985-11-22,1985,"Stade Rennes","SC Bastia","3-1",3,1,"1",1,4,2,"H"
"15566",1985-11-23,1985,"FC Nantes","RC Strasbourg","2-0",2,0,"1",1,2,2,"H"
"15567",1985-11-23,1985,"Sporting Toulon Var","AS Monaco","1-1",1,1,"1",1,2,0,"D"
"15568",1985-11-29,1985,"Girondins Bordeaux","Paris Saint-Germain","0-0",0,0,"1",1,0,0,"D"
"15569",1985-11-29,1985,"Toulouse FC","RC Lens","1-1",1,1,"1",1,2,0,"D"
"15570",1985-11-29,1985,"AS Monaco","Stade Rennes","1-0",1,0,"1",1,1,1,"H"
"15571",1985-11-29,1985,"Stade Laval","AS Nancy","2-0",2,0,"1",1,2,2,"H"
"15572",1985-11-29,1985,"Olympique Marseille","Brest Armorique FC","3-0",3,0,"1",1,3,3,"H"
"15573",1985-11-29,1985,"Le Havre AC","FC Sochaux","1-0",1,0,"1",1,1,1,"H"
"15574",1985-11-29,1985,"Lille OSC","RC Strasbourg","2-0",2,0,"1",1,2,2,"H"
"15575",1985-11-30,1985,"SC Bastia","FC Nantes","2-3",2,3,"1",1,5,-1,"D"
"15576",1985-11-30,1985,"AJ Auxerre","OGC Nice","1-2",1,2,"1",1,3,-1,"D"
"15577",1985-11-30,1985,"FC Metz","Sporting Toulon Var","0-2",0,2,"1",1,2,-2,"D"
"15578",1985-12-06,1985,"FC Nantes","FC Metz","1-0",1,0,"1",1,1,1,"H"
"15579",1985-12-07,1985,"Paris Saint-Germain","Stade Laval","5-1",5,1,"1",1,6,4,"H"
"15580",1985-12-07,1985,"AS Nancy","Girondins Bordeaux","1-1",1,1,"1",1,2,0,"D"
"15581",1985-12-07,1985,"RC Lens","Olympique Marseille","2-1",2,1,"1",1,3,1,"H"
"15582",1985-12-07,1985,"RC Strasbourg","AS Monaco","1-1",1,1,"1",1,2,0,"D"
"15583",1985-12-07,1985,"Brest Armorique FC","AJ Auxerre","1-3",1,3,"1",1,4,-2,"D"
"15584",1985-12-07,1985,"OGC Nice","Le Havre AC","0-3",0,3,"1",1,3,-3,"D"
"15585",1985-12-07,1985,"Stade Rennes","Toulouse FC","2-1",2,1,"1",1,3,1,"H"
"15586",1985-12-07,1985,"Sporting Toulon Var","SC Bastia","1-1",1,1,"1",1,2,0,"D"
"15587",1985-12-08,1985,"FC Sochaux","Lille OSC","3-1",3,1,"1",1,4,2,"H"
"15588",1985-12-14,1985,"Girondins Bordeaux","Sporting Toulon Var","2-1",2,1,"1",1,3,1,"H"
"15589",1985-12-14,1985,"Toulouse FC","FC Nantes","4-2",4,2,"1",1,6,2,"H"
"15590",1985-12-14,1985,"Stade Laval","RC Lens","2-1",2,1,"1",1,3,1,"H"
"15591",1985-12-14,1985,"AJ Auxerre","AS Nancy","3-0",3,0,"1",1,3,3,"H"
"15592",1985-12-14,1985,"OGC Nice","Brest Armorique FC","2-2",2,2,"1",1,4,0,"D"
"15593",1985-12-14,1985,"Le Havre AC","RC Strasbourg","4-1",4,1,"1",1,5,3,"H"
"15594",1985-12-14,1985,"Lille OSC","Stade Rennes","2-0",2,0,"1",1,2,2,"H"
"15595",1985-12-14,1985,"SC Bastia","FC Sochaux","0-0",0,0,"1",1,0,0,"D"
"15596",1985-12-15,1985,"Olympique Marseille","Paris Saint-Germain","0-0",0,0,"1",1,0,0,"D"
"15597",1985-12-15,1985,"FC Metz","AS Monaco","3-2",3,2,"1",1,5,1,"H"
"15598",1985-12-21,1985,"Paris Saint-Germain","AJ Auxerre","4-0",4,0,"1",1,4,4,"H"
"15599",1985-12-21,1985,"FC Nantes","Lille OSC","5-1",5,1,"1",1,6,4,"H"
"15600",1985-12-21,1985,"Stade Rennes","Girondins Bordeaux","0-0",0,0,"1",1,0,0,"D"
"15601",1985-12-21,1985,"RC Lens","OGC Nice","2-0",2,0,"1",1,2,2,"H"
"15602",1985-12-21,1985,"AS Monaco","SC Bastia","2-1",2,1,"1",1,3,1,"H"
"15603",1985-12-21,1985,"Sporting Toulon Var","Toulouse FC","1-1",1,1,"1",1,2,0,"D"
"15604",1985-12-21,1985,"Brest Armorique FC","Le Havre AC","1-1",1,1,"1",1,2,0,"D"
"15605",1985-12-22,1985,"RC Strasbourg","FC Metz","0-0",0,0,"1",1,0,0,"D"
"15606",1985-12-22,1985,"FC Sochaux","Stade Laval","1-0",1,0,"1",1,1,1,"H"
"15607",1985-12-22,1985,"AS Nancy","Olympique Marseille","0-2",0,2,"1",1,2,-2,"D"
"15608",1986-01-11,1985,"Brest Armorique FC","Paris Saint-Germain","1-1",1,1,"1",1,2,0,"D"
"15609",1986-01-11,1985,"Stade Laval","FC Nantes","0-0",0,0,"1",1,0,0,"D"
"15610",1986-01-11,1985,"Girondins Bordeaux","RC Strasbourg","1-0",1,0,"1",1,1,1,"H"
"15611",1986-01-11,1985,"Le Havre AC","RC Lens","3-0",3,0,"1",1,3,3,"H"
"15612",1986-01-11,1985,"AJ Auxerre","Stade Rennes","1-0",1,0,"1",1,1,1,"H"
"15613",1986-01-11,1985,"Toulouse FC","AS Monaco","2-1",2,1,"1",1,3,1,"H"
"15614",1986-01-11,1985,"SC Bastia","FC Metz","0-0",0,0,"1",1,0,0,"D"
"15615",1986-01-11,1985,"OGC Nice","AS Nancy","3-1",3,1,"1",1,4,2,"H"
"15616",1986-01-11,1985,"Lille OSC","Sporting Toulon Var","1-0",1,0,"1",1,1,1,"H"
"15617",1986-01-12,1985,"Olympique Marseille","FC Sochaux","1-2",1,2,"1",1,3,-1,"D"
"15618",1986-01-18,1985,"Paris Saint-Germain","OGC Nice","3-2",3,2,"1",1,5,1,"H"
"15619",1986-01-18,1985,"FC Nantes","Olympique Marseille","0-2",0,2,"1",1,2,-2,"D"
"15620",1986-01-18,1985,"AS Monaco","Girondins Bordeaux","9-0",9,0,"1",1,9,9,"H"
"15621",1986-01-18,1985,"RC Lens","Lille OSC","1-4",1,4,"1",1,5,-3,"D"
"15622",1986-01-18,1985,"Sporting Toulon Var","Stade Laval","3-0",3,0,"1",1,3,3,"H"
"15623",1986-01-18,1985,"Stade Rennes","Le Havre AC","2-1",2,1,"1",1,3,1,"H"
"15624",1986-01-19,1985,"FC Sochaux","AJ Auxerre","2-0",2,0,"1",1,2,2,"H"
"15625",1986-01-19,1985,"FC Metz","Toulouse FC","1-1",1,1,"1",1,2,0,"D"
"15626",1986-01-19,1985,"AS Nancy","Brest Armorique FC","2-0",2,0,"1",1,2,2,"H"
"15627",1986-01-19,1985,"RC Strasbourg","SC Bastia","6-1",6,1,"1",1,7,5,"H"
"15628",1986-01-22,1985,"Lille OSC","Paris Saint-Germain","2-0",2,0,"1",1,2,2,"H"
"15629",1986-01-31,1985,"Le Havre AC","FC Nantes","0-1",0,1,"1",1,1,-1,"D"
"15630",1986-02-01,1985,"Girondins Bordeaux","FC Sochaux","1-1",1,1,"1",1,2,0,"D"
"15631",1986-02-01,1985,"AJ Auxerre","SC Bastia","2-0",2,0,"1",1,2,2,"H"
"15632",1986-02-01,1985,"OGC Nice","AS Monaco","1-0",1,0,"1",1,1,1,"H"
"15633",1986-02-01,1985,"Brest Armorique FC","RC Lens","2-0",2,0,"1",1,2,2,"H"
"15634",1986-02-01,1985,"Toulouse FC","RC Strasbourg","3-0",3,0,"1",1,3,3,"H"
"15635",1986-02-01,1985,"Lille OSC","FC Metz","1-0",1,0,"1",1,1,1,"H"
"15636",1986-02-01,1985,"Stade Laval","Stade Rennes","1-0",1,0,"1",1,1,1,"H"
"15637",1986-02-02,1985,"AS Nancy","Paris Saint-Germain","1-0",1,0,"1",1,1,1,"H"
"15638",1986-02-02,1985,"Olympique Marseille","Sporting Toulon Var","2-3",2,3,"1",1,5,-1,"D"
"15639",1986-02-08,1985,"Paris Saint-Germain","Le Havre AC","1-0",1,0,"1",1,1,1,"H"
"15640",1986-02-08,1985,"FC Nantes","Girondins Bordeaux","0-0",0,0,"1",1,0,0,"D"
"15641",1986-02-08,1985,"AS Monaco","Lille OSC","3-2",3,2,"1",1,5,1,"H"
"15642",1986-02-08,1985,"RC Lens","AS Nancy","1-0",1,0,"1",1,1,1,"H"
"15643",1986-02-08,1985,"SC Bastia","Toulouse FC","0-2",0,2,"1",1,2,-2,"D"
"15644",1986-02-08,1985,"Stade Rennes","Olympique Marseille","1-2",1,2,"1",1,3,-1,"D"
"15645",1986-02-08,1985,"Sporting Toulon Var","Brest Armorique FC","2-3",2,3,"1",1,5,-1,"D"
"15646",1986-02-09,1985,"RC Strasbourg","AJ Auxerre","1-3",1,3,"1",1,4,-2,"D"
"15647",1986-02-09,1985,"FC Metz","Stade Laval","2-1",2,1,"1",1,3,1,"H"
"15648",1986-02-09,1985,"FC Sochaux","OGC Nice","2-0",2,0,"1",1,2,2,"H"
"15649",1986-02-22,1985,"Paris Saint-Germain","RC Lens","2-2",2,2,"1",1,4,0,"D"
"15650",1986-02-22,1985,"OGC Nice","FC Nantes","0-0",0,0,"1",1,0,0,"D"
"15651",1986-02-22,1985,"Girondins Bordeaux","FC Metz","3-1",3,1,"1",1,4,2,"H"
"15652",1986-02-22,1985,"AJ Auxerre","Sporting Toulon Var","0-0",0,0,"1",1,0,0,"D"
"15653",1986-02-22,1985,"Stade Laval","AS Monaco","0-0",0,0,"1",1,0,0,"D"
"15654",1986-02-22,1985,"Le Havre AC","Toulouse FC","1-0",1,0,"1",1,1,1,"H"
"15655",1986-02-22,1985,"Lille OSC","SC Bastia","2-2",2,2,"1",1,4,0,"D"
"15656",1986-02-23,1985,"AS Nancy","FC Sochaux","3-0",3,0,"1",1,3,3,"H"
"15657",1986-02-23,1985,"Olympique Marseille","RC Strasbourg","0-1",0,1,"1",1,1,-1,"D"
"15658",1986-03-01,1985,"Sporting Toulon Var","AS Nancy","1-0",1,0,"1",1,1,1,"H"
"15659",1986-03-01,1985,"Stade Rennes","OGC Nice","2-0",2,0,"1",1,2,2,"H"
"15660",1986-03-01,1985,"AS Monaco","Olympique Marseille","0-0",0,0,"1",1,0,0,"D"
"15661",1986-03-01,1985,"Toulouse FC","Lille OSC","1-0",1,0,"1",1,1,1,"H"
"15662",1986-03-07,1985,"OGC Nice","Sporting Toulon Var","2-1",2,1,"1",1,3,1,"H"
"15663",1986-03-07,1985,"Le Havre AC","SC Bastia","5-2",5,2,"1",1,7,3,"H"
"15664",1986-03-07,1985,"Brest Armorique FC","RC Strasbourg","2-1",2,1,"1",1,3,1,"H"
"15665",1986-03-08,1985,"Paris Saint-Germain","Stade Rennes","1-0",1,0,"1",1,1,1,"H"
"15666",1986-03-08,1985,"AS Nancy","FC Nantes","1-3",1,3,"1",1,4,-2,"D"
"15667",1986-03-08,1985,"Girondins Bordeaux","Toulouse FC","1-1",1,1,"1",1,2,0,"D"
"15668",1986-03-08,1985,"AJ Auxerre","AS Monaco","1-0",1,0,"1",1,1,1,"H"
"15669",1986-03-08,1985,"RC Lens","FC Sochaux","3-1",3,1,"1",1,4,2,"H"
"15670",1986-03-08,1985,"Olympique Marseille","FC Metz","0-0",0,0,"1",1,0,0,"D"
"15671",1986-03-08,1985,"Stade Laval","Lille OSC","2-2",2,2,"1",1,4,0,"D"
"15672",1986-03-11,1985,"Brest Armorique FC","Stade Rennes","2-1",2,1,"1",1,3,1,"H"
"15673",1986-03-11,1985,"SC Bastia","Girondins Bordeaux","0-2",0,2,"1",1,2,-2,"D"
"15674",1986-03-14,1985,"FC Nantes","Paris Saint-Germain","2-0",2,0,"1",1,2,2,"H"
"15675",1986-03-14,1985,"Lille OSC","Girondins Bordeaux","1-0",1,0,"1",1,1,1,"H"
"15676",1986-03-14,1985,"Sporting Toulon Var","RC Lens","0-0",0,0,"1",1,0,0,"D"
"15677",1986-03-14,1985,"AS Monaco","Le Havre AC","2-2",2,2,"1",1,4,0,"D"
"15678",1986-03-14,1985,"RC Strasbourg","OGC Nice","2-0",2,0,"1",1,2,2,"H"
"15679",1986-03-14,1985,"SC Bastia","Olympique Marseille","0-3",0,3,"1",1,3,-3,"D"
"15680",1986-03-15,1985,"Toulouse FC","Stade Laval","2-0",2,0,"1",1,2,2,"H"
"15681",1986-03-15,1985,"FC Metz","AJ Auxerre","2-0",2,0,"1",1,2,2,"H"
"15682",1986-03-15,1985,"Stade Rennes","AS Nancy","1-0",1,0,"1",1,1,1,"H"
"15683",1986-03-15,1985,"FC Sochaux","Brest Armorique FC","4-2",4,2,"1",1,6,2,"H"
"15684",1986-03-21,1985,"Brest Armorique FC","AS Monaco","2-1",2,1,"1",1,3,1,"H"
"15685",1986-03-21,1985,"OGC Nice","FC Metz","2-0",2,0,"1",1,2,2,"H"
"15686",1986-03-21,1985,"Le Havre AC","Lille OSC","0-0",0,0,"1",1,0,0,"D"
"15687",1986-03-21,1985,"AS Nancy","RC Strasbourg","1-1",1,1,"1",1,2,0,"D"
"15688",1986-03-22,1985,"Paris Saint-Germain","Sporting Toulon Var","1-0",1,0,"1",1,1,1,"H"
"15689",1986-03-22,1985,"RC Lens","FC Nantes","0-0",0,0,"1",1,0,0,"D"
"15690",1986-03-22,1985,"AJ Auxerre","Girondins Bordeaux","2-2",2,2,"1",1,4,0,"D"
"15691",1986-03-22,1985,"Olympique Marseille","Toulouse FC","1-1",1,1,"1",1,2,0,"D"
"15692",1986-03-22,1985,"Stade Laval","SC Bastia","1-0",1,0,"1",1,1,1,"H"
"15693",1986-03-22,1985,"FC Sochaux","Stade Rennes","0-0",0,0,"1",1,0,0,"D"
"15694",1986-03-28,1985,"FC Metz","Le Havre AC","3-0",3,0,"1",1,3,3,"H"
"15695",1986-04-04,1985,"RC Strasbourg","Paris Saint-Germain","1-0",1,0,"1",1,1,1,"H"
"15696",1986-04-04,1985,"FC Nantes","FC Sochaux","3-2",3,2,"1",1,5,1,"H"
"15697",1986-04-04,1985,"Girondins Bordeaux","Stade Laval","2-1",2,1,"1",1,3,1,"H"
"15698",1986-04-04,1985,"Toulouse FC","AJ Auxerre","2-0",2,0,"1",1,2,2,"H"
"15699",1986-04-04,1985,"FC Metz","Brest Armorique FC","3-1",3,1,"1",1,4,2,"H"
"15700",1986-04-04,1985,"Stade Rennes","RC Lens","2-0",2,0,"1",1,2,2,"H"
"15701",1986-04-04,1985,"AS Monaco","AS Nancy","1-1",1,1,"1",1,2,0,"D"
"15702",1986-04-04,1985,"SC Bastia","OGC Nice","0-1",0,1,"1",1,1,-1,"D"
"15703",1986-04-04,1985,"Lille OSC","Olympique Marseille","0-0",0,0,"1",1,0,0,"D"
"15704",1986-04-04,1985,"Sporting Toulon Var","Le Havre AC","1-0",1,0,"1",1,1,1,"H"
"15705",1986-04-08,1985,"FC Sochaux","Paris Saint-Germain","1-1",1,1,"1",1,2,0,"D"
"15706",1986-04-08,1985,"RC Lens","AJ Auxerre","2-1",2,1,"1",1,3,1,"H"
"15707",1986-04-08,1985,"RC Strasbourg","Stade Laval","2-1",2,1,"1",1,3,1,"H"
"15708",1986-04-08,1985,"FC Nantes","Brest Armorique FC","3-1",3,1,"1",1,4,2,"H"
"15709",1986-04-11,1985,"Paris Saint-Germain","AS Monaco","1-0",1,0,"1",1,1,1,"H"
"15710",1986-04-11,1985,"Stade Rennes","FC Nantes","0-0",0,0,"1",1,0,0,"D"
"15711",1986-04-11,1985,"Olympique Marseille","Girondins Bordeaux","4-0",4,0,"1",1,4,4,"H"
"15712",1986-04-11,1985,"RC Lens","RC Strasbourg","0-0",0,0,"1",1,0,0,"D"
"15713",1986-04-11,1985,"AS Nancy","FC Metz","0-2",0,2,"1",1,2,-2,"D"
"15714",1986-04-11,1985,"OGC Nice","Toulouse FC","3-1",3,1,"1",1,4,2,"H"
"15715",1986-04-11,1985,"AJ Auxerre","Lille OSC","2-0",2,0,"1",1,2,2,"H"
"15716",1986-04-11,1985,"Brest Armorique FC","SC Bastia","7-0",7,0,"1",1,7,7,"H"
"15717",1986-04-11,1985,"Le Havre AC","Stade Laval","1-1",1,1,"1",1,2,0,"D"
"15718",1986-04-12,1985,"FC Sochaux","Sporting Toulon Var","1-0",1,0,"1",1,1,1,"H"
"15719",1986-04-18,1985,"FC Metz","Paris Saint-Germain","3-1",3,1,"1",1,4,2,"H"
"15720",1986-04-18,1985,"FC Nantes","AJ Auxerre","2-1",2,1,"1",1,3,1,"H"
"15721",1986-04-18,1985,"Girondins Bordeaux","Le Havre AC","5-3",5,3,"1",1,8,2,"H"
"15722",1986-04-18,1985,"AS Monaco","RC Lens","1-2",1,2,"1",1,3,-1,"D"
"15723",1986-04-18,1985,"Toulouse FC","Brest Armorique FC","2-0",2,0,"1",1,2,2,"H"
"15724",1986-04-18,1985,"Lille OSC","OGC Nice","1-0",1,0,"1",1,1,1,"H"
"15725",1986-04-18,1985,"Stade Laval","Olympique Marseille","1-0",1,0,"1",1,1,1,"H"
"15726",1986-04-18,1985,"SC Bastia","AS Nancy","2-2",2,2,"1",1,4,0,"D"
"15727",1986-04-18,1985,"Sporting Toulon Var","Stade Rennes","1-1",1,1,"1",1,2,0,"D"
"15728",1986-04-18,1985,"RC Strasbourg","FC Sochaux","3-0",3,0,"1",1,3,3,"H"
"15729",1986-04-25,1985,"Paris Saint-Germain","SC Bastia","3-1",3,1,"1",1,4,2,"H"
"15730",1986-04-25,1985,"FC Nantes","Sporting Toulon Var","1-1",1,1,"1",1,2,0,"D"
"15731",1986-04-25,1985,"OGC Nice","Girondins Bordeaux","1-1",1,1,"1",1,2,0,"D"
"15732",1986-04-25,1985,"AS Nancy","Toulouse FC","0-1",0,1,"1",1,1,-1,"D"
"15733",1986-04-25,1985,"RC Lens","FC Metz","0-0",0,0,"1",1,0,0,"D"
"15734",1986-04-25,1985,"AJ Auxerre","Stade Laval","2-0",2,0,"1",1,2,2,"H"
"15735",1986-04-25,1985,"FC Sochaux","AS Monaco","1-1",1,1,"1",1,2,0,"D"
"15736",1986-04-25,1985,"Brest Armorique FC","Lille OSC","1-1",1,1,"1",1,2,0,"D"
"15737",1986-04-25,1985,"Olympique Marseille","Le Havre AC","1-1",1,1,"1",1,2,0,"D"
"15738",1986-04-25,1985,"Stade Rennes","RC Strasbourg","1-1",1,1,"1",1,2,0,"D"
"15739",1986-08-05,1986,"Olympique Marseille","AS Monaco","3-1",3,1,"1",1,4,2,"H"
"15740",1986-08-05,1986,"Le Havre AC","Brest Armorique FC","1-2",1,2,"1",1,3,-1,"D"
"15741",1986-08-05,1986,"Girondins Bordeaux","FC Metz","1-0",1,0,"1",1,1,1,"H"
"15742",1986-08-05,1986,"FC Nantes","Lille OSC","1-0",1,0,"1",1,1,1,"H"
"15743",1986-08-05,1986,"Stade Rennes","Racing Club de France","1-0",1,0,"1",1,1,1,"H"
"15744",1986-08-05,1986,"Paris Saint-Germain","Stade Laval","1-0",1,0,"1",1,1,1,"H"
"15745",1986-08-05,1986,"FC Sochaux","AS Saint-Etienne","3-3",3,3,"1",1,6,0,"D"
"15746",1986-08-05,1986,"OGC Nice","Sporting Toulon Var","2-2",2,2,"1",1,4,0,"D"
"15747",1986-08-05,1986,"RC Lens","Toulouse FC","1-1",1,1,"1",1,2,0,"D"
"15748",1986-08-05,1986,"AS Nancy","AJ Auxerre","1-1",1,1,"1",1,2,0,"D"
"15749",1986-08-08,1986,"AJ Auxerre","Paris Saint-Germain","1-2",1,2,"1",1,3,-1,"D"
"15750",1986-08-08,1986,"Brest Armorique FC","Olympique Marseille","0-0",0,0,"1",1,0,0,"D"
"15751",1986-08-08,1986,"OGC Nice","Stade Rennes","1-0",1,0,"1",1,1,1,"H"
"15752",1986-08-08,1986,"Toulouse FC","AS Monaco","2-1",2,1,"1",1,3,1,"H"
"15753",1986-08-08,1986,"Sporting Toulon Var","FC Nantes","1-1",1,1,"1",1,2,0,"D"
"15754",1986-08-08,1986,"Lille OSC","Girondins Bordeaux","0-0",0,0,"1",1,0,0,"D"
"15755",1986-08-08,1986,"FC Metz","FC Sochaux","5-1",5,1,"1",1,6,4,"H"
"15756",1986-08-08,1986,"AS Saint-Etienne","AS Nancy","0-0",0,0,"1",1,0,0,"D"
"15757",1986-08-08,1986,"Racing Club de France","Le Havre AC","2-1",2,1,"1",1,3,1,"H"
"15758",1986-08-08,1986,"Stade Laval","RC Lens","1-1",1,1,"1",1,2,0,"D"
"15759",1986-08-12,1986,"AS Nancy","Brest Armorique FC","0-4",0,4,"1",1,4,-4,"D"
"15760",1986-08-12,1986,"Olympique Marseille","Toulouse FC","2-1",2,1,"1",1,3,1,"H"
"15761",1986-08-12,1986,"Girondins Bordeaux","Racing Club de France","2-0",2,0,"1",1,2,2,"H"
"15762",1986-08-12,1986,"Paris Saint-Germain","FC Metz","0-0",0,0,"1",1,0,0,"D"
"15763",1986-08-12,1986,"FC Nantes","OGC Nice","1-0",1,0,"1",1,1,1,"H"
"15764",1986-08-12,1986,"Stade Rennes","Sporting Toulon Var","2-0",2,0,"1",1,2,2,"H"
"15765",1986-08-12,1986,"RC Lens","AJ Auxerre","1-1",1,1,"1",1,2,0,"D"
"15766",1986-08-12,1986,"FC Sochaux","Lille OSC","1-0",1,0,"1",1,1,1,"H"
"15767",1986-08-12,1986,"Le Havre AC","AS Saint-Etienne","1-0",1,0,"1",1,1,1,"H"
"15768",1986-08-12,1986,"AS Monaco","Stade Laval","0-0",0,0,"1",1,0,0,"D"
"15769",1986-08-15,1986,"Racing Club de France","Olympique Marseille","0-1",0,1,"1",1,1,-1,"D"
"15770",1986-08-15,1986,"FC Nantes","AS Nancy","1-0",1,0,"1",1,1,1,"H"
"15771",1986-08-15,1986,"OGC Nice","Girondins Bordeaux","0-0",0,0,"1",1,0,0,"D"
"15772",1986-08-15,1986,"FC Metz","Le Havre AC","3-0",3,0,"1",1,3,3,"H"
"15773",1986-08-15,1986,"Brest Armorique FC","RC Lens","1-3",1,3,"1",1,4,-2,"D"
"15774",1986-08-15,1986,"AS Saint-Etienne","Paris Saint-Germain","1-0",1,0,"1",1,1,1,"H"
"15775",1986-08-15,1986,"Stade Laval","Toulouse FC","0-0",0,0,"1",1,0,0,"D"
"15776",1986-08-15,1986,"Lille OSC","Stade Rennes","3-0",3,0,"1",1,3,3,"H"
"15777",1986-08-15,1986,"Sporting Toulon Var","FC Sochaux","0-0",0,0,"1",1,0,0,"D"
"15778",1986-08-15,1986,"AJ Auxerre","AS Monaco","1-1",1,1,"1",1,2,0,"D"
"15779",1986-08-22,1986,"Olympique Marseille","Stade Laval","3-0",3,0,"1",1,3,3,"H"
"15780",1986-08-22,1986,"Stade Rennes","FC Nantes","1-3",1,3,"1",1,4,-2,"D"
"15781",1986-08-22,1986,"Girondins Bordeaux","Sporting Toulon Var","2-1",2,1,"1",1,3,1,"H"
"15782",1986-08-22,1986,"RC Lens","AS Saint-Etienne","2-0",2,0,"1",1,2,2,"H"
"15783",1986-08-22,1986,"Paris Saint-Germain","Brest Armorique FC","1-0",1,0,"1",1,1,1,"H"
"15784",1986-08-22,1986,"Toulouse FC","AJ Auxerre","2-0",2,0,"1",1,2,2,"H"
"15785",1986-08-22,1986,"AS Monaco","FC Metz","2-1",2,1,"1",1,3,1,"H"
"15786",1986-08-22,1986,"FC Sochaux","OGC Nice","0-0",0,0,"1",1,0,0,"D"
"15787",1986-08-22,1986,"Le Havre AC","Lille OSC","1-1",1,1,"1",1,2,0,"D"
"15788",1986-08-22,1986,"AS Nancy","Racing Club de France","2-1",2,1,"1",1,3,1,"H"
"15789",1986-08-26,1986,"FC Nantes","Girondins Bordeaux","3-0",3,0,"1",1,3,3,"H"
"15790",1986-08-26,1986,"Stade Rennes","Olympique Marseille","0-0",0,0,"1",1,0,0,"D"
"15791",1986-08-26,1986,"OGC Nice","Paris Saint-Germain","0-2",0,2,"1",1,2,-2,"D"
"15792",1986-08-26,1986,"FC Metz","RC Lens","2-0",2,0,"1",1,2,2,"H"
"15793",1986-08-26,1986,"Brest Armorique FC","AS Monaco","1-0",1,0,"1",1,1,1,"H"
"15794",1986-08-26,1986,"AS Saint-Etienne","Toulouse FC","0-0",0,0,"1",1,0,0,"D"
"15795",1986-08-26,1986,"Racing Club de France","FC Sochaux","0-2",0,2,"1",1,2,-2,"D"
"15796",1986-08-26,1986,"Lille OSC","AS Nancy","4-3",4,3,"1",1,7,1,"H"
"15797",1986-08-26,1986,"Sporting Toulon Var","Le Havre AC","0-0",0,0,"1",1,0,0,"D"
"15798",1986-08-26,1986,"AJ Auxerre","Stade Laval","1-1",1,1,"1",1,2,0,"D"
"15799",1986-08-29,1986,"Olympique Marseille","AJ Auxerre","1-1",1,1,"1",1,2,0,"D"
"15800",1986-08-29,1986,"FC Sochaux","FC Nantes","3-1",3,1,"1",1,4,2,"H"
"15801",1986-08-29,1986,"Girondins Bordeaux","Stade Rennes","4-1",4,1,"1",1,5,3,"H"
"15802",1986-08-29,1986,"Paris Saint-Germain","Lille OSC","1-1",1,1,"1",1,2,0,"D"
"15803",1986-08-29,1986,"Toulouse FC","Brest Armorique FC","5-0",5,0,"1",1,5,5,"H"
"15804",1986-08-29,1986,"Stade Laval","FC Metz","1-1",1,1,"1",1,2,0,"D"
"15805",1986-08-29,1986,"RC Lens","Racing Club de France","0-1",0,1,"1",1,1,-1,"D"
"15806",1986-08-29,1986,"AS Nancy","Sporting Toulon Var","3-0",3,0,"1",1,3,3,"H"
"15807",1986-08-29,1986,"Le Havre AC","OGC Nice","3-0",3,0,"1",1,3,3,"H"
"15808",1986-08-29,1986,"AS Monaco","AS Saint-Etienne","0-0",0,0,"1",1,0,0,"D"
"15809",1986-09-03,1986,"FC Metz","Olympique Marseille","1-1",1,1,"1",1,2,0,"D"
"15810",1986-09-03,1986,"FC Nantes","Le Havre AC","0-0",0,0,"1",1,0,0,"D"
"15811",1986-09-03,1986,"Girondins Bordeaux","RC Lens","0-0",0,0,"1",1,0,0,"D"
"15812",1986-09-03,1986,"Sporting Toulon Var","Paris Saint-Germain","1-1",1,1,"1",1,2,0,"D"
"15813",1986-09-03,1986,"Lille OSC","Toulouse FC","1-0",1,0,"1",1,1,1,"H"
"15814",1986-09-03,1986,"Stade Rennes","FC Sochaux","1-0",1,0,"1",1,1,1,"H"
"15815",1986-09-03,1986,"Brest Armorique FC","AJ Auxerre","0-0",0,0,"1",1,0,0,"D"
"15816",1986-09-03,1986,"AS Saint-Etienne","Stade Laval","0-0",0,0,"1",1,0,0,"D"
"15817",1986-09-03,1986,"OGC Nice","AS Nancy","1-0",1,0,"1",1,1,1,"H"
"15818",1986-09-03,1986,"Racing Club de France","AS Monaco","1-1",1,1,"1",1,2,0,"D"
"15819",1986-09-12,1986,"Toulouse FC","OGC Nice","2-0",2,0,"1",1,2,2,"H"
"15820",1986-09-13,1986,"Olympique Marseille","Sporting Toulon Var","3-0",3,0,"1",1,3,3,"H"
"15821",1986-09-13,1986,"FC Sochaux","Girondins Bordeaux","0-2",0,2,"1",1,2,-2,"D"
"15822",1986-09-13,1986,"AS Monaco","FC Nantes","3-1",3,1,"1",1,4,2,"H"
"15823",1986-09-13,1986,"RC Lens","Lille OSC","1-3",1,3,"1",1,4,-2,"D"
"15824",1986-09-13,1986,"Paris Saint-Germain","Racing Club de France","1-2",1,2,"1",1,3,-1,"D"
"15825",1986-09-13,1986,"AS Nancy","FC Metz","0-0",0,0,"1",1,0,0,"D"
"15826",1986-09-13,1986,"AJ Auxerre","AS Saint-Etienne","3-0",3,0,"1",1,3,3,"H"
"15827",1986-09-13,1986,"Stade Laval","Brest Armorique FC","1-0",1,0,"1",1,1,1,"H"
"15828",1986-09-13,1986,"Le Havre AC","Stade Rennes","1-1",1,1,"1",1,2,0,"D"
"15829",1986-09-19,1986,"FC Metz","AJ Auxerre","0-1",0,1,"1",1,1,-1,"D"
"15830",1986-09-20,1986,"Lille OSC","Olympique Marseille","2-2",2,2,"1",1,4,0,"D"
"15831",1986-09-20,1986,"Girondins Bordeaux","Le Havre AC","3-0",3,0,"1",1,3,3,"H"
"15832",1986-09-20,1986,"FC Nantes","Paris Saint-Germain","0-1",0,1,"1",1,1,-1,"D"
"15833",1986-09-20,1986,"FC Sochaux","Toulouse FC","1-1",1,1,"1",1,2,0,"D"
"15834",1986-09-20,1986,"Sporting Toulon Var","AS Monaco","1-3",1,3,"1",1,4,-2,"D"
"15835",1986-09-20,1986,"AS Saint-Etienne","Brest Armorique FC","1-1",1,1,"1",1,2,0,"D"
"15836",1986-09-20,1986,"Racing Club de France","Stade Laval","1-1",1,1,"1",1,2,0,"D"
"15837",1986-09-20,1986,"OGC Nice","RC Lens","3-1",3,1,"1",1,4,2,"H"
"15838",1986-09-20,1986,"Stade Rennes","AS Nancy","0-0",0,0,"1",1,0,0,"D"
"15839",1986-09-24,1986,"Olympique Marseille","AS Saint-Etienne","1-0",1,0,"1",1,1,1,"H"
"15840",1986-09-24,1986,"AS Nancy","Girondins Bordeaux","0-1",0,1,"1",1,1,-1,"D"
"15841",1986-09-24,1986,"Paris Saint-Germain","Stade Rennes","1-0",1,0,"1",1,1,1,"H"
"15842",1986-09-24,1986,"Toulouse FC","Racing Club de France","3-0",3,0,"1",1,3,3,"H"
"15843",1986-09-24,1986,"AS Monaco","Lille OSC","1-0",1,0,"1",1,1,1,"H"
"15844",1986-09-24,1986,"AJ Auxerre","FC Nantes","1-0",1,0,"1",1,1,1,"H"
"15845",1986-09-24,1986,"Brest Armorique FC","FC Metz","0-0",0,0,"1",1,0,0,"D"
"15846",1986-09-24,1986,"RC Lens","Sporting Toulon Var","2-1",2,1,"1",1,3,1,"H"
"15847",1986-09-24,1986,"Stade Laval","OGC Nice","0-0",0,0,"1",1,0,0,"D"
"15848",1986-09-24,1986,"Le Havre AC","FC Sochaux","3-1",3,1,"1",1,4,2,"H"
"15849",1986-10-03,1986,"OGC Nice","AS Monaco","1-0",1,0,"1",1,1,1,"H"
"15850",1986-10-04,1986,"Girondins Bordeaux","Paris Saint-Germain","2-0",2,0,"1",1,2,2,"H"
"15851",1986-10-04,1986,"FC Sochaux","Olympique Marseille","2-0",2,0,"1",1,2,2,"H"
"15852",1986-10-04,1986,"FC Nantes","Toulouse FC","2-1",2,1,"1",1,3,1,"H"
"15853",1986-10-04,1986,"Lille OSC","AJ Auxerre","1-1",1,1,"1",1,2,0,"D"
"15854",1986-10-04,1986,"FC Metz","AS Saint-Etienne","1-1",1,1,"1",1,2,0,"D"
"15855",1986-10-04,1986,"Le Havre AC","AS Nancy","3-0",3,0,"1",1,3,3,"H"
"15856",1986-10-04,1986,"Stade Rennes","RC Lens","1-2",1,2,"1",1,3,-1,"D"
"15857",1986-10-04,1986,"Racing Club de France","Brest Armorique FC","2-2",2,2,"1",1,4,0,"D"
"15858",1986-10-04,1986,"Sporting Toulon Var","Stade Laval","3-0",3,0,"1",1,3,3,"H"
"15859",1986-10-17,1986,"Olympique Marseille","Girondins Bordeaux","1-1",1,1,"1",1,2,0,"D"
"15860",1986-10-17,1986,"Paris Saint-Germain","Le Havre AC","1-1",1,1,"1",1,2,0,"D"
"15861",1986-10-17,1986,"Toulouse FC","FC Metz","0-0",0,0,"1",1,0,0,"D"
"15862",1986-10-17,1986,"AJ Auxerre","Sporting Toulon Var","2-0",2,0,"1",1,2,2,"H"
"15863",1986-10-17,1986,"RC Lens","FC Nantes","2-2",2,2,"1",1,4,0,"D"
"15864",1986-10-17,1986,"AS Monaco","Stade Rennes","1-0",1,0,"1",1,1,1,"H"
"15865",1986-10-17,1986,"AS Nancy","FC Sochaux","0-1",0,1,"1",1,1,-1,"D"
"15866",1986-10-17,1986,"Brest Armorique FC","OGC Nice","1-3",1,3,"1",1,4,-2,"D"
"15867",1986-10-17,1986,"AS Saint-Etienne","Racing Club de France","4-0",4,0,"1",1,4,4,"H"
"15868",1986-10-18,1986,"Stade Laval","Lille OSC","2-1",2,1,"1",1,3,1,"H"
"15869",1986-10-24,1986,"Lille OSC","AS Saint-Etienne","1-0",1,0,"1",1,1,1,"H"
"15870",1986-10-25,1986,"Girondins Bordeaux","AS Monaco","1-1",1,1,"1",1,2,0,"D"
"15871",1986-10-25,1986,"Le Havre AC","Olympique Marseille","1-3",1,3,"1",1,4,-2,"D"
"15872",1986-10-25,1986,"FC Sochaux","Paris Saint-Germain","0-1",0,1,"1",1,1,-1,"D"
"15873",1986-10-25,1986,"Stade Rennes","Toulouse FC","0-0",0,0,"1",1,0,0,"D"
"15874",1986-10-25,1986,"FC Nantes","Stade Laval","1-1",1,1,"1",1,2,0,"D"
"15875",1986-10-25,1986,"OGC Nice","AJ Auxerre","2-0",2,0,"1",1,2,2,"H"
"15876",1986-10-25,1986,"Racing Club de France","FC Metz","1-1",1,1,"1",1,2,0,"D"
"15877",1986-10-25,1986,"AS Nancy","RC Lens","1-1",1,1,"1",1,2,0,"D"
"15878",1986-10-25,1986,"Sporting Toulon Var","Brest Armorique FC","2-3",2,3,"1",1,5,-1,"D"
"15879",1986-10-31,1986,"Olympique Marseille","FC Nantes","1-0",1,0,"1",1,1,1,"H"
"15880",1986-10-31,1986,"Toulouse FC","Girondins Bordeaux","1-1",1,1,"1",1,2,0,"D"
"15881",1986-10-31,1986,"Paris Saint-Germain","AS Nancy","0-0",0,0,"1",1,0,0,"D"
"15882",1986-10-31,1986,"AS Monaco","FC Sochaux","2-0",2,0,"1",1,2,2,"H"
"15883",1986-10-31,1986,"AJ Auxerre","Racing Club de France","2-0",2,0,"1",1,2,2,"H"
"15884",1986-10-31,1986,"FC Metz","OGC Nice","1-1",1,1,"1",1,2,0,"D"
"15885",1986-10-31,1986,"Brest Armorique FC","Lille OSC","0-0",0,0,"1",1,0,0,"D"
"15886",1986-10-31,1986,"RC Lens","Le Havre AC","0-0",0,0,"1",1,0,0,"D"
"15887",1986-10-31,1986,"Stade Laval","Stade Rennes","3-0",3,0,"1",1,3,3,"H"
"15888",1986-10-31,1986,"AS Saint-Etienne","Sporting Toulon Var","1-0",1,0,"1",1,1,1,"H"
"15889",1986-11-07,1986,"Stade Rennes","AJ Auxerre","1-3",1,3,"1",1,4,-2,"D"
"15890",1986-11-07,1986,"FC Nantes","Brest Armorique FC","0-0",0,0,"1",1,0,0,"D"
"15891",1986-11-08,1986,"AS Nancy","Olympique Marseille","0-0",0,0,"1",1,0,0,"D"
"15892",1986-11-08,1986,"Girondins Bordeaux","Stade Laval","1-1",1,1,"1",1,2,0,"D"
"15893",1986-11-08,1986,"Paris Saint-Germain","Toulouse FC","2-3",2,3,"1",1,5,-1,"D"
"15894",1986-11-08,1986,"OGC Nice","AS Saint-Etienne","1-0",1,0,"1",1,1,1,"H"
"15895",1986-11-08,1986,"Le Havre AC","AS Monaco","1-1",1,1,"1",1,2,0,"D"
"15896",1986-11-08,1986,"Lille OSC","Racing Club de France","0-1",0,1,"1",1,1,-1,"D"
"15897",1986-11-08,1986,"FC Sochaux","RC Lens","0-0",0,0,"1",1,0,0,"D"
"15898",1986-11-08,1986,"Sporting Toulon Var","FC Metz","2-0",2,0,"1",1,2,2,"H"
"15899",1986-11-11,1986,"Brest Armorique FC","Stade Rennes","2-1",2,1,"1",1,3,1,"H"
"15900",1986-11-12,1986,"Olympique Marseille","OGC Nice","3-1",3,1,"1",1,4,2,"H"
"15901",1986-11-12,1986,"AJ Auxerre","Girondins Bordeaux","0-1",0,1,"1",1,1,-1,"D"
"15902",1986-11-12,1986,"Toulouse FC","Le Havre AC","3-0",3,0,"1",1,3,3,"H"
"15903",1986-11-12,1986,"AS Monaco","AS Nancy","1-0",1,0,"1",1,1,1,"H"
"15904",1986-11-12,1986,"RC Lens","Paris Saint-Germain","1-0",1,0,"1",1,1,1,"H"
"15905",1986-11-12,1986,"AS Saint-Etienne","FC Nantes","0-0",0,0,"1",1,0,0,"D"
"15906",1986-11-12,1986,"FC Metz","Lille OSC","3-0",3,0,"1",1,3,3,"H"
"15907",1986-11-12,1986,"Stade Laval","FC Sochaux","1-1",1,1,"1",1,2,0,"D"
"15908",1986-11-12,1986,"Racing Club de France","Sporting Toulon Var","2-0",2,0,"1",1,2,2,"H"
"15909",1986-11-22,1986,"Girondins Bordeaux","Brest Armorique FC","1-2",1,2,"1",1,3,-1,"D"
"15910",1986-11-22,1986,"RC Lens","Olympique Marseille","3-0",3,0,"1",1,3,3,"H"
"15911",1986-11-22,1986,"Paris Saint-Germain","AS Monaco","0-1",0,1,"1",1,1,-1,"D"
"15912",1986-11-22,1986,"AS Nancy","Toulouse FC","2-0",2,0,"1",1,2,2,"H"
"15913",1986-11-22,1986,"OGC Nice","Racing Club de France","1-0",1,0,"1",1,1,1,"H"
"15914",1986-11-22,1986,"FC Sochaux","AJ Auxerre","2-2",2,2,"1",1,4,0,"D"
"15915",1986-11-22,1986,"FC Nantes","FC Metz","1-0",1,0,"1",1,1,1,"H"
"15916",1986-11-22,1986,"Le Havre AC","Stade Laval","2-1",2,1,"1",1,3,1,"H"
"15917",1986-11-22,1986,"Sporting Toulon Var","Lille OSC","1-0",1,0,"1",1,1,1,"H"
"15918",1986-11-22,1986,"Stade Rennes","AS Saint-Etienne","0-0",0,0,"1",1,0,0,"D"
"15919",1986-11-28,1986,"Olympique Marseille","Paris Saint-Germain","4-0",4,0,"1",1,4,4,"H"
"15920",1986-11-28,1986,"FC Metz","Stade Rennes","6-1",6,1,"1",1,7,5,"H"
"15921",1986-11-29,1986,"AS Saint-Etienne","Girondins Bordeaux","2-0",2,0,"1",1,2,2,"H"
"15922",1986-11-29,1986,"AS Monaco","RC Lens","2-1",2,1,"1",1,3,1,"H"
"15923",1986-11-29,1986,"Toulouse FC","Sporting Toulon Var","1-0",1,0,"1",1,1,1,"H"
"15924",1986-11-29,1986,"AJ Auxerre","Le Havre AC","1-0",1,0,"1",1,1,1,"H"
"15925",1986-11-29,1986,"Lille OSC","OGC Nice","1-1",1,1,"1",1,2,0,"D"
"15926",1986-11-29,1986,"Racing Club de France","FC Nantes","1-1",1,1,"1",1,2,0,"D"
"15927",1986-11-29,1986,"Brest Armorique FC","FC Sochaux","0-0",0,0,"1",1,0,0,"D"
"15928",1986-11-29,1986,"Stade Laval","AS Nancy","0-0",0,0,"1",1,0,0,"D"
"15929",1986-12-05,1986,"Olympique Marseille","Brest Armorique FC","2-2",2,2,"1",1,4,0,"D"
"15930",1986-12-05,1986,"Girondins Bordeaux","Lille OSC","3-0",3,0,"1",1,3,3,"H"
"15931",1986-12-05,1986,"AS Monaco","Toulouse FC","1-0",1,0,"1",1,1,1,"H"
"15932",1986-12-05,1986,"FC Nantes","Sporting Toulon Var","1-0",1,0,"1",1,1,1,"H"
"15933",1986-12-05,1986,"Paris Saint-Germain","AJ Auxerre","1-0",1,0,"1",1,1,1,"H"
"15934",1986-12-05,1986,"Stade Rennes","OGC Nice","1-0",1,0,"1",1,1,1,"H"
"15935",1986-12-05,1986,"FC Sochaux","FC Metz","2-2",2,2,"1",1,4,0,"D"
"15936",1986-12-05,1986,"RC Lens","Stade Laval","0-2",0,2,"1",1,2,-2,"D"
"15937",1986-12-05,1986,"Le Havre AC","Racing Club de France","2-2",2,2,"1",1,4,0,"D"
"15938",1986-12-05,1986,"AS Nancy","AS Saint-Etienne","1-0",1,0,"1",1,1,1,"H"
"15939",1986-12-12,1986,"Toulouse FC","Olympique Marseille","0-0",0,0,"1",1,0,0,"D"
"15940",1986-12-13,1986,"Racing Club de France","Girondins Bordeaux","1-2",1,2,"1",1,3,-1,"D"
"15941",1986-12-13,1986,"Stade Laval","AS Monaco","2-0",2,0,"1",1,2,2,"H"
"15942",1986-12-13,1986,"AJ Auxerre","RC Lens","3-1",3,1,"1",1,4,2,"H"
"15943",1986-12-13,1986,"OGC Nice","FC Nantes","1-1",1,1,"1",1,2,0,"D"
"15944",1986-12-13,1986,"Brest Armorique FC","AS Nancy","2-0",2,0,"1",1,2,2,"H"
"15945",1986-12-13,1986,"Lille OSC","FC Sochaux","6-0",6,0,"1",1,6,6,"H"
"15946",1986-12-13,1986,"Sporting Toulon Var","Stade Rennes","2-0",2,0,"1",1,2,2,"H"
"15947",1986-12-14,1986,"AS Saint-Etienne","Le Havre AC","1-1",1,1,"1",1,2,0,"D"
"15948",1986-12-14,1986,"FC Metz","Paris Saint-Germain","0-0",0,0,"1",1,0,0,"D"
"15949",1986-12-17,1986,"Olympique Marseille","Racing Club de France","2-0",2,0,"1",1,2,2,"H"
"15950",1986-12-17,1986,"Girondins Bordeaux","OGC Nice","4-1",4,1,"1",1,5,3,"H"
"15951",1986-12-17,1986,"AS Monaco","AJ Auxerre","2-0",2,0,"1",1,2,2,"H"
"15952",1986-12-17,1986,"Toulouse FC","Stade Laval","2-0",2,0,"1",1,2,2,"H"
"15953",1986-12-17,1986,"AS Nancy","FC Nantes","0-0",0,0,"1",1,0,0,"D"
"15954",1986-12-17,1986,"Paris Saint-Germain","AS Saint-Etienne","3-0",3,0,"1",1,3,3,"H"
"15955",1986-12-17,1986,"RC Lens","Brest Armorique FC","2-1",2,1,"1",1,3,1,"H"
"15956",1986-12-17,1986,"Le Havre AC","FC Metz","2-2",2,2,"1",1,4,0,"D"
"15957",1986-12-17,1986,"Stade Rennes","Lille OSC","1-0",1,0,"1",1,1,1,"H"
"15958",1986-12-17,1986,"FC Sochaux","Sporting Toulon Var","0-1",0,1,"1",1,1,-1,"D"
"15959",1986-12-20,1986,"Stade Laval","Olympique Marseille","0-0",0,0,"1",1,0,0,"D"
"15960",1986-12-20,1986,"FC Nantes","Stade Rennes","3-1",3,1,"1",1,4,2,"H"
"15961",1986-12-20,1986,"AJ Auxerre","Toulouse FC","2-1",2,1,"1",1,3,1,"H"
"15962",1986-12-20,1986,"Brest Armorique FC","Paris Saint-Germain","0-0",0,0,"1",1,0,0,"D"
"15963",1986-12-20,1986,"Lille OSC","Le Havre AC","3-2",3,2,"1",1,5,1,"H"
"15964",1986-12-20,1986,"Racing Club de France","AS Nancy","1-0",1,0,"1",1,1,1,"H"
"15965",1986-12-21,1986,"OGC Nice","FC Sochaux","1-0",1,0,"1",1,1,1,"H"
"15966",1986-12-21,1986,"AS Saint-Etienne","RC Lens","1-0",1,0,"1",1,1,1,"H"
"15967",1986-12-21,1986,"FC Metz","AS Monaco","4-1",4,1,"1",1,5,3,"H"
"15968",1986-12-21,1986,"Sporting Toulon Var","Girondins Bordeaux","0-0",0,0,"1",1,0,0,"D"
"15969",1987-02-27,1986,"Stade Laval","AJ Auxerre","0-2",0,2,"1",1,2,-2,"D"
"15970",1987-02-28,1986,"Girondins Bordeaux","FC Nantes","2-0",2,0,"1",1,2,2,"H"
"15971",1987-02-28,1986,"Toulouse FC","AS Saint-Etienne","2-1",2,1,"1",1,3,1,"H"
"15972",1987-02-28,1986,"AS Monaco","Brest Armorique FC","0-1",0,1,"1",1,1,-1,"D"
"15973",1987-02-28,1986,"Paris Saint-Germain","OGC Nice","0-3",0,3,"1",1,3,-3,"D"
"15974",1987-02-28,1986,"RC Lens","FC Metz","0-0",0,0,"1",1,0,0,"D"
"15975",1987-02-28,1986,"AS Nancy","Lille OSC","0-1",0,1,"1",1,1,-1,"D"
"15976",1987-02-28,1986,"Le Havre AC","Sporting Toulon Var","1-1",1,1,"1",1,2,0,"D"
"15977",1987-02-28,1986,"FC Sochaux","Matra Racing","0-1",0,1,"1",1,1,-1,"D"
"15978",1987-03-01,1986,"Olympique Marseille","Stade Rennes","1-0",1,0,"1",1,1,1,"H"
"15979",1987-03-05,1986,"Matra Racing","RC Lens","5-0",5,0,"1",1,5,5,"H"
"15980",1987-03-07,1986,"Stade Rennes","Girondins Bordeaux","0-1",0,1,"1",1,1,-1,"D"
"15981",1987-03-07,1986,"AJ Auxerre","Olympique Marseille","0-0",0,0,"1",1,0,0,"D"
"15982",1987-03-07,1986,"Brest Armorique FC","Toulouse FC","1-2",1,2,"1",1,3,-1,"D"
"15983",1987-03-07,1986,"FC Nantes","FC Sochaux","2-1",2,1,"1",1,3,1,"H"
"15984",1987-03-07,1986,"AS Saint-Etienne","AS Monaco","0-0",0,0,"1",1,0,0,"D"
"15985",1987-03-07,1986,"OGC Nice","Le Havre AC","3-1",3,1,"1",1,4,2,"H"
"15986",1987-03-07,1986,"FC Metz","Stade Laval","1-0",1,0,"1",1,1,1,"H"
"15987",1987-03-07,1986,"Lille OSC","Paris Saint-Germain","1-0",1,0,"1",1,1,1,"H"
"15988",1987-03-07,1986,"Sporting Toulon Var","AS Nancy","1-0",1,0,"1",1,1,1,"H"
"15989",1987-03-11,1986,"RC Lens","Girondins Bordeaux","0-0",0,0,"1",1,0,0,"D"
"15990",1987-03-11,1986,"Olympique Marseille","FC Metz","3-2",3,2,"1",1,5,1,"H"
"15991",1987-03-11,1986,"Toulouse FC","Lille OSC","0-0",0,0,"1",1,0,0,"D"
"15992",1987-03-11,1986,"AJ Auxerre","Brest Armorique FC","1-0",1,0,"1",1,1,1,"H"
"15993",1987-03-11,1986,"AS Monaco","Matra Racing","0-0",0,0,"1",1,0,0,"D"
"15994",1987-03-11,1986,"Le Havre AC","FC Nantes","1-0",1,0,"1",1,1,1,"H"
"15995",1987-03-11,1986,"AS Nancy","OGC Nice","1-0",1,0,"1",1,1,1,"H"
"15996",1987-03-11,1986,"Paris Saint-Germain","Sporting Toulon Var","1-1",1,1,"1",1,2,0,"D"
"15997",1987-03-11,1986,"Stade Laval","AS Saint-Etienne","2-1",2,1,"1",1,3,1,"H"
"15998",1987-03-11,1986,"FC Sochaux","Stade Rennes","1-1",1,1,"1",1,2,0,"D"
"15999",1987-03-14,1986,"Girondins Bordeaux","FC Sochaux","3-0",3,0,"1",1,3,3,"H"
"16000",1987-03-14,1986,"Sporting Toulon Var","Olympique Marseille","0-0",0,0,"1",1,0,0,"D"
"16001",1987-03-14,1986,"OGC Nice","Toulouse FC","1-4",1,4,"1",1,5,-3,"D"
"16002",1987-03-14,1986,"AS Saint-Etienne","AJ Auxerre","1-1",1,1,"1",1,2,0,"D"
"16003",1987-03-14,1986,"FC Nantes","AS Monaco","0-0",0,0,"1",1,0,0,"D"
"16004",1987-03-14,1986,"FC Metz","AS Nancy","2-0",2,0,"1",1,2,2,"H"
"16005",1987-03-14,1986,"Matra Racing","Paris Saint-Germain","0-1",0,1,"1",1,1,-1,"D"
"16006",1987-03-14,1986,"Brest Armorique FC","Stade Laval","1-2",1,2,"1",1,3,-1,"D"
"16007",1987-03-14,1986,"Lille OSC","RC Lens","0-1",0,1,"1",1,1,-1,"D"
"16008",1987-03-14,1986,"Stade Rennes","Le Havre AC","0-1",0,1,"1",1,1,-1,"D"
"16009",1987-03-24,1986,"AJ Auxerre","FC Metz","0-0",0,0,"1",1,0,0,"D"
"16010",1987-03-25,1986,"Le Havre AC","Girondins Bordeaux","1-1",1,1,"1",1,2,0,"D"
"16011",1987-03-25,1986,"Olympique Marseille","Lille OSC","2-0",2,0,"1",1,2,2,"H"
"16012",1987-03-25,1986,"Toulouse FC","FC Sochaux","2-1",2,1,"1",1,3,1,"H"
"16013",1987-03-25,1986,"Brest Armorique FC","AS Saint-Etienne","1-0",1,0,"1",1,1,1,"H"
"16014",1987-03-25,1986,"AS Monaco","Sporting Toulon Var","2-2",2,2,"1",1,4,0,"D"
"16015",1987-03-25,1986,"Paris Saint-Germain","FC Nantes","2-1",2,1,"1",1,3,1,"H"
"16016",1987-03-25,1986,"Stade Laval","Matra Racing","3-1",3,1,"1",1,4,2,"H"
"16017",1987-03-25,1986,"RC Lens","OGC Nice","4-0",4,0,"1",1,4,4,"H"
"16018",1987-03-25,1986,"AS Nancy","Stade Rennes","2-0",2,0,"1",1,2,2,"H"
"16019",1987-03-28,1986,"Girondins Bordeaux","AS Nancy","4-2",4,2,"1",1,6,2,"H"
"16020",1987-03-28,1986,"AS Saint-Etienne","Olympique Marseille","0-1",0,1,"1",1,1,-1,"D"
"16021",1987-03-28,1986,"Matra Racing","Toulouse FC","0-0",0,0,"1",1,0,0,"D"
"16022",1987-03-28,1986,"FC Nantes","AJ Auxerre","0-1",0,1,"1",1,1,-1,"D"
"16023",1987-03-28,1986,"Lille OSC","AS Monaco","1-1",1,1,"1",1,2,0,"D"
"16024",1987-03-28,1986,"FC Metz","Brest Armorique FC","3-0",3,0,"1",1,3,3,"H"
"16025",1987-03-28,1986,"Stade Rennes","Paris Saint-Germain","0-0",0,0,"1",1,0,0,"D"
"16026",1987-03-28,1986,"OGC Nice","Stade Laval","2-1",2,1,"1",1,3,1,"H"
"16027",1987-03-28,1986,"Sporting Toulon Var","RC Lens","0-0",0,0,"1",1,0,0,"D"
"16028",1987-03-28,1986,"FC Sochaux","Le Havre AC","2-1",2,1,"1",1,3,1,"H"
"16029",1987-04-04,1986,"Olympique Marseille","FC Sochaux","4-0",4,0,"1",1,4,4,"H"
"16030",1987-04-04,1986,"Paris Saint-Germain","Girondins Bordeaux","0-0",0,0,"1",1,0,0,"D"
"16031",1987-04-04,1986,"Toulouse FC","FC Nantes","1-0",1,0,"1",1,1,1,"H"
"16032",1987-04-04,1986,"AJ Auxerre","Lille OSC","1-0",1,0,"1",1,1,1,"H"
"16033",1987-04-04,1986,"AS Monaco","OGC Nice","1-0",1,0,"1",1,1,1,"H"
"16034",1987-04-04,1986,"AS Saint-Etienne","FC Metz","0-0",0,0,"1",1,0,0,"D"
"16035",1987-04-04,1986,"Stade Laval","Sporting Toulon Var","3-2",3,2,"1",1,5,1,"H"
"16036",1987-04-04,1986,"RC Lens","Stade Rennes","2-1",2,1,"1",1,3,1,"H"
"16037",1987-04-04,1986,"Brest Armorique FC","Matra Racing","2-0",2,0,"1",1,2,2,"H"
"16038",1987-04-04,1986,"AS Nancy","Le Havre AC","0-0",0,0,"1",1,0,0,"D"
"16039",1987-04-11,1986,"Girondins Bordeaux","Olympique Marseille","3-0",3,0,"1",1,3,3,"H"
"16040",1987-04-11,1986,"FC Metz","Toulouse FC","2-0",2,0,"1",1,2,2,"H"
"16041",1987-04-11,1986,"Sporting Toulon Var","AJ Auxerre","1-1",1,1,"1",1,2,0,"D"
"16042",1987-04-11,1986,"Stade Rennes","AS Monaco","0-1",0,1,"1",1,1,-1,"D"
"16043",1987-04-11,1986,"FC Nantes","RC Lens","1-0",1,0,"1",1,1,1,"H"
"16044",1987-04-11,1986,"OGC Nice","Brest Armorique FC","0-4",0,4,"1",1,4,-4,"D"
"16045",1987-04-11,1986,"Le Havre AC","Paris Saint-Germain","2-0",2,0,"1",1,2,2,"H"
"16046",1987-04-11,1986,"Lille OSC","Stade Laval","2-1",2,1,"1",1,3,1,"H"
"16047",1987-04-11,1986,"Matra Racing","AS Saint-Etienne","1-2",1,2,"1",1,3,-1,"D"
"16048",1987-04-11,1986,"FC Sochaux","AS Nancy","0-1",0,1,"1",1,1,-1,"D"
"16049",1987-04-17,1986,"AS Monaco","Girondins Bordeaux","2-2",2,2,"1",1,4,0,"D"
"16050",1987-04-17,1986,"Olympique Marseille","Le Havre AC","1-1",1,1,"1",1,2,0,"D"
"16051",1987-04-17,1986,"Toulouse FC","Stade Rennes","4-2",4,2,"1",1,6,2,"H"
"16052",1987-04-17,1986,"AJ Auxerre","OGC Nice","2-1",2,1,"1",1,3,1,"H"
"16053",1987-04-17,1986,"FC Metz","Matra Racing","0-2",0,2,"1",1,2,-2,"D"
"16054",1987-04-17,1986,"Paris Saint-Germain","FC Sochaux","2-0",2,0,"1",1,2,2,"H"
"16055",1987-04-17,1986,"Stade Laval","FC Nantes","1-1",1,1,"1",1,2,0,"D"
"16056",1987-04-17,1986,"Brest Armorique FC","Sporting Toulon Var","1-1",1,1,"1",1,2,0,"D"
"16057",1987-04-17,1986,"RC Lens","AS Nancy","0-0",0,0,"1",1,0,0,"D"
"16058",1987-04-17,1986,"AS Saint-Etienne","Lille OSC","1-0",1,0,"1",1,1,1,"H"
"16059",1987-05-01,1986,"AS Nancy","Paris Saint-Germain","0-0",0,0,"1",1,0,0,"D"
"16060",1987-05-02,1986,"FC Nantes","Olympique Marseille","0-2",0,2,"1",1,2,-2,"D"
"16061",1987-05-02,1986,"Girondins Bordeaux","Toulouse FC","2-3",2,3,"1",1,5,-1,"D"
"16062",1987-05-02,1986,"FC Sochaux","AS Monaco","2-1",2,1,"1",1,3,1,"H"
"16063",1987-05-02,1986,"OGC Nice","FC Metz","3-1",3,1,"1",1,4,2,"H"
"16064",1987-05-02,1986,"Stade Rennes","Stade Laval","1-2",1,2,"1",1,3,-1,"D"
"16065",1987-05-02,1986,"Lille OSC","Brest Armorique FC","2-1",2,1,"1",1,3,1,"H"
"16066",1987-05-02,1986,"Le Havre AC","RC Lens","0-0",0,0,"1",1,0,0,"D"
"16067",1987-05-02,1986,"Sporting Toulon Var","AS Saint-Etienne","2-1",2,1,"1",1,3,1,"H"
"16068",1987-05-03,1986,"Matra Racing","AJ Auxerre","3-0",3,0,"1",1,3,3,"H"
"16069",1987-05-09,1986,"Olympique Marseille","AS Nancy","3-2",3,2,"1",1,5,1,"H"
"16070",1987-05-09,1986,"Stade Laval","Girondins Bordeaux","1-2",1,2,"1",1,3,-1,"D"
"16071",1987-05-09,1986,"Toulouse FC","Paris Saint-Germain","1-1",1,1,"1",1,2,0,"D"
"16072",1987-05-09,1986,"AJ Auxerre","Stade Rennes","1-0",1,0,"1",1,1,1,"H"
"16073",1987-05-09,1986,"AS Monaco","Le Havre AC","2-1",2,1,"1",1,3,1,"H"
"16074",1987-05-09,1986,"FC Metz","Sporting Toulon Var","4-0",4,0,"1",1,4,4,"H"
"16075",1987-05-09,1986,"Brest Armorique FC","FC Nantes","2-1",2,1,"1",1,3,1,"H"
"16076",1987-05-09,1986,"RC Lens","FC Sochaux","0-0",0,0,"1",1,0,0,"D"
"16077",1987-05-09,1986,"AS Saint-Etienne","OGC Nice","1-0",1,0,"1",1,1,1,"H"
"16078",1987-05-09,1986,"Matra Racing","Lille OSC","1-0",1,0,"1",1,1,1,"H"
"16079",1987-05-15,1986,"Girondins Bordeaux","AJ Auxerre","2-0",2,0,"1",1,2,2,"H"
"16080",1987-05-15,1986,"OGC Nice","Olympique Marseille","2-1",2,1,"1",1,3,1,"H"
"16081",1987-05-15,1986,"Le Havre AC","Toulouse FC","1-1",1,1,"1",1,2,0,"D"
"16082",1987-05-15,1986,"AS Nancy","AS Monaco","1-1",1,1,"1",1,2,0,"D"
"16083",1987-05-15,1986,"Paris Saint-Germain","RC Lens","3-1",3,1,"1",1,4,2,"H"
"16084",1987-05-15,1986,"Lille OSC","FC Metz","3-0",3,0,"1",1,3,3,"H"
"16085",1987-05-15,1986,"Stade Rennes","Brest Armorique FC","0-2",0,2,"1",1,2,-2,"D"
"16086",1987-05-15,1986,"FC Nantes","AS Saint-Etienne","1-1",1,1,"1",1,2,0,"D"
"16087",1987-05-15,1986,"FC Sochaux","Stade Laval","4-0",4,0,"1",1,4,4,"H"
"16088",1987-05-15,1986,"Sporting Toulon Var","Matra Racing","1-0",1,0,"1",1,1,1,"H"
"16089",1987-05-22,1986,"Brest Armorique FC","Girondins Bordeaux","1-1",1,1,"1",1,2,0,"D"
"16090",1987-05-22,1986,"Olympique Marseille","RC Lens","1-3",1,3,"1",1,4,-2,"D"
"16091",1987-05-22,1986,"Toulouse FC","AS Nancy","2-1",2,1,"1",1,3,1,"H"
"16092",1987-05-22,1986,"AJ Auxerre","FC Sochaux","0-0",0,0,"1",1,0,0,"D"
"16093",1987-05-22,1986,"AS Monaco","Paris Saint-Germain","1-1",1,1,"1",1,2,0,"D"
"16094",1987-05-22,1986,"FC Metz","FC Nantes","3-1",3,1,"1",1,4,2,"H"
"16095",1987-05-22,1986,"Matra Racing","OGC Nice","3-1",3,1,"1",1,4,2,"H"
"16096",1987-05-22,1986,"Lille OSC","Sporting Toulon Var","1-1",1,1,"1",1,2,0,"D"
"16097",1987-05-22,1986,"AS Saint-Etienne","Stade Rennes","2-0",2,0,"1",1,2,2,"H"
"16098",1987-05-23,1986,"Stade Laval","Le Havre AC","2-1",2,1,"1",1,3,1,"H"
"16099",1987-05-29,1986,"Girondins Bordeaux","AS Saint-Etienne","1-0",1,0,"1",1,1,1,"H"
"16100",1987-05-29,1986,"Paris Saint-Germain","Olympique Marseille","2-0",2,0,"1",1,2,2,"H"
"16101",1987-05-29,1986,"Sporting Toulon Var","Toulouse FC","3-2",3,2,"1",1,5,1,"H"
"16102",1987-05-29,1986,"Le Havre AC","AJ Auxerre","1-4",1,4,"1",1,5,-3,"D"
"16103",1987-05-29,1986,"RC Lens","AS Monaco","1-1",1,1,"1",1,2,0,"D"
"16104",1987-05-29,1986,"Stade Rennes","FC Metz","0-1",0,1,"1",1,1,-1,"D"
"16105",1987-05-29,1986,"FC Sochaux","Brest Armorique FC","3-0",3,0,"1",1,3,3,"H"
"16106",1987-05-29,1986,"OGC Nice","Lille OSC","1-0",1,0,"1",1,1,1,"H"
"16107",1987-05-29,1986,"AS Nancy","Stade Laval","3-0",3,0,"1",1,3,3,"H"
"16108",1987-05-29,1986,"FC Nantes","Matra Racing","2-3",2,3,"1",1,5,-1,"D"
"16109",1987-06-05,1986,"FC Metz","Girondins Bordeaux","2-1",2,1,"1",1,3,1,"H"
"16110",1987-06-05,1986,"AS Monaco","Olympique Marseille","2-0",2,0,"1",1,2,2,"H"
"16111",1987-06-05,1986,"Toulouse FC","RC Lens","1-0",1,0,"1",1,1,1,"H"
"16112",1987-06-05,1986,"AJ Auxerre","AS Nancy","4-2",4,2,"1",1,6,2,"H"
"16113",1987-06-05,1986,"Stade Laval","Paris Saint-Germain","4-3",4,3,"1",1,7,1,"H"
"16114",1987-06-05,1986,"Brest Armorique FC","Le Havre AC","2-0",2,0,"1",1,2,2,"H"
"16115",1987-06-05,1986,"Sporting Toulon Var","OGC Nice","2-0",2,0,"1",1,2,2,"H"
"16116",1987-06-05,1986,"Lille OSC","FC Nantes","0-1",0,1,"1",1,1,-1,"D"
"16117",1987-06-05,1986,"Matra Racing","Stade Rennes","2-1",2,1,"1",1,3,1,"H"
"16118",1987-06-05,1986,"AS Saint-Etienne","FC Sochaux","1-1",1,1,"1",1,2,0,"D"
"16119",1987-07-18,1987,"Stade Laval","AS Saint-Etienne","4-0",4,0,"1",1,4,4,"H"
"16120",1987-07-18,1987,"Sporting Toulon Var","OGC Nice","4-1",4,1,"1",1,5,3,"H"
"16121",1987-07-18,1987,"Lille OSC","FC Nantes","3-0",3,0,"1",1,3,3,"H"
"16122",1987-07-18,1987,"Toulouse FC","Montpellier La Paillade SC","3-1",3,1,"1",1,4,2,"H"
"16123",1987-07-18,1987,"AS Monaco","Olympique Marseille","3-1",3,1,"1",1,4,2,"H"
"16124",1987-07-18,1987,"Paris Saint-Germain","Le Havre AC","2-0",2,0,"1",1,2,2,"H"
"16125",1987-07-18,1987,"Girondins Bordeaux","FC Metz","3-2",3,2,"1",1,5,1,"H"
"16126",1987-07-18,1987,"Chamois Niortais","RC Lens","1-1",1,1,"1",1,2,0,"D"
"16127",1987-07-18,1987,"AS Cannes","AJ Auxerre","0-0",0,0,"1",1,0,0,"D"
"16128",1987-07-18,1987,"Brest Armorique FC","Matra Racing","0-0",0,0,"1",1,0,0,"D"
"16129",1987-07-25,1987,"RC Lens","AS Monaco","1-3",1,3,"1",1,4,-2,"D"
"16130",1987-07-25,1987,"AJ Auxerre","Girondins Bordeaux","1-3",1,3,"1",1,4,-2,"D"
"16131",1987-07-25,1987,"Toulouse FC","Stade Laval","1-0",1,0,"1",1,1,1,"H"
"16132",1987-07-25,1987,"OGC Nice","Lille OSC","2-1",2,1,"1",1,3,1,"H"
"16133",1987-07-25,1987,"Montpellier La Paillade SC","Paris Saint-Germain","4-1",4,1,"1",1,5,3,"H"
"16134",1987-07-25,1987,"FC Metz","Sporting Toulon Var","2-0",2,0,"1",1,2,2,"H"
"16135",1987-07-25,1987,"Olympique Marseille","AS Cannes","3-0",3,0,"1",1,3,3,"H"
"16136",1987-07-25,1987,"Le Havre AC","Chamois Niortais","3-0",3,0,"1",1,3,3,"H"
"16137",1987-07-25,1987,"Matra Racing","AS Saint-Etienne","2-2",2,2,"1",1,4,0,"D"
"16138",1987-07-25,1987,"FC Nantes","Brest Armorique FC","1-0",1,0,"1",1,1,1,"H"
"16139",1987-08-01,1987,"AS Monaco","Le Havre AC","2-0",2,0,"1",1,2,2,"H"
"16140",1987-08-01,1987,"Girondins Bordeaux","Olympique Marseille","2-0",2,0,"1",1,2,2,"H"
"16141",1987-08-01,1987,"Lille OSC","FC Metz","1-0",1,0,"1",1,1,1,"H"
"16142",1987-08-01,1987,"Paris Saint-Germain","Toulouse FC","2-0",2,0,"1",1,2,2,"H"
"16143",1987-08-01,1987,"Brest Armorique FC","OGC Nice","0-1",0,1,"1",1,1,-1,"D"
"16144",1987-08-01,1987,"Stade Laval","Matra Racing","1-1",1,1,"1",1,2,0,"D"
"16145",1987-08-01,1987,"Sporting Toulon Var","AJ Auxerre","0-0",0,0,"1",1,0,0,"D"
"16146",1987-08-01,1987,"AS Saint-Etienne","FC Nantes","1-1",1,1,"1",1,2,0,"D"
"16147",1987-08-01,1987,"Chamois Niortais","Montpellier La Paillade SC","1-0",1,0,"1",1,1,1,"H"
"16148",1987-08-01,1987,"AS Cannes","RC Lens","2-1",2,1,"1",1,3,1,"H"
"16149",1987-08-08,1987,"Montpellier La Paillade SC","AS Monaco","2-1",2,1,"1",1,3,1,"H"
"16150",1987-08-08,1987,"RC Lens","Girondins Bordeaux","1-0",1,0,"1",1,1,1,"H"
"16151",1987-08-08,1987,"Toulouse FC","Chamois Niortais","1-0",1,0,"1",1,1,1,"H"
"16152",1987-08-08,1987,"Paris Saint-Germain","Brest Armorique FC","0-0",0,0,"1",1,0,0,"D"
"16153",1987-08-08,1987,"AJ Auxerre","Lille OSC","2-1",2,1,"1",1,3,1,"H"
"16154",1987-08-08,1987,"FC Metz","Stade Laval","2-1",2,1,"1",1,3,1,"H"
"16155",1987-08-08,1987,"Olympique Marseille","Sporting Toulon Var","1-1",1,1,"1",1,2,0,"D"
"16156",1987-08-08,1987,"FC Nantes","Matra Racing","1-1",1,1,"1",1,2,0,"D"
"16157",1987-08-08,1987,"OGC Nice","AS Saint-Etienne","2-3",2,3,"1",1,5,-1,"D"
"16158",1987-08-08,1987,"Le Havre AC","AS Cannes","2-2",2,2,"1",1,4,0,"D"
"16159",1987-08-15,1987,"AS Monaco","Toulouse FC","5-1",5,1,"1",1,6,4,"H"
"16160",1987-08-15,1987,"Girondins Bordeaux","Le Havre AC","2-2",2,2,"1",1,4,0,"D"
"16161",1987-08-15,1987,"Chamois Niortais","Paris Saint-Germain","1-2",1,2,"1",1,3,-1,"D"
"16162",1987-08-15,1987,"Sporting Toulon Var","RC Lens","2-0",2,0,"1",1,2,2,"H"
"16163",1987-08-15,1987,"Matra Racing","OGC Nice","2-1",2,1,"1",1,3,1,"H"
"16164",1987-08-15,1987,"AS Saint-Etienne","FC Metz","2-0",2,0,"1",1,2,2,"H"
"16165",1987-08-15,1987,"Lille OSC","Olympique Marseille","1-1",1,1,"1",1,2,0,"D"
"16166",1987-08-15,1987,"AS Cannes","Montpellier La Paillade SC","0-0",0,0,"1",1,0,0,"D"
"16167",1987-08-15,1987,"Brest Armorique FC","AJ Auxerre","1-1",1,1,"1",1,2,0,"D"
"16168",1987-08-15,1987,"Stade Laval","FC Nantes","1-1",1,1,"1",1,2,0,"D"
"16169",1987-08-19,1987,"Paris Saint-Germain","AS Monaco","0-1",0,1,"1",1,1,-1,"D"
"16170",1987-08-19,1987,"Montpellier La Paillade SC","Girondins Bordeaux","0-0",0,0,"1",1,0,0,"D"
"16171",1987-08-19,1987,"Le Havre AC","Sporting Toulon Var","1-1",1,1,"1",1,2,0,"D"
"16172",1987-08-19,1987,"FC Metz","Matra Racing","0-0",0,0,"1",1,0,0,"D"
"16173",1987-08-19,1987,"Toulouse FC","AS Cannes","0-1",0,1,"1",1,1,-1,"D"
"16174",1987-08-19,1987,"RC Lens","Lille OSC","1-1",1,1,"1",1,2,0,"D"
"16175",1987-08-19,1987,"Olympique Marseille","Brest Armorique FC","1-0",1,0,"1",1,1,1,"H"
"16176",1987-08-19,1987,"OGC Nice","FC Nantes","3-1",3,1,"1",1,4,2,"H"
"16177",1987-08-19,1987,"AJ Auxerre","Stade Laval","1-1",1,1,"1",1,2,0,"D"
"16178",1987-08-19,1987,"Chamois Niortais","AS Saint-Etienne","2-1",2,1,"1",1,3,1,"H"
"16179",1987-08-22,1987,"AS Monaco","Chamois Niortais","1-3",1,3,"1",1,4,-2,"D"
"16180",1987-08-22,1987,"Girondins Bordeaux","Toulouse FC","2-2",2,2,"1",1,4,0,"D"
"16181",1987-08-22,1987,"AS Cannes","Paris Saint-Germain","1-3",1,3,"1",1,4,-2,"D"
"16182",1987-08-22,1987,"Sporting Toulon Var","Montpellier La Paillade SC","0-0",0,0,"1",1,0,0,"D"
"16183",1987-08-22,1987,"Matra Racing","Olympique Marseille","0-0",0,0,"1",1,0,0,"D"
"16184",1987-08-22,1987,"Stade Laval","OGC Nice","1-2",1,2,"1",1,3,-1,"D"
"16185",1987-08-22,1987,"AS Saint-Etienne","AJ Auxerre","2-1",2,1,"1",1,3,1,"H"
"16186",1987-08-22,1987,"Lille OSC","Le Havre AC","0-0",0,0,"1",1,0,0,"D"
"16187",1987-08-22,1987,"FC Nantes","FC Metz","0-0",0,0,"1",1,0,0,"D"
"16188",1987-08-22,1987,"Brest Armorique FC","RC Lens","4-1",4,1,"1",1,5,3,"H"
"16189",1987-08-29,1987,"AS Monaco","Stade Laval","2-0",2,0,"1",1,2,2,"H"
"16190",1987-08-29,1987,"Paris Saint-Germain","Girondins Bordeaux","1-0",1,0,"1",1,1,1,"H"
"16191",1987-08-29,1987,"Olympique Marseille","AS Saint-Etienne","5-1",5,1,"1",1,6,4,"H"
"16192",1987-08-29,1987,"Montpellier La Paillade SC","Lille OSC","3-1",3,1,"1",1,4,2,"H"
"16193",1987-08-29,1987,"Chamois Niortais","AS Cannes","2-0",2,0,"1",1,2,2,"H"
"16194",1987-08-29,1987,"Toulouse FC","Sporting Toulon Var","1-0",1,0,"1",1,1,1,"H"
"16195",1987-08-29,1987,"FC Metz","OGC Nice","2-0",2,0,"1",1,2,2,"H"
"16196",1987-08-29,1987,"Le Havre AC","Brest Armorique FC","3-2",3,2,"1",1,5,1,"H"
"16197",1987-08-29,1987,"RC Lens","Matra Racing","2-1",2,1,"1",1,3,1,"H"
"16198",1987-08-29,1987,"AJ Auxerre","FC Nantes","1-0",1,0,"1",1,1,1,"H"
"16199",1987-09-01,1987,"FC Nantes","Olympique Marseille","5-0",5,0,"1",1,5,5,"H"
"16200",1987-09-02,1987,"AS Cannes","AS Monaco","1-1",1,1,"1",1,2,0,"D"
"16201",1987-09-02,1987,"Girondins Bordeaux","Chamois Niortais","1-0",1,0,"1",1,1,1,"H"
"16202",1987-09-02,1987,"Sporting Toulon Var","Paris Saint-Germain","1-0",1,0,"1",1,1,1,"H"
"16203",1987-09-02,1987,"Matra Racing","Le Havre AC","2-0",2,0,"1",1,2,2,"H"
"16204",1987-09-02,1987,"OGC Nice","AJ Auxerre","1-0",1,0,"1",1,1,1,"H"
"16205",1987-09-02,1987,"AS Saint-Etienne","RC Lens","2-1",2,1,"1",1,3,1,"H"
"16206",1987-09-02,1987,"Lille OSC","Toulouse FC","2-0",2,0,"1",1,2,2,"H"
"16207",1987-09-02,1987,"Stade Laval","Montpellier La Paillade SC","1-0",1,0,"1",1,1,1,"H"
"16208",1987-09-02,1987,"Brest Armorique FC","FC Metz","1-0",1,0,"1",1,1,1,"H"
"16209",1987-09-12,1987,"AS Monaco","Girondins Bordeaux","1-0",1,0,"1",1,1,1,"H"
"16210",1987-09-12,1987,"Montpellier La Paillade SC","Matra Racing","6-1",6,1,"1",1,7,5,"H"
"16211",1987-09-12,1987,"Paris Saint-Germain","Lille OSC","1-3",1,3,"1",1,4,-2,"D"
"16212",1987-09-12,1987,"Olympique Marseille","OGC Nice","2-0",2,0,"1",1,2,2,"H"
"16213",1987-09-12,1987,"Chamois Niortais","Sporting Toulon Var","2-1",2,1,"1",1,3,1,"H"
"16214",1987-09-12,1987,"Toulouse FC","Brest Armorique FC","2-1",2,1,"1",1,3,1,"H"
"16215",1987-09-12,1987,"Le Havre AC","AS Saint-Etienne","1-1",1,1,"1",1,2,0,"D"
"16216",1987-09-12,1987,"RC Lens","FC Nantes","1-2",1,2,"1",1,3,-1,"D"
"16217",1987-09-12,1987,"AJ Auxerre","FC Metz","0-1",0,1,"1",1,1,-1,"D"
"16218",1987-09-12,1987,"AS Cannes","Stade Laval","1-0",1,0,"1",1,1,1,"H"
"16219",1987-09-19,1987,"Sporting Toulon Var","AS Monaco","0-0",0,0,"1",1,0,0,"D"
"16220",1987-09-19,1987,"Lille OSC","Chamois Niortais","0-1",0,1,"1",1,1,-1,"D"
"16221",1987-09-19,1987,"AS Saint-Etienne","Toulouse FC","2-0",2,0,"1",1,2,2,"H"
"16222",1987-09-19,1987,"Girondins Bordeaux","AS Cannes","3-3",3,3,"1",1,6,0,"D"
"16223",1987-09-19,1987,"FC Nantes","Le Havre AC","2-0",2,0,"1",1,2,2,"H"
"16224",1987-09-19,1987,"FC Metz","Olympique Marseille","3-1",3,1,"1",1,4,2,"H"
"16225",1987-09-19,1987,"Brest Armorique FC","Montpellier La Paillade SC","4-0",4,0,"1",1,4,4,"H"
"16226",1987-09-19,1987,"Stade Laval","Paris Saint-Germain","2-0",2,0,"1",1,2,2,"H"
"16227",1987-09-19,1987,"OGC Nice","RC Lens","0-1",0,1,"1",1,1,-1,"D"
"16228",1987-09-20,1987,"Matra Racing","AJ Auxerre","1-0",1,0,"1",1,1,1,"H"
"16229",1987-09-26,1987,"AS Monaco","Lille OSC","1-0",1,0,"1",1,1,1,"H"
"16230",1987-09-26,1987,"Chamois Niortais","Brest Armorique FC","3-0",3,0,"1",1,3,3,"H"
"16231",1987-09-26,1987,"Girondins Bordeaux","Stade Laval","1-0",1,0,"1",1,1,1,"H"
"16232",1987-09-26,1987,"Montpellier La Paillade SC","FC Nantes","0-0",0,0,"1",1,0,0,"D"
"16233",1987-09-26,1987,"Paris Saint-Germain","AS Saint-Etienne","3-0",3,0,"1",1,3,3,"H"
"16234",1987-09-26,1987,"Toulouse FC","Matra Racing","0-0",0,0,"1",1,0,0,"D"
"16235",1987-09-26,1987,"AS Cannes","Sporting Toulon Var","1-0",1,0,"1",1,1,1,"H"
"16236",1987-09-26,1987,"RC Lens","FC Metz","2-0",2,0,"1",1,2,2,"H"
"16237",1987-09-26,1987,"Olympique Marseille","AJ Auxerre","0-1",0,1,"1",1,1,-1,"D"
"16238",1987-09-26,1987,"Le Havre AC","OGC Nice","2-1",2,1,"1",1,3,1,"H"
"16239",1987-10-02,1987,"Matra Racing","Paris Saint-Germain","2-1",2,1,"1",1,3,1,"H"
"16240",1987-10-03,1987,"Brest Armorique FC","AS Monaco","0-2",0,2,"1",1,2,-2,"D"
"16241",1987-10-03,1987,"Sporting Toulon Var","Girondins Bordeaux","0-1",0,1,"1",1,1,-1,"D"
"16242",1987-10-03,1987,"FC Nantes","Toulouse FC","3-1",3,1,"1",1,4,2,"H"
"16243",1987-10-03,1987,"OGC Nice","Chamois Niortais","1-0",1,0,"1",1,1,1,"H"
"16244",1987-10-03,1987,"AS Saint-Etienne","Montpellier La Paillade SC","2-1",2,1,"1",1,3,1,"H"
"16245",1987-10-03,1987,"FC Metz","Le Havre AC","1-0",1,0,"1",1,1,1,"H"
"16246",1987-10-03,1987,"Lille OSC","AS Cannes","0-0",0,0,"1",1,0,0,"D"
"16247",1987-10-03,1987,"Stade Laval","Olympique Marseille","0-2",0,2,"1",1,2,-2,"D"
"16248",1987-10-03,1987,"AJ Auxerre","RC Lens","2-0",2,0,"1",1,2,2,"H"
"16249",1987-10-06,1987,"Montpellier La Paillade SC","FC Metz","1-0",1,0,"1",1,1,1,"H"
"16250",1987-10-07,1987,"AS Monaco","AS Saint-Etienne","2-1",2,1,"1",1,3,1,"H"
"16251",1987-10-07,1987,"Girondins Bordeaux","Lille OSC","1-0",1,0,"1",1,1,1,"H"
"16252",1987-10-07,1987,"Paris Saint-Germain","FC Nantes","0-2",0,2,"1",1,2,-2,"D"
"16253",1987-10-07,1987,"Chamois Niortais","Matra Racing","2-2",2,2,"1",1,4,0,"D"
"16254",1987-10-07,1987,"AS Cannes","Brest Armorique FC","2-1",2,1,"1",1,3,1,"H"
"16255",1987-10-07,1987,"RC Lens","Olympique Marseille","2-4",2,4,"1",1,6,-2,"D"
"16256",1987-10-07,1987,"Le Havre AC","AJ Auxerre","1-2",1,2,"1",1,3,-1,"D"
"16257",1987-10-07,1987,"Toulouse FC","OGC Nice","2-0",2,0,"1",1,2,2,"H"
"16258",1987-10-07,1987,"Sporting Toulon Var","Stade Laval","3-0",3,0,"1",1,3,3,"H"
"16259",1987-10-17,1987,"Matra Racing","AS Monaco","1-0",1,0,"1",1,1,1,"H"
"16260",1987-10-17,1987,"FC Nantes","Chamois Niortais","2-1",2,1,"1",1,3,1,"H"
"16261",1987-10-17,1987,"Brest Armorique FC","Girondins Bordeaux","1-1",1,1,"1",1,2,0,"D"
"16262",1987-10-17,1987,"Olympique Marseille","Le Havre AC","3-1",3,1,"1",1,4,2,"H"
"16263",1987-10-17,1987,"AS Saint-Etienne","AS Cannes","1-0",1,0,"1",1,1,1,"H"
"16264",1987-10-17,1987,"FC Metz","Toulouse FC","4-1",4,1,"1",1,5,3,"H"
"16265",1987-10-17,1987,"AJ Auxerre","Montpellier La Paillade SC","1-1",1,1,"1",1,2,0,"D"
"16266",1987-10-17,1987,"Lille OSC","Sporting Toulon Var","1-0",1,0,"1",1,1,1,"H"
"16267",1987-10-17,1987,"OGC Nice","Paris Saint-Germain","2-0",2,0,"1",1,2,2,"H"
"16268",1987-10-17,1987,"Stade Laval","RC Lens","4-0",4,0,"1",1,4,4,"H"
"16269",1987-10-24,1987,"AS Monaco","FC Nantes","2-1",2,1,"1",1,3,1,"H"
"16270",1987-10-24,1987,"Girondins Bordeaux","AS Saint-Etienne","1-0",1,0,"1",1,1,1,"H"
"16271",1987-10-24,1987,"Paris Saint-Germain","FC Metz","0-2",0,2,"1",1,2,-2,"D"
"16272",1987-10-24,1987,"Chamois Niortais","Olympique Marseille","1-0",1,0,"1",1,1,1,"H"
"16273",1987-10-24,1987,"AS Cannes","Matra Racing","3-1",3,1,"1",1,4,2,"H"
"16274",1987-10-24,1987,"Montpellier La Paillade SC","OGC Nice","4-1",4,1,"1",1,5,3,"H"
"16275",1987-10-24,1987,"Toulouse FC","AJ Auxerre","0-0",0,0,"1",1,0,0,"D"
"16276",1987-10-24,1987,"Sporting Toulon Var","Brest Armorique FC","3-0",3,0,"1",1,3,3,"H"
"16277",1987-10-24,1987,"Lille OSC","Stade Laval","0-0",0,0,"1",1,0,0,"D"
"16278",1987-10-24,1987,"Le Havre AC","RC Lens","0-1",0,1,"1",1,1,-1,"D"
"16279",1987-10-31,1987,"OGC Nice","AS Monaco","0-0",0,0,"1",1,0,0,"D"
"16280",1987-11-01,1987,"FC Nantes","AS Cannes","2-1",2,1,"1",1,3,1,"H"
"16281",1987-11-01,1987,"Matra Racing","Girondins Bordeaux","1-0",1,0,"1",1,1,1,"H"
"16282",1987-11-01,1987,"FC Metz","Chamois Niortais","2-0",2,0,"1",1,2,2,"H"
"16283",1987-11-01,1987,"Olympique Marseille","Toulouse FC","1-0",1,0,"1",1,1,1,"H"
"16284",1987-11-01,1987,"AJ Auxerre","Paris Saint-Germain","3-0",3,0,"1",1,3,3,"H"
"16285",1987-11-01,1987,"AS Saint-Etienne","Sporting Toulon Var","0-0",0,0,"1",1,0,0,"D"
"16286",1987-11-01,1987,"RC Lens","Montpellier La Paillade SC","2-1",2,1,"1",1,3,1,"H"
"16287",1987-11-01,1987,"Brest Armorique FC","Lille OSC","2-2",2,2,"1",1,4,0,"D"
"16288",1987-11-01,1987,"Stade Laval","Le Havre AC","4-3",4,3,"1",1,7,1,"H"
"16289",1987-11-07,1987,"AS Monaco","FC Metz","2-1",2,1,"1",1,3,1,"H"
"16290",1987-11-07,1987,"Girondins Bordeaux","FC Nantes","2-1",2,1,"1",1,3,1,"H"
"16291",1987-11-07,1987,"Lille OSC","AS Saint-Etienne","1-2",1,2,"1",1,3,-1,"D"
"16292",1987-11-07,1987,"Montpellier La Paillade SC","Le Havre AC","3-1",3,1,"1",1,4,2,"H"
"16293",1987-11-07,1987,"Chamois Niortais","AJ Auxerre","0-0",0,0,"1",1,0,0,"D"
"16294",1987-11-07,1987,"AS Cannes","OGC Nice","0-1",0,1,"1",1,1,-1,"D"
"16295",1987-11-07,1987,"Toulouse FC","RC Lens","0-1",0,1,"1",1,1,-1,"D"
"16296",1987-11-08,1987,"Paris Saint-Germain","Olympique Marseille","1-1",1,1,"1",1,2,0,"D"
"16297",1987-11-10,1987,"Matra Racing","Lille OSC","3-0",3,0,"1",1,3,3,"H"
"16298",1987-11-11,1987,"AJ Auxerre","AS Monaco","0-0",0,0,"1",1,0,0,"D"
"16299",1987-11-11,1987,"OGC Nice","Girondins Bordeaux","0-1",0,1,"1",1,1,-1,"D"
"16300",1987-11-11,1987,"FC Nantes","Sporting Toulon Var","1-1",1,1,"1",1,2,0,"D"
"16301",1987-11-11,1987,"AS Saint-Etienne","Brest Armorique FC","4-0",4,0,"1",1,4,4,"H"
"16302",1987-11-11,1987,"Olympique Marseille","Montpellier La Paillade SC","1-1",1,1,"1",1,2,0,"D"
"16303",1987-11-11,1987,"FC Metz","AS Cannes","2-3",2,3,"1",1,5,-1,"D"
"16304",1987-11-11,1987,"Stade Laval","Chamois Niortais","2-0",2,0,"1",1,2,2,"H"
"16305",1987-11-11,1987,"Le Havre AC","Toulouse FC","0-1",0,1,"1",1,1,-1,"D"
"16306",1987-11-11,1987,"RC Lens","Paris Saint-Germain","0-0",0,0,"1",1,0,0,"D"
"16307",1987-11-21,1987,"AS Monaco","RC Lens","3-0",3,0,"1",1,3,3,"H"
"16308",1987-11-21,1987,"Girondins Bordeaux","AJ Auxerre","0-0",0,0,"1",1,0,0,"D"
"16309",1987-11-21,1987,"AS Saint-Etienne","Matra Racing","0-2",0,2,"1",1,2,-2,"D"
"16310",1987-11-21,1987,"Brest Armorique FC","FC Nantes","0-0",0,0,"1",1,0,0,"D"
"16311",1987-11-21,1987,"AS Cannes","Olympique Marseille","1-0",1,0,"1",1,1,1,"H"
"16312",1987-11-21,1987,"Paris Saint-Germain","Montpellier La Paillade SC","2-1",2,1,"1",1,3,1,"H"
"16313",1987-11-21,1987,"Sporting Toulon Var","FC Metz","1-0",1,0,"1",1,1,1,"H"
"16314",1987-11-21,1987,"Chamois Niortais","Le Havre AC","1-2",1,2,"1",1,3,-1,"D"
"16315",1987-11-21,1987,"Stade Laval","Toulouse FC","1-0",1,0,"1",1,1,1,"H"
"16316",1987-11-21,1987,"Lille OSC","OGC Nice","1-0",1,0,"1",1,1,1,"H"
"16317",1987-11-27,1987,"Olympique Marseille","Girondins Bordeaux","1-0",1,0,"1",1,1,1,"H"
"16318",1987-11-28,1987,"Le Havre AC","AS Monaco","0-0",0,0,"1",1,0,0,"D"
"16319",1987-11-28,1987,"Matra Racing","Stade Laval","1-0",1,0,"1",1,1,1,"H"
"16320",1987-11-28,1987,"FC Nantes","AS Saint-Etienne","2-3",2,3,"1",1,5,-1,"D"
"16321",1987-11-28,1987,"RC Lens","AS Cannes","0-0",0,0,"1",1,0,0,"D"
"16322",1987-11-28,1987,"Montpellier La Paillade SC","Chamois Niortais","1-0",1,0,"1",1,1,1,"H"
"16323",1987-11-28,1987,"FC Metz","Lille OSC","3-1",3,1,"1",1,4,2,"H"
"16324",1987-11-28,1987,"AJ Auxerre","Sporting Toulon Var","0-0",0,0,"1",1,0,0,"D"
"16325",1987-11-28,1987,"OGC Nice","Brest Armorique FC","2-0",2,0,"1",1,2,2,"H"
"16326",1987-11-28,1987,"Toulouse FC","Paris Saint-Germain","2-1",2,1,"1",1,3,1,"H"
"16327",1987-12-02,1987,"Brest Armorique FC","Stade Laval","2-1",2,1,"1",1,3,1,"H"
"16328",1987-12-02,1987,"Sporting Toulon Var","Matra Racing","0-0",0,0,"1",1,0,0,"D"
"16329",1987-12-05,1987,"AS Monaco","Montpellier La Paillade SC","0-0",0,0,"1",1,0,0,"D"
"16330",1987-12-05,1987,"Girondins Bordeaux","RC Lens","5-2",5,2,"1",1,7,3,"H"
"16331",1987-12-05,1987,"Matra Racing","FC Nantes","2-2",2,2,"1",1,4,0,"D"
"16332",1987-12-05,1987,"AS Saint-Etienne","OGC Nice","3-2",3,2,"1",1,5,1,"H"
"16333",1987-12-05,1987,"Sporting Toulon Var","Olympique Marseille","1-2",1,2,"1",1,3,-1,"D"
"16334",1987-12-05,1987,"AS Cannes","Le Havre AC","3-0",3,0,"1",1,3,3,"H"
"16335",1987-12-05,1987,"Lille OSC","AJ Auxerre","0-1",0,1,"1",1,1,-1,"D"
"16336",1987-12-05,1987,"Stade Laval","FC Metz","3-0",3,0,"1",1,3,3,"H"
"16337",1987-12-05,1987,"Chamois Niortais","Toulouse FC","0-0",0,0,"1",1,0,0,"D"
"16338",1987-12-05,1987,"Brest Armorique FC","Paris Saint-Germain","0-0",0,0,"1",1,0,0,"D"
"16339",1987-12-12,1987,"Toulouse FC","AS Monaco","1-1",1,1,"1",1,2,0,"D"
"16340",1987-12-12,1987,"Le Havre AC","Girondins Bordeaux","0-1",0,1,"1",1,1,-1,"D"
"16341",1987-12-12,1987,"OGC Nice","Matra Racing","1-2",1,2,"1",1,3,-1,"D"
"16342",1987-12-12,1987,"AJ Auxerre","Brest Armorique FC","4-0",4,0,"1",1,4,4,"H"
"16343",1987-12-12,1987,"FC Metz","AS Saint-Etienne","2-1",2,1,"1",1,3,1,"H"
"16344",1987-12-12,1987,"Montpellier La Paillade SC","AS Cannes","4-2",4,2,"1",1,6,2,"H"
"16345",1987-12-12,1987,"Olympique Marseille","Lille OSC","0-1",0,1,"1",1,1,-1,"D"
"16346",1987-12-12,1987,"FC Nantes","Stade Laval","1-2",1,2,"1",1,3,-1,"D"
"16347",1987-12-12,1987,"Paris Saint-Germain","Chamois Niortais","1-3",1,3,"1",1,4,-2,"D"
"16348",1987-12-12,1987,"RC Lens","Sporting Toulon Var","3-1",3,1,"1",1,4,2,"H"
"16349",1987-12-18,1987,"AS Monaco","Paris Saint-Germain","2-1",2,1,"1",1,3,1,"H"
"16350",1987-12-19,1987,"Girondins Bordeaux","Montpellier La Paillade SC","1-0",1,0,"1",1,1,1,"H"
"16351",1987-12-19,1987,"Matra Racing","FC Metz","2-0",2,0,"1",1,2,2,"H"
"16352",1987-12-19,1987,"AS Saint-Etienne","Chamois Niortais","2-0",2,0,"1",1,2,2,"H"
"16353",1987-12-19,1987,"Stade Laval","AJ Auxerre","0-0",0,0,"1",1,0,0,"D"
"16354",1987-12-19,1987,"AS Cannes","Toulouse FC","1-1",1,1,"1",1,2,0,"D"
"16355",1987-12-19,1987,"Brest Armorique FC","Olympique Marseille","2-1",2,1,"1",1,3,1,"H"
"16356",1987-12-19,1987,"FC Nantes","OGC Nice","0-1",0,1,"1",1,1,-1,"D"
"16357",1987-12-19,1987,"Sporting Toulon Var","Le Havre AC","3-0",3,0,"1",1,3,3,"H"
"16358",1987-12-19,1987,"Lille OSC","RC Lens","1-1",1,1,"1",1,2,0,"D"
"16359",1988-02-19,1987,"Olympique Marseille","Matra Racing","2-0",2,0,"1",1,2,2,"H"
"16360",1988-02-20,1987,"Chamois Niortais","AS Monaco","0-0",0,0,"1",1,0,0,"D"
"16361",1988-02-20,1987,"Toulouse FC","Girondins Bordeaux","2-1",2,1,"1",1,3,1,"H"
"16362",1988-02-20,1987,"AJ Auxerre","AS Saint-Etienne","0-1",0,1,"1",1,1,-1,"D"
"16363",1988-02-20,1987,"FC Metz","FC Nantes","1-0",1,0,"1",1,1,1,"H"
"16364",1988-02-20,1987,"Montpellier La Paillade SC","Sporting Toulon Var","0-1",0,1,"1",1,1,-1,"D"
"16365",1988-02-20,1987,"OGC Nice","Stade Laval","0-1",0,1,"1",1,1,-1,"D"
"16366",1988-02-20,1987,"RC Lens","Brest Armorique FC","2-1",2,1,"1",1,3,1,"H"
"16367",1988-02-20,1987,"Le Havre AC","Lille OSC","0-0",0,0,"1",1,0,0,"D"
"16368",1988-02-23,1987,"Paris Saint-Germain","AS Cannes","1-1",1,1,"1",1,2,0,"D"
"16369",1988-02-26,1987,"Stade Laval","AS Monaco","0-0",0,0,"1",1,0,0,"D"
"16370",1988-02-27,1987,"Girondins Bordeaux","Paris Saint-Germain","0-0",0,0,"1",1,0,0,"D"
"16371",1988-02-27,1987,"FC Nantes","AJ Auxerre","0-0",0,0,"1",1,0,0,"D"
"16372",1988-02-27,1987,"OGC Nice","FC Metz","0-0",0,0,"1",1,0,0,"D"
"16373",1988-02-27,1987,"Matra Racing","RC Lens","1-0",1,0,"1",1,1,1,"H"
"16374",1988-02-27,1987,"AS Saint-Etienne","Olympique Marseille","0-1",0,1,"1",1,1,-1,"D"
"16375",1988-02-27,1987,"AS Cannes","Chamois Niortais","2-1",2,1,"1",1,3,1,"H"
"16376",1988-02-27,1987,"Sporting Toulon Var","Toulouse FC","1-0",1,0,"1",1,1,1,"H"
"16377",1988-02-27,1987,"Lille OSC","Montpellier La Paillade SC","3-1",3,1,"1",1,4,2,"H"
"16378",1988-02-27,1987,"Brest Armorique FC","Le Havre AC","3-1",3,1,"1",1,4,2,"H"
"16379",1988-03-04,1987,"RC Lens","AS Saint-Etienne","1-0",1,0,"1",1,1,1,"H"
"16380",1988-03-05,1987,"AS Monaco","AS Cannes","4-1",4,1,"1",1,5,3,"H"
"16381",1988-03-05,1987,"Le Havre AC","Matra Racing","1-1",1,1,"1",1,2,0,"D"
"16382",1988-03-05,1987,"Chamois Niortais","Girondins Bordeaux","0-0",0,0,"1",1,0,0,"D"
"16383",1988-03-05,1987,"Olympique Marseille","FC Nantes","3-0",3,0,"1",1,3,3,"H"
"16384",1988-03-05,1987,"AJ Auxerre","OGC Nice","2-0",2,0,"1",1,2,2,"H"
"16385",1988-03-05,1987,"FC Metz","Brest Armorique FC","1-1",1,1,"1",1,2,0,"D"
"16386",1988-03-05,1987,"Paris Saint-Germain","Sporting Toulon Var","1-0",1,0,"1",1,1,1,"H"
"16387",1988-03-05,1987,"Montpellier La Paillade SC","Stade Laval","2-1",2,1,"1",1,3,1,"H"
"16388",1988-03-05,1987,"Toulouse FC","Lille OSC","2-1",2,1,"1",1,3,1,"H"
"16389",1988-03-19,1987,"Girondins Bordeaux","AS Monaco","3-1",3,1,"1",1,4,2,"H"
"16390",1988-03-19,1987,"Matra Racing","Montpellier La Paillade SC","0-2",0,2,"1",1,2,-2,"D"
"16391",1988-03-19,1987,"AS Saint-Etienne","Le Havre AC","2-1",2,1,"1",1,3,1,"H"
"16392",1988-03-19,1987,"OGC Nice","Olympique Marseille","3-1",3,1,"1",1,4,2,"H"
"16393",1988-03-19,1987,"FC Metz","AJ Auxerre","1-0",1,0,"1",1,1,1,"H"
"16394",1988-03-19,1987,"Stade Laval","AS Cannes","2-1",2,1,"1",1,3,1,"H"
"16395",1988-03-19,1987,"Sporting Toulon Var","Chamois Niortais","1-1",1,1,"1",1,2,0,"D"
"16396",1988-03-19,1987,"FC Nantes","RC Lens","2-0",2,0,"1",1,2,2,"H"
"16397",1988-03-19,1987,"Lille OSC","Paris Saint-Germain","1-0",1,0,"1",1,1,1,"H"
"16398",1988-03-19,1987,"Brest Armorique FC","Toulouse FC","1-0",1,0,"1",1,1,1,"H"
"16399",1988-03-26,1987,"AS Monaco","Sporting Toulon Var","0-0",0,0,"1",1,0,0,"D"
"16400",1988-03-26,1987,"AS Cannes","Girondins Bordeaux","1-0",1,0,"1",1,1,1,"H"
"16401",1988-03-26,1987,"AJ Auxerre","Matra Racing","3-0",3,0,"1",1,3,3,"H"
"16402",1988-03-26,1987,"Toulouse FC","AS Saint-Etienne","2-3",2,3,"1",1,5,-1,"D"
"16403",1988-03-26,1987,"Olympique Marseille","FC Metz","1-0",1,0,"1",1,1,1,"H"
"16404",1988-03-26,1987,"Montpellier La Paillade SC","Brest Armorique FC","6-0",6,0,"1",1,6,6,"H"
"16405",1988-03-26,1987,"Paris Saint-Germain","Stade Laval","0-0",0,0,"1",1,0,0,"D"
"16406",1988-03-26,1987,"Le Havre AC","FC Nantes","1-0",1,0,"1",1,1,1,"H"
"16407",1988-03-26,1987,"Chamois Niortais","Lille OSC","1-0",1,0,"1",1,1,1,"H"
"16408",1988-03-26,1987,"RC Lens","OGC Nice","0-1",0,1,"1",1,1,-1,"D"
"16409",1988-04-02,1987,"Lille OSC","AS Monaco","0-1",0,1,"1",1,1,-1,"D"
"16410",1988-04-02,1987,"Stade Laval","Girondins Bordeaux","0-0",0,0,"1",1,0,0,"D"
"16411",1988-04-02,1987,"Matra Racing","Toulouse FC","0-0",0,0,"1",1,0,0,"D"
"16412",1988-04-02,1987,"AJ Auxerre","Olympique Marseille","2-0",2,0,"1",1,2,2,"H"
"16413",1988-04-02,1987,"AS Saint-Etienne","Paris Saint-Germain","1-3",1,3,"1",1,4,-2,"D"
"16414",1988-04-02,1987,"FC Nantes","Montpellier La Paillade SC","0-0",0,0,"1",1,0,0,"D"
"16415",1988-04-02,1987,"Sporting Toulon Var","AS Cannes","1-0",1,0,"1",1,1,1,"H"
"16416",1988-04-02,1987,"FC Metz","RC Lens","2-2",2,2,"1",1,4,0,"D"
"16417",1988-04-02,1987,"Brest Armorique FC","Chamois Niortais","1-0",1,0,"1",1,1,1,"H"
"16418",1988-04-02,1987,"OGC Nice","Le Havre AC","1-2",1,2,"1",1,3,-1,"D"
"16419",1988-04-08,1987,"Paris Saint-Germain","Matra Racing","1-1",1,1,"1",1,2,0,"D"
"16420",1988-04-09,1987,"AS Monaco","Brest Armorique FC","2-0",2,0,"1",1,2,2,"H"
"16421",1988-04-09,1987,"Girondins Bordeaux","Sporting Toulon Var","3-0",3,0,"1",1,3,3,"H"
"16422",1988-04-09,1987,"Olympique Marseille","Stade Laval","2-1",2,1,"1",1,3,1,"H"
"16423",1988-04-09,1987,"Montpellier La Paillade SC","AS Saint-Etienne","5-0",5,0,"1",1,5,5,"H"
"16424",1988-04-09,1987,"RC Lens","AJ Auxerre","2-1",2,1,"1",1,3,1,"H"
"16425",1988-04-09,1987,"Le Havre AC","FC Metz","1-1",1,1,"1",1,2,0,"D"
"16426",1988-04-09,1987,"AS Cannes","Lille OSC","1-5",1,5,"1",1,6,-4,"D"
"16427",1988-04-09,1987,"Toulouse FC","FC Nantes","0-1",0,1,"1",1,1,-1,"D"
"16428",1988-04-09,1987,"Chamois Niortais","OGC Nice","0-0",0,0,"1",1,0,0,"D"
"16429",1988-04-15,1987,"AS Saint-Etienne","AS Monaco","3-0",3,0,"1",1,3,3,"H"
"16430",1988-04-16,1987,"Lille OSC","Girondins Bordeaux","1-0",1,0,"1",1,1,1,"H"
"16431",1988-04-16,1987,"Matra Racing","Chamois Niortais","1-1",1,1,"1",1,2,0,"D"
"16432",1988-04-16,1987,"Olympique Marseille","RC Lens","4-1",4,1,"1",1,5,3,"H"
"16433",1988-04-16,1987,"FC Metz","Montpellier La Paillade SC","0-1",0,1,"1",1,1,-1,"D"
"16434",1988-04-16,1987,"AJ Auxerre","Le Havre AC","1-1",1,1,"1",1,2,0,"D"
"16435",1988-04-16,1987,"Stade Laval","Sporting Toulon Var","0-3",0,3,"1",1,3,-3,"D"
"16436",1988-04-16,1987,"FC Nantes","Paris Saint-Germain","0-0",0,0,"1",1,0,0,"D"
"16437",1988-04-16,1987,"Brest Armorique FC","AS Cannes","1-0",1,0,"1",1,1,1,"H"
"16438",1988-04-16,1987,"OGC Nice","Toulouse FC","3-0",3,0,"1",1,3,3,"H"
"16439",1988-04-30,1987,"AS Monaco","Matra Racing","3-0",3,0,"1",1,3,3,"H"
"16440",1988-04-30,1987,"Girondins Bordeaux","Brest Armorique FC","2-0",2,0,"1",1,2,2,"H"
"16441",1988-04-30,1987,"Toulouse FC","FC Metz","2-0",2,0,"1",1,2,2,"H"
"16442",1988-04-30,1987,"Sporting Toulon Var","Lille OSC","3-0",3,0,"1",1,3,3,"H"
"16443",1988-04-30,1987,"Montpellier La Paillade SC","AJ Auxerre","2-2",2,2,"1",1,4,0,"D"
"16444",1988-04-30,1987,"Le Havre AC","Olympique Marseille","1-0",1,0,"1",1,1,1,"H"
"16445",1988-04-30,1987,"AS Cannes","AS Saint-Etienne","1-0",1,0,"1",1,1,1,"H"
"16446",1988-04-30,1987,"Chamois Niortais","FC Nantes","1-3",1,3,"1",1,4,-2,"D"
"16447",1988-04-30,1987,"RC Lens","Stade Laval","1-2",1,2,"1",1,3,-1,"D"
"16448",1988-04-30,1987,"Paris Saint-Germain","OGC Nice","0-4",0,4,"1",1,4,-4,"D"
"16449",1988-05-06,1987,"Olympique Marseille","Chamois Niortais","1-0",1,0,"1",1,1,1,"H"
"16450",1988-05-07,1987,"Brest Armorique FC","Sporting Toulon Var","1-0",1,0,"1",1,1,1,"H"
"16451",1988-05-07,1987,"FC Metz","Paris Saint-Germain","1-0",1,0,"1",1,1,1,"H"
"16452",1988-05-07,1987,"AS Saint-Etienne","Girondins Bordeaux","1-1",1,1,"1",1,2,0,"D"
"16453",1988-05-07,1987,"Matra Racing","AS Cannes","0-0",0,0,"1",1,0,0,"D"
"16454",1988-05-07,1987,"RC Lens","Le Havre AC","0-0",0,0,"1",1,0,0,"D"
"16455",1988-05-07,1987,"OGC Nice","Montpellier La Paillade SC","2-0",2,0,"1",1,2,2,"H"
"16456",1988-05-07,1987,"AJ Auxerre","Toulouse FC","0-2",0,2,"1",1,2,-2,"D"
"16457",1988-05-07,1987,"Stade Laval","Lille OSC","0-1",0,1,"1",1,1,-1,"D"
"16458",1988-05-07,1987,"FC Nantes","AS Monaco","1-1",1,1,"1",1,2,0,"D"
"16459",1988-05-13,1987,"AS Monaco","OGC Nice","1-0",1,0,"1",1,1,1,"H"
"16460",1988-05-14,1987,"Girondins Bordeaux","Matra Racing","1-0",1,0,"1",1,1,1,"H"
"16461",1988-05-14,1987,"Toulouse FC","Olympique Marseille","1-0",1,0,"1",1,1,1,"H"
"16462",1988-05-14,1987,"Montpellier La Paillade SC","RC Lens","4-0",4,0,"1",1,4,4,"H"
"16463",1988-05-14,1987,"Sporting Toulon Var","AS Saint-Etienne","1-1",1,1,"1",1,2,0,"D"
"16464",1988-05-14,1987,"Paris Saint-Germain","AJ Auxerre","1-1",1,1,"1",1,2,0,"D"
"16465",1988-05-14,1987,"AS Cannes","FC Nantes","1-4",1,4,"1",1,5,-3,"D"
"16466",1988-05-14,1987,"Chamois Niortais","FC Metz","1-3",1,3,"1",1,4,-2,"D"
"16467",1988-05-14,1987,"Lille OSC","Brest Armorique FC","2-0",2,0,"1",1,2,2,"H"
"16468",1988-05-14,1987,"Le Havre AC","Stade Laval","2-1",2,1,"1",1,3,1,"H"
"16469",1988-05-20,1987,"FC Nantes","Girondins Bordeaux","1-0",1,0,"1",1,1,1,"H"
"16470",1988-05-21,1987,"FC Metz","AS Monaco","2-2",2,2,"1",1,4,0,"D"
"16471",1988-05-21,1987,"Le Havre AC","Montpellier La Paillade SC","1-3",1,3,"1",1,4,-2,"D"
"16472",1988-05-21,1987,"AS Saint-Etienne","Lille OSC","4-3",4,3,"1",1,7,1,"H"
"16473",1988-05-21,1987,"Matra Racing","Sporting Toulon Var","0-0",0,0,"1",1,0,0,"D"
"16474",1988-05-21,1987,"Olympique Marseille","Paris Saint-Germain","1-2",1,2,"1",1,3,-1,"D"
"16475",1988-05-21,1987,"AJ Auxerre","Chamois Niortais","1-3",1,3,"1",1,4,-2,"D"
"16476",1988-05-21,1987,"OGC Nice","AS Cannes","1-2",1,2,"1",1,3,-1,"D"
"16477",1988-05-21,1987,"Stade Laval","Brest Armorique FC","0-0",0,0,"1",1,0,0,"D"
"16478",1988-05-21,1987,"RC Lens","Toulouse FC","2-0",2,0,"1",1,2,2,"H"
"16479",1988-05-27,1987,"AS Monaco","AJ Auxerre","3-2",3,2,"1",1,5,1,"H"
"16480",1988-05-27,1987,"Girondins Bordeaux","OGC Nice","4-2",4,2,"1",1,6,2,"H"
"16481",1988-05-27,1987,"Montpellier La Paillade SC","Olympique Marseille","4-0",4,0,"1",1,4,4,"H"
"16482",1988-05-27,1987,"Brest Armorique FC","AS Saint-Etienne","1-0",1,0,"1",1,1,1,"H"
"16483",1988-05-27,1987,"Lille OSC","Matra Racing","5-0",5,0,"1",1,5,5,"H"
"16484",1988-05-27,1987,"Sporting Toulon Var","FC Nantes","5-2",5,2,"1",1,7,3,"H"
"16485",1988-05-27,1987,"AS Cannes","FC Metz","3-3",3,3,"1",1,6,0,"D"
"16486",1988-05-27,1987,"Toulouse FC","Le Havre AC","2-1",2,1,"1",1,3,1,"H"
"16487",1988-05-27,1987,"Chamois Niortais","Stade Laval","0-0",0,0,"1",1,0,0,"D"
"16488",1988-05-27,1987,"Paris Saint-Germain","RC Lens","4-1",4,1,"1",1,5,3,"H"
"16489",1988-06-04,1987,"Olympique Marseille","AS Monaco","2-0",2,0,"1",1,2,2,"H"
"16490",1988-06-04,1987,"FC Metz","Girondins Bordeaux","2-0",2,0,"1",1,2,2,"H"
"16491",1988-06-04,1987,"Montpellier La Paillade SC","Toulouse FC","4-2",4,2,"1",1,6,2,"H"
"16492",1988-06-04,1987,"AS Saint-Etienne","Stade Laval","2-1",2,1,"1",1,3,1,"H"
"16493",1988-06-04,1987,"OGC Nice","Sporting Toulon Var","0-2",0,2,"1",1,2,-2,"D"
"16494",1988-06-04,1987,"Matra Racing","Brest Armorique FC","1-1",1,1,"1",1,2,0,"D"
"16495",1988-06-04,1987,"AJ Auxerre","AS Cannes","1-0",1,0,"1",1,1,1,"H"
"16496",1988-06-04,1987,"FC Nantes","Lille OSC","1-1",1,1,"1",1,2,0,"D"
"16497",1988-06-04,1987,"Le Havre AC","Paris Saint-Germain","0-1",0,1,"1",1,1,-1,"D"
"16498",1988-06-04,1987,"RC Lens","Chamois Niortais","3-1",3,1,"1",1,4,2,"H"
"16499",1988-07-15,1988,"FC Nantes","AS Monaco","1-1",1,1,"1",1,2,0,"D"
"16500",1988-07-16,1988,"RC Strasbourg","FC Sochaux","0-3",0,3,"1",1,3,-3,"D"
"16501",1988-07-16,1988,"Girondins Bordeaux","AJ Auxerre","2-0",2,0,"1",1,2,2,"H"
"16502",1988-07-16,1988,"AS Cannes","SM Caen","2-0",2,0,"1",1,2,2,"H"
"16503",1988-07-16,1988,"Stade Laval","Lille OSC","1-2",1,2,"1",1,3,-1,"D"
"16504",1988-07-16,1988,"RC Lens","Sporting Toulon Var","0-1",0,1,"1",1,1,-1,"D"
"16505",1988-07-16,1988,"Matra Racing","Toulouse FC","0-1",0,1,"1",1,1,-1,"D"
"16506",1988-07-16,1988,"OGC Nice","AS Saint-Etienne","1-0",1,0,"1",1,1,1,"H"
"16507",1988-07-16,1988,"FC Metz","Paris Saint-Germain","0-1",0,1,"1",1,1,-1,"D"
"16508",1988-07-16,1988,"Olympique Marseille","Montpellier La Paillade SC","1-1",1,1,"1",1,2,0,"D"
"16509",1988-07-23,1988,"FC Sochaux","Matra Racing","2-0",2,0,"1",1,2,2,"H"
"16510",1988-07-23,1988,"Lille OSC","Olympique Marseille","2-1",2,1,"1",1,3,1,"H"
"16511",1988-07-23,1988,"Toulouse FC","RC Lens","2-1",2,1,"1",1,3,1,"H"
"16512",1988-07-23,1988,"Sporting Toulon Var","FC Metz","1-0",1,0,"1",1,1,1,"H"
"16513",1988-07-23,1988,"AS Monaco","AS Cannes","2-0",2,0,"1",1,2,2,"H"
"16514",1988-07-23,1988,"SM Caen","FC Nantes","2-3",2,3,"1",1,5,-1,"D"
"16515",1988-07-23,1988,"Montpellier La Paillade SC","OGC Nice","1-1",1,1,"1",1,2,0,"D"
"16516",1988-07-23,1988,"AJ Auxerre","Stade Laval","2-1",2,1,"1",1,3,1,"H"
"16517",1988-07-23,1988,"AS Saint-Etienne","RC Strasbourg","0-0",0,0,"1",1,0,0,"D"
"16518",1988-07-26,1988,"Girondins Bordeaux","Montpellier La Paillade SC","2-1",2,1,"1",1,3,1,"H"
"16519",1988-07-27,1988,"Olympique Marseille","FC Sochaux","0-0",0,0,"1",1,0,0,"D"
"16520",1988-07-27,1988,"AS Monaco","Lille OSC","1-1",1,1,"1",1,2,0,"D"
"16521",1988-07-27,1988,"FC Nantes","Sporting Toulon Var","0-0",0,0,"1",1,0,0,"D"
"16522",1988-07-27,1988,"AS Cannes","Paris Saint-Germain","0-3",0,3,"1",1,3,-3,"D"
"16523",1988-07-27,1988,"Stade Laval","Toulouse FC","2-0",2,0,"1",1,2,2,"H"
"16524",1988-07-27,1988,"RC Lens","AJ Auxerre","0-1",0,1,"1",1,1,-1,"D"
"16525",1988-07-27,1988,"RC Strasbourg","OGC Nice","3-0",3,0,"1",1,3,3,"H"
"16526",1988-07-27,1988,"Matra Racing","AS Saint-Etienne","3-1",3,1,"1",1,4,2,"H"
"16527",1988-07-27,1988,"FC Metz","SM Caen","1-0",1,0,"1",1,1,1,"H"
"16528",1988-07-30,1988,"FC Sochaux","Stade Laval","3-0",3,0,"1",1,3,3,"H"
"16529",1988-07-30,1988,"Sporting Toulon Var","AS Cannes","3-0",3,0,"1",1,3,3,"H"
"16530",1988-07-30,1988,"SM Caen","AS Monaco","0-3",0,3,"1",1,3,-3,"D"
"16531",1988-07-30,1988,"Paris Saint-Germain","FC Nantes","1-0",1,0,"1",1,1,1,"H"
"16532",1988-07-30,1988,"Lille OSC","Girondins Bordeaux","0-1",0,1,"1",1,1,-1,"D"
"16533",1988-07-30,1988,"AJ Auxerre","FC Metz","2-1",2,1,"1",1,3,1,"H"
"16534",1988-07-30,1988,"Toulouse FC","Olympique Marseille","0-0",0,0,"1",1,0,0,"D"
"16535",1988-07-30,1988,"OGC Nice","Matra Racing","3-2",3,2,"1",1,5,1,"H"
"16536",1988-07-30,1988,"Montpellier La Paillade SC","RC Strasbourg","1-0",1,0,"1",1,1,1,"H"
"16537",1988-07-30,1988,"AS Saint-Etienne","RC Lens","2-4",2,4,"1",1,6,-2,"D"
"16538",1988-08-06,1988,"RC Lens","FC Sochaux","2-2",2,2,"1",1,4,0,"D"
"16539",1988-08-06,1988,"AS Monaco","Paris Saint-Germain","1-0",1,0,"1",1,1,1,"H"
"16540",1988-08-06,1988,"Girondins Bordeaux","Sporting Toulon Var","1-1",1,1,"1",1,2,0,"D"
"16541",1988-08-06,1988,"FC Nantes","AJ Auxerre","3-2",3,2,"1",1,5,1,"H"
"16542",1988-08-06,1988,"SM Caen","Montpellier La Paillade SC","0-1",0,1,"1",1,1,-1,"D"
"16543",1988-08-06,1988,"Olympique Marseille","OGC Nice","3-2",3,2,"1",1,5,1,"H"
"16544",1988-08-06,1988,"FC Metz","Lille OSC","3-1",3,1,"1",1,4,2,"H"
"16545",1988-08-06,1988,"AS Cannes","Toulouse FC","5-1",5,1,"1",1,6,4,"H"
"16546",1988-08-06,1988,"Matra Racing","RC Strasbourg","2-1",2,1,"1",1,3,1,"H"
"16547",1988-08-06,1988,"Stade Laval","AS Saint-Etienne","1-1",1,1,"1",1,2,0,"D"
"16548",1988-08-12,1988,"AS Saint-Etienne","Olympique Marseille","0-0",0,0,"1",1,0,0,"D"
"16549",1988-08-13,1988,"Sporting Toulon Var","AS Monaco","1-0",1,0,"1",1,1,1,"H"
"16550",1988-08-13,1988,"FC Sochaux","Girondins Bordeaux","1-1",1,1,"1",1,2,0,"D"
"16551",1988-08-13,1988,"Paris Saint-Germain","SM Caen","3-0",3,0,"1",1,3,3,"H"
"16552",1988-08-13,1988,"Lille OSC","FC Nantes","0-1",0,1,"1",1,1,-1,"D"
"16553",1988-08-13,1988,"Montpellier La Paillade SC","Matra Racing","0-0",0,0,"1",1,0,0,"D"
"16554",1988-08-13,1988,"AJ Auxerre","AS Cannes","0-0",0,0,"1",1,0,0,"D"
"16555",1988-08-13,1988,"OGC Nice","Stade Laval","1-0",1,0,"1",1,1,1,"H"
"16556",1988-08-13,1988,"Toulouse FC","FC Metz","2-1",2,1,"1",1,3,1,"H"
"16557",1988-08-13,1988,"RC Strasbourg","RC Lens","4-1",4,1,"1",1,5,3,"H"
"16558",1988-08-17,1988,"Girondins Bordeaux","AS Saint-Etienne","5-0",5,0,"1",1,5,5,"H"
"16559",1988-08-17,1988,"Paris Saint-Germain","FC Sochaux","1-0",1,0,"1",1,1,1,"H"
"16560",1988-08-17,1988,"SM Caen","Sporting Toulon Var","2-1",2,1,"1",1,3,1,"H"
"16561",1988-08-17,1988,"AS Monaco","AJ Auxerre","1-2",1,2,"1",1,3,-1,"D"
"16562",1988-08-17,1988,"FC Nantes","Toulouse FC","1-2",1,2,"1",1,3,-1,"D"
"16563",1988-08-17,1988,"Olympique Marseille","Matra Racing","2-0",2,0,"1",1,2,2,"H"
"16564",1988-08-17,1988,"RC Lens","Montpellier La Paillade SC","0-0",0,0,"1",1,0,0,"D"
"16565",1988-08-17,1988,"AS Cannes","Lille OSC","1-0",1,0,"1",1,1,1,"H"
"16566",1988-08-17,1988,"FC Metz","OGC Nice","1-0",1,0,"1",1,1,1,"H"
"16567",1988-08-17,1988,"Stade Laval","RC Strasbourg","1-0",1,0,"1",1,1,1,"H"
"16568",1988-08-20,1988,"Sporting Toulon Var","Paris Saint-Germain","0-1",0,1,"1",1,1,-1,"D"
"16569",1988-08-20,1988,"Toulouse FC","Girondins Bordeaux","1-1",1,1,"1",1,2,0,"D"
"16570",1988-08-20,1988,"FC Sochaux","FC Metz","1-0",1,0,"1",1,1,1,"H"
"16571",1988-08-20,1988,"AJ Auxerre","SM Caen","3-0",3,0,"1",1,3,3,"H"
"16572",1988-08-20,1988,"AS Saint-Etienne","AS Monaco","0-1",0,1,"1",1,1,-1,"D"
"16573",1988-08-20,1988,"Montpellier La Paillade SC","FC Nantes","1-4",1,4,"1",1,5,-3,"D"
"16574",1988-08-20,1988,"RC Strasbourg","Olympique Marseille","2-3",2,3,"1",1,5,-1,"D"
"16575",1988-08-20,1988,"OGC Nice","AS Cannes","2-1",2,1,"1",1,3,1,"H"
"16576",1988-08-20,1988,"Lille OSC","RC Lens","1-0",1,0,"1",1,1,1,"H"
"16577",1988-08-20,1988,"Matra Racing","Stade Laval","2-2",2,2,"1",1,4,0,"D"
"16578",1988-08-27,1988,"Girondins Bordeaux","RC Strasbourg","2-0",2,0,"1",1,2,2,"H"
"16579",1988-08-27,1988,"Paris Saint-Germain","AJ Auxerre","2-2",2,2,"1",1,4,0,"D"
"16580",1988-08-27,1988,"AS Monaco","Toulouse FC","1-0",1,0,"1",1,1,1,"H"
"16581",1988-08-27,1988,"Stade Laval","Olympique Marseille","0-1",0,1,"1",1,1,-1,"D"
"16582",1988-08-27,1988,"AS Cannes","FC Sochaux","2-0",2,0,"1",1,2,2,"H"
"16583",1988-08-27,1988,"FC Nantes","AS Saint-Etienne","1-1",1,1,"1",1,2,0,"D"
"16584",1988-08-27,1988,"Sporting Toulon Var","OGC Nice","0-0",0,0,"1",1,0,0,"D"
"16585",1988-08-27,1988,"FC Metz","Montpellier La Paillade SC","1-2",1,2,"1",1,3,-1,"D"
"16586",1988-08-27,1988,"RC Lens","Matra Racing","1-1",1,1,"1",1,2,0,"D"
"16587",1988-08-27,1988,"SM Caen","Lille OSC","2-1",2,1,"1",1,3,1,"H"
"16588",1988-09-02,1988,"Matra Racing","AS Monaco","3-0",3,0,"1",1,3,3,"H"
"16589",1988-09-03,1988,"AJ Auxerre","Sporting Toulon Var","3-0",3,0,"1",1,3,3,"H"
"16590",1988-09-03,1988,"Olympique Marseille","RC Lens","5-2",5,2,"1",1,7,3,"H"
"16591",1988-09-03,1988,"OGC Nice","Girondins Bordeaux","1-0",1,0,"1",1,1,1,"H"
"16592",1988-09-03,1988,"Lille OSC","Paris Saint-Germain","2-1",2,1,"1",1,3,1,"H"
"16593",1988-09-03,1988,"FC Sochaux","FC Nantes","0-1",0,1,"1",1,1,-1,"D"
"16594",1988-09-03,1988,"Montpellier La Paillade SC","Stade Laval","6-2",6,2,"1",1,8,4,"H"
"16595",1988-09-03,1988,"AS Saint-Etienne","FC Metz","0-1",0,1,"1",1,1,-1,"D"
"16596",1988-09-03,1988,"Toulouse FC","SM Caen","0-0",0,0,"1",1,0,0,"D"
"16597",1988-09-03,1988,"RC Strasbourg","AS Cannes","0-0",0,0,"1",1,0,0,"D"
"16598",1988-09-10,1988,"AJ Auxerre","Lille OSC","1-0",1,0,"1",1,1,1,"H"
"16599",1988-09-10,1988,"Paris Saint-Germain","Toulouse FC","2-1",2,1,"1",1,3,1,"H"
"16600",1988-09-10,1988,"Girondins Bordeaux","Olympique Marseille","0-0",0,0,"1",1,0,0,"D"
"16601",1988-09-10,1988,"FC Nantes","RC Strasbourg","2-2",2,2,"1",1,4,0,"D"
"16602",1988-09-10,1988,"Sporting Toulon Var","Montpellier La Paillade SC","1-1",1,1,"1",1,2,0,"D"
"16603",1988-09-10,1988,"AS Monaco","OGC Nice","1-1",1,1,"1",1,2,0,"D"
"16604",1988-09-10,1988,"SM Caen","FC Sochaux","0-0",0,0,"1",1,0,0,"D"
"16605",1988-09-10,1988,"AS Cannes","AS Saint-Etienne","1-0",1,0,"1",1,1,1,"H"
"16606",1988-09-10,1988,"FC Metz","Matra Racing","1-1",1,1,"1",1,2,0,"D"
"16607",1988-09-10,1988,"RC Lens","Stade Laval","0-2",0,2,"1",1,2,-2,"D"
"16608",1988-09-14,1988,"Paris Saint-Germain","Girondins Bordeaux","1-1",1,1,"1",1,2,0,"D"
"16609",1988-09-17,1988,"Montpellier La Paillade SC","Paris Saint-Germain","0-0",0,0,"1",1,0,0,"D"
"16610",1988-09-17,1988,"Toulouse FC","AJ Auxerre","0-0",0,0,"1",1,0,0,"D"
"16611",1988-09-17,1988,"Olympique Marseille","AS Cannes","2-1",2,1,"1",1,3,1,"H"
"16612",1988-09-17,1988,"Stade Laval","Girondins Bordeaux","1-0",1,0,"1",1,1,1,"H"
"16613",1988-09-17,1988,"OGC Nice","RC Lens","3-0",3,0,"1",1,3,3,"H"
"16614",1988-09-17,1988,"Matra Racing","FC Nantes","2-0",2,0,"1",1,2,2,"H"
"16615",1988-09-17,1988,"FC Sochaux","AS Monaco","0-0",0,0,"1",1,0,0,"D"
"16616",1988-09-17,1988,"Lille OSC","Sporting Toulon Var","0-0",0,0,"1",1,0,0,"D"
"16617",1988-09-17,1988,"RC Strasbourg","FC Metz","1-2",1,2,"1",1,3,-1,"D"
"16618",1988-09-17,1988,"AS Saint-Etienne","SM Caen","1-1",1,1,"1",1,2,0,"D"
"16619",1988-09-20,1988,"Sporting Toulon Var","Toulouse FC","1-1",1,1,"1",1,2,0,"D"
"16620",1988-09-21,1988,"Paris Saint-Germain","AS Saint-Etienne","3-1",3,1,"1",1,4,2,"H"
"16621",1988-09-21,1988,"AJ Auxerre","Montpellier La Paillade SC","1-0",1,0,"1",1,1,1,"H"
"16622",1988-09-21,1988,"FC Nantes","Olympique Marseille","1-1",1,1,"1",1,2,0,"D"
"16623",1988-09-21,1988,"Girondins Bordeaux","RC Lens","4-1",4,1,"1",1,5,3,"H"
"16624",1988-09-21,1988,"AS Monaco","RC Strasbourg","4-1",4,1,"1",1,5,3,"H"
"16625",1988-09-21,1988,"SM Caen","OGC Nice","2-1",2,1,"1",1,3,1,"H"
"16626",1988-09-21,1988,"AS Cannes","Matra Racing","2-1",2,1,"1",1,3,1,"H"
"16627",1988-09-21,1988,"Lille OSC","FC Sochaux","2-0",2,0,"1",1,2,2,"H"
"16628",1988-09-21,1988,"FC Metz","Stade Laval","0-0",0,0,"1",1,0,0,"D"
"16629",1988-10-01,1988,"Olympique Marseille","FC Metz","3-2",3,2,"1",1,5,1,"H"
"16630",1988-10-01,1988,"OGC Nice","Paris Saint-Germain","3-1",3,1,"1",1,4,2,"H"
"16631",1988-10-01,1988,"FC Sochaux","AJ Auxerre","3-2",3,2,"1",1,5,1,"H"
"16632",1988-10-01,1988,"Matra Racing","Girondins Bordeaux","4-1",4,1,"1",1,5,3,"H"
"16633",1988-10-01,1988,"Stade Laval","FC Nantes","0-2",0,2,"1",1,2,-2,"D"
"16634",1988-10-01,1988,"Montpellier La Paillade SC","AS Monaco","4-2",4,2,"1",1,6,2,"H"
"16635",1988-10-01,1988,"RC Lens","AS Cannes","2-2",2,2,"1",1,4,0,"D"
"16636",1988-10-01,1988,"AS Saint-Etienne","Sporting Toulon Var","2-1",2,1,"1",1,3,1,"H"
"16637",1988-10-01,1988,"Toulouse FC","Lille OSC","1-1",1,1,"1",1,2,0,"D"
"16638",1988-10-01,1988,"RC Strasbourg","SM Caen","1-2",1,2,"1",1,3,-1,"D"
"16639",1988-10-08,1988,"AJ Auxerre","AS Saint-Etienne","2-0",2,0,"1",1,2,2,"H"
"16640",1988-10-08,1988,"Paris Saint-Germain","RC Strasbourg","1-0",1,0,"1",1,1,1,"H"
"16641",1988-10-08,1988,"AS Monaco","Olympique Marseille","3-0",3,0,"1",1,3,3,"H"
"16642",1988-10-08,1988,"FC Nantes","RC Lens","3-1",3,1,"1",1,4,2,"H"
"16643",1988-10-08,1988,"FC Metz","Girondins Bordeaux","3-0",3,0,"1",1,3,3,"H"
"16644",1988-10-08,1988,"Toulouse FC","OGC Nice","2-1",2,1,"1",1,3,1,"H"
"16645",1988-10-08,1988,"AS Cannes","Stade Laval","3-2",3,2,"1",1,5,1,"H"
"16646",1988-10-08,1988,"Sporting Toulon Var","FC Sochaux","0-0",0,0,"1",1,0,0,"D"
"16647",1988-10-08,1988,"Lille OSC","Montpellier La Paillade SC","3-1",3,1,"1",1,4,2,"H"
"16648",1988-10-08,1988,"SM Caen","Matra Racing","1-1",1,1,"1",1,2,0,"D"
"16649",1988-10-14,1988,"Matra Racing","Paris Saint-Germain","0-2",0,2,"1",1,2,-2,"D"
"16650",1988-10-15,1988,"Olympique Marseille","SM Caen","4-2",4,2,"1",1,6,2,"H"
"16651",1988-10-15,1988,"OGC Nice","AJ Auxerre","1-0",1,0,"1",1,1,1,"H"
"16652",1988-10-15,1988,"Girondins Bordeaux","FC Nantes","5-0",5,0,"1",1,5,5,"H"
"16653",1988-10-15,1988,"Stade Laval","AS Monaco","0-0",0,0,"1",1,0,0,"D"
"16654",1988-10-15,1988,"Montpellier La Paillade SC","AS Cannes","0-0",0,0,"1",1,0,0,"D"
"16655",1988-10-15,1988,"FC Sochaux","Toulouse FC","2-2",2,2,"1",1,4,0,"D"
"16656",1988-10-15,1988,"RC Lens","FC Metz","0-2",0,2,"1",1,2,-2,"D"
"16657",1988-10-15,1988,"AS Saint-Etienne","Lille OSC","2-0",2,0,"1",1,2,2,"H"
"16658",1988-10-15,1988,"RC Strasbourg","Sporting Toulon Var","2-1",2,1,"1",1,3,1,"H"
"16659",1988-10-29,1988,"Paris Saint-Germain","Olympique Marseille","0-0",0,0,"1",1,0,0,"D"
"16660",1988-10-29,1988,"AJ Auxerre","RC Strasbourg","2-1",2,1,"1",1,3,1,"H"
"16661",1988-10-29,1988,"AS Monaco","RC Lens","1-0",1,0,"1",1,1,1,"H"
"16662",1988-10-29,1988,"FC Nantes","FC Metz","1-0",1,0,"1",1,1,1,"H"
"16663",1988-10-29,1988,"AS Cannes","Girondins Bordeaux","1-1",1,1,"1",1,2,0,"D"
"16664",1988-10-29,1988,"FC Sochaux","Montpellier La Paillade SC","2-0",2,0,"1",1,2,2,"H"
"16665",1988-10-29,1988,"Lille OSC","OGC Nice","2-0",2,0,"1",1,2,2,"H"
"16666",1988-10-29,1988,"Toulouse FC","AS Saint-Etienne","3-1",3,1,"1",1,4,2,"H"
"16667",1988-10-29,1988,"Sporting Toulon Var","Matra Racing","1-0",1,0,"1",1,1,1,"H"
"16668",1988-10-29,1988,"SM Caen","Stade Laval","1-1",1,1,"1",1,2,0,"D"
"16669",1988-11-04,1988,"Girondins Bordeaux","AS Monaco","1-1",1,1,"1",1,2,0,"D"
"16670",1988-11-05,1988,"Stade Laval","Paris Saint-Germain","1-2",1,2,"1",1,3,-1,"D"
"16671",1988-11-05,1988,"Matra Racing","AJ Auxerre","1-2",1,2,"1",1,3,-1,"D"
"16672",1988-11-05,1988,"Olympique Marseille","Sporting Toulon Var","1-0",1,0,"1",1,1,1,"H"
"16673",1988-11-05,1988,"RC Lens","SM Caen","5-0",5,0,"1",1,5,5,"H"
"16674",1988-11-05,1988,"AS Saint-Etienne","FC Sochaux","1-2",1,2,"1",1,3,-1,"D"
"16675",1988-11-05,1988,"OGC Nice","FC Nantes","1-0",1,0,"1",1,1,1,"H"
"16676",1988-11-05,1988,"RC Strasbourg","Lille OSC","1-3",1,3,"1",1,4,-2,"D"
"16677",1988-11-05,1988,"FC Metz","AS Cannes","2-1",2,1,"1",1,3,1,"H"
"16678",1988-11-05,1988,"Montpellier La Paillade SC","Toulouse FC","1-0",1,0,"1",1,1,1,"H"
"16679",1988-11-12,1988,"Paris Saint-Germain","RC Lens","3-2",3,2,"1",1,5,1,"H"
"16680",1988-11-12,1988,"AJ Auxerre","Olympique Marseille","1-0",1,0,"1",1,1,1,"H"
"16681",1988-11-12,1988,"AS Monaco","FC Metz","1-1",1,1,"1",1,2,0,"D"
"16682",1988-11-12,1988,"FC Sochaux","OGC Nice","1-0",1,0,"1",1,1,1,"H"
"16683",1988-11-12,1988,"AS Cannes","FC Nantes","1-2",1,2,"1",1,3,-1,"D"
"16684",1988-11-12,1988,"SM Caen","Girondins Bordeaux","3-0",3,0,"1",1,3,3,"H"
"16685",1988-11-12,1988,"Lille OSC","Matra Racing","3-0",3,0,"1",1,3,3,"H"
"16686",1988-11-12,1988,"Montpellier La Paillade SC","AS Saint-Etienne","2-0",2,0,"1",1,2,2,"H"
"16687",1988-11-12,1988,"Toulouse FC","RC Strasbourg","4-0",4,0,"1",1,4,4,"H"
"16688",1988-11-12,1988,"Sporting Toulon Var","Stade Laval","0-0",0,0,"1",1,0,0,"D"
"16689",1988-11-25,1988,"Olympique Marseille","Lille OSC","1-1",1,1,"1",1,2,0,"D"
"16690",1988-11-26,1988,"Girondins Bordeaux","Paris Saint-Germain","0-1",0,1,"1",1,1,-1,"D"
"16691",1988-11-26,1988,"Stade Laval","AJ Auxerre","0-1",0,1,"1",1,1,-1,"D"
"16692",1988-11-26,1988,"Matra Racing","FC Sochaux","0-2",0,2,"1",1,2,-2,"D"
"16693",1988-11-26,1988,"FC Nantes","SM Caen","3-1",3,1,"1",1,4,2,"H"
"16694",1988-11-26,1988,"AS Cannes","AS Monaco","3-2",3,2,"1",1,5,1,"H"
"16695",1988-11-26,1988,"OGC Nice","Montpellier La Paillade SC","3-3",3,3,"1",1,6,0,"D"
"16696",1988-11-26,1988,"RC Lens","Toulouse FC","1-1",1,1,"1",1,2,0,"D"
"16697",1988-11-26,1988,"FC Metz","Sporting Toulon Var","1-2",1,2,"1",1,3,-1,"D"
"16698",1988-11-26,1988,"RC Strasbourg","AS Saint-Etienne","0-1",0,1,"1",1,1,-1,"D"
"16699",1988-12-03,1988,"Paris Saint-Germain","AS Cannes","1-0",1,0,"1",1,1,1,"H"
"16700",1988-12-03,1988,"AJ Auxerre","RC Lens","1-0",1,0,"1",1,1,1,"H"
"16701",1988-12-03,1988,"FC Sochaux","Olympique Marseille","0-0",0,0,"1",1,0,0,"D"
"16702",1988-12-03,1988,"Lille OSC","AS Monaco","2-4",2,4,"1",1,6,-2,"D"
"16703",1988-12-03,1988,"Sporting Toulon Var","FC Nantes","1-0",1,0,"1",1,1,1,"H"
"16704",1988-12-03,1988,"OGC Nice","RC Strasbourg","1-0",1,0,"1",1,1,1,"H"
"16705",1988-12-03,1988,"Montpellier La Paillade SC","Girondins Bordeaux","2-2",2,2,"1",1,4,0,"D"
"16706",1988-12-03,1988,"Toulouse FC","Stade Laval","0-0",0,0,"1",1,0,0,"D"
"16707",1988-12-03,1988,"SM Caen","FC Metz","0-0",0,0,"1",1,0,0,"D"
"16708",1988-12-03,1988,"AS Saint-Etienne","Matra Racing","4-3",4,3,"1",1,7,1,"H"
"16709",1988-12-10,1988,"FC Nantes","Paris Saint-Germain","1-1",1,1,"1",1,2,0,"D"
"16710",1988-12-10,1988,"FC Metz","AJ Auxerre","2-1",2,1,"1",1,3,1,"H"
"16711",1988-12-10,1988,"Olympique Marseille","Toulouse FC","3-1",3,1,"1",1,4,2,"H"
"16712",1988-12-10,1988,"AS Monaco","SM Caen","3-1",3,1,"1",1,4,2,"H"
"16713",1988-12-10,1988,"Stade Laval","FC Sochaux","1-1",1,1,"1",1,2,0,"D"
"16714",1988-12-10,1988,"Matra Racing","OGC Nice","1-1",1,1,"1",1,2,0,"D"
"16715",1988-12-10,1988,"Girondins Bordeaux","Lille OSC","0-0",0,0,"1",1,0,0,"D"
"16716",1988-12-10,1988,"RC Strasbourg","Montpellier La Paillade SC","3-1",3,1,"1",1,4,2,"H"
"16717",1988-12-10,1988,"AS Cannes","Sporting Toulon Var","1-0",1,0,"1",1,1,1,"H"
"16718",1988-12-10,1988,"RC Lens","AS Saint-Etienne","1-3",1,3,"1",1,4,-2,"D"
"16719",1988-12-10,1988,"FC Nantes","Montpellier La Paillade SC","2-1",2,1,"1",1,3,1,"H"
"16720",1988-12-11,1988,"Olympique Marseille","RC Strasbourg","3-1",3,1,"1",1,4,2,"H"
"16721",1988-12-11,1988,"Paris Saint-Germain","Sporting Toulon Var","0-0",0,0,"1",1,0,0,"D"
"16722",1988-12-11,1988,"SM Caen","AJ Auxerre","1-0",1,0,"1",1,1,1,"H"
"16723",1988-12-11,1988,"AS Monaco","AS Saint-Etienne","2-2",2,2,"1",1,4,0,"D"
"16724",1988-12-11,1988,"AS Cannes","OGC Nice","2-0",2,0,"1",1,2,2,"H"
"16725",1988-12-11,1988,"RC Lens","Lille OSC","1-2",1,2,"1",1,3,-1,"D"
"16726",1988-12-11,1988,"Girondins Bordeaux","Toulouse FC","1-1",1,1,"1",1,2,0,"D"
"16727",1988-12-11,1988,"Stade Laval","Matra Racing","4-2",4,2,"1",1,6,2,"H"
"16728",1988-12-12,1988,"FC Metz","FC Sochaux","1-0",1,0,"1",1,1,1,"H"
"16729",1988-12-13,1988,"OGC Nice","Olympique Marseille","2-2",2,2,"1",1,4,0,"D"
"16730",1988-12-13,1988,"FC Sochaux","RC Lens","2-1",2,1,"1",1,3,1,"H"
"16731",1988-12-14,1988,"Toulouse FC","AS Cannes","4-1",4,1,"1",1,5,3,"H"
"16732",1988-12-14,1988,"AJ Auxerre","FC Nantes","1-0",1,0,"1",1,1,1,"H"
"16733",1988-12-14,1988,"Paris Saint-Germain","AS Monaco","0-2",0,2,"1",1,2,-2,"D"
"16734",1988-12-14,1988,"Montpellier La Paillade SC","SM Caen","1-0",1,0,"1",1,1,1,"H"
"16735",1988-12-14,1988,"Lille OSC","FC Metz","1-1",1,1,"1",1,2,0,"D"
"16736",1988-12-14,1988,"Sporting Toulon Var","Girondins Bordeaux","1-0",1,0,"1",1,1,1,"H"
"16737",1988-12-14,1988,"RC Strasbourg","Matra Racing","1-1",1,1,"1",1,2,0,"D"
"16738",1988-12-14,1988,"AS Saint-Etienne","Stade Laval","1-0",1,0,"1",1,1,1,"H"
"16739",1988-12-17,1988,"SM Caen","Paris Saint-Germain","0-1",0,1,"1",1,1,-1,"D"
"16740",1988-12-17,1988,"AS Cannes","AJ Auxerre","3-0",3,0,"1",1,3,3,"H"
"16741",1988-12-17,1988,"Olympique Marseille","AS Saint-Etienne","2-0",2,0,"1",1,2,2,"H"
"16742",1988-12-17,1988,"Girondins Bordeaux","FC Sochaux","1-2",1,2,"1",1,3,-1,"D"
"16743",1988-12-17,1988,"AS Monaco","Sporting Toulon Var","2-2",2,2,"1",1,4,0,"D"
"16744",1988-12-17,1988,"FC Nantes","Lille OSC","1-0",1,0,"1",1,1,1,"H"
"16745",1988-12-17,1988,"Stade Laval","OGC Nice","1-2",1,2,"1",1,3,-1,"D"
"16746",1988-12-17,1988,"FC Metz","Toulouse FC","1-1",1,1,"1",1,2,0,"D"
"16747",1988-12-17,1988,"Matra Racing","Montpellier La Paillade SC","4-0",4,0,"1",1,4,4,"H"
"16748",1988-12-17,1988,"RC Lens","RC Strasbourg","1-3",1,3,"1",1,4,-2,"D"
"16749",1989-02-04,1988,"Racing Club de France","Olympique Marseille","0-2",0,2,"1",1,2,-2,"D"
"16750",1989-02-04,1988,"AJ Auxerre","AS Monaco","0-0",0,0,"1",1,0,0,"D"
"16751",1989-02-04,1988,"Toulouse FC","FC Nantes","1-2",1,2,"1",1,3,-1,"D"
"16752",1989-02-04,1988,"OGC Nice","FC Metz","1-1",1,1,"1",1,2,0,"D"
"16753",1989-02-04,1988,"Sporting Toulon Var","SM Caen","1-0",1,0,"1",1,1,1,"H"
"16754",1989-02-04,1988,"Montpellier La Paillade SC","RC Lens","2-0",2,0,"1",1,2,2,"H"
"16755",1989-02-04,1988,"Lille OSC","AS Cannes","1-0",1,0,"1",1,1,1,"H"
"16756",1989-02-04,1988,"AS Saint-Etienne","Girondins Bordeaux","1-0",1,0,"1",1,1,1,"H"
"16757",1989-02-04,1988,"RC Strasbourg","Stade Laval","3-0",3,0,"1",1,3,3,"H"
"16758",1989-02-05,1988,"FC Sochaux","Paris Saint-Germain","2-1",2,1,"1",1,3,1,"H"
"16759",1989-02-18,1988,"Olympique Marseille","Stade Laval","1-0",1,0,"1",1,1,1,"H"
"16760",1989-02-18,1988,"AJ Auxerre","Paris Saint-Germain","0-0",0,0,"1",1,0,0,"D"
"16761",1989-02-18,1988,"FC Sochaux","AS Cannes","4-0",4,0,"1",1,4,4,"H"
"16762",1989-02-18,1988,"AS Saint-Etienne","FC Nantes","1-1",1,1,"1",1,2,0,"D"
"16763",1989-02-18,1988,"Toulouse FC","AS Monaco","2-0",2,0,"1",1,2,2,"H"
"16764",1989-02-18,1988,"OGC Nice","Sporting Toulon Var","1-0",1,0,"1",1,1,1,"H"
"16765",1989-02-18,1988,"Lille OSC","SM Caen","1-1",1,1,"1",1,2,0,"D"
"16766",1989-02-18,1988,"Montpellier La Paillade SC","FC Metz","5-3",5,3,"1",1,8,2,"H"
"16767",1989-02-19,1988,"RC Strasbourg","Girondins Bordeaux","3-2",3,2,"1",1,5,1,"H"
"16768",1989-02-21,1988,"SM Caen","Toulouse FC","3-0",3,0,"1",1,3,3,"H"
"16769",1989-02-21,1988,"AS Monaco","Racing Club de France","1-0",1,0,"1",1,1,1,"H"
"16770",1989-02-22,1988,"RC Lens","Olympique Marseille","0-1",0,1,"1",1,1,-1,"D"
"16771",1989-02-22,1988,"Paris Saint-Germain","Lille OSC","1-1",1,1,"1",1,2,0,"D"
"16772",1989-02-22,1988,"Sporting Toulon Var","AJ Auxerre","1-2",1,2,"1",1,3,-1,"D"
"16773",1989-02-22,1988,"FC Nantes","FC Sochaux","0-0",0,0,"1",1,0,0,"D"
"16774",1989-02-22,1988,"Stade Laval","Montpellier La Paillade SC","0-1",0,1,"1",1,1,-1,"D"
"16775",1989-02-22,1988,"Girondins Bordeaux","OGC Nice","2-0",2,0,"1",1,2,2,"H"
"16776",1989-02-22,1988,"AS Cannes","RC Strasbourg","4-1",4,1,"1",1,5,3,"H"
"16777",1989-02-22,1988,"FC Metz","AS Saint-Etienne","1-2",1,2,"1",1,3,-1,"D"
"16778",1989-02-28,1988,"Racing Club de France","RC Lens","3-0",3,0,"1",1,3,3,"H"
"16779",1989-03-11,1988,"Olympique Marseille","Girondins Bordeaux","2-2",2,2,"1",1,4,0,"D"
"16780",1989-03-11,1988,"Toulouse FC","Paris Saint-Germain","0-0",0,0,"1",1,0,0,"D"
"16781",1989-03-11,1988,"FC Sochaux","SM Caen","1-0",1,0,"1",1,1,1,"H"
"16782",1989-03-11,1988,"Lille OSC","AJ Auxerre","1-0",1,0,"1",1,1,1,"H"
"16783",1989-03-11,1988,"OGC Nice","AS Monaco","1-1",1,1,"1",1,2,0,"D"
"16784",1989-03-11,1988,"RC Strasbourg","FC Nantes","2-0",2,0,"1",1,2,2,"H"
"16785",1989-03-11,1988,"Montpellier La Paillade SC","Sporting Toulon Var","0-1",0,1,"1",1,1,-1,"D"
"16786",1989-03-11,1988,"Racing Club de France","FC Metz","1-4",1,4,"1",1,5,-3,"D"
"16787",1989-03-11,1988,"AS Saint-Etienne","AS Cannes","1-0",1,0,"1",1,1,1,"H"
"16788",1989-03-11,1988,"Stade Laval","RC Lens","2-1",2,1,"1",1,3,1,"H"
"16789",1989-03-14,1988,"Paris Saint-Germain","Montpellier La Paillade SC","3-2",3,2,"1",1,5,1,"H"
"16790",1989-03-17,1988,"FC Metz","RC Strasbourg","1-1",1,1,"1",1,2,0,"D"
"16791",1989-03-18,1988,"AS Cannes","Olympique Marseille","3-1",3,1,"1",1,4,2,"H"
"16792",1989-03-18,1988,"AS Monaco","FC Sochaux","0-0",0,0,"1",1,0,0,"D"
"16793",1989-03-18,1988,"AJ Auxerre","Toulouse FC","0-0",0,0,"1",1,0,0,"D"
"16794",1989-03-18,1988,"FC Nantes","Racing Club de France","1-0",1,0,"1",1,1,1,"H"
"16795",1989-03-18,1988,"Sporting Toulon Var","Lille OSC","2-1",2,1,"1",1,3,1,"H"
"16796",1989-03-18,1988,"RC Lens","OGC Nice","2-0",2,0,"1",1,2,2,"H"
"16797",1989-03-18,1988,"Girondins Bordeaux","Stade Laval","2-1",2,1,"1",1,3,1,"H"
"16798",1989-03-18,1988,"SM Caen","AS Saint-Etienne","2-3",2,3,"1",1,5,-1,"D"
"16799",1989-03-25,1988,"AS Saint-Etienne","Paris Saint-Germain","0-0",0,0,"1",1,0,0,"D"
"16800",1989-03-25,1988,"FC Sochaux","Lille OSC","2-0",2,0,"1",1,2,2,"H"
"16801",1989-03-25,1988,"RC Strasbourg","AS Monaco","1-2",1,2,"1",1,3,-1,"D"
"16802",1989-03-25,1988,"Montpellier La Paillade SC","AJ Auxerre","1-0",1,0,"1",1,1,1,"H"
"16803",1989-03-25,1988,"OGC Nice","SM Caen","5-0",5,0,"1",1,5,5,"H"
"16804",1989-03-25,1988,"Toulouse FC","Sporting Toulon Var","1-0",1,0,"1",1,1,1,"H"
"16805",1989-03-25,1988,"RC Lens","Girondins Bordeaux","0-2",0,2,"1",1,2,-2,"D"
"16806",1989-03-25,1988,"Racing Club de France","AS Cannes","1-0",1,0,"1",1,1,1,"H"
"16807",1989-03-25,1988,"Stade Laval","FC Metz","3-0",3,0,"1",1,3,3,"H"
"16808",1989-04-01,1988,"Paris Saint-Germain","OGC Nice","1-0",1,0,"1",1,1,1,"H"
"16809",1989-04-01,1988,"FC Metz","Olympique Marseille","1-3",1,3,"1",1,4,-2,"D"
"16810",1989-04-01,1988,"AJ Auxerre","FC Sochaux","2-1",2,1,"1",1,3,1,"H"
"16811",1989-04-01,1988,"AS Monaco","Montpellier La Paillade SC","4-2",4,2,"1",1,6,2,"H"
"16812",1989-04-01,1988,"FC Nantes","Stade Laval","1-1",1,1,"1",1,2,0,"D"
"16813",1989-04-01,1988,"Lille OSC","Toulouse FC","0-0",0,0,"1",1,0,0,"D"
"16814",1989-04-01,1988,"Girondins Bordeaux","Racing Club de France","3-2",3,2,"1",1,5,1,"H"
"16815",1989-04-01,1988,"AS Cannes","RC Lens","3-0",3,0,"1",1,3,3,"H"
"16816",1989-04-01,1988,"Sporting Toulon Var","AS Saint-Etienne","0-0",0,0,"1",1,0,0,"D"
"16817",1989-04-01,1988,"SM Caen","RC Strasbourg","3-3",3,3,"1",1,6,0,"D"
"16818",1989-04-04,1988,"Olympique Marseille","FC Nantes","1-0",1,0,"1",1,1,1,"H"
"16819",1989-04-11,1988,"Olympique Marseille","AS Monaco","2-2",2,2,"1",1,4,0,"D"
"16820",1989-04-12,1988,"RC Strasbourg","Paris Saint-Germain","0-0",0,0,"1",1,0,0,"D"
"16821",1989-04-12,1988,"FC Sochaux","Sporting Toulon Var","2-1",2,1,"1",1,3,1,"H"
"16822",1989-04-12,1988,"AS Saint-Etienne","AJ Auxerre","1-1",1,1,"1",1,2,0,"D"
"16823",1989-04-12,1988,"RC Lens","FC Nantes","0-0",0,0,"1",1,0,0,"D"
"16824",1989-04-12,1988,"OGC Nice","Toulouse FC","2-0",2,0,"1",1,2,2,"H"
"16825",1989-04-12,1988,"Girondins Bordeaux","FC Metz","4-1",4,1,"1",1,5,3,"H"
"16826",1989-04-12,1988,"Montpellier La Paillade SC","Lille OSC","2-3",2,3,"1",1,5,-1,"D"
"16827",1989-04-12,1988,"Stade Laval","AS Cannes","2-0",2,0,"1",1,2,2,"H"
"16828",1989-04-12,1988,"Racing Club de France","SM Caen","3-1",3,1,"1",1,4,2,"H"
"16829",1989-04-21,1988,"FC Nantes","Girondins Bordeaux","1-0",1,0,"1",1,1,1,"H"
"16830",1989-04-22,1988,"SM Caen","Olympique Marseille","0-0",0,0,"1",1,0,0,"D"
"16831",1989-04-22,1988,"Paris Saint-Germain","Racing Club de France","2-1",2,1,"1",1,3,1,"H"
"16832",1989-04-22,1988,"Toulouse FC","FC Sochaux","2-1",2,1,"1",1,3,1,"H"
"16833",1989-04-22,1988,"AS Monaco","Stade Laval","1-0",1,0,"1",1,1,1,"H"
"16834",1989-04-22,1988,"AJ Auxerre","OGC Nice","1-0",1,0,"1",1,1,1,"H"
"16835",1989-04-22,1988,"Lille OSC","AS Saint-Etienne","2-2",2,2,"1",1,4,0,"D"
"16836",1989-04-22,1988,"AS Cannes","Montpellier La Paillade SC","0-1",0,1,"1",1,1,-1,"D"
"16837",1989-04-22,1988,"Sporting Toulon Var","RC Strasbourg","0-0",0,0,"1",1,0,0,"D"
"16838",1989-04-22,1988,"FC Metz","RC Lens","4-0",4,0,"1",1,4,4,"H"
"16839",1989-05-05,1988,"Olympique Marseille","Paris Saint-Germain","1-0",1,0,"1",1,1,1,"H"
"16840",1989-05-06,1988,"Montpellier La Paillade SC","FC Sochaux","1-2",1,2,"1",1,3,-1,"D"
"16841",1989-05-06,1988,"RC Lens","AS Monaco","1-1",1,1,"1",1,2,0,"D"
"16842",1989-05-06,1988,"RC Strasbourg","AJ Auxerre","1-0",1,0,"1",1,1,1,"H"
"16843",1989-05-06,1988,"FC Metz","FC Nantes","0-0",0,0,"1",1,0,0,"D"
"16844",1989-05-06,1988,"OGC Nice","Lille OSC","0-1",0,1,"1",1,1,-1,"D"
"16845",1989-05-06,1988,"Girondins Bordeaux","AS Cannes","0-0",0,0,"1",1,0,0,"D"
"16846",1989-05-06,1988,"AS Saint-Etienne","Toulouse FC","3-2",3,2,"1",1,5,1,"H"
"16847",1989-05-06,1988,"Racing Club de France","Sporting Toulon Var","1-1",1,1,"1",1,2,0,"D"
"16848",1989-05-06,1988,"Stade Laval","SM Caen","1-1",1,1,"1",1,2,0,"D"
"16849",1989-05-12,1988,"Paris Saint-Germain","Stade Laval","3-0",3,0,"1",1,3,3,"H"
"16850",1989-05-13,1988,"Sporting Toulon Var","Olympique Marseille","1-2",1,2,"1",1,3,-1,"D"
"16851",1989-05-13,1988,"FC Sochaux","AS Saint-Etienne","1-0",1,0,"1",1,1,1,"H"
"16852",1989-05-13,1988,"AS Monaco","Girondins Bordeaux","4-2",4,2,"1",1,6,2,"H"
"16853",1989-05-13,1988,"AJ Auxerre","Racing Club de France","1-1",1,1,"1",1,2,0,"D"
"16854",1989-05-13,1988,"FC Nantes","OGC Nice","0-1",0,1,"1",1,1,-1,"D"
"16855",1989-05-13,1988,"Lille OSC","RC Strasbourg","1-1",1,1,"1",1,2,0,"D"
"16856",1989-05-13,1988,"Toulouse FC","Montpellier La Paillade SC","2-2",2,2,"1",1,4,0,"D"
"16857",1989-05-13,1988,"AS Cannes","FC Metz","1-1",1,1,"1",1,2,0,"D"
"16858",1989-05-13,1988,"SM Caen","RC Lens","1-0",1,0,"1",1,1,1,"H"
"16859",1989-05-20,1988,"Olympique Marseille","AJ Auxerre","2-1",2,1,"1",1,3,1,"H"
"16860",1989-05-20,1988,"RC Lens","Paris Saint-Germain","0-0",0,0,"1",1,0,0,"D"
"16861",1989-05-20,1988,"FC Metz","AS Monaco","0-3",0,3,"1",1,3,-3,"D"
"16862",1989-05-20,1988,"OGC Nice","FC Sochaux","3-2",3,2,"1",1,5,1,"H"
"16863",1989-05-20,1988,"FC Nantes","AS Cannes","1-1",1,1,"1",1,2,0,"D"
"16864",1989-05-20,1988,"Racing Club de France","Lille OSC","1-0",1,0,"1",1,1,1,"H"
"16865",1989-05-20,1988,"RC Strasbourg","Toulouse FC","4-1",4,1,"1",1,5,3,"H"
"16866",1989-05-20,1988,"Girondins Bordeaux","SM Caen","2-3",2,3,"1",1,5,-1,"D"
"16867",1989-05-20,1988,"Stade Laval","Sporting Toulon Var","0-0",0,0,"1",1,0,0,"D"
"16868",1989-05-20,1988,"AS Saint-Etienne","Montpellier La Paillade SC","1-0",1,0,"1",1,1,1,"H"
"16869",1989-05-31,1988,"Montpellier La Paillade SC","Olympique Marseille","1-0",1,0,"1",1,1,1,"H"
"16870",1989-05-31,1988,"Paris Saint-Germain","FC Metz","2-2",2,2,"1",1,4,0,"D"
"16871",1989-05-31,1988,"AS Monaco","FC Nantes","4-1",4,1,"1",1,5,3,"H"
"16872",1989-05-31,1988,"FC Sochaux","RC Strasbourg","3-0",3,0,"1",1,3,3,"H"
"16873",1989-05-31,1988,"AJ Auxerre","Girondins Bordeaux","1-1",1,1,"1",1,2,0,"D"
"16874",1989-05-31,1988,"Lille OSC","Stade Laval","8-0",8,0,"1",1,8,8,"H"
"16875",1989-05-31,1988,"AS Saint-Etienne","OGC Nice","0-0",0,0,"1",1,0,0,"D"
"16876",1989-05-31,1988,"Toulouse FC","Racing Club de France","2-1",2,1,"1",1,3,1,"H"
"16877",1989-05-31,1988,"Sporting Toulon Var","RC Lens","3-1",3,1,"1",1,4,2,"H"
"16878",1989-05-31,1988,"SM Caen","AS Cannes","3-0",3,0,"1",1,3,3,"H"
"16879",1989-07-21,1989,"Olympique Lyon","Olympique Marseille","1-4",1,4,"1",1,5,-3,"D"
"16880",1989-07-22,1989,"Montpellier HSC","AS Cannes","4-1",4,1,"1",1,5,3,"H"
"16881",1989-07-22,1989,"Toulouse FC","FC Mulhouse","3-0",3,0,"1",1,3,3,"H"
"16882",1989-07-22,1989,"Sporting Toulon Var","AS Saint-Etienne","2-0",2,0,"1",1,2,2,"H"
"16883",1989-07-22,1989,"FC Nantes","AJ Auxerre","2-1",2,1,"1",1,3,1,"H"
"16884",1989-07-22,1989,"Lille OSC","SM Caen","1-0",1,0,"1",1,1,1,"H"
"16885",1989-07-22,1989,"FC Sochaux","Brest Armorique FC","1-0",1,0,"1",1,1,1,"H"
"16886",1989-07-22,1989,"OGC Nice","Paris Saint-Germain","3-3",3,3,"1",1,6,0,"D"
"16887",1989-07-22,1989,"FC Metz","Girondins Bordeaux","0-0",0,0,"1",1,0,0,"D"
"16888",1989-07-22,1989,"Racing Club de France","AS Monaco","0-0",0,0,"1",1,0,0,"D"
"16889",1989-07-29,1989,"Olympique Marseille","FC Nantes","1-0",1,0,"1",1,1,1,"H"
"16890",1989-07-29,1989,"Girondins Bordeaux","Racing Club de France","4-0",4,0,"1",1,4,4,"H"
"16891",1989-07-29,1989,"AS Cannes","Sporting Toulon Var","0-0",0,0,"1",1,0,0,"D"
"16892",1989-07-29,1989,"Paris Saint-Germain","FC Metz","1-0",1,0,"1",1,1,1,"H"
"16893",1989-07-29,1989,"AS Monaco","FC Sochaux","2-1",2,1,"1",1,3,1,"H"
"16894",1989-07-29,1989,"FC Mulhouse","Montpellier HSC","2-0",2,0,"1",1,2,2,"H"
"16895",1989-07-29,1989,"Olympique Lyon","Toulouse FC","3-0",3,0,"1",1,3,3,"H"
"16896",1989-07-29,1989,"SM Caen","AS Saint-Etienne","3-2",3,2,"1",1,5,1,"H"
"16897",1989-07-29,1989,"AJ Auxerre","OGC Nice","1-0",1,0,"1",1,1,1,"H"
"16898",1989-07-29,1989,"Brest Armorique FC","Lille OSC","1-0",1,0,"1",1,1,1,"H"
"16899",1989-08-01,1989,"Lille OSC","AS Monaco","1-1",1,1,"1",1,2,0,"D"
"16900",1989-08-02,1989,"Montpellier HSC","Girondins Bordeaux","1-2",1,2,"1",1,3,-1,"D"
"16901",1989-08-02,1989,"Sporting Toulon Var","SM Caen","2-0",2,0,"1",1,2,2,"H"
"16902",1989-08-02,1989,"Toulouse FC","Olympique Marseille","2-1",2,1,"1",1,3,1,"H"
"16903",1989-08-02,1989,"FC Nantes","Olympique Lyon","2-1",2,1,"1",1,3,1,"H"
"16904",1989-08-02,1989,"FC Sochaux","Paris Saint-Germain","1-0",1,0,"1",1,1,1,"H"
"16905",1989-08-02,1989,"OGC Nice","FC Mulhouse","2-0",2,0,"1",1,2,2,"H"
"16906",1989-08-02,1989,"FC Metz","AJ Auxerre","2-1",2,1,"1",1,3,1,"H"
"16907",1989-08-02,1989,"Racing Club de France","AS Cannes","3-2",3,2,"1",1,5,1,"H"
"16908",1989-08-02,1989,"AS Saint-Etienne","Brest Armorique FC","2-0",2,0,"1",1,2,2,"H"
"16909",1989-08-05,1989,"Girondins Bordeaux","FC Sochaux","1-0",1,0,"1",1,1,1,"H"
"16910",1989-08-05,1989,"FC Nantes","Racing Club de France","5-1",5,1,"1",1,6,4,"H"
"16911",1989-08-05,1989,"Olympique Marseille","FC Metz","2-1",2,1,"1",1,3,1,"H"
"16912",1989-08-05,1989,"AJ Auxerre","Toulouse FC","2-2",2,2,"1",1,4,0,"D"
"16913",1989-08-05,1989,"Paris Saint-Germain","Montpellier HSC","2-1",2,1,"1",1,3,1,"H"
"16914",1989-08-05,1989,"AS Monaco","AS Saint-Etienne","0-0",0,0,"1",1,0,0,"D"
"16915",1989-08-05,1989,"FC Mulhouse","Sporting Toulon Var","4-0",4,0,"1",1,4,4,"H"
"16916",1989-08-05,1989,"Olympique Lyon","OGC Nice","2-0",2,0,"1",1,2,2,"H"
"16917",1989-08-05,1989,"Brest Armorique FC","SM Caen","2-1",2,1,"1",1,3,1,"H"
"16918",1989-08-05,1989,"AS Cannes","Lille OSC","3-0",3,0,"1",1,3,3,"H"
"16919",1989-08-12,1989,"Lille OSC","Girondins Bordeaux","0-1",0,1,"1",1,1,-1,"D"
"16920",1989-08-12,1989,"Toulouse FC","FC Nantes","1-1",1,1,"1",1,2,0,"D"
"16921",1989-08-12,1989,"OGC Nice","Olympique Marseille","1-1",1,1,"1",1,2,0,"D"
"16922",1989-08-12,1989,"AS Saint-Etienne","Paris Saint-Germain","1-2",1,2,"1",1,3,-1,"D"
"16923",1989-08-12,1989,"Sporting Toulon Var","Brest Armorique FC","2-0",2,0,"1",1,2,2,"H"
"16924",1989-08-12,1989,"FC Sochaux","AS Cannes","3-0",3,0,"1",1,3,3,"H"
"16925",1989-08-12,1989,"FC Metz","Olympique Lyon","2-3",2,3,"1",1,5,-1,"D"
"16926",1989-08-12,1989,"SM Caen","AS Monaco","1-1",1,1,"1",1,2,0,"D"
"16927",1989-08-12,1989,"Racing Club de France","FC Mulhouse","2-1",2,1,"1",1,3,1,"H"
"16928",1989-08-12,1989,"Montpellier HSC","AJ Auxerre","1-0",1,0,"1",1,1,1,"H"
"16929",1989-08-19,1989,"Girondins Bordeaux","AS Saint-Etienne","1-0",1,0,"1",1,1,1,"H"
"16930",1989-08-19,1989,"Olympique Marseille","Montpellier HSC","2-0",2,0,"1",1,2,2,"H"
"16931",1989-08-19,1989,"Paris Saint-Germain","Lille OSC","2-1",2,1,"1",1,3,1,"H"
"16932",1989-08-19,1989,"Olympique Lyon","FC Sochaux","0-4",0,4,"1",1,4,-4,"D"
"16933",1989-08-19,1989,"FC Nantes","OGC Nice","2-2",2,2,"1",1,4,0,"D"
"16934",1989-08-19,1989,"AS Monaco","Brest Armorique FC","2-0",2,0,"1",1,2,2,"H"
"16935",1989-08-19,1989,"Toulouse FC","Sporting Toulon Var","0-0",0,0,"1",1,0,0,"D"
"16936",1989-08-19,1989,"FC Mulhouse","FC Metz","2-2",2,2,"1",1,4,0,"D"
"16937",1989-08-19,1989,"AJ Auxerre","Racing Club de France","2-0",2,0,"1",1,2,2,"H"
"16938",1989-08-19,1989,"AS Cannes","SM Caen","3-1",3,1,"1",1,4,2,"H"
"16939",1989-08-26,1989,"SM Caen","Girondins Bordeaux","1-0",1,0,"1",1,1,1,"H"
"16940",1989-08-26,1989,"Brest Armorique FC","Paris Saint-Germain","0-1",0,1,"1",1,1,-1,"D"
"16941",1989-08-26,1989,"Racing Club de France","Olympique Marseille","1-1",1,1,"1",1,2,0,"D"
"16942",1989-08-26,1989,"Sporting Toulon Var","AS Monaco","2-0",2,0,"1",1,2,2,"H"
"16943",1989-08-26,1989,"FC Sochaux","AJ Auxerre","0-0",0,0,"1",1,0,0,"D"
"16944",1989-08-26,1989,"FC Metz","FC Nantes","1-1",1,1,"1",1,2,0,"D"
"16945",1989-08-26,1989,"OGC Nice","Toulouse FC","1-1",1,1,"1",1,2,0,"D"
"16946",1989-08-26,1989,"Lille OSC","FC Mulhouse","1-1",1,1,"1",1,2,0,"D"
"16947",1989-08-26,1989,"Montpellier HSC","Olympique Lyon","2-0",2,0,"1",1,2,2,"H"
"16948",1989-08-26,1989,"AS Saint-Etienne","AS Cannes","1-0",1,0,"1",1,1,1,"H"
"16949",1989-08-29,1989,"FC Mulhouse","AS Saint-Etienne","1-2",1,2,"1",1,3,-1,"D"
"16950",1989-08-30,1989,"Girondins Bordeaux","Brest Armorique FC","3-0",3,0,"1",1,3,3,"H"
"16951",1989-08-30,1989,"Olympique Marseille","FC Sochaux","6-1",6,1,"1",1,7,5,"H"
"16952",1989-08-30,1989,"Paris Saint-Germain","Sporting Toulon Var","1-1",1,1,"1",1,2,0,"D"
"16953",1989-08-30,1989,"FC Nantes","Montpellier HSC","1-1",1,1,"1",1,2,0,"D"
"16954",1989-08-30,1989,"Toulouse FC","FC Metz","2-0",2,0,"1",1,2,2,"H"
"16955",1989-08-30,1989,"AS Cannes","AS Monaco","0-0",0,0,"1",1,0,0,"D"
"16956",1989-08-30,1989,"AJ Auxerre","SM Caen","3-0",3,0,"1",1,3,3,"H"
"16957",1989-08-30,1989,"OGC Nice","Lille OSC","1-1",1,1,"1",1,2,0,"D"
"16958",1989-08-30,1989,"Olympique Lyon","Racing Club de France","1-1",1,1,"1",1,2,0,"D"
"16959",1989-09-09,1989,"SM Caen","FC Nantes","2-0",2,0,"1",1,2,2,"H"
"16960",1989-09-09,1989,"Racing Club de France","Paris Saint-Germain","2-2",2,2,"1",1,4,0,"D"
"16961",1989-09-09,1989,"Sporting Toulon Var","Girondins Bordeaux","0-2",0,2,"1",1,2,-2,"D"
"16962",1989-09-09,1989,"FC Sochaux","FC Mulhouse","0-0",0,0,"1",1,0,0,"D"
"16963",1989-09-09,1989,"Montpellier HSC","Toulouse FC","1-0",1,0,"1",1,1,1,"H"
"16964",1989-09-09,1989,"AS Saint-Etienne","Olympique Lyon","1-0",1,0,"1",1,1,1,"H"
"16965",1989-09-09,1989,"Lille OSC","AJ Auxerre","2-1",2,1,"1",1,3,1,"H"
"16966",1989-09-09,1989,"FC Metz","OGC Nice","0-0",0,0,"1",1,0,0,"D"
"16967",1989-09-09,1989,"Brest Armorique FC","AS Cannes","2-0",2,0,"1",1,2,2,"H"
"16968",1989-09-16,1989,"Girondins Bordeaux","AS Cannes","2-0",2,0,"1",1,2,2,"H"
"16969",1989-09-16,1989,"Paris Saint-Germain","AS Monaco","2-1",2,1,"1",1,3,1,"H"
"16970",1989-09-16,1989,"Olympique Marseille","AS Saint-Etienne","2-0",2,0,"1",1,2,2,"H"
"16971",1989-09-16,1989,"FC Nantes","FC Sochaux","0-1",0,1,"1",1,1,-1,"D"
"16972",1989-09-16,1989,"Toulouse FC","Racing Club de France","1-0",1,0,"1",1,1,1,"H"
"16973",1989-09-16,1989,"AJ Auxerre","Sporting Toulon Var","2-0",2,0,"1",1,2,2,"H"
"16974",1989-09-16,1989,"OGC Nice","Montpellier HSC","3-0",3,0,"1",1,3,3,"H"
"16975",1989-09-16,1989,"FC Mulhouse","Brest Armorique FC","2-0",2,0,"1",1,2,2,"H"
"16976",1989-09-16,1989,"Olympique Lyon","Lille OSC","2-1",2,1,"1",1,3,1,"H"
"16977",1989-09-16,1989,"FC Metz","SM Caen","0-0",0,0,"1",1,0,0,"D"
"16978",1989-09-22,1989,"AS Monaco","Girondins Bordeaux","2-0",2,0,"1",1,2,2,"H"
"16979",1989-09-23,1989,"Sporting Toulon Var","Olympique Marseille","0-4",0,4,"1",1,4,-4,"D"
"16980",1989-09-23,1989,"AS Cannes","Paris Saint-Germain","3-1",3,1,"1",1,4,2,"H"
"16981",1989-09-23,1989,"FC Sochaux","Toulouse FC","1-0",1,0,"1",1,1,1,"H"
"16982",1989-09-23,1989,"AS Saint-Etienne","AJ Auxerre","4-1",4,1,"1",1,5,3,"H"
"16983",1989-09-23,1989,"Brest Armorique FC","Olympique Lyon","0-2",0,2,"1",1,2,-2,"D"
"16984",1989-09-23,1989,"Lille OSC","FC Nantes","1-0",1,0,"1",1,1,1,"H"
"16985",1989-09-23,1989,"Racing Club de France","OGC Nice","5-1",5,1,"1",1,6,4,"H"
"16986",1989-09-23,1989,"SM Caen","FC Mulhouse","1-0",1,0,"1",1,1,1,"H"
"16987",1989-09-23,1989,"Montpellier HSC","FC Metz","1-2",1,2,"1",1,3,-1,"D"
"16988",1989-09-30,1989,"Olympique Marseille","Brest Armorique FC","1-0",1,0,"1",1,1,1,"H"
"16989",1989-09-30,1989,"Paris Saint-Germain","Girondins Bordeaux","1-1",1,1,"1",1,2,0,"D"
"16990",1989-09-30,1989,"OGC Nice","FC Sochaux","2-4",2,4,"1",1,6,-2,"D"
"16991",1989-09-30,1989,"Toulouse FC","Lille OSC","3-1",3,1,"1",1,4,2,"H"
"16992",1989-09-30,1989,"Olympique Lyon","SM Caen","2-1",2,1,"1",1,3,1,"H"
"16993",1989-09-30,1989,"FC Nantes","AS Saint-Etienne","2-0",2,0,"1",1,2,2,"H"
"16994",1989-09-30,1989,"AJ Auxerre","AS Monaco","0-0",0,0,"1",1,0,0,"D"
"16995",1989-09-30,1989,"FC Metz","Sporting Toulon Var","0-0",0,0,"1",1,0,0,"D"
"16996",1989-09-30,1989,"FC Mulhouse","AS Cannes","1-0",1,0,"1",1,1,1,"H"
"16997",1989-09-30,1989,"Montpellier HSC","Racing Club de France","2-1",2,1,"1",1,3,1,"H"
"16998",1989-10-03,1989,"Sporting Toulon Var","OGC Nice","1-1",1,1,"1",1,2,0,"D"
"16999",1989-10-04,1989,"Girondins Bordeaux","FC Mulhouse","1-0",1,0,"1",1,1,1,"H"
"17000",1989-10-04,1989,"Lille OSC","Olympique Marseille","2-0",2,0,"1",1,2,2,"H"
"17001",1989-10-04,1989,"FC Sochaux","Montpellier HSC","3-1",3,1,"1",1,4,2,"H"
"17002",1989-10-04,1989,"AS Saint-Etienne","Toulouse FC","0-3",0,3,"1",1,3,-3,"D"
"17003",1989-10-04,1989,"SM Caen","Paris Saint-Germain","2-0",2,0,"1",1,2,2,"H"
"17004",1989-10-04,1989,"AS Monaco","FC Nantes","0-0",0,0,"1",1,0,0,"D"
"17005",1989-10-04,1989,"AS Cannes","Olympique Lyon","2-1",2,1,"1",1,3,1,"H"
"17006",1989-10-04,1989,"Brest Armorique FC","AJ Auxerre","2-1",2,1,"1",1,3,1,"H"
"17007",1989-10-06,1989,"Racing Club de France","FC Metz","1-1",1,1,"1",1,2,0,"D"
"17008",1989-10-13,1989,"Olympique Lyon","AS Monaco","0-2",0,2,"1",1,2,-2,"D"
"17009",1989-10-14,1989,"AJ Auxerre","Girondins Bordeaux","1-1",1,1,"1",1,2,0,"D"
"17010",1989-10-14,1989,"Olympique Marseille","AS Cannes","1-1",1,1,"1",1,2,0,"D"
"17011",1989-10-14,1989,"Toulouse FC","SM Caen","2-1",2,1,"1",1,3,1,"H"
"17012",1989-10-14,1989,"FC Metz","FC Sochaux","2-0",2,0,"1",1,2,2,"H"
"17013",1989-10-14,1989,"FC Mulhouse","Paris Saint-Germain","1-0",1,0,"1",1,1,1,"H"
"17014",1989-10-14,1989,"FC Nantes","Brest Armorique FC","1-0",1,0,"1",1,1,1,"H"
"17015",1989-10-14,1989,"Montpellier HSC","Sporting Toulon Var","3-0",3,0,"1",1,3,3,"H"
"17016",1989-10-14,1989,"OGC Nice","AS Saint-Etienne","1-3",1,3,"1",1,4,-2,"D"
"17017",1989-10-14,1989,"Racing Club de France","Lille OSC","2-0",2,0,"1",1,2,2,"H"
"17018",1989-10-21,1989,"Girondins Bordeaux","Olympique Marseille","3-0",3,0,"1",1,3,3,"H"
"17019",1989-10-21,1989,"FC Sochaux","Racing Club de France","2-0",2,0,"1",1,2,2,"H"
"17020",1989-10-21,1989,"Brest Armorique FC","Toulouse FC","0-0",0,0,"1",1,0,0,"D"
"17021",1989-10-21,1989,"Sporting Toulon Var","FC Nantes","0-0",0,0,"1",1,0,0,"D"
"17022",1989-10-21,1989,"AS Monaco","FC Mulhouse","0-0",0,0,"1",1,0,0,"D"
"17023",1989-10-21,1989,"Paris Saint-Germain","Olympique Lyon","0-1",0,1,"1",1,1,-1,"D"
"17024",1989-10-21,1989,"AS Saint-Etienne","FC Metz","4-3",4,3,"1",1,7,1,"H"
"17025",1989-10-21,1989,"AS Cannes","AJ Auxerre","2-2",2,2,"1",1,4,0,"D"
"17026",1989-10-21,1989,"Lille OSC","Montpellier HSC","1-0",1,0,"1",1,1,1,"H"
"17027",1989-10-21,1989,"SM Caen","OGC Nice","1-1",1,1,"1",1,2,0,"D"
"17028",1989-10-26,1989,"Toulouse FC","AS Monaco","0-1",0,1,"1",1,1,-1,"D"
"17029",1989-10-27,1989,"Olympique Marseille","Paris Saint-Germain","2-1",2,1,"1",1,3,1,"H"
"17030",1989-10-28,1989,"Olympique Lyon","Girondins Bordeaux","0-0",0,0,"1",1,0,0,"D"
"17031",1989-10-28,1989,"FC Sochaux","SM Caen","5-0",5,0,"1",1,5,5,"H"
"17032",1989-10-28,1989,"FC Nantes","AS Cannes","1-0",1,0,"1",1,1,1,"H"
"17033",1989-10-28,1989,"Montpellier HSC","AS Saint-Etienne","3-3",3,3,"1",1,6,0,"D"
"17034",1989-10-28,1989,"Racing Club de France","Sporting Toulon Var","0-2",0,2,"1",1,2,-2,"D"
"17035",1989-10-28,1989,"AJ Auxerre","FC Mulhouse","3-1",3,1,"1",1,4,2,"H"
"17036",1989-10-28,1989,"FC Metz","Lille OSC","1-1",1,1,"1",1,2,0,"D"
"17037",1989-10-28,1989,"OGC Nice","Brest Armorique FC","0-1",0,1,"1",1,1,-1,"D"
"17038",1989-11-04,1989,"Girondins Bordeaux","FC Nantes","3-0",3,0,"1",1,3,3,"H"
"17039",1989-11-04,1989,"FC Mulhouse","Olympique Marseille","1-2",1,2,"1",1,3,-1,"D"
"17040",1989-11-04,1989,"Lille OSC","FC Sochaux","5-0",5,0,"1",1,5,5,"H"
"17041",1989-11-04,1989,"AS Cannes","Toulouse FC","2-2",2,2,"1",1,4,0,"D"
"17042",1989-11-04,1989,"AS Monaco","OGC Nice","1-0",1,0,"1",1,1,1,"H"
"17043",1989-11-04,1989,"Paris Saint-Germain","AJ Auxerre","1-1",1,1,"1",1,2,0,"D"
"17044",1989-11-04,1989,"Sporting Toulon Var","Olympique Lyon","1-1",1,1,"1",1,2,0,"D"
"17045",1989-11-04,1989,"AS Saint-Etienne","Racing Club de France","0-1",0,1,"1",1,1,-1,"D"
"17046",1989-11-04,1989,"SM Caen","Montpellier HSC","3-2",3,2,"1",1,5,1,"H"
"17047",1989-11-04,1989,"Brest Armorique FC","FC Metz","2-0",2,0,"1",1,2,2,"H"
"17048",1989-11-07,1989,"Toulouse FC","Girondins Bordeaux","0-1",0,1,"1",1,1,-1,"D"
"17049",1989-11-08,1989,"Olympique Marseille","AJ Auxerre","1-1",1,1,"1",1,2,0,"D"
"17050",1989-11-08,1989,"FC Sochaux","AS Saint-Etienne","2-3",2,3,"1",1,5,-1,"D"
"17051",1989-11-08,1989,"FC Metz","AS Monaco","1-0",1,0,"1",1,1,1,"H"
"17052",1989-11-08,1989,"Olympique Lyon","FC Mulhouse","3-1",3,1,"1",1,4,2,"H"
"17053",1989-11-08,1989,"FC Nantes","Paris Saint-Germain","0-1",0,1,"1",1,1,-1,"D"
"17054",1989-11-08,1989,"Lille OSC","Sporting Toulon Var","3-0",3,0,"1",1,3,3,"H"
"17055",1989-11-08,1989,"Racing Club de France","SM Caen","0-0",0,0,"1",1,0,0,"D"
"17056",1989-11-08,1989,"Montpellier HSC","Brest Armorique FC","1-1",1,1,"1",1,2,0,"D"
"17057",1989-11-08,1989,"OGC Nice","AS Cannes","2-0",2,0,"1",1,2,2,"H"
"17058",1989-11-11,1989,"Girondins Bordeaux","OGC Nice","3-0",3,0,"1",1,3,3,"H"
"17059",1989-11-11,1989,"SM Caen","Olympique Marseille","0-2",0,2,"1",1,2,-2,"D"
"17060",1989-11-11,1989,"Paris Saint-Germain","Toulouse FC","0-1",0,1,"1",1,1,-1,"D"
"17061",1989-11-11,1989,"Sporting Toulon Var","FC Sochaux","2-1",2,1,"1",1,3,1,"H"
"17062",1989-11-11,1989,"AS Monaco","Montpellier HSC","1-0",1,0,"1",1,1,1,"H"
"17063",1989-11-11,1989,"AJ Auxerre","Olympique Lyon","0-1",0,1,"1",1,1,-1,"D"
"17064",1989-11-11,1989,"FC Mulhouse","FC Nantes","0-2",0,2,"1",1,2,-2,"D"
"17065",1989-11-11,1989,"AS Saint-Etienne","Lille OSC","2-1",2,1,"1",1,3,1,"H"
"17066",1989-11-11,1989,"AS Cannes","FC Metz","1-0",1,0,"1",1,1,1,"H"
"17067",1989-11-11,1989,"Brest Armorique FC","Racing Club de France","2-0",2,0,"1",1,2,2,"H"
"17068",1989-11-22,1989,"AS Monaco","Olympique Marseille","1-3",1,3,"1",1,4,-2,"D"
"17069",1989-11-24,1989,"Racing Club de France","Girondins Bordeaux","1-3",1,3,"1",1,4,-2,"D"
"17070",1989-11-25,1989,"FC Nantes","Olympique Marseille","0-0",0,0,"1",1,0,0,"D"
"17071",1989-11-25,1989,"FC Sochaux","AS Monaco","1-0",1,0,"1",1,1,1,"H"
"17072",1989-11-25,1989,"Toulouse FC","Olympique Lyon","0-0",0,0,"1",1,0,0,"D"
"17073",1989-11-25,1989,"AS Saint-Etienne","SM Caen","0-0",0,0,"1",1,0,0,"D"
"17074",1989-11-25,1989,"FC Metz","Paris Saint-Germain","0-1",0,1,"1",1,1,-1,"D"
"17075",1989-11-25,1989,"Sporting Toulon Var","AS Cannes","0-1",0,1,"1",1,1,-1,"D"
"17076",1989-11-25,1989,"Lille OSC","Brest Armorique FC","1-2",1,2,"1",1,3,-1,"D"
"17077",1989-11-25,1989,"OGC Nice","AJ Auxerre","1-1",1,1,"1",1,2,0,"D"
"17078",1989-11-25,1989,"Montpellier HSC","FC Mulhouse","3-3",3,3,"1",1,6,0,"D"
"17079",1989-12-01,1989,"AJ Auxerre","FC Metz","1-1",1,1,"1",1,2,0,"D"
"17080",1989-12-02,1989,"Paris Saint-Germain","FC Sochaux","1-0",1,0,"1",1,1,1,"H"
"17081",1989-12-03,1989,"Girondins Bordeaux","Montpellier HSC","2-0",2,0,"1",1,2,2,"H"
"17082",1989-12-03,1989,"Olympique Marseille","Toulouse FC","6-1",6,1,"1",1,7,5,"H"
"17083",1989-12-03,1989,"AS Monaco","Lille OSC","1-1",1,1,"1",1,2,0,"D"
"17084",1989-12-03,1989,"Brest Armorique FC","AS Saint-Etienne","0-0",0,0,"1",1,0,0,"D"
"17085",1989-12-03,1989,"SM Caen","Sporting Toulon Var","2-2",2,2,"1",1,4,0,"D"
"17086",1989-12-03,1989,"AS Cannes","Racing Club de France","3-1",3,1,"1",1,4,2,"H"
"17087",1989-12-03,1989,"FC Mulhouse","OGC Nice","1-0",1,0,"1",1,1,1,"H"
"17088",1989-12-09,1989,"AS Saint-Etienne","AS Monaco","0-2",0,2,"1",1,2,-2,"D"
"17089",1989-12-10,1989,"FC Sochaux","Girondins Bordeaux","2-0",2,0,"1",1,2,2,"H"
"17090",1989-12-10,1989,"FC Metz","Olympique Marseille","3-2",3,2,"1",1,5,1,"H"
"17091",1989-12-10,1989,"Toulouse FC","AJ Auxerre","1-1",1,1,"1",1,2,0,"D"
"17092",1989-12-10,1989,"Montpellier HSC","Paris Saint-Germain","2-0",2,0,"1",1,2,2,"H"
"17093",1989-12-10,1989,"OGC Nice","Olympique Lyon","1-0",1,0,"1",1,1,1,"H"
"17094",1989-12-10,1989,"Sporting Toulon Var","FC Mulhouse","2-1",2,1,"1",1,3,1,"H"
"17095",1989-12-10,1989,"Lille OSC","AS Cannes","2-1",2,1,"1",1,3,1,"H"
"17096",1989-12-10,1989,"Racing Club de France","FC Nantes","2-1",2,1,"1",1,3,1,"H"
"17097",1989-12-10,1989,"SM Caen","Brest Armorique FC","2-1",2,1,"1",1,3,1,"H"
"17098",1989-12-16,1989,"FC Nantes","Toulouse FC","0-1",0,1,"1",1,1,-1,"D"
"17099",1989-12-17,1989,"Girondins Bordeaux","Lille OSC","3-1",3,1,"1",1,4,2,"H"
"17100",1989-12-17,1989,"Olympique Marseille","OGC Nice","3-0",3,0,"1",1,3,3,"H"
"17101",1989-12-17,1989,"AS Cannes","FC Sochaux","1-1",1,1,"1",1,2,0,"D"
"17102",1989-12-17,1989,"AS Monaco","SM Caen","2-1",2,1,"1",1,3,1,"H"
"17103",1989-12-17,1989,"Paris Saint-Germain","AS Saint-Etienne","2-0",2,0,"1",1,2,2,"H"
"17104",1989-12-17,1989,"Olympique Lyon","FC Metz","0-0",0,0,"1",1,0,0,"D"
"17105",1989-12-17,1989,"AJ Auxerre","Montpellier HSC","2-1",2,1,"1",1,3,1,"H"
"17106",1989-12-17,1989,"Brest Armorique FC","Sporting Toulon Var","2-1",2,1,"1",1,3,1,"H"
"17107",1989-12-17,1989,"FC Mulhouse","Racing Club de France","4-2",4,2,"1",1,6,2,"H"
"17108",1990-02-04,1989,"AS Saint-Etienne","Girondins Bordeaux","1-1",1,1,"1",1,2,0,"D"
"17109",1990-02-04,1989,"Montpellier HSC","Olympique Marseille","1-1",1,1,"1",1,2,0,"D"
"17110",1990-02-04,1989,"FC Sochaux","Olympique Lyon","1-0",1,0,"1",1,1,1,"H"
"17111",1990-02-04,1989,"Brest Armorique FC","AS Monaco","1-1",1,1,"1",1,2,0,"D"
"17112",1990-02-04,1989,"Sporting Toulon Var","Toulouse FC","0-0",0,0,"1",1,0,0,"D"
"17113",1990-02-04,1989,"Lille OSC","Paris Saint-Germain","2-0",2,0,"1",1,2,2,"H"
"17114",1990-02-04,1989,"OGC Nice","FC Nantes","1-2",1,2,"1",1,3,-1,"D"
"17115",1990-02-04,1989,"Racing Club de France","AJ Auxerre","3-1",3,1,"1",1,4,2,"H"
"17116",1990-02-04,1989,"SM Caen","AS Cannes","1-0",1,0,"1",1,1,1,"H"
"17117",1990-02-04,1989,"FC Metz","FC Mulhouse","1-1",1,1,"1",1,2,0,"D"
"17118",1990-02-09,1989,"AS Cannes","AS Saint-Etienne","0-0",0,0,"1",1,0,0,"D"
"17119",1990-02-11,1989,"Girondins Bordeaux","SM Caen","2-1",2,1,"1",1,3,1,"H"
"17120",1990-02-11,1989,"Olympique Marseille","Racing Club de France","4-1",4,1,"1",1,5,3,"H"
"17121",1990-02-11,1989,"AJ Auxerre","FC Sochaux","1-1",1,1,"1",1,2,0,"D"
"17122",1990-02-11,1989,"AS Monaco","Sporting Toulon Var","2-1",2,1,"1",1,3,1,"H"
"17123",1990-02-11,1989,"Toulouse FC","OGC Nice","0-1",0,1,"1",1,1,-1,"D"
"17124",1990-02-11,1989,"Paris Saint-Germain","Brest Armorique FC","3-1",3,1,"1",1,4,2,"H"
"17125",1990-02-11,1989,"Olympique Lyon","Montpellier HSC","3-1",3,1,"1",1,4,2,"H"
"17126",1990-02-11,1989,"FC Nantes","FC Metz","0-0",0,0,"1",1,0,0,"D"
"17127",1990-02-11,1989,"FC Mulhouse","Lille OSC","2-1",2,1,"1",1,3,1,"H"
"17128",1990-02-21,1989,"Brest Armorique FC","Girondins Bordeaux","2-0",2,0,"1",1,2,2,"H"
"17129",1990-02-21,1989,"AS Monaco","AS Cannes","0-0",0,0,"1",1,0,0,"D"
"17130",1990-02-21,1989,"Sporting Toulon Var","Paris Saint-Germain","0-3",0,3,"1",1,3,-3,"D"
"17131",1990-02-21,1989,"Racing Club de France","Olympique Lyon","0-1",0,1,"1",1,1,-1,"D"
"17132",1990-02-21,1989,"FC Metz","Toulouse FC","3-0",3,0,"1",1,3,3,"H"
"17133",1990-02-21,1989,"AS Saint-Etienne","FC Mulhouse","3-0",3,0,"1",1,3,3,"H"
"17134",1990-02-21,1989,"Lille OSC","OGC Nice","1-1",1,1,"1",1,2,0,"D"
"17135",1990-02-21,1989,"Montpellier HSC","FC Nantes","2-1",2,1,"1",1,3,1,"H"
"17136",1990-02-21,1989,"SM Caen","AJ Auxerre","1-0",1,0,"1",1,1,1,"H"
"17137",1990-02-25,1989,"Girondins Bordeaux","Sporting Toulon Var","2-1",2,1,"1",1,3,1,"H"
"17138",1990-02-25,1989,"Olympique Marseille","AS Monaco","2-2",2,2,"1",1,4,0,"D"
"17139",1990-02-25,1989,"FC Mulhouse","FC Sochaux","1-2",1,2,"1",1,3,-1,"D"
"17140",1990-02-25,1989,"Paris Saint-Germain","Racing Club de France","1-2",1,2,"1",1,3,-1,"D"
"17141",1990-02-25,1989,"Olympique Lyon","AS Saint-Etienne","0-0",0,0,"1",1,0,0,"D"
"17142",1990-02-25,1989,"Toulouse FC","Montpellier HSC","0-0",0,0,"1",1,0,0,"D"
"17143",1990-02-25,1989,"AJ Auxerre","Lille OSC","3-0",3,0,"1",1,3,3,"H"
"17144",1990-02-25,1989,"FC Nantes","SM Caen","0-0",0,0,"1",1,0,0,"D"
"17145",1990-02-25,1989,"OGC Nice","FC Metz","0-0",0,0,"1",1,0,0,"D"
"17146",1990-02-25,1989,"AS Cannes","Brest Armorique FC","1-1",1,1,"1",1,2,0,"D"
"17147",1990-03-02,1989,"AS Monaco","Paris Saint-Germain","2-0",2,0,"1",1,2,2,"H"
"17148",1990-03-03,1989,"AS Cannes","Girondins Bordeaux","3-0",3,0,"1",1,3,3,"H"
"17149",1990-03-03,1989,"FC Sochaux","FC Nantes","1-3",1,3,"1",1,4,-2,"D"
"17150",1990-03-03,1989,"Lille OSC","Olympique Lyon","0-0",0,0,"1",1,0,0,"D"
"17151",1990-03-03,1989,"Racing Club de France","Toulouse FC","1-0",1,0,"1",1,1,1,"H"
"17152",1990-03-03,1989,"Brest Armorique FC","FC Mulhouse","2-0",2,0,"1",1,2,2,"H"
"17153",1990-03-03,1989,"SM Caen","FC Metz","1-0",1,0,"1",1,1,1,"H"
"17154",1990-03-03,1989,"Sporting Toulon Var","AJ Auxerre","1-0",1,0,"1",1,1,1,"H"
"17155",1990-03-03,1989,"Montpellier HSC","OGC Nice","1-0",1,0,"1",1,1,1,"H"
"17156",1990-03-13,1989,"Olympique Lyon","FC Nantes","0-0",0,0,"1",1,0,0,"D"
"17157",1990-03-14,1989,"FC Sochaux","Olympique Marseille","0-2",0,2,"1",1,2,-2,"D"
"17158",1990-03-15,1989,"Girondins Bordeaux","AS Monaco","0-0",0,0,"1",1,0,0,"D"
"17159",1990-03-15,1989,"AJ Auxerre","AS Saint-Etienne","2-1",2,1,"1",1,3,1,"H"
"17160",1990-03-17,1989,"Olympique Marseille","Sporting Toulon Var","3-0",3,0,"1",1,3,3,"H"
"17161",1990-03-17,1989,"Toulouse FC","FC Sochaux","0-0",0,0,"1",1,0,0,"D"
"17162",1990-03-17,1989,"Olympique Lyon","Brest Armorique FC","4-0",4,0,"1",1,4,4,"H"
"17163",1990-03-17,1989,"Paris Saint-Germain","AS Cannes","5-1",5,1,"1",1,6,4,"H"
"17164",1990-03-17,1989,"FC Nantes","Lille OSC","1-0",1,0,"1",1,1,1,"H"
"17165",1990-03-17,1989,"FC Mulhouse","SM Caen","0-0",0,0,"1",1,0,0,"D"
"17166",1990-03-17,1989,"FC Metz","Montpellier HSC","1-0",1,0,"1",1,1,1,"H"
"17167",1990-03-17,1989,"OGC Nice","Racing Club de France","2-0",2,0,"1",1,2,2,"H"
"17168",1990-03-24,1989,"Girondins Bordeaux","Paris Saint-Germain","3-0",3,0,"1",1,3,3,"H"
"17169",1990-03-24,1989,"Brest Armorique FC","Olympique Marseille","2-1",2,1,"1",1,3,1,"H"
"17170",1990-03-24,1989,"AS Monaco","AJ Auxerre","2-4",2,4,"1",1,6,-2,"D"
"17171",1990-03-24,1989,"FC Sochaux","OGC Nice","1-1",1,1,"1",1,2,0,"D"
"17172",1990-03-24,1989,"SM Caen","Olympique Lyon","1-1",1,1,"1",1,2,0,"D"
"17173",1990-03-24,1989,"AS Saint-Etienne","FC Nantes","0-0",0,0,"1",1,0,0,"D"
"17174",1990-03-24,1989,"Lille OSC","Toulouse FC","3-0",3,0,"1",1,3,3,"H"
"17175",1990-03-24,1989,"Sporting Toulon Var","FC Metz","1-1",1,1,"1",1,2,0,"D"
"17176",1990-03-24,1989,"AS Cannes","FC Mulhouse","4-1",4,1,"1",1,5,3,"H"
"17177",1990-03-24,1989,"Racing Club de France","Montpellier HSC","0-0",0,0,"1",1,0,0,"D"
"17178",1990-03-31,1989,"FC Mulhouse","Girondins Bordeaux","0-0",0,0,"1",1,0,0,"D"
"17179",1990-03-31,1989,"Olympique Marseille","Lille OSC","4-1",4,1,"1",1,5,3,"H"
"17180",1990-03-31,1989,"FC Nantes","AS Monaco","0-0",0,0,"1",1,0,0,"D"
"17181",1990-03-31,1989,"Montpellier HSC","FC Sochaux","2-0",2,0,"1",1,2,2,"H"
"17182",1990-03-31,1989,"Olympique Lyon","AS Cannes","0-1",0,1,"1",1,1,-1,"D"
"17183",1990-03-31,1989,"Paris Saint-Germain","SM Caen","3-1",3,1,"1",1,4,2,"H"
"17184",1990-03-31,1989,"AJ Auxerre","Brest Armorique FC","3-1",3,1,"1",1,4,2,"H"
"17185",1990-03-31,1989,"Toulouse FC","AS Saint-Etienne","1-1",1,1,"1",1,2,0,"D"
"17186",1990-03-31,1989,"FC Metz","Racing Club de France","0-0",0,0,"1",1,0,0,"D"
"17187",1990-03-31,1989,"OGC Nice","Sporting Toulon Var","1-2",1,2,"1",1,3,-1,"D"
"17188",1990-04-06,1989,"Brest Armorique FC","FC Nantes","3-2",3,2,"1",1,5,1,"H"
"17189",1990-04-07,1989,"SM Caen","Toulouse FC","0-1",0,1,"1",1,1,-1,"D"
"17190",1990-04-07,1989,"AS Saint-Etienne","OGC Nice","0-0",0,0,"1",1,0,0,"D"
"17191",1990-04-07,1989,"Sporting Toulon Var","Montpellier HSC","3-0",3,0,"1",1,3,3,"H"
"17192",1990-04-07,1989,"Lille OSC","Racing Club de France","2-1",2,1,"1",1,3,1,"H"
"17193",1990-04-07,1989,"Girondins Bordeaux","AJ Auxerre","0-1",0,1,"1",1,1,-1,"D"
"17194",1990-04-07,1989,"AS Cannes","Olympique Marseille","2-2",2,2,"1",1,4,0,"D"
"17195",1990-04-07,1989,"AS Monaco","Olympique Lyon","1-0",1,0,"1",1,1,1,"H"
"17196",1990-04-07,1989,"Paris Saint-Germain","FC Mulhouse","1-0",1,0,"1",1,1,1,"H"
"17197",1990-04-07,1989,"FC Sochaux","FC Metz","0-0",0,0,"1",1,0,0,"D"
"17198",1990-04-14,1989,"Olympique Marseille","Girondins Bordeaux","2-0",2,0,"1",1,2,2,"H"
"17199",1990-04-14,1989,"FC Mulhouse","AS Monaco","1-1",1,1,"1",1,2,0,"D"
"17200",1990-04-14,1989,"Olympique Lyon","Paris Saint-Germain","1-2",1,2,"1",1,3,-1,"D"
"17201",1990-04-14,1989,"Racing Club de France","FC Sochaux","1-1",1,1,"1",1,2,0,"D"
"17202",1990-04-14,1989,"AJ Auxerre","AS Cannes","1-0",1,0,"1",1,1,1,"H"
"17203",1990-04-14,1989,"FC Nantes","Sporting Toulon Var","4-0",4,0,"1",1,4,4,"H"
"17204",1990-04-14,1989,"Toulouse FC","Brest Armorique FC","2-1",2,1,"1",1,3,1,"H"
"17205",1990-04-14,1989,"FC Metz","AS Saint-Etienne","1-0",1,0,"1",1,1,1,"H"
"17206",1990-04-14,1989,"Montpellier HSC","Lille OSC","5-0",5,0,"1",1,5,5,"H"
"17207",1990-04-14,1989,"OGC Nice","SM Caen","1-0",1,0,"1",1,1,1,"H"
"17208",1990-04-20,1989,"Girondins Bordeaux","Olympique Lyon","2-0",2,0,"1",1,2,2,"H"
"17209",1990-04-21,1989,"Paris Saint-Germain","Olympique Marseille","2-1",2,1,"1",1,3,1,"H"
"17210",1990-04-21,1989,"AS Monaco","Toulouse FC","2-0",2,0,"1",1,2,2,"H"
"17211",1990-04-21,1989,"FC Mulhouse","AJ Auxerre","1-2",1,2,"1",1,3,-1,"D"
"17212",1990-04-21,1989,"SM Caen","FC Sochaux","1-1",1,1,"1",1,2,0,"D"
"17213",1990-04-21,1989,"AS Cannes","FC Nantes","2-1",2,1,"1",1,3,1,"H"
"17214",1990-04-21,1989,"Brest Armorique FC","OGC Nice","3-0",3,0,"1",1,3,3,"H"
"17215",1990-04-21,1989,"Lille OSC","FC Metz","2-1",2,1,"1",1,3,1,"H"
"17216",1990-04-21,1989,"AS Saint-Etienne","Montpellier HSC","1-0",1,0,"1",1,1,1,"H"
"17217",1990-04-21,1989,"Sporting Toulon Var","Racing Club de France","1-0",1,0,"1",1,1,1,"H"
"17218",1990-04-25,1989,"AS Saint-Etienne","Olympique Marseille","0-0",0,0,"1",1,0,0,"D"
"17219",1990-04-28,1989,"Olympique Marseille","FC Mulhouse","3-1",3,1,"1",1,4,2,"H"
"17220",1990-04-28,1989,"FC Nantes","Girondins Bordeaux","2-1",2,1,"1",1,3,1,"H"
"17221",1990-04-28,1989,"OGC Nice","AS Monaco","1-0",1,0,"1",1,1,1,"H"
"17222",1990-04-28,1989,"AJ Auxerre","Paris Saint-Germain","2-0",2,0,"1",1,2,2,"H"
"17223",1990-04-28,1989,"FC Sochaux","Lille OSC","1-0",1,0,"1",1,1,1,"H"
"17224",1990-04-28,1989,"Toulouse FC","AS Cannes","4-0",4,0,"1",1,4,4,"H"
"17225",1990-04-28,1989,"Olympique Lyon","Sporting Toulon Var","3-2",3,2,"1",1,5,1,"H"
"17226",1990-04-28,1989,"FC Metz","Brest Armorique FC","1-1",1,1,"1",1,2,0,"D"
"17227",1990-04-28,1989,"Racing Club de France","AS Saint-Etienne","3-0",3,0,"1",1,3,3,"H"
"17228",1990-04-28,1989,"Montpellier HSC","SM Caen","5-1",5,1,"1",1,6,4,"H"
"17229",1990-05-05,1989,"AJ Auxerre","Olympique Marseille","0-2",0,2,"1",1,2,-2,"D"
"17230",1990-05-05,1989,"Girondins Bordeaux","Toulouse FC","2-1",2,1,"1",1,3,1,"H"
"17231",1990-05-05,1989,"AS Monaco","FC Metz","1-0",1,0,"1",1,1,1,"H"
"17232",1990-05-05,1989,"AS Saint-Etienne","FC Sochaux","0-2",0,2,"1",1,2,-2,"D"
"17233",1990-05-05,1989,"Paris Saint-Germain","FC Nantes","2-2",2,2,"1",1,4,0,"D"
"17234",1990-05-05,1989,"FC Mulhouse","Olympique Lyon","4-4",4,4,"1",1,8,0,"D"
"17235",1990-05-05,1989,"Brest Armorique FC","Montpellier HSC","1-1",1,1,"1",1,2,0,"D"
"17236",1990-05-05,1989,"AS Cannes","OGC Nice","1-0",1,0,"1",1,1,1,"H"
"17237",1990-05-05,1989,"Sporting Toulon Var","Lille OSC","1-1",1,1,"1",1,2,0,"D"
"17238",1990-05-05,1989,"SM Caen","Racing Club de France","1-0",1,0,"1",1,1,1,"H"
"17239",1990-05-12,1989,"Olympique Marseille","SM Caen","1-0",1,0,"1",1,1,1,"H"
"17240",1990-05-12,1989,"OGC Nice","Girondins Bordeaux","1-0",1,0,"1",1,1,1,"H"
"17241",1990-05-12,1989,"Montpellier HSC","AS Monaco","0-0",0,0,"1",1,0,0,"D"
"17242",1990-05-12,1989,"FC Sochaux","Sporting Toulon Var","1-0",1,0,"1",1,1,1,"H"
"17243",1990-05-12,1989,"Olympique Lyon","AJ Auxerre","1-1",1,1,"1",1,2,0,"D"
"17244",1990-05-12,1989,"Toulouse FC","Paris Saint-Germain","4-1",4,1,"1",1,5,3,"H"
"17245",1990-05-12,1989,"FC Nantes","FC Mulhouse","3-2",3,2,"1",1,5,1,"H"
"17246",1990-05-12,1989,"Racing Club de France","Brest Armorique FC","1-1",1,1,"1",1,2,0,"D"
"17247",1990-05-12,1989,"FC Metz","AS Cannes","2-2",2,2,"1",1,4,0,"D"
"17248",1990-05-12,1989,"Lille OSC","AS Saint-Etienne","2-2",2,2,"1",1,4,0,"D"
"17249",1990-05-19,1989,"Olympique Marseille","Olympique Lyon","0-1",0,1,"1",1,1,-1,"D"
"17250",1990-05-19,1989,"Girondins Bordeaux","FC Metz","1-0",1,0,"1",1,1,1,"H"
"17251",1990-05-19,1989,"AS Monaco","Racing Club de France","4-0",4,0,"1",1,4,4,"H"
"17252",1990-05-19,1989,"Brest Armorique FC","FC Sochaux","1-0",1,0,"1",1,1,1,"H"
"17253",1990-05-19,1989,"Paris Saint-Germain","OGC Nice","2-1",2,1,"1",1,3,1,"H"
"17254",1990-05-19,1989,"AJ Auxerre","FC Nantes","0-0",0,0,"1",1,0,0,"D"
"17255",1990-05-19,1989,"FC Mulhouse","Toulouse FC","1-0",1,0,"1",1,1,1,"H"
"17256",1990-05-19,1989,"AS Cannes","Montpellier HSC","1-1",1,1,"1",1,2,0,"D"
"17257",1990-05-19,1989,"AS Saint-Etienne","Sporting Toulon Var","1-2",1,2,"1",1,3,-1,"D"
"17258",1990-05-19,1989,"SM Caen","Lille OSC","2-0",2,0,"1",1,2,2,"H"
"17259",1990-07-21,1990,"AS Cannes","Montpellier HSC","2-1",2,1,"1",1,3,1,"H"
"17260",1990-07-21,1990,"Paris Saint-Germain","AS Nancy","2-1",2,1,"1",1,3,1,"H"
"17261",1990-07-21,1990,"Olympique Marseille","OGC Nice","1-0",1,0,"1",1,1,1,"H"
"17262",1990-07-21,1990,"FC Metz","Lille OSC","2-2",2,2,"1",1,4,0,"D"
"17263",1990-07-21,1990,"FC Sochaux","Brest Armorique FC","1-1",1,1,"1",1,2,0,"D"
"17264",1990-07-21,1990,"Toulouse FC","AJ Auxerre","0-0",0,0,"1",1,0,0,"D"
"17265",1990-07-21,1990,"Girondins Bordeaux","Olympique Lyon","0-0",0,0,"1",1,0,0,"D"
"17266",1990-07-21,1990,"FC Nantes","SM Caen","0-0",0,0,"1",1,0,0,"D"
"17267",1990-07-21,1990,"AS Saint-Etienne","Stade Rennes","0-0",0,0,"1",1,0,0,"D"
"17268",1990-07-21,1990,"AS Monaco","Sporting Toulon Var","2-1",2,1,"1",1,3,1,"H"
"17269",1990-07-27,1990,"FC Metz","Olympique Marseille","0-2",0,2,"1",1,2,-2,"D"
"17270",1990-07-28,1990,"AJ Auxerre","AS Monaco","0-1",0,1,"1",1,1,-1,"D"
"17271",1990-07-28,1990,"SM Caen","Girondins Bordeaux","2-0",2,0,"1",1,2,2,"H"
"17272",1990-07-28,1990,"Stade Rennes","Paris Saint-Germain","2-1",2,1,"1",1,3,1,"H"
"17273",1990-07-28,1990,"Olympique Lyon","AS Cannes","1-0",1,0,"1",1,1,1,"H"
"17274",1990-07-28,1990,"Montpellier HSC","FC Sochaux","2-0",2,0,"1",1,2,2,"H"
"17275",1990-07-28,1990,"Lille OSC","FC Nantes","1-1",1,1,"1",1,2,0,"D"
"17276",1990-07-28,1990,"AS Nancy","Brest Armorique FC","0-0",0,0,"1",1,0,0,"D"
"17277",1990-07-28,1990,"OGC Nice","Toulouse FC","1-1",1,1,"1",1,2,0,"D"
"17278",1990-07-28,1990,"Sporting Toulon Var","AS Saint-Etienne","3-0",3,0,"1",1,3,3,"H"
"17279",1990-08-04,1990,"AS Monaco","Montpellier HSC","3-1",3,1,"1",1,4,2,"H"
"17280",1990-08-04,1990,"Olympique Marseille","SM Caen","2-1",2,1,"1",1,3,1,"H"
"17281",1990-08-04,1990,"Toulouse FC","Olympique Lyon","3-1",3,1,"1",1,4,2,"H"
"17282",1990-08-04,1990,"Brest Armorique FC","Stade Rennes","0-0",0,0,"1",1,0,0,"D"
"17283",1990-08-04,1990,"AS Cannes","AJ Auxerre","0-3",0,3,"1",1,3,-3,"D"
"17284",1990-08-04,1990,"Girondins Bordeaux","Lille OSC","1-1",1,1,"1",1,2,0,"D"
"17285",1990-08-04,1990,"FC Nantes","FC Metz","1-1",1,1,"1",1,2,0,"D"
"17286",1990-08-04,1990,"FC Sochaux","AS Nancy","1-0",1,0,"1",1,1,1,"H"
"17287",1990-08-04,1990,"AS Saint-Etienne","OGC Nice","1-0",1,0,"1",1,1,1,"H"
"17288",1990-08-04,1990,"Paris Saint-Germain","Sporting Toulon Var","4-0",4,0,"1",1,4,4,"H"
"17289",1990-08-10,1990,"Montpellier HSC","Paris Saint-Germain","4-0",4,0,"1",1,4,4,"H"
"17290",1990-08-10,1990,"OGC Nice","AS Cannes","0-0",0,0,"1",1,0,0,"D"
"17291",1990-08-11,1990,"Olympique Lyon","Olympique Marseille","2-2",2,2,"1",1,4,0,"D"
"17292",1990-08-11,1990,"FC Nantes","AS Monaco","3-1",3,1,"1",1,4,2,"H"
"17293",1990-08-11,1990,"Stade Rennes","AS Nancy","1-0",1,0,"1",1,1,1,"H"
"17294",1990-08-11,1990,"AJ Auxerre","AS Saint-Etienne","2-0",2,0,"1",1,2,2,"H"
"17295",1990-08-11,1990,"Lille OSC","Toulouse FC","3-0",3,0,"1",1,3,3,"H"
"17296",1990-08-11,1990,"SM Caen","FC Sochaux","2-0",2,0,"1",1,2,2,"H"
"17297",1990-08-11,1990,"FC Metz","Girondins Bordeaux","1-0",1,0,"1",1,1,1,"H"
"17298",1990-08-11,1990,"Sporting Toulon Var","Brest Armorique FC","1-2",1,2,"1",1,3,-1,"D"
"17299",1990-08-18,1990,"Olympique Marseille","Lille OSC","2-0",2,0,"1",1,2,2,"H"
"17300",1990-08-18,1990,"Brest Armorique FC","OGC Nice","4-0",4,0,"1",1,4,4,"H"
"17301",1990-08-18,1990,"AS Monaco","Olympique Lyon","0-0",0,0,"1",1,0,0,"D"
"17302",1990-08-18,1990,"Paris Saint-Germain","AJ Auxerre","1-1",1,1,"1",1,2,0,"D"
"17303",1990-08-18,1990,"AS Cannes","SM Caen","1-1",1,1,"1",1,2,0,"D"
"17304",1990-08-18,1990,"Toulouse FC","FC Metz","2-1",2,1,"1",1,3,1,"H"
"17305",1990-08-18,1990,"FC Sochaux","Stade Rennes","4-0",4,0,"1",1,4,4,"H"
"17306",1990-08-18,1990,"Girondins Bordeaux","FC Nantes","2-0",2,0,"1",1,2,2,"H"
"17307",1990-08-18,1990,"AS Saint-Etienne","Montpellier HSC","1-0",1,0,"1",1,1,1,"H"
"17308",1990-08-18,1990,"AS Nancy","Sporting Toulon Var","2-1",2,1,"1",1,3,1,"H"
"17309",1990-08-24,1990,"Girondins Bordeaux","AS Monaco","0-0",0,0,"1",1,0,0,"D"
"17310",1990-08-25,1990,"FC Nantes","Olympique Marseille","1-1",1,1,"1",1,2,0,"D"
"17311",1990-08-25,1990,"AJ Auxerre","Brest Armorique FC","2-2",2,2,"1",1,4,0,"D"
"17312",1990-08-25,1990,"SM Caen","Toulouse FC","2-0",2,0,"1",1,2,2,"H"
"17313",1990-08-25,1990,"Olympique Lyon","FC Sochaux","1-0",1,0,"1",1,1,1,"H"
"17314",1990-08-25,1990,"Montpellier HSC","AS Nancy","5-0",5,0,"1",1,5,5,"H"
"17315",1990-08-25,1990,"OGC Nice","Paris Saint-Germain","1-1",1,1,"1",1,2,0,"D"
"17316",1990-08-25,1990,"FC Metz","AS Saint-Etienne","3-1",3,1,"1",1,4,2,"H"
"17317",1990-08-25,1990,"Lille OSC","AS Cannes","0-2",0,2,"1",1,2,-2,"D"
"17318",1990-08-25,1990,"Sporting Toulon Var","Stade Rennes","1-0",1,0,"1",1,1,1,"H"
"17319",1990-08-29,1990,"Olympique Marseille","Girondins Bordeaux","2-0",2,0,"1",1,2,2,"H"
"17320",1990-08-29,1990,"Brest Armorique FC","Montpellier HSC","1-1",1,1,"1",1,2,0,"D"
"17321",1990-08-29,1990,"AS Saint-Etienne","SM Caen","0-0",0,0,"1",1,0,0,"D"
"17322",1990-08-29,1990,"AS Monaco","Lille OSC","1-1",1,1,"1",1,2,0,"D"
"17323",1990-08-29,1990,"AS Nancy","AJ Auxerre","1-1",1,1,"1",1,2,0,"D"
"17324",1990-08-29,1990,"Paris Saint-Germain","Olympique Lyon","3-0",3,0,"1",1,3,3,"H"
"17325",1990-08-29,1990,"AS Cannes","FC Metz","0-1",0,1,"1",1,1,-1,"D"
"17326",1990-08-29,1990,"Toulouse FC","FC Nantes","2-0",2,0,"1",1,2,2,"H"
"17327",1990-08-29,1990,"Stade Rennes","OGC Nice","0-3",0,3,"1",1,3,-3,"D"
"17328",1990-08-29,1990,"FC Sochaux","Sporting Toulon Var","0-0",0,0,"1",1,0,0,"D"
"17329",1990-09-08,1990,"Olympique Marseille","Paris Saint-Germain","2-1",2,1,"1",1,3,1,"H"
"17330",1990-09-08,1990,"SM Caen","AS Nancy","4-1",4,1,"1",1,5,3,"H"
"17331",1990-09-08,1990,"AJ Auxerre","Stade Rennes","4-0",4,0,"1",1,4,4,"H"
"17332",1990-09-08,1990,"FC Metz","AS Monaco","1-1",1,1,"1",1,2,0,"D"
"17333",1990-09-08,1990,"Olympique Lyon","Brest Armorique FC","2-0",2,0,"1",1,2,2,"H"
"17334",1990-09-08,1990,"Lille OSC","AS Saint-Etienne","3-2",3,2,"1",1,5,1,"H"
"17335",1990-09-08,1990,"Girondins Bordeaux","Toulouse FC","2-1",2,1,"1",1,3,1,"H"
"17336",1990-09-08,1990,"FC Nantes","AS Cannes","1-0",1,0,"1",1,1,1,"H"
"17337",1990-09-08,1990,"OGC Nice","FC Sochaux","3-0",3,0,"1",1,3,3,"H"
"17338",1990-09-08,1990,"Montpellier HSC","Sporting Toulon Var","0-0",0,0,"1",1,0,0,"D"
"17339",1990-09-14,1990,"OGC Nice","AS Monaco","0-0",0,0,"1",1,0,0,"D"
"17340",1990-09-15,1990,"Toulouse FC","Olympique Marseille","0-2",0,2,"1",1,2,-2,"D"
"17341",1990-09-15,1990,"FC Sochaux","AJ Auxerre","0-1",0,1,"1",1,1,-1,"D"
"17342",1990-09-15,1990,"Paris Saint-Germain","SM Caen","3-2",3,2,"1",1,5,1,"H"
"17343",1990-09-15,1990,"Brest Armorique FC","FC Metz","1-0",1,0,"1",1,1,1,"H"
"17344",1990-09-15,1990,"AS Saint-Etienne","Olympique Lyon","0-1",0,1,"1",1,1,-1,"D"
"17345",1990-09-15,1990,"Stade Rennes","Montpellier HSC","1-2",1,2,"1",1,3,-1,"D"
"17346",1990-09-15,1990,"AS Nancy","FC Nantes","3-2",3,2,"1",1,5,1,"H"
"17347",1990-09-15,1990,"AS Cannes","Girondins Bordeaux","1-1",1,1,"1",1,2,0,"D"
"17348",1990-09-15,1990,"Sporting Toulon Var","Lille OSC","0-0",0,0,"1",1,0,0,"D"
"17349",1990-09-22,1990,"Olympique Marseille","AS Cannes","0-1",0,1,"1",1,1,-1,"D"
"17350",1990-09-22,1990,"SM Caen","AS Monaco","0-2",0,2,"1",1,2,-2,"D"
"17351",1990-09-22,1990,"Olympique Lyon","Stade Rennes","0-0",0,0,"1",1,0,0,"D"
"17352",1990-09-22,1990,"FC Metz","Paris Saint-Germain","2-2",2,2,"1",1,4,0,"D"
"17353",1990-09-22,1990,"Lille OSC","Brest Armorique FC","1-0",1,0,"1",1,1,1,"H"
"17354",1990-09-22,1990,"FC Nantes","AS Saint-Etienne","2-1",2,1,"1",1,3,1,"H"
"17355",1990-09-22,1990,"Girondins Bordeaux","FC Sochaux","1-0",1,0,"1",1,1,1,"H"
"17356",1990-09-22,1990,"Toulouse FC","AS Nancy","0-0",0,0,"1",1,0,0,"D"
"17357",1990-09-22,1990,"OGC Nice","Sporting Toulon Var","0-0",0,0,"1",1,0,0,"D"
"17358",1990-09-23,1990,"AJ Auxerre","Montpellier HSC","3-2",3,2,"1",1,5,1,"H"
"17359",1990-09-28,1990,"AS Monaco","Olympique Marseille","1-3",1,3,"1",1,4,-2,"D"
"17360",1990-09-29,1990,"Brest Armorique FC","SM Caen","5-0",5,0,"1",1,5,5,"H"
"17361",1990-09-29,1990,"Montpellier HSC","OGC Nice","3-0",3,0,"1",1,3,3,"H"
"17362",1990-09-29,1990,"Paris Saint-Germain","FC Nantes","1-1",1,1,"1",1,2,0,"D"
"17363",1990-09-29,1990,"Stade Rennes","FC Metz","0-2",0,2,"1",1,2,-2,"D"
"17364",1990-09-29,1990,"FC Sochaux","Lille OSC","0-0",0,0,"1",1,0,0,"D"
"17365",1990-09-29,1990,"AS Nancy","Olympique Lyon","2-0",2,0,"1",1,2,2,"H"
"17366",1990-09-29,1990,"AS Saint-Etienne","Girondins Bordeaux","0-0",0,0,"1",1,0,0,"D"
"17367",1990-09-29,1990,"AS Cannes","Toulouse FC","0-0",0,0,"1",1,0,0,"D"
"17368",1990-09-29,1990,"Sporting Toulon Var","AJ Auxerre","2-3",2,3,"1",1,5,-1,"D"
"17369",1990-10-05,1990,"FC Nantes","Brest Armorique FC","1-0",1,0,"1",1,1,1,"H"
"17370",1990-10-05,1990,"Lille OSC","Stade Rennes","1-1",1,1,"1",1,2,0,"D"
"17371",1990-10-06,1990,"Olympique Marseille","AS Saint-Etienne","3-1",3,1,"1",1,4,2,"H"
"17372",1990-10-06,1990,"OGC Nice","AJ Auxerre","1-1",1,1,"1",1,2,0,"D"
"17373",1990-10-06,1990,"AS Cannes","AS Monaco","1-2",1,2,"1",1,3,-1,"D"
"17374",1990-10-06,1990,"FC Metz","AS Nancy","4-0",4,0,"1",1,4,4,"H"
"17375",1990-10-06,1990,"Olympique Lyon","Montpellier HSC","3-3",3,3,"1",1,6,0,"D"
"17376",1990-10-06,1990,"SM Caen","Sporting Toulon Var","2-0",2,0,"1",1,2,2,"H"
"17377",1990-10-06,1990,"Girondins Bordeaux","Paris Saint-Germain","3-0",3,0,"1",1,3,3,"H"
"17378",1990-10-06,1990,"Toulouse FC","FC Sochaux","0-0",0,0,"1",1,0,0,"D"
"17379",1990-10-19,1990,"AS Monaco","Toulouse FC","2-1",2,1,"1",1,3,1,"H"
"17380",1990-10-19,1990,"Brest Armorique FC","Girondins Bordeaux","4-0",4,0,"1",1,4,4,"H"
"17381",1990-10-20,1990,"FC Sochaux","Olympique Marseille","2-1",2,1,"1",1,3,1,"H"
"17382",1990-10-20,1990,"AJ Auxerre","Olympique Lyon","1-0",1,0,"1",1,1,1,"H"
"17383",1990-10-20,1990,"Montpellier HSC","FC Metz","5-2",5,2,"1",1,7,3,"H"
"17384",1990-10-20,1990,"Paris Saint-Germain","Lille OSC","2-0",2,0,"1",1,2,2,"H"
"17385",1990-10-20,1990,"Stade Rennes","SM Caen","1-1",1,1,"1",1,2,0,"D"
"17386",1990-10-20,1990,"AS Nancy","OGC Nice","2-1",2,1,"1",1,3,1,"H"
"17387",1990-10-20,1990,"AS Saint-Etienne","AS Cannes","1-0",1,0,"1",1,1,1,"H"
"17388",1990-10-20,1990,"Sporting Toulon Var","FC Nantes","3-1",3,1,"1",1,4,2,"H"
"17389",1990-10-26,1990,"SM Caen","AJ Auxerre","0-1",0,1,"1",1,1,-1,"D"
"17390",1990-10-27,1990,"Girondins Bordeaux","AS Nancy","5-0",5,0,"1",1,5,5,"H"
"17391",1990-10-27,1990,"FC Nantes","Stade Rennes","2-0",2,0,"1",1,2,2,"H"
"17392",1990-10-27,1990,"Lille OSC","Montpellier HSC","1-0",1,0,"1",1,1,1,"H"
"17393",1990-10-27,1990,"Olympique Lyon","OGC Nice","1-0",1,0,"1",1,1,1,"H"
"17394",1990-10-27,1990,"Toulouse FC","AS Saint-Etienne","0-0",0,0,"1",1,0,0,"D"
"17395",1990-10-27,1990,"AS Cannes","FC Sochaux","1-1",1,1,"1",1,2,0,"D"
"17396",1990-10-27,1990,"FC Metz","Sporting Toulon Var","0-0",0,0,"1",1,0,0,"D"
"17397",1990-10-28,1990,"AS Monaco","Paris Saint-Germain","2-0",2,0,"1",1,2,2,"H"
"17398",1990-10-28,1990,"Olympique Marseille","Brest Armorique FC","3-1",3,1,"1",1,4,2,"H"
"17399",1990-11-02,1990,"Stade Rennes","Girondins Bordeaux","2-1",2,1,"1",1,3,1,"H"
"17400",1990-11-02,1990,"Montpellier HSC","SM Caen","0-0",0,0,"1",1,0,0,"D"
"17401",1990-11-03,1990,"AJ Auxerre","Lille OSC","3-2",3,2,"1",1,5,1,"H"
"17402",1990-11-03,1990,"AS Nancy","Olympique Marseille","2-0",2,0,"1",1,2,2,"H"
"17403",1990-11-03,1990,"AS Saint-Etienne","AS Monaco","1-0",1,0,"1",1,1,1,"H"
"17404",1990-11-03,1990,"OGC Nice","FC Metz","1-2",1,2,"1",1,3,-1,"D"
"17405",1990-11-03,1990,"Brest Armorique FC","Toulouse FC","0-0",0,0,"1",1,0,0,"D"
"17406",1990-11-03,1990,"FC Sochaux","FC Nantes","1-1",1,1,"1",1,2,0,"D"
"17407",1990-11-03,1990,"Paris Saint-Germain","AS Cannes","0-0",0,0,"1",1,0,0,"D"
"17408",1990-11-03,1990,"Sporting Toulon Var","Olympique Lyon","1-0",1,0,"1",1,1,1,"H"
"17409",1990-11-10,1990,"AS Monaco","FC Sochaux","1-0",1,0,"1",1,1,1,"H"
"17410",1990-11-10,1990,"AS Cannes","Brest Armorique FC","0-0",0,0,"1",1,0,0,"D"
"17411",1990-11-10,1990,"SM Caen","Olympique Lyon","1-0",1,0,"1",1,1,1,"H"
"17412",1990-11-10,1990,"FC Nantes","Montpellier HSC","1-1",1,1,"1",1,2,0,"D"
"17413",1990-11-10,1990,"Lille OSC","OGC Nice","0-0",0,0,"1",1,0,0,"D"
"17414",1990-11-10,1990,"Toulouse FC","Paris Saint-Germain","2-1",2,1,"1",1,3,1,"H"
"17415",1990-11-10,1990,"AS Saint-Etienne","AS Nancy","4-1",4,1,"1",1,5,3,"H"
"17416",1990-11-10,1990,"FC Metz","AJ Auxerre","1-0",1,0,"1",1,1,1,"H"
"17417",1990-11-10,1990,"Girondins Bordeaux","Sporting Toulon Var","0-1",0,1,"1",1,1,-1,"D"
"17418",1990-11-11,1990,"Olympique Marseille","Stade Rennes","4-1",4,1,"1",1,5,3,"H"
"17419",1990-11-23,1990,"Brest Armorique FC","AS Monaco","1-2",1,2,"1",1,3,-1,"D"
"17420",1990-11-24,1990,"AJ Auxerre","FC Nantes","0-2",0,2,"1",1,2,-2,"D"
"17421",1990-11-24,1990,"FC Sochaux","FC Metz","1-1",1,1,"1",1,2,0,"D"
"17422",1990-11-24,1990,"Montpellier HSC","Girondins Bordeaux","2-1",2,1,"1",1,3,1,"H"
"17423",1990-11-24,1990,"OGC Nice","SM Caen","0-0",0,0,"1",1,0,0,"D"
"17424",1990-11-24,1990,"Paris Saint-Germain","AS Saint-Etienne","4-2",4,2,"1",1,6,2,"H"
"17425",1990-11-24,1990,"Olympique Lyon","Lille OSC","2-1",2,1,"1",1,3,1,"H"
"17426",1990-11-24,1990,"Stade Rennes","Toulouse FC","2-0",2,0,"1",1,2,2,"H"
"17427",1990-11-24,1990,"AS Nancy","AS Cannes","2-0",2,0,"1",1,2,2,"H"
"17428",1990-11-24,1990,"Sporting Toulon Var","Olympique Marseille","0-1",0,1,"1",1,1,-1,"D"
"17429",1990-12-02,1990,"Olympique Marseille","Montpellier HSC","2-0",2,0,"1",1,2,2,"H"
"17430",1990-12-02,1990,"Girondins Bordeaux","AJ Auxerre","1-1",1,1,"1",1,2,0,"D"
"17431",1990-12-02,1990,"AS Monaco","AS Nancy","2-2",2,2,"1",1,4,0,"D"
"17432",1990-12-02,1990,"FC Metz","Olympique Lyon","1-2",1,2,"1",1,3,-1,"D"
"17433",1990-12-02,1990,"FC Nantes","OGC Nice","2-2",2,2,"1",1,4,0,"D"
"17434",1990-12-02,1990,"Lille OSC","SM Caen","1-0",1,0,"1",1,1,1,"H"
"17435",1990-12-02,1990,"AS Saint-Etienne","Brest Armorique FC","6-1",6,1,"1",1,7,5,"H"
"17436",1990-12-02,1990,"Paris Saint-Germain","FC Sochaux","0-2",0,2,"1",1,2,-2,"D"
"17437",1990-12-02,1990,"AS Cannes","Stade Rennes","1-0",1,0,"1",1,1,1,"H"
"17438",1990-12-02,1990,"Toulouse FC","Sporting Toulon Var","1-1",1,1,"1",1,2,0,"D"
"17439",1990-12-07,1990,"Stade Rennes","AS Monaco","1-1",1,1,"1",1,2,0,"D"
"17440",1990-12-07,1990,"OGC Nice","Girondins Bordeaux","0-0",0,0,"1",1,0,0,"D"
"17441",1990-12-09,1990,"AJ Auxerre","Olympique Marseille","4-0",4,0,"1",1,4,4,"H"
"17442",1990-12-09,1990,"Montpellier HSC","Toulouse FC","2-0",2,0,"1",1,2,2,"H"
"17443",1990-12-09,1990,"SM Caen","FC Metz","4-1",4,1,"1",1,5,3,"H"
"17444",1990-12-09,1990,"AS Nancy","Lille OSC","1-1",1,1,"1",1,2,0,"D"
"17445",1990-12-09,1990,"FC Sochaux","AS Saint-Etienne","2-0",2,0,"1",1,2,2,"H"
"17446",1990-12-09,1990,"Sporting Toulon Var","AS Cannes","0-0",0,0,"1",1,0,0,"D"
"17447",1990-12-16,1990,"Olympique Marseille","FC Metz","3-0",3,0,"1",1,3,3,"H"
"17448",1990-12-16,1990,"AS Monaco","AJ Auxerre","0-0",0,0,"1",1,0,0,"D"
"17449",1990-12-16,1990,"Girondins Bordeaux","SM Caen","1-1",1,1,"1",1,2,0,"D"
"17450",1990-12-16,1990,"FC Nantes","Lille OSC","0-0",0,0,"1",1,0,0,"D"
"17451",1990-12-16,1990,"AS Cannes","Olympique Lyon","3-2",3,2,"1",1,5,1,"H"
"17452",1990-12-16,1990,"Brest Armorique FC","AS Nancy","3-3",3,3,"1",1,6,0,"D"
"17453",1990-12-16,1990,"Paris Saint-Germain","Stade Rennes","1-1",1,1,"1",1,2,0,"D"
"17454",1990-12-16,1990,"Toulouse FC","OGC Nice","1-2",1,2,"1",1,3,-1,"D"
"17455",1990-12-21,1990,"AJ Auxerre","AS Cannes","0-3",0,3,"1",1,3,-3,"D"
"17456",1990-12-22,1990,"Sporting Toulon Var","Paris Saint-Germain","0-0",0,0,"1",1,0,0,"D"
"17457",1990-12-23,1990,"SM Caen","Olympique Marseille","0-0",0,0,"1",1,0,0,"D"
"17458",1990-12-23,1990,"Montpellier HSC","AS Monaco","2-1",2,1,"1",1,3,1,"H"
"17459",1990-12-23,1990,"Olympique Lyon","Toulouse FC","4-1",4,1,"1",1,5,3,"H"
"17460",1990-12-23,1990,"Lille OSC","Girondins Bordeaux","0-0",0,0,"1",1,0,0,"D"
"17461",1990-12-23,1990,"Stade Rennes","Brest Armorique FC","3-0",3,0,"1",1,3,3,"H"
"17462",1990-12-23,1990,"OGC Nice","AS Saint-Etienne","2-0",2,0,"1",1,2,2,"H"
"17463",1991-01-13,1990,"Olympique Marseille","Olympique Lyon","7-0",7,0,"1",1,7,7,"H"
"17464",1991-01-13,1990,"AS Monaco","FC Nantes","2-1",2,1,"1",1,3,1,"H"
"17465",1991-01-13,1990,"AS Saint-Etienne","AJ Auxerre","2-1",2,1,"1",1,3,1,"H"
"17466",1991-01-13,1990,"Paris Saint-Germain","Montpellier HSC","2-0",2,0,"1",1,2,2,"H"
"17467",1991-01-13,1990,"FC Sochaux","SM Caen","1-0",1,0,"1",1,1,1,"H"
"17468",1991-01-13,1990,"AS Cannes","OGC Nice","2-1",2,1,"1",1,3,1,"H"
"17469",1991-01-13,1990,"Toulouse FC","Lille OSC","2-2",2,2,"1",1,4,0,"D"
"17470",1991-01-13,1990,"Girondins Bordeaux","FC Metz","1-1",1,1,"1",1,2,0,"D"
"17471",1991-01-13,1990,"AS Nancy","Stade Rennes","0-0",0,0,"1",1,0,0,"D"
"17472",1991-01-13,1990,"Stade Brest","Sporting Toulon Var","2-2",2,2,"1",1,4,0,"D"
"17473",1991-01-18,1990,"Olympique Lyon","AS Monaco","1-0",1,0,"1",1,1,1,"H"
"17474",1991-01-19,1990,"FC Nantes","Girondins Bordeaux","0-0",0,0,"1",1,0,0,"D"
"17475",1991-01-20,1990,"Lille OSC","Olympique Marseille","1-0",1,0,"1",1,1,1,"H"
"17476",1991-01-20,1990,"AJ Auxerre","Paris Saint-Germain","0-1",0,1,"1",1,1,-1,"D"
"17477",1991-01-20,1990,"Montpellier HSC","AS Saint-Etienne","0-0",0,0,"1",1,0,0,"D"
"17478",1991-01-20,1990,"SM Caen","AS Cannes","0-1",0,1,"1",1,1,-1,"D"
"17479",1991-01-20,1990,"FC Metz","Toulouse FC","2-1",2,1,"1",1,3,1,"H"
"17480",1991-01-20,1990,"Stade Rennes","FC Sochaux","1-1",1,1,"1",1,2,0,"D"
"17481",1991-01-20,1990,"OGC Nice","Stade Brest","2-0",2,0,"1",1,2,2,"H"
"17482",1991-01-20,1990,"Sporting Toulon Var","AS Nancy","2-0",2,0,"1",1,2,2,"H"
"17483",1991-01-23,1990,"Stade Brest","Paris Saint-Germain","0-0",0,0,"1",1,0,0,"D"
"17484",1991-01-23,1990,"FC Sochaux","Montpellier HSC","0-0",0,0,"1",1,0,0,"D"
"17485",1991-01-23,1990,"AS Saint-Etienne","Sporting Toulon Var","3-0",3,0,"1",1,3,3,"H"
"17486",1991-01-23,1990,"FC Metz","FC Nantes","2-0",2,0,"1",1,2,2,"H"
"17487",1991-01-26,1990,"Toulouse FC","SM Caen","3-2",3,2,"1",1,5,1,"H"
"17488",1991-01-27,1990,"Olympique Marseille","FC Nantes","6-0",6,0,"1",1,6,6,"H"
"17489",1991-01-27,1990,"AS Monaco","Girondins Bordeaux","2-0",2,0,"1",1,2,2,"H"
"17490",1991-01-27,1990,"Stade Brest","AJ Auxerre","1-3",1,3,"1",1,4,-2,"D"
"17491",1991-01-27,1990,"AS Nancy","Montpellier HSC","1-1",1,1,"1",1,2,0,"D"
"17492",1991-01-27,1990,"AS Cannes","Lille OSC","2-1",2,1,"1",1,3,1,"H"
"17493",1991-01-27,1990,"AS Saint-Etienne","FC Metz","2-1",2,1,"1",1,3,1,"H"
"17494",1991-01-27,1990,"FC Sochaux","Olympique Lyon","1-2",1,2,"1",1,3,-1,"D"
"17495",1991-01-27,1990,"Paris Saint-Germain","OGC Nice","0-2",0,2,"1",1,2,-2,"D"
"17496",1991-01-27,1990,"Stade Rennes","Sporting Toulon Var","0-0",0,0,"1",1,0,0,"D"
"17497",1991-01-30,1990,"Olympique Lyon","FC Nantes","2-0",2,0,"1",1,2,2,"H"
"17498",1991-01-30,1990,"AS Nancy","FC Sochaux","2-0",2,0,"1",1,2,2,"H"
"17499",1991-02-01,1990,"Girondins Bordeaux","Olympique Marseille","1-1",1,1,"1",1,2,0,"D"
"17500",1991-02-02,1990,"SM Caen","AS Saint-Etienne","1-0",1,0,"1",1,1,1,"H"
"17501",1991-02-03,1990,"Lille OSC","AS Monaco","0-0",0,0,"1",1,0,0,"D"
"17502",1991-02-03,1990,"AJ Auxerre","AS Nancy","1-1",1,1,"1",1,2,0,"D"
"17503",1991-02-03,1990,"Montpellier HSC","Stade Brest","1-0",1,0,"1",1,1,1,"H"
"17504",1991-02-03,1990,"Olympique Lyon","Paris Saint-Germain","0-0",0,0,"1",1,0,0,"D"
"17505",1991-02-03,1990,"FC Metz","AS Cannes","0-0",0,0,"1",1,0,0,"D"
"17506",1991-02-03,1990,"OGC Nice","Stade Rennes","2-2",2,2,"1",1,4,0,"D"
"17507",1991-02-03,1990,"FC Nantes","Toulouse FC","0-0",0,0,"1",1,0,0,"D"
"17508",1991-02-03,1990,"Sporting Toulon Var","FC Sochaux","1-0",1,0,"1",1,1,1,"H"
"17509",1991-02-08,1990,"Sporting Toulon Var","Montpellier HSC","1-1",1,1,"1",1,2,0,"D"
"17510",1991-02-09,1990,"AS Monaco","FC Metz","2-0",2,0,"1",1,2,2,"H"
"17511",1991-02-10,1990,"Paris Saint-Germain","Olympique Marseille","0-1",0,1,"1",1,1,-1,"D"
"17512",1991-02-10,1990,"Stade Rennes","AJ Auxerre","2-2",2,2,"1",1,4,0,"D"
"17513",1991-02-10,1990,"AS Cannes","FC Nantes","2-1",2,1,"1",1,3,1,"H"
"17514",1991-02-10,1990,"AS Saint-Etienne","Lille OSC","0-0",0,0,"1",1,0,0,"D"
"17515",1991-02-10,1990,"Toulouse FC","Girondins Bordeaux","0-0",0,0,"1",1,0,0,"D"
"17516",1991-02-13,1990,"Olympique Marseille","Toulouse FC","1-0",1,0,"1",1,1,1,"H"
"17517",1991-02-13,1990,"AS Monaco","OGC Nice","2-1",2,1,"1",1,3,1,"H"
"17518",1991-02-13,1990,"Montpellier HSC","Stade Rennes","1-0",1,0,"1",1,1,1,"H"
"17519",1991-02-13,1990,"Girondins Bordeaux","AS Cannes","1-1",1,1,"1",1,2,0,"D"
"17520",1991-02-13,1990,"SM Caen","Paris Saint-Germain","2-0",2,0,"1",1,2,2,"H"
"17521",1991-02-23,1990,"Montpellier HSC","AJ Auxerre","1-2",1,2,"1",1,3,-1,"D"
"17522",1991-02-24,1990,"AS Cannes","Olympique Marseille","0-0",0,0,"1",1,0,0,"D"
"17523",1991-02-24,1990,"AS Monaco","SM Caen","2-0",2,0,"1",1,2,2,"H"
"17524",1991-02-24,1990,"Stade Rennes","Olympique Lyon","2-0",2,0,"1",1,2,2,"H"
"17525",1991-02-24,1990,"Paris Saint-Germain","FC Metz","2-1",2,1,"1",1,3,1,"H"
"17526",1991-02-24,1990,"Stade Brest","Lille OSC","1-0",1,0,"1",1,1,1,"H"
"17527",1991-02-24,1990,"AS Saint-Etienne","FC Nantes","1-3",1,3,"1",1,4,-2,"D"
"17528",1991-02-24,1990,"FC Sochaux","Girondins Bordeaux","1-0",1,0,"1",1,1,1,"H"
"17529",1991-02-24,1990,"AS Nancy","Toulouse FC","1-1",1,1,"1",1,2,0,"D"
"17530",1991-02-24,1990,"Sporting Toulon Var","OGC Nice","1-2",1,2,"1",1,3,-1,"D"
"17531",1991-02-27,1990,"Stade Brest","Olympique Lyon","3-0",3,0,"1",1,3,3,"H"
"17532",1991-02-27,1990,"FC Nantes","AS Nancy","1-0",1,0,"1",1,1,1,"H"
"17533",1991-02-27,1990,"Lille OSC","Sporting Toulon Var","4-1",4,1,"1",1,5,3,"H"
"17534",1991-03-01,1990,"Olympique Marseille","AS Monaco","1-0",1,0,"1",1,1,1,"H"
"17535",1991-03-01,1990,"OGC Nice","Montpellier HSC","2-0",2,0,"1",1,2,2,"H"
"17536",1991-03-02,1990,"Toulouse FC","AS Cannes","2-2",2,2,"1",1,4,0,"D"
"17537",1991-03-02,1990,"FC Nantes","Paris Saint-Germain","2-0",2,0,"1",1,2,2,"H"
"17538",1991-03-02,1990,"Lille OSC","FC Sochaux","0-1",0,1,"1",1,1,-1,"D"
"17539",1991-03-02,1990,"FC Metz","Stade Rennes","2-0",2,0,"1",1,2,2,"H"
"17540",1991-03-02,1990,"Olympique Lyon","AS Nancy","0-1",0,1,"1",1,1,-1,"D"
"17541",1991-03-02,1990,"SM Caen","Stade Brest","1-2",1,2,"1",1,3,-1,"D"
"17542",1991-03-02,1990,"Girondins Bordeaux","AS Saint-Etienne","2-1",2,1,"1",1,3,1,"H"
"17543",1991-03-02,1990,"AJ Auxerre","Sporting Toulon Var","3-0",3,0,"1",1,3,3,"H"
"17544",1991-03-05,1990,"FC Sochaux","OGC Nice","0-0",0,0,"1",1,0,0,"D"
"17545",1991-03-05,1990,"AS Nancy","SM Caen","0-0",0,0,"1",1,0,0,"D"
"17546",1991-03-12,1990,"AJ Auxerre","FC Sochaux","4-1",4,1,"1",1,5,3,"H"
"17547",1991-03-12,1990,"FC Metz","Stade Brest","0-0",0,0,"1",1,0,0,"D"
"17548",1991-03-14,1990,"Montpellier HSC","Olympique Lyon","1-0",1,0,"1",1,1,1,"H"
"17549",1991-03-15,1990,"AS Saint-Etienne","Olympique Marseille","1-1",1,1,"1",1,2,0,"D"
"17550",1991-03-15,1990,"AS Nancy","FC Metz","0-1",0,1,"1",1,1,-1,"D"
"17551",1991-03-15,1990,"AJ Auxerre","OGC Nice","5-1",5,1,"1",1,6,4,"H"
"17552",1991-03-15,1990,"AS Monaco","AS Cannes","0-0",0,0,"1",1,0,0,"D"
"17553",1991-03-16,1990,"Stade Rennes","Lille OSC","1-3",1,3,"1",1,4,-2,"D"
"17554",1991-03-16,1990,"Stade Brest","FC Nantes","1-0",1,0,"1",1,1,1,"H"
"17555",1991-03-16,1990,"Paris Saint-Germain","Girondins Bordeaux","1-0",1,0,"1",1,1,1,"H"
"17556",1991-03-16,1990,"FC Sochaux","Toulouse FC","0-1",0,1,"1",1,1,-1,"D"
"17557",1991-03-16,1990,"Sporting Toulon Var","SM Caen","0-0",0,0,"1",1,0,0,"D"
"17558",1991-03-22,1990,"OGC Nice","AS Nancy","3-0",3,0,"1",1,3,3,"H"
"17559",1991-03-23,1990,"Olympique Marseille","FC Sochaux","0-0",0,0,"1",1,0,0,"D"
"17560",1991-03-23,1990,"Toulouse FC","AS Monaco","1-2",1,2,"1",1,3,-1,"D"
"17561",1991-03-23,1990,"Olympique Lyon","AJ Auxerre","1-0",1,0,"1",1,1,1,"H"
"17562",1991-03-23,1990,"FC Metz","Montpellier HSC","0-0",0,0,"1",1,0,0,"D"
"17563",1991-03-23,1990,"AS Cannes","AS Saint-Etienne","0-1",0,1,"1",1,1,-1,"D"
"17564",1991-03-23,1990,"Girondins Bordeaux","Stade Brest","1-4",1,4,"1",1,5,-3,"D"
"17565",1991-03-23,1990,"Lille OSC","Paris Saint-Germain","0-0",0,0,"1",1,0,0,"D"
"17566",1991-03-23,1990,"SM Caen","Stade Rennes","2-0",2,0,"1",1,2,2,"H"
"17567",1991-03-23,1990,"FC Nantes","Sporting Toulon Var","0-0",0,0,"1",1,0,0,"D"
"17568",1991-03-26,1990,"Olympique Lyon","AS Saint-Etienne","1-1",1,1,"1",1,2,0,"D"
"17569",1991-04-06,1990,"Paris Saint-Germain","AS Monaco","0-2",0,2,"1",1,2,-2,"D"
"17570",1991-04-06,1990,"AJ Auxerre","SM Caen","3-0",3,0,"1",1,3,3,"H"
"17571",1991-04-06,1990,"Montpellier HSC","Lille OSC","1-2",1,2,"1",1,3,-1,"D"
"17572",1991-04-06,1990,"FC Sochaux","AS Cannes","0-0",0,0,"1",1,0,0,"D"
"17573",1991-04-06,1990,"OGC Nice","Olympique Lyon","1-1",1,1,"1",1,2,0,"D"
"17574",1991-04-06,1990,"Stade Rennes","FC Nantes","2-0",2,0,"1",1,2,2,"H"
"17575",1991-04-06,1990,"AS Nancy","Girondins Bordeaux","0-2",0,2,"1",1,2,-2,"D"
"17576",1991-04-06,1990,"AS Saint-Etienne","Toulouse FC","1-4",1,4,"1",1,5,-3,"D"
"17577",1991-04-06,1990,"Sporting Toulon Var","FC Metz","2-1",2,1,"1",1,3,1,"H"
"17578",1991-04-12,1990,"Lille OSC","AJ Auxerre","1-0",1,0,"1",1,1,1,"H"
"17579",1991-04-13,1990,"Olympique Marseille","AS Nancy","6-2",6,2,"1",1,8,4,"H"
"17580",1991-04-13,1990,"AS Monaco","AS Saint-Etienne","2-0",2,0,"1",1,2,2,"H"
"17581",1991-04-13,1990,"AS Cannes","Paris Saint-Germain","2-0",2,0,"1",1,2,2,"H"
"17582",1991-04-13,1990,"SM Caen","Montpellier HSC","1-0",1,0,"1",1,1,1,"H"
"17583",1991-04-13,1990,"FC Metz","OGC Nice","1-0",1,0,"1",1,1,1,"H"
"17584",1991-04-13,1990,"Toulouse FC","Stade Brest","0-0",0,0,"1",1,0,0,"D"
"17585",1991-04-13,1990,"Olympique Lyon","Sporting Toulon Var","1-1",1,1,"1",1,2,0,"D"
"17586",1991-04-13,1990,"FC Nantes","FC Sochaux","0-0",0,0,"1",1,0,0,"D"
"17587",1991-04-13,1990,"Girondins Bordeaux","Stade Rennes","1-0",1,0,"1",1,1,1,"H"
"17588",1991-04-19,1990,"Stade Rennes","Olympique Marseille","1-1",1,1,"1",1,2,0,"D"
"17589",1991-04-19,1990,"FC Sochaux","AS Monaco","0-2",0,2,"1",1,2,-2,"D"
"17590",1991-04-20,1990,"AJ Auxerre","FC Metz","3-1",3,1,"1",1,4,2,"H"
"17591",1991-04-20,1990,"Stade Brest","AS Cannes","3-2",3,2,"1",1,5,1,"H"
"17592",1991-04-20,1990,"Montpellier HSC","FC Nantes","1-1",1,1,"1",1,2,0,"D"
"17593",1991-04-20,1990,"OGC Nice","Lille OSC","4-1",4,1,"1",1,5,3,"H"
"17594",1991-04-20,1990,"Olympique Lyon","SM Caen","3-2",3,2,"1",1,5,1,"H"
"17595",1991-04-20,1990,"Sporting Toulon Var","Girondins Bordeaux","0-2",0,2,"1",1,2,-2,"D"
"17596",1991-04-20,1990,"Paris Saint-Germain","Toulouse FC","3-0",3,0,"1",1,3,3,"H"
"17597",1991-04-20,1990,"AS Nancy","AS Saint-Etienne","1-0",1,0,"1",1,1,1,"H"
"17598",1991-05-01,1990,"Stade Brest","Olympique Marseille","1-1",1,1,"1",1,2,0,"D"
"17599",1991-05-03,1990,"AS Cannes","AS Nancy","1-0",1,0,"1",1,1,1,"H"
"17600",1991-05-04,1990,"Olympique Marseille","Sporting Toulon Var","3-3",3,3,"1",1,6,0,"D"
"17601",1991-05-04,1990,"AS Monaco","Stade Brest","5-0",5,0,"1",1,5,5,"H"
"17602",1991-05-04,1990,"FC Nantes","AJ Auxerre","2-3",2,3,"1",1,5,-1,"D"
"17603",1991-05-04,1990,"Lille OSC","Olympique Lyon","1-1",1,1,"1",1,2,0,"D"
"17604",1991-05-04,1990,"Girondins Bordeaux","Montpellier HSC","1-0",1,0,"1",1,1,1,"H"
"17605",1991-05-04,1990,"FC Metz","FC Sochaux","2-2",2,2,"1",1,4,0,"D"
"17606",1991-05-04,1990,"SM Caen","OGC Nice","2-1",2,1,"1",1,3,1,"H"
"17607",1991-05-04,1990,"AS Saint-Etienne","Paris Saint-Germain","1-1",1,1,"1",1,2,0,"D"
"17608",1991-05-04,1990,"Toulouse FC","Stade Rennes","2-0",2,0,"1",1,2,2,"H"
"17609",1991-05-10,1990,"Montpellier HSC","Olympique Marseille","0-0",0,0,"1",1,0,0,"D"
"17610",1991-05-10,1990,"AS Nancy","AS Monaco","4-0",4,0,"1",1,4,4,"H"
"17611",1991-05-10,1990,"AJ Auxerre","Girondins Bordeaux","0-0",0,0,"1",1,0,0,"D"
"17612",1991-05-10,1990,"Stade Rennes","AS Cannes","1-1",1,1,"1",1,2,0,"D"
"17613",1991-05-10,1990,"Olympique Lyon","FC Metz","3-1",3,1,"1",1,4,2,"H"
"17614",1991-05-10,1990,"SM Caen","Lille OSC","0-0",0,0,"1",1,0,0,"D"
"17615",1991-05-10,1990,"Stade Brest","AS Saint-Etienne","0-1",0,1,"1",1,1,-1,"D"
"17616",1991-05-10,1990,"OGC Nice","FC Nantes","1-1",1,1,"1",1,2,0,"D"
"17617",1991-05-10,1990,"FC Sochaux","Paris Saint-Germain","0-0",0,0,"1",1,0,0,"D"
"17618",1991-05-10,1990,"Sporting Toulon Var","Toulouse FC","1-0",1,0,"1",1,1,1,"H"
"17619",1991-05-17,1990,"Olympique Marseille","AJ Auxerre","1-0",1,0,"1",1,1,1,"H"
"17620",1991-05-17,1990,"AS Monaco","Stade Rennes","2-1",2,1,"1",1,3,1,"H"
"17621",1991-05-17,1990,"AS Cannes","Sporting Toulon Var","0-0",0,0,"1",1,0,0,"D"
"17622",1991-05-17,1990,"FC Nantes","Olympique Lyon","0-0",0,0,"1",1,0,0,"D"
"17623",1991-05-17,1990,"Toulouse FC","Montpellier HSC","0-0",0,0,"1",1,0,0,"D"
"17624",1991-05-17,1990,"Girondins Bordeaux","OGC Nice","3-0",3,0,"1",1,3,3,"H"
"17625",1991-05-17,1990,"Lille OSC","AS Nancy","0-2",0,2,"1",1,2,-2,"D"
"17626",1991-05-17,1990,"FC Metz","SM Caen","1-1",1,1,"1",1,2,0,"D"
"17627",1991-05-17,1990,"Paris Saint-Germain","Stade Brest","1-1",1,1,"1",1,2,0,"D"
"17628",1991-05-17,1990,"AS Saint-Etienne","FC Sochaux","2-1",2,1,"1",1,3,1,"H"
"17629",1991-05-22,1990,"OGC Nice","Olympique Marseille","0-1",0,1,"1",1,1,-1,"D"
"17630",1991-05-24,1990,"Sporting Toulon Var","AS Monaco","1-1",1,1,"1",1,2,0,"D"
"17631",1991-05-24,1990,"AJ Auxerre","Toulouse FC","2-1",2,1,"1",1,3,1,"H"
"17632",1991-05-24,1990,"Montpellier HSC","AS Cannes","0-0",0,0,"1",1,0,0,"D"
"17633",1991-05-24,1990,"Olympique Lyon","Girondins Bordeaux","1-0",1,0,"1",1,1,1,"H"
"17634",1991-05-24,1990,"Lille OSC","FC Metz","4-1",4,1,"1",1,5,3,"H"
"17635",1991-05-24,1990,"SM Caen","FC Nantes","1-0",1,0,"1",1,1,1,"H"
"17636",1991-05-24,1990,"Stade Brest","FC Sochaux","0-0",0,0,"1",1,0,0,"D"
"17637",1991-05-24,1990,"AS Nancy","Paris Saint-Germain","0-2",0,2,"1",1,2,-2,"D"
"17638",1991-05-24,1990,"Stade Rennes","AS Saint-Etienne","0-2",0,2,"1",1,2,-2,"D"
"17639",1991-07-20,1991,"Montpellier HSC","AS Monaco","1-4",1,4,"1",1,5,-3,"D"
"17640",1991-07-20,1991,"AJ Auxerre","Stade Rennes","3-1",3,1,"1",1,4,2,"H"
"17641",1991-07-20,1991,"RC Lens","FC Metz","0-2",0,2,"1",1,2,-2,"D"
"17642",1991-07-20,1991,"Le Havre AC","Olympique Lyon","1-0",1,0,"1",1,1,1,"H"
"17643",1991-07-20,1991,"Olympique Marseille","Lille OSC","1-0",1,0,"1",1,1,1,"H"
"17644",1991-07-20,1991,"AS Nancy","AS Cannes","1-0",1,0,"1",1,1,1,"H"
"17645",1991-07-20,1991,"FC Sochaux","Nimes Olympique","1-1",1,1,"1",1,2,0,"D"
"17646",1991-07-20,1991,"FC Nantes","Paris Saint-Germain","0-0",0,0,"1",1,0,0,"D"
"17647",1991-07-20,1991,"Toulouse FC","SM Caen","0-0",0,0,"1",1,0,0,"D"
"17648",1991-07-20,1991,"AS Saint-Etienne","Sporting Toulon Var","3-1",3,1,"1",1,4,2,"H"
"17649",1991-07-26,1991,"Stade Rennes","FC Nantes","0-1",0,1,"1",1,1,-1,"D"
"17650",1991-07-26,1991,"AS Cannes","Montpellier HSC","2-0",2,0,"1",1,2,2,"H"
"17651",1991-07-27,1991,"AS Monaco","AS Nancy","4-1",4,1,"1",1,5,3,"H"
"17652",1991-07-27,1991,"FC Metz","FC Sochaux","3-1",3,1,"1",1,4,2,"H"
"17653",1991-07-27,1991,"Paris Saint-Germain","AJ Auxerre","1-1",1,1,"1",1,2,0,"D"
"17654",1991-07-27,1991,"Olympique Lyon","Olympique Marseille","1-1",1,1,"1",1,2,0,"D"
"17655",1991-07-27,1991,"Lille OSC","Le Havre AC","0-0",0,0,"1",1,0,0,"D"
"17656",1991-07-27,1991,"SM Caen","AS Saint-Etienne","1-0",1,0,"1",1,1,1,"H"
"17657",1991-07-27,1991,"Nimes Olympique","Toulouse FC","2-2",2,2,"1",1,4,0,"D"
"17658",1991-07-27,1991,"Sporting Toulon Var","RC Lens","0-1",0,1,"1",1,1,-1,"D"
"17659",1991-07-31,1991,"AS Monaco","Stade Rennes","3-1",3,1,"1",1,4,2,"H"
"17660",1991-07-31,1991,"Olympique Marseille","FC Metz","2-0",2,0,"1",1,2,2,"H"
"17661",1991-07-31,1991,"Le Havre AC","AS Cannes","1-0",1,0,"1",1,1,1,"H"
"17662",1991-07-31,1991,"AS Saint-Etienne","Nimes Olympique","3-0",3,0,"1",1,3,3,"H"
"17663",1991-07-31,1991,"Toulouse FC","FC Sochaux","2-1",2,1,"1",1,3,1,"H"
"17664",1991-07-31,1991,"RC Lens","SM Caen","0-0",0,0,"1",1,0,0,"D"
"17665",1991-07-31,1991,"FC Nantes","Lille OSC","1-2",1,2,"1",1,3,-1,"D"
"17666",1991-07-31,1991,"Montpellier HSC","Paris Saint-Germain","1-1",1,1,"1",1,2,0,"D"
"17667",1991-07-31,1991,"AS Nancy","Olympique Lyon","0-0",0,0,"1",1,0,0,"D"
"17668",1991-07-31,1991,"AJ Auxerre","Sporting Toulon Var","1-0",1,0,"1",1,1,1,"H"
"17669",1991-08-03,1991,"Stade Rennes","Olympique Marseille","1-2",1,2,"1",1,3,-1,"D"
"17670",1991-08-03,1991,"FC Metz","Toulouse FC","4-0",4,0,"1",1,4,4,"H"
"17671",1991-08-03,1991,"Paris Saint-Germain","Le Havre AC","1-1",1,1,"1",1,2,0,"D"
"17672",1991-08-03,1991,"SM Caen","AJ Auxerre","1-0",1,0,"1",1,1,1,"H"
"17673",1991-08-03,1991,"Lille OSC","AS Nancy","2-1",2,1,"1",1,3,1,"H"
"17674",1991-08-03,1991,"Nimes Olympique","RC Lens","0-2",0,2,"1",1,2,-2,"D"
"17675",1991-08-03,1991,"FC Sochaux","AS Saint-Etienne","1-0",1,0,"1",1,1,1,"H"
"17676",1991-08-03,1991,"Olympique Lyon","Montpellier HSC","1-0",1,0,"1",1,1,1,"H"
"17677",1991-08-03,1991,"Sporting Toulon Var","FC Nantes","0-2",0,2,"1",1,2,-2,"D"
"17678",1991-08-04,1991,"AS Cannes","AS Monaco","1-2",1,2,"1",1,3,-1,"D"
"17679",1991-08-09,1991,"Olympique Marseille","Paris Saint-Germain","0-0",0,0,"1",1,0,0,"D"
"17680",1991-08-10,1991,"AS Monaco","Olympique Lyon","1-0",1,0,"1",1,1,1,"H"
"17681",1991-08-10,1991,"AS Nancy","FC Metz","1-3",1,3,"1",1,4,-2,"D"
"17682",1991-08-10,1991,"FC Nantes","SM Caen","2-1",2,1,"1",1,3,1,"H"
"17683",1991-08-10,1991,"Le Havre AC","Stade Rennes","0-0",0,0,"1",1,0,0,"D"
"17684",1991-08-10,1991,"AS Saint-Etienne","Toulouse FC","2-1",2,1,"1",1,3,1,"H"
"17685",1991-08-10,1991,"AJ Auxerre","Nimes Olympique","0-0",0,0,"1",1,0,0,"D"
"17686",1991-08-10,1991,"AS Cannes","Lille OSC","1-1",1,1,"1",1,2,0,"D"
"17687",1991-08-10,1991,"RC Lens","FC Sochaux","1-1",1,1,"1",1,2,0,"D"
"17688",1991-08-10,1991,"Montpellier HSC","Sporting Toulon Var","1-0",1,0,"1",1,1,1,"H"
"17689",1991-08-17,1991,"FC Metz","AS Saint-Etienne","1-0",1,0,"1",1,1,1,"H"
"17690",1991-08-17,1991,"Paris Saint-Germain","AS Monaco","2-0",2,0,"1",1,2,2,"H"
"17691",1991-08-17,1991,"Nimes Olympique","FC Nantes","0-0",0,0,"1",1,0,0,"D"
"17692",1991-08-17,1991,"Lille OSC","Montpellier HSC","1-0",1,0,"1",1,1,1,"H"
"17693",1991-08-17,1991,"Toulouse FC","RC Lens","1-1",1,1,"1",1,2,0,"D"
"17694",1991-08-17,1991,"FC Sochaux","AJ Auxerre","1-0",1,0,"1",1,1,1,"H"
"17695",1991-08-17,1991,"Olympique Lyon","AS Cannes","0-0",0,0,"1",1,0,0,"D"
"17696",1991-08-17,1991,"Stade Rennes","AS Nancy","3-1",3,1,"1",1,4,2,"H"
"17697",1991-08-17,1991,"Sporting Toulon Var","Le Havre AC","4-0",4,0,"1",1,4,4,"H"
"17698",1991-08-18,1991,"SM Caen","Olympique Marseille","1-3",1,3,"1",1,4,-2,"D"
"17699",1991-08-23,1991,"RC Lens","AS Saint-Etienne","1-1",1,1,"1",1,2,0,"D"
"17700",1991-08-24,1991,"AS Monaco","Lille OSC","1-0",1,0,"1",1,1,1,"H"
"17701",1991-08-24,1991,"Olympique Marseille","Nimes Olympique","4-2",4,2,"1",1,6,2,"H"
"17702",1991-08-24,1991,"FC Nantes","FC Metz","4-1",4,1,"1",1,5,3,"H"
"17703",1991-08-24,1991,"Le Havre AC","FC Sochaux","1-0",1,0,"1",1,1,1,"H"
"17704",1991-08-24,1991,"AJ Auxerre","Toulouse FC","3-0",3,0,"1",1,3,3,"H"
"17705",1991-08-24,1991,"AS Cannes","Paris Saint-Germain","1-1",1,1,"1",1,2,0,"D"
"17706",1991-08-24,1991,"Olympique Lyon","SM Caen","2-2",2,2,"1",1,4,0,"D"
"17707",1991-08-24,1991,"Montpellier HSC","Stade Rennes","0-0",0,0,"1",1,0,0,"D"
"17708",1991-08-24,1991,"AS Nancy","Sporting Toulon Var","0-0",0,0,"1",1,0,0,"D"
"17709",1991-08-28,1991,"FC Sochaux","AS Monaco","1-3",1,3,"1",1,4,-2,"D"
"17710",1991-08-28,1991,"Toulouse FC","FC Nantes","2-1",2,1,"1",1,3,1,"H"
"17711",1991-08-28,1991,"Paris Saint-Germain","AS Nancy","1-0",1,0,"1",1,1,1,"H"
"17712",1991-08-28,1991,"Lille OSC","Olympique Lyon","1-0",1,0,"1",1,1,1,"H"
"17713",1991-08-28,1991,"AS Saint-Etienne","AJ Auxerre","1-1",1,1,"1",1,2,0,"D"
"17714",1991-08-28,1991,"Stade Rennes","RC Lens","0-0",0,0,"1",1,0,0,"D"
"17715",1991-08-28,1991,"SM Caen","Le Havre AC","2-1",2,1,"1",1,3,1,"H"
"17716",1991-08-28,1991,"Nimes Olympique","AS Cannes","2-1",2,1,"1",1,3,1,"H"
"17717",1991-08-28,1991,"Sporting Toulon Var","Olympique Marseille","1-0",1,0,"1",1,1,1,"H"
"17718",1991-08-29,1991,"FC Metz","Montpellier HSC","1-3",1,3,"1",1,4,-2,"D"
"17719",1991-09-07,1991,"FC Nantes","AS Saint-Etienne","1-0",1,0,"1",1,1,1,"H"
"17720",1991-09-07,1991,"Olympique Lyon","Paris Saint-Germain","0-1",0,1,"1",1,1,-1,"D"
"17721",1991-09-07,1991,"AJ Auxerre","RC Lens","1-0",1,0,"1",1,1,1,"H"
"17722",1991-09-07,1991,"Le Havre AC","FC Metz","0-0",0,0,"1",1,0,0,"D"
"17723",1991-09-07,1991,"Lille OSC","FC Sochaux","0-0",0,0,"1",1,0,0,"D"
"17724",1991-09-07,1991,"Montpellier HSC","SM Caen","3-1",3,1,"1",1,4,2,"H"
"17725",1991-09-07,1991,"AS Nancy","Nimes Olympique","2-3",2,3,"1",1,5,-1,"D"
"17726",1991-09-07,1991,"AS Cannes","Stade Rennes","3-1",3,1,"1",1,4,2,"H"
"17727",1991-09-07,1991,"AS Monaco","Sporting Toulon Var","3-0",3,0,"1",1,3,3,"H"
"17728",1991-09-08,1991,"Olympique Marseille","Toulouse FC","2-0",2,0,"1",1,2,2,"H"
"17729",1991-09-12,1991,"AS Saint-Etienne","AS Monaco","0-1",0,1,"1",1,1,-1,"D"
"17730",1991-09-12,1991,"FC Metz","AJ Auxerre","2-1",2,1,"1",1,3,1,"H"
"17731",1991-09-13,1991,"Paris Saint-Germain","Lille OSC","2-0",2,0,"1",1,2,2,"H"
"17732",1991-09-14,1991,"FC Sochaux","Olympique Marseille","2-3",2,3,"1",1,5,-1,"D"
"17733",1991-09-14,1991,"RC Lens","FC Nantes","0-0",0,0,"1",1,0,0,"D"
"17734",1991-09-14,1991,"SM Caen","AS Nancy","5-1",5,1,"1",1,6,4,"H"
"17735",1991-09-14,1991,"Nimes Olympique","Le Havre AC","1-0",1,0,"1",1,1,1,"H"
"17736",1991-09-14,1991,"Toulouse FC","Montpellier HSC","1-1",1,1,"1",1,2,0,"D"
"17737",1991-09-14,1991,"Stade Rennes","Olympique Lyon","0-2",0,2,"1",1,2,-2,"D"
"17738",1991-09-14,1991,"Sporting Toulon Var","AS Cannes","4-3",4,3,"1",1,7,1,"H"
"17739",1991-09-21,1991,"AS Monaco","Nimes Olympique","1-1",1,1,"1",1,2,0,"D"
"17740",1991-09-21,1991,"Olympique Marseille","RC Lens","1-1",1,1,"1",1,2,0,"D"
"17741",1991-09-21,1991,"Paris Saint-Germain","FC Metz","3-0",3,0,"1",1,3,3,"H"
"17742",1991-09-21,1991,"FC Nantes","AJ Auxerre","2-0",2,0,"1",1,2,2,"H"
"17743",1991-09-21,1991,"Lille OSC","Stade Rennes","1-1",1,1,"1",1,2,0,"D"
"17744",1991-09-21,1991,"Le Havre AC","AS Saint-Etienne","2-1",2,1,"1",1,3,1,"H"
"17745",1991-09-21,1991,"Montpellier HSC","FC Sochaux","3-2",3,2,"1",1,5,1,"H"
"17746",1991-09-21,1991,"AS Nancy","Toulouse FC","1-1",1,1,"1",1,2,0,"D"
"17747",1991-09-21,1991,"Olympique Lyon","Sporting Toulon Var","1-1",1,1,"1",1,2,0,"D"
"17748",1991-09-22,1991,"AS Cannes","SM Caen","2-0",2,0,"1",1,2,2,"H"
"17749",1991-09-26,1991,"SM Caen","AS Monaco","1-0",1,0,"1",1,1,1,"H"
"17750",1991-09-27,1991,"AJ Auxerre","Olympique Marseille","1-1",1,1,"1",1,2,0,"D"
"17751",1991-09-28,1991,"Stade Rennes","Paris Saint-Germain","0-0",0,0,"1",1,0,0,"D"
"17752",1991-09-28,1991,"FC Sochaux","FC Nantes","3-1",3,1,"1",1,4,2,"H"
"17753",1991-09-28,1991,"FC Metz","AS Cannes","1-2",1,2,"1",1,3,-1,"D"
"17754",1991-09-28,1991,"Toulouse FC","Le Havre AC","0-0",0,0,"1",1,0,0,"D"
"17755",1991-09-28,1991,"Nimes Olympique","Olympique Lyon","2-1",2,1,"1",1,3,1,"H"
"17756",1991-09-28,1991,"RC Lens","Montpellier HSC","1-1",1,1,"1",1,2,0,"D"
"17757",1991-09-28,1991,"AS Saint-Etienne","AS Nancy","3-0",3,0,"1",1,3,3,"H"
"17758",1991-09-28,1991,"Sporting Toulon Var","Lille OSC","1-2",1,2,"1",1,3,-1,"D"
"17759",1991-10-05,1991,"Olympique Marseille","FC Nantes","4-0",4,0,"1",1,4,4,"H"
"17760",1991-10-05,1991,"AS Monaco","Toulouse FC","0-2",0,2,"1",1,2,-2,"D"
"17761",1991-10-05,1991,"Lille OSC","FC Metz","0-2",0,2,"1",1,2,-2,"D"
"17762",1991-10-05,1991,"Le Havre AC","AJ Auxerre","1-0",1,0,"1",1,1,1,"H"
"17763",1991-10-05,1991,"Montpellier HSC","Nimes Olympique","0-0",0,0,"1",1,0,0,"D"
"17764",1991-10-05,1991,"Stade Rennes","SM Caen","1-0",1,0,"1",1,1,1,"H"
"17765",1991-10-05,1991,"AS Nancy","RC Lens","3-1",3,1,"1",1,4,2,"H"
"17766",1991-10-05,1991,"Paris Saint-Germain","Sporting Toulon Var","2-3",2,3,"1",1,5,-1,"D"
"17767",1991-10-06,1991,"Olympique Lyon","AS Saint-Etienne","0-0",0,0,"1",1,0,0,"D"
"17768",1991-10-06,1991,"AS Cannes","FC Sochaux","2-1",2,1,"1",1,3,1,"H"
"17769",1991-10-17,1991,"FC Metz","AS Monaco","2-0",2,0,"1",1,2,2,"H"
"17770",1991-10-17,1991,"Toulouse FC","AS Cannes","2-0",2,0,"1",1,2,2,"H"
"17771",1991-10-18,1991,"FC Sochaux","Olympique Lyon","1-0",1,0,"1",1,1,1,"H"
"17772",1991-10-18,1991,"AJ Auxerre","AS Nancy","3-1",3,1,"1",1,4,2,"H"
"17773",1991-10-19,1991,"SM Caen","Paris Saint-Germain","2-0",2,0,"1",1,2,2,"H"
"17774",1991-10-19,1991,"FC Nantes","Montpellier HSC","0-0",0,0,"1",1,0,0,"D"
"17775",1991-10-19,1991,"RC Lens","Le Havre AC","0-0",0,0,"1",1,0,0,"D"
"17776",1991-10-19,1991,"Nimes Olympique","Lille OSC","1-0",1,0,"1",1,1,1,"H"
"17777",1991-10-20,1991,"Sporting Toulon Var","Stade Rennes","1-0",1,0,"1",1,1,1,"H"
"17778",1991-10-26,1991,"Le Havre AC","Olympique Marseille","0-2",0,2,"1",1,2,-2,"D"
"17779",1991-10-26,1991,"AS Monaco","RC Lens","0-0",0,0,"1",1,0,0,"D"
"17780",1991-10-26,1991,"Paris Saint-Germain","Nimes Olympique","2-0",2,0,"1",1,2,2,"H"
"17781",1991-10-26,1991,"Stade Rennes","FC Metz","3-1",3,1,"1",1,4,2,"H"
"17782",1991-10-26,1991,"Lille OSC","SM Caen","1-2",1,2,"1",1,3,-1,"D"
"17783",1991-10-26,1991,"AS Nancy","FC Nantes","3-1",3,1,"1",1,4,2,"H"
"17784",1991-10-26,1991,"Montpellier HSC","AJ Auxerre","1-1",1,1,"1",1,2,0,"D"
"17785",1991-10-26,1991,"Olympique Lyon","Toulouse FC","1-0",1,0,"1",1,1,1,"H"
"17786",1991-10-26,1991,"AS Cannes","AS Saint-Etienne","0-2",0,2,"1",1,2,-2,"D"
"17787",1991-10-26,1991,"Sporting Toulon Var","FC Sochaux","2-0",2,0,"1",1,2,2,"H"
"17788",1991-10-31,1991,"AJ Auxerre","AS Monaco","1-1",1,1,"1",1,2,0,"D"
"17789",1991-11-01,1991,"Olympique Marseille","AS Nancy","4-0",4,0,"1",1,4,4,"H"
"17790",1991-11-01,1991,"FC Metz","Olympique Lyon","1-1",1,1,"1",1,2,0,"D"
"17791",1991-11-01,1991,"AS Saint-Etienne","Montpellier HSC","1-1",1,1,"1",1,2,0,"D"
"17792",1991-11-01,1991,"RC Lens","AS Cannes","1-1",1,1,"1",1,2,0,"D"
"17793",1991-11-02,1991,"FC Sochaux","Paris Saint-Germain","0-2",0,2,"1",1,2,-2,"D"
"17794",1991-11-02,1991,"FC Nantes","Le Havre AC","0-0",0,0,"1",1,0,0,"D"
"17795",1991-11-02,1991,"Toulouse FC","Lille OSC","1-0",1,0,"1",1,1,1,"H"
"17796",1991-11-02,1991,"Nimes Olympique","Stade Rennes","1-2",1,2,"1",1,3,-1,"D"
"17797",1991-11-02,1991,"SM Caen","Sporting Toulon Var","4-1",4,1,"1",1,5,3,"H"
"17798",1991-11-09,1991,"Montpellier HSC","Olympique Marseille","0-0",0,0,"1",1,0,0,"D"
"17799",1991-11-09,1991,"AS Monaco","FC Nantes","1-0",1,0,"1",1,1,1,"H"
"17800",1991-11-09,1991,"Paris Saint-Germain","Toulouse FC","0-0",0,0,"1",1,0,0,"D"
"17801",1991-11-09,1991,"SM Caen","FC Metz","1-0",1,0,"1",1,1,1,"H"
"17802",1991-11-09,1991,"AS Nancy","Le Havre AC","1-3",1,3,"1",1,4,-2,"D"
"17803",1991-11-09,1991,"AS Cannes","AJ Auxerre","1-1",1,1,"1",1,2,0,"D"
"17804",1991-11-09,1991,"Lille OSC","AS Saint-Etienne","2-0",2,0,"1",1,2,2,"H"
"17805",1991-11-09,1991,"Olympique Lyon","RC Lens","1-1",1,1,"1",1,2,0,"D"
"17806",1991-11-09,1991,"Stade Rennes","FC Sochaux","2-0",2,0,"1",1,2,2,"H"
"17807",1991-11-09,1991,"Sporting Toulon Var","Nimes Olympique","5-0",5,0,"1",1,5,5,"H"
"17808",1991-11-14,1991,"Olympique Marseille","AS Monaco","1-1",1,1,"1",1,2,0,"D"
"17809",1991-11-16,1991,"Nimes Olympique","SM Caen","0-1",0,1,"1",1,1,-1,"D"
"17810",1991-11-16,1991,"AS Saint-Etienne","Paris Saint-Germain","3-0",3,0,"1",1,3,3,"H"
"17811",1991-11-16,1991,"Le Havre AC","Montpellier HSC","3-1",3,1,"1",1,4,2,"H"
"17812",1991-11-16,1991,"AJ Auxerre","Olympique Lyon","3-0",3,0,"1",1,3,3,"H"
"17813",1991-11-16,1991,"FC Nantes","AS Cannes","1-0",1,0,"1",1,1,1,"H"
"17814",1991-11-16,1991,"Toulouse FC","Stade Rennes","2-0",2,0,"1",1,2,2,"H"
"17815",1991-11-16,1991,"RC Lens","Lille OSC","0-0",0,0,"1",1,0,0,"D"
"17816",1991-11-16,1991,"FC Sochaux","AS Nancy","2-2",2,2,"1",1,4,0,"D"
"17817",1991-11-16,1991,"FC Metz","Sporting Toulon Var","4-1",4,1,"1",1,5,3,"H"
"17818",1991-11-23,1991,"AS Cannes","Olympique Marseille","1-2",1,2,"1",1,3,-1,"D"
"17819",1991-11-23,1991,"AS Monaco","Le Havre AC","0-2",0,2,"1",1,2,-2,"D"
"17820",1991-11-23,1991,"SM Caen","FC Sochaux","1-1",1,1,"1",1,2,0,"D"
"17821",1991-11-23,1991,"Paris Saint-Germain","RC Lens","1-0",1,0,"1",1,1,1,"H"
"17822",1991-11-23,1991,"FC Metz","Nimes Olympique","4-0",4,0,"1",1,4,4,"H"
"17823",1991-11-23,1991,"Olympique Lyon","FC Nantes","0-1",0,1,"1",1,1,-1,"D"
"17824",1991-11-23,1991,"Lille OSC","AJ Auxerre","1-0",1,0,"1",1,1,1,"H"
"17825",1991-11-23,1991,"Montpellier HSC","AS Nancy","2-0",2,0,"1",1,2,2,"H"
"17826",1991-11-23,1991,"Stade Rennes","AS Saint-Etienne","0-0",0,0,"1",1,0,0,"D"
"17827",1991-11-23,1991,"Sporting Toulon Var","Toulouse FC","1-0",1,0,"1",1,1,1,"H"
"17828",1991-11-29,1991,"FC Nantes","Stade Rennes","1-0",1,0,"1",1,1,1,"H"
"17829",1991-11-30,1991,"Olympique Marseille","Olympique Lyon","0-0",0,0,"1",1,0,0,"D"
"17830",1991-11-30,1991,"AS Nancy","AS Monaco","1-4",1,4,"1",1,5,-3,"D"
"17831",1991-11-30,1991,"AJ Auxerre","Paris Saint-Germain","2-2",2,2,"1",1,4,0,"D"
"17832",1991-11-30,1991,"Le Havre AC","Lille OSC","0-0",0,0,"1",1,0,0,"D"
"17833",1991-11-30,1991,"FC Sochaux","FC Metz","0-0",0,0,"1",1,0,0,"D"
"17834",1991-11-30,1991,"Montpellier HSC","AS Cannes","3-0",3,0,"1",1,3,3,"H"
"17835",1991-11-30,1991,"Toulouse FC","Nimes Olympique","0-1",0,1,"1",1,1,-1,"D"
"17836",1991-11-30,1991,"RC Lens","Sporting Toulon Var","2-1",2,1,"1",1,3,1,"H"
"17837",1991-12-01,1991,"AS Saint-Etienne","SM Caen","1-1",1,1,"1",1,2,0,"D"
"17838",1991-12-06,1991,"SM Caen","RC Lens","2-0",2,0,"1",1,2,2,"H"
"17839",1991-12-07,1991,"FC Metz","Olympique Marseille","0-0",0,0,"1",1,0,0,"D"
"17840",1991-12-07,1991,"Stade Rennes","AS Monaco","0-0",0,0,"1",1,0,0,"D"
"17841",1991-12-07,1991,"Paris Saint-Germain","Montpellier HSC","1-1",1,1,"1",1,2,0,"D"
"17842",1991-12-07,1991,"AS Cannes","Le Havre AC","0-0",0,0,"1",1,0,0,"D"
"17843",1991-12-07,1991,"Lille OSC","FC Nantes","0-0",0,0,"1",1,0,0,"D"
"17844",1991-12-07,1991,"FC Sochaux","Toulouse FC","0-0",0,0,"1",1,0,0,"D"
"17845",1991-12-07,1991,"Nimes Olympique","AS Saint-Etienne","1-1",1,1,"1",1,2,0,"D"
"17846",1991-12-07,1991,"Olympique Lyon","AS Nancy","2-1",2,1,"1",1,3,1,"H"
"17847",1991-12-07,1991,"Sporting Toulon Var","AJ Auxerre","0-3",0,3,"1",1,3,-3,"D"
"17848",1991-12-14,1991,"Olympique Marseille","Stade Rennes","5-1",5,1,"1",1,6,4,"H"
"17849",1991-12-14,1991,"AS Monaco","AS Cannes","3-1",3,1,"1",1,4,2,"H"
"17850",1991-12-14,1991,"Le Havre AC","Paris Saint-Germain","1-1",1,1,"1",1,2,0,"D"
"17851",1991-12-14,1991,"AJ Auxerre","SM Caen","5-1",5,1,"1",1,6,4,"H"
"17852",1991-12-14,1991,"Toulouse FC","FC Metz","1-0",1,0,"1",1,1,1,"H"
"17853",1991-12-14,1991,"Montpellier HSC","Olympique Lyon","3-0",3,0,"1",1,3,3,"H"
"17854",1991-12-14,1991,"AS Nancy","Lille OSC","1-2",1,2,"1",1,3,-1,"D"
"17855",1991-12-14,1991,"AS Saint-Etienne","FC Sochaux","2-1",2,1,"1",1,3,1,"H"
"17856",1991-12-14,1991,"RC Lens","Nimes Olympique","0-0",0,0,"1",1,0,0,"D"
"17857",1991-12-14,1991,"FC Nantes","Sporting Toulon Var","1-2",1,2,"1",1,3,-1,"D"
"17858",1991-12-17,1991,"Paris Saint-Germain","Olympique Marseille","0-0",0,0,"1",1,0,0,"D"
"17859",1991-12-18,1991,"Olympique Lyon","AS Monaco","2-0",2,0,"1",1,2,2,"H"
"17860",1991-12-18,1991,"SM Caen","FC Nantes","1-1",1,1,"1",1,2,0,"D"
"17861",1991-12-18,1991,"Stade Rennes","Le Havre AC","0-2",0,2,"1",1,2,-2,"D"
"17862",1991-12-18,1991,"Nimes Olympique","AJ Auxerre","0-0",0,0,"1",1,0,0,"D"
"17863",1991-12-18,1991,"Lille OSC","AS Cannes","0-0",0,0,"1",1,0,0,"D"
"17864",1991-12-18,1991,"Toulouse FC","AS Saint-Etienne","1-1",1,1,"1",1,2,0,"D"
"17865",1991-12-18,1991,"FC Sochaux","RC Lens","1-2",1,2,"1",1,3,-1,"D"
"17866",1991-12-18,1991,"Sporting Toulon Var","Montpellier HSC","0-1",0,1,"1",1,1,-1,"D"
"17867",1991-12-21,1991,"Olympique Marseille","SM Caen","5-0",5,0,"1",1,5,5,"H"
"17868",1991-12-21,1991,"AS Monaco","Paris Saint-Germain","1-0",1,0,"1",1,1,1,"H"
"17869",1991-12-21,1991,"AJ Auxerre","FC Sochaux","4-0",4,0,"1",1,4,4,"H"
"17870",1991-12-21,1991,"Montpellier HSC","Lille OSC","0-0",0,0,"1",1,0,0,"D"
"17871",1991-12-21,1991,"FC Nantes","Nimes Olympique","3-2",3,2,"1",1,5,1,"H"
"17872",1991-12-21,1991,"AS Saint-Etienne","FC Metz","2-0",2,0,"1",1,2,2,"H"
"17873",1991-12-21,1991,"RC Lens","Toulouse FC","4-0",4,0,"1",1,4,4,"H"
"17874",1991-12-21,1991,"AS Cannes","Olympique Lyon","0-0",0,0,"1",1,0,0,"D"
"17875",1991-12-21,1991,"AS Nancy","Stade Rennes","1-1",1,1,"1",1,2,0,"D"
"17876",1991-12-21,1991,"Le Havre AC","Sporting Toulon Var","3-0",3,0,"1",1,3,3,"H"
"17877",1992-01-18,1991,"Lille OSC","AS Monaco","1-2",1,2,"1",1,3,-1,"D"
"17878",1992-01-18,1991,"Paris Saint-Germain","AS Cannes","3-2",3,2,"1",1,5,1,"H"
"17879",1992-01-18,1991,"SM Caen","Olympique Lyon","1-0",1,0,"1",1,1,1,"H"
"17880",1992-01-18,1991,"Toulouse FC","AJ Auxerre","2-3",2,3,"1",1,5,-1,"D"
"17881",1992-01-18,1991,"Stade Rennes","Montpellier HSC","0-2",0,2,"1",1,2,-2,"D"
"17882",1992-01-18,1991,"FC Metz","FC Nantes","1-1",1,1,"1",1,2,0,"D"
"17883",1992-01-18,1991,"Sporting Toulon Var","AS Nancy","4-2",4,2,"1",1,6,2,"H"
"17884",1992-01-19,1991,"AS Saint-Etienne","RC Lens","0-4",0,4,"1",1,4,-4,"D"
"17885",1992-01-19,1991,"Nimes Olympique","Olympique Marseille","1-2",1,2,"1",1,3,-1,"D"
"17886",1992-01-19,1991,"FC Sochaux","Le Havre AC","0-0",0,0,"1",1,0,0,"D"
"17887",1992-01-24,1991,"Le Havre AC","SM Caen","0-1",0,1,"1",1,1,-1,"D"
"17888",1992-01-25,1991,"AS Monaco","FC Sochaux","2-0",2,0,"1",1,2,2,"H"
"17889",1992-01-25,1991,"AJ Auxerre","AS Saint-Etienne","2-0",2,0,"1",1,2,2,"H"
"17890",1992-01-25,1991,"Montpellier HSC","FC Metz","1-0",1,0,"1",1,1,1,"H"
"17891",1992-01-25,1991,"AS Nancy","Paris Saint-Germain","0-0",0,0,"1",1,0,0,"D"
"17892",1992-01-25,1991,"FC Nantes","Toulouse FC","1-1",1,1,"1",1,2,0,"D"
"17893",1992-01-25,1991,"RC Lens","Stade Rennes","0-0",0,0,"1",1,0,0,"D"
"17894",1992-01-25,1991,"Olympique Lyon","Lille OSC","1-0",1,0,"1",1,1,1,"H"
"17895",1992-01-25,1991,"AS Cannes","Nimes Olympique","0-0",0,0,"1",1,0,0,"D"
"17896",1992-01-26,1991,"Olympique Marseille","Sporting Toulon Var","0-1",0,1,"1",1,1,-1,"D"
"17897",1992-01-29,1991,"AS Saint-Etienne","Olympique Marseille","1-1",1,1,"1",1,2,0,"D"
"17898",1992-02-01,1991,"Toulouse FC","Olympique Marseille","0-2",0,2,"1",1,2,-2,"D"
"17899",1992-02-01,1991,"Paris Saint-Germain","Olympique Lyon","3-0",3,0,"1",1,3,3,"H"
"17900",1992-02-01,1991,"SM Caen","Montpellier HSC","0-0",0,0,"1",1,0,0,"D"
"17901",1992-02-01,1991,"RC Lens","AJ Auxerre","0-0",0,0,"1",1,0,0,"D"
"17902",1992-02-01,1991,"FC Metz","Le Havre AC","1-1",1,1,"1",1,2,0,"D"
"17903",1992-02-01,1991,"Stade Rennes","AS Cannes","0-0",0,0,"1",1,0,0,"D"
"17904",1992-02-01,1991,"Sporting Toulon Var","AS Monaco","1-1",1,1,"1",1,2,0,"D"
"17905",1992-02-02,1991,"Nimes Olympique","AS Nancy","1-2",1,2,"1",1,3,-1,"D"
"17906",1992-02-02,1991,"FC Sochaux","Lille OSC","2-1",2,1,"1",1,3,1,"H"
"17907",1992-02-07,1991,"AJ Auxerre","FC Metz","3-0",3,0,"1",1,3,3,"H"
"17908",1992-02-08,1991,"AS Monaco","AS Saint-Etienne","2-0",2,0,"1",1,2,2,"H"
"17909",1992-02-08,1991,"Lille OSC","Paris Saint-Germain","0-0",0,0,"1",1,0,0,"D"
"17910",1992-02-08,1991,"Montpellier HSC","Toulouse FC","0-0",0,0,"1",1,0,0,"D"
"17911",1992-02-08,1991,"Le Havre AC","Nimes Olympique","1-1",1,1,"1",1,2,0,"D"
"17912",1992-02-08,1991,"AS Nancy","SM Caen","3-0",3,0,"1",1,3,3,"H"
"17913",1992-02-08,1991,"FC Nantes","RC Lens","1-0",1,0,"1",1,1,1,"H"
"17914",1992-02-08,1991,"Olympique Lyon","Stade Rennes","3-1",3,1,"1",1,4,2,"H"
"17915",1992-02-08,1991,"AS Cannes","Sporting Toulon Var","0-1",0,1,"1",1,1,-1,"D"
"17916",1992-02-09,1991,"Olympique Marseille","FC Sochaux","2-2",2,2,"1",1,4,0,"D"
"17917",1992-02-14,1991,"Nimes Olympique","AS Monaco","0-1",0,1,"1",1,1,-1,"D"
"17918",1992-02-15,1991,"RC Lens","Olympique Marseille","2-1",2,1,"1",1,3,1,"H"
"17919",1992-02-15,1991,"AJ Auxerre","FC Nantes","2-2",2,2,"1",1,4,0,"D"
"17920",1992-02-15,1991,"SM Caen","AS Cannes","3-1",3,1,"1",1,4,2,"H"
"17921",1992-02-15,1991,"Stade Rennes","Lille OSC","2-3",2,3,"1",1,5,-1,"D"
"17922",1992-02-15,1991,"Toulouse FC","AS Nancy","1-0",1,0,"1",1,1,1,"H"
"17923",1992-02-15,1991,"Sporting Toulon Var","Olympique Lyon","1-0",1,0,"1",1,1,1,"H"
"17924",1992-02-16,1991,"FC Metz","Paris Saint-Germain","0-0",0,0,"1",1,0,0,"D"
"17925",1992-02-16,1991,"FC Sochaux","Montpellier HSC","1-1",1,1,"1",1,2,0,"D"
"17926",1992-02-16,1991,"AS Saint-Etienne","Le Havre AC","4-0",4,0,"1",1,4,4,"H"
"17927",1992-02-28,1991,"AS Monaco","SM Caen","2-1",2,1,"1",1,3,1,"H"
"17928",1992-02-29,1991,"Olympique Marseille","AJ Auxerre","2-0",2,0,"1",1,2,2,"H"
"17929",1992-02-29,1991,"Paris Saint-Germain","Stade Rennes","1-0",1,0,"1",1,1,1,"H"
"17930",1992-02-29,1991,"Montpellier HSC","RC Lens","0-0",0,0,"1",1,0,0,"D"
"17931",1992-02-29,1991,"Le Havre AC","Toulouse FC","1-1",1,1,"1",1,2,0,"D"
"17932",1992-02-29,1991,"FC Nantes","FC Sochaux","0-0",0,0,"1",1,0,0,"D"
"17933",1992-02-29,1991,"AS Nancy","AS Saint-Etienne","0-2",0,2,"1",1,2,-2,"D"
"17934",1992-02-29,1991,"AS Cannes","FC Metz","1-1",1,1,"1",1,2,0,"D"
"17935",1992-02-29,1991,"Olympique Lyon","Nimes Olympique","1-0",1,0,"1",1,1,1,"H"
"17936",1992-02-29,1991,"Lille OSC","Sporting Toulon Var","1-0",1,0,"1",1,1,1,"H"
"17937",1992-03-03,1991,"FC Metz","AS Nancy","0-1",0,1,"1",1,1,-1,"D"
"17938",1992-03-06,1991,"Sporting Toulon Var","Paris Saint-Germain","2-5",2,5,"1",1,7,-3,"D"
"17939",1992-03-07,1991,"FC Nantes","Olympique Marseille","0-1",0,1,"1",1,1,-1,"D"
"17940",1992-03-07,1991,"Toulouse FC","AS Monaco","0-0",0,0,"1",1,0,0,"D"
"17941",1992-03-07,1991,"AJ Auxerre","Le Havre AC","3-0",3,0,"1",1,3,3,"H"
"17942",1992-03-07,1991,"SM Caen","Stade Rennes","0-0",0,0,"1",1,0,0,"D"
"17943",1992-03-07,1991,"Nimes Olympique","Montpellier HSC","2-1",2,1,"1",1,3,1,"H"
"17944",1992-03-07,1991,"RC Lens","AS Nancy","1-0",1,0,"1",1,1,1,"H"
"17945",1992-03-07,1991,"FC Metz","Lille OSC","1-0",1,0,"1",1,1,1,"H"
"17946",1992-03-07,1991,"AS Saint-Etienne","Olympique Lyon","1-2",1,2,"1",1,3,-1,"D"
"17947",1992-03-07,1991,"FC Sochaux","AS Cannes","1-0",1,0,"1",1,1,1,"H"
"17948",1992-03-17,1991,"AS Saint-Etienne","FC Nantes","2-1",2,1,"1",1,3,1,"H"
"17949",1992-03-19,1991,"Paris Saint-Germain","SM Caen","3-1",3,1,"1",1,4,2,"H"
"17950",1992-03-20,1991,"Montpellier HSC","FC Nantes","2-1",2,1,"1",1,3,1,"H"
"17951",1992-03-21,1991,"Olympique Marseille","AS Saint-Etienne","2-0",2,0,"1",1,2,2,"H"
"17952",1992-03-21,1991,"AS Monaco","FC Metz","3-1",3,1,"1",1,4,2,"H"
"17953",1992-03-21,1991,"AS Nancy","AJ Auxerre","2-1",2,1,"1",1,3,1,"H"
"17954",1992-03-21,1991,"Le Havre AC","RC Lens","1-0",1,0,"1",1,1,1,"H"
"17955",1992-03-21,1991,"Lille OSC","Nimes Olympique","1-1",1,1,"1",1,2,0,"D"
"17956",1992-03-21,1991,"AS Cannes","Toulouse FC","2-0",2,0,"1",1,2,2,"H"
"17957",1992-03-21,1991,"Olympique Lyon","FC Sochaux","0-1",0,1,"1",1,1,-1,"D"
"17958",1992-03-21,1991,"Stade Rennes","Sporting Toulon Var","0-0",0,0,"1",1,0,0,"D"
"17959",1992-03-27,1991,"RC Lens","AS Monaco","0-1",0,1,"1",1,1,-1,"D"
"17960",1992-03-28,1991,"Olympique Marseille","Le Havre AC","2-0",2,0,"1",1,2,2,"H"
"17961",1992-03-28,1991,"Nimes Olympique","Paris Saint-Germain","0-1",0,1,"1",1,1,-1,"D"
"17962",1992-03-28,1991,"AJ Auxerre","Montpellier HSC","1-0",1,0,"1",1,1,1,"H"
"17963",1992-03-28,1991,"SM Caen","Lille OSC","3-3",3,3,"1",1,6,0,"D"
"17964",1992-03-28,1991,"FC Nantes","AS Nancy","0-0",0,0,"1",1,0,0,"D"
"17965",1992-03-28,1991,"AS Saint-Etienne","AS Cannes","2-0",2,0,"1",1,2,2,"H"
"17966",1992-03-28,1991,"FC Metz","Stade Rennes","0-0",0,0,"1",1,0,0,"D"
"17967",1992-03-28,1991,"Toulouse FC","Olympique Lyon","1-0",1,0,"1",1,1,1,"H"
"17968",1992-03-28,1991,"FC Sochaux","Sporting Toulon Var","2-0",2,0,"1",1,2,2,"H"
"17969",1992-04-03,1991,"AS Nancy","Olympique Marseille","1-3",1,3,"1",1,4,-2,"D"
"17970",1992-04-04,1991,"AS Monaco","AJ Auxerre","2-0",2,0,"1",1,2,2,"H"
"17971",1992-04-04,1991,"Paris Saint-Germain","FC Sochaux","2-0",2,0,"1",1,2,2,"H"
"17972",1992-04-04,1991,"Montpellier HSC","AS Saint-Etienne","2-0",2,0,"1",1,2,2,"H"
"17973",1992-04-04,1991,"Le Havre AC","FC Nantes","1-1",1,1,"1",1,2,0,"D"
"17974",1992-04-04,1991,"Lille OSC","Toulouse FC","3-1",3,1,"1",1,4,2,"H"
"17975",1992-04-04,1991,"AS Cannes","RC Lens","2-1",2,1,"1",1,3,1,"H"
"17976",1992-04-04,1991,"Olympique Lyon","FC Metz","0-0",0,0,"1",1,0,0,"D"
"17977",1992-04-04,1991,"Stade Rennes","Nimes Olympique","1-1",1,1,"1",1,2,0,"D"
"17978",1992-04-04,1991,"Sporting Toulon Var","SM Caen","0-0",0,0,"1",1,0,0,"D"
"17979",1992-04-10,1991,"FC Nantes","AS Monaco","1-4",1,4,"1",1,5,-3,"D"
"17980",1992-04-10,1991,"Toulouse FC","Paris Saint-Germain","3-0",3,0,"1",1,3,3,"H"
"17981",1992-04-11,1991,"Olympique Marseille","Montpellier HSC","0-0",0,0,"1",1,0,0,"D"
"17982",1992-04-11,1991,"AJ Auxerre","AS Cannes","3-1",3,1,"1",1,4,2,"H"
"17983",1992-04-11,1991,"FC Metz","SM Caen","1-2",1,2,"1",1,3,-1,"D"
"17984",1992-04-11,1991,"Le Havre AC","AS Nancy","1-2",1,2,"1",1,3,-1,"D"
"17985",1992-04-11,1991,"RC Lens","Olympique Lyon","4-2",4,2,"1",1,6,2,"H"
"17986",1992-04-11,1991,"AS Saint-Etienne","Lille OSC","1-1",1,1,"1",1,2,0,"D"
"17987",1992-04-11,1991,"FC Sochaux","Stade Rennes","0-0",0,0,"1",1,0,0,"D"
"17988",1992-04-11,1991,"Nimes Olympique","Sporting Toulon Var","1-0",1,0,"1",1,1,1,"H"
"17989",1992-04-18,1991,"AS Monaco","Olympique Marseille","0-3",0,3,"1",1,3,-3,"D"
"17990",1992-04-18,1991,"Paris Saint-Germain","AS Saint-Etienne","0-0",0,0,"1",1,0,0,"D"
"17991",1992-04-18,1991,"SM Caen","Nimes Olympique","2-0",2,0,"1",1,2,2,"H"
"17992",1992-04-18,1991,"Olympique Lyon","AJ Auxerre","1-0",1,0,"1",1,1,1,"H"
"17993",1992-04-18,1991,"Montpellier HSC","Le Havre AC","2-2",2,2,"1",1,4,0,"D"
"17994",1992-04-18,1991,"Lille OSC","RC Lens","1-2",1,2,"1",1,3,-1,"D"
"17995",1992-04-18,1991,"AS Cannes","FC Nantes","2-0",2,0,"1",1,2,2,"H"
"17996",1992-04-18,1991,"Stade Rennes","Toulouse FC","1-1",1,1,"1",1,2,0,"D"
"17997",1992-04-18,1991,"AS Nancy","FC Sochaux","3-1",3,1,"1",1,4,2,"H"
"17998",1992-04-18,1991,"Sporting Toulon Var","FC Metz","1-1",1,1,"1",1,2,0,"D"
"17999",1992-04-25,1991,"Olympique Marseille","AS Cannes","2-0",2,0,"1",1,2,2,"H"
"18000",1992-04-25,1991,"Le Havre AC","AS Monaco","3-0",3,0,"1",1,3,3,"H"
"18001",1992-04-25,1991,"RC Lens","Paris Saint-Germain","1-0",1,0,"1",1,1,1,"H"
"18002",1992-04-25,1991,"AJ Auxerre","Lille OSC","1-0",1,0,"1",1,1,1,"H"
"18003",1992-04-25,1991,"FC Sochaux","SM Caen","2-0",2,0,"1",1,2,2,"H"
"18004",1992-04-25,1991,"AS Nancy","Montpellier HSC","3-1",3,1,"1",1,4,2,"H"
"18005",1992-04-25,1991,"FC Nantes","Olympique Lyon","3-0",3,0,"1",1,3,3,"H"
"18006",1992-04-25,1991,"AS Saint-Etienne","Stade Rennes","0-1",0,1,"1",1,1,-1,"D"
"18007",1992-04-25,1991,"Nimes Olympique","FC Metz","1-0",1,0,"1",1,1,1,"H"
"18008",1992-04-25,1991,"Toulouse FC","Sporting Toulon Var","3-0",3,0,"1",1,3,3,"H"
"18009",1992-05-01,1991,"Lille OSC","Olympique Marseille","0-1",0,1,"1",1,1,-1,"D"
"18010",1992-05-01,1991,"AS Monaco","Montpellier HSC","1-1",1,1,"1",1,2,0,"D"
"18011",1992-05-01,1991,"Paris Saint-Germain","FC Nantes","1-1",1,1,"1",1,2,0,"D"
"18012",1992-05-01,1991,"Stade Rennes","AJ Auxerre","1-1",1,1,"1",1,2,0,"D"
"18013",1992-05-01,1991,"SM Caen","Toulouse FC","1-0",1,0,"1",1,1,1,"H"
"18014",1992-05-01,1991,"Olympique Lyon","Le Havre AC","0-2",0,2,"1",1,2,-2,"D"
"18015",1992-05-01,1991,"FC Metz","RC Lens","3-2",3,2,"1",1,5,1,"H"
"18016",1992-05-01,1991,"Nimes Olympique","FC Sochaux","2-2",2,2,"1",1,4,0,"D"
"18017",1992-05-01,1991,"AS Cannes","AS Nancy","1-1",1,1,"1",1,2,0,"D"
"18018",1992-05-01,1991,"Sporting Toulon Var","AS Saint-Etienne","1-2",1,2,"1",1,3,-1,"D"
"18019",1992-08-08,1992,"RC Lens","AJ Auxerre","0-3",0,3,"1",1,3,-3,"D"
"18020",1992-08-08,1992,"Le Havre AC","Nimes Olympique","2-0",2,0,"1",1,2,2,"H"
"18021",1992-08-08,1992,"Montpellier HSC","SM Caen","2-0",2,0,"1",1,2,2,"H"
"18022",1992-08-08,1992,"RC Strasbourg","Lille OSC","2-0",2,0,"1",1,2,2,"H"
"18023",1992-08-08,1992,"Olympique Marseille","Toulouse FC","2-1",2,1,"1",1,3,1,"H"
"18024",1992-08-08,1992,"AS Saint-Etienne","Paris Saint-Germain","1-2",1,2,"1",1,3,-1,"D"
"18025",1992-08-08,1992,"FC Sochaux","US Valenciennes-Anzin","2-1",2,1,"1",1,3,1,"H"
"18026",1992-08-08,1992,"Girondins Bordeaux","Olympique Lyon","0-0",0,0,"1",1,0,0,"D"
"18027",1992-08-08,1992,"FC Nantes","FC Metz","0-0",0,0,"1",1,0,0,"D"
"18028",1992-08-08,1992,"AS Monaco","Sporting Toulon Var","4-0",4,0,"1",1,4,4,"H"
"18029",1992-08-14,1992,"Le Havre AC","Girondins Bordeaux","0-1",0,1,"1",1,1,-1,"D"
"18030",1992-08-15,1992,"AJ Auxerre","AS Monaco","4-1",4,1,"1",1,5,3,"H"
"18031",1992-08-15,1992,"Toulouse FC","Montpellier HSC","1-3",1,3,"1",1,4,-2,"D"
"18032",1992-08-15,1992,"Paris Saint-Germain","FC Sochaux","2-0",2,0,"1",1,2,2,"H"
"18033",1992-08-15,1992,"US Valenciennes-Anzin","RC Strasbourg","1-2",1,2,"1",1,3,-1,"D"
"18034",1992-08-15,1992,"Olympique Lyon","FC Nantes","0-2",0,2,"1",1,2,-2,"D"
"18035",1992-08-15,1992,"FC Metz","AS Saint-Etienne","2-2",2,2,"1",1,4,0,"D"
"18036",1992-08-15,1992,"Nimes Olympique","RC Lens","1-1",1,1,"1",1,2,0,"D"
"18037",1992-08-15,1992,"Lille OSC","SM Caen","1-0",1,0,"1",1,1,1,"H"
"18038",1992-08-15,1992,"Sporting Toulon Var","Olympique Marseille","0-0",0,0,"1",1,0,0,"D"
"18039",1992-08-21,1992,"FC Nantes","AJ Auxerre","2-1",2,1,"1",1,3,1,"H"
"18040",1992-08-22,1992,"Montpellier HSC","Lille OSC","3-0",3,0,"1",1,3,3,"H"
"18041",1992-08-22,1992,"RC Strasbourg","Paris Saint-Germain","0-4",0,4,"1",1,4,-4,"D"
"18042",1992-08-22,1992,"Olympique Marseille","FC Metz","3-2",3,2,"1",1,5,1,"H"
"18043",1992-08-22,1992,"AS Monaco","Nimes Olympique","3-1",3,1,"1",1,4,2,"H"
"18044",1992-08-22,1992,"FC Sochaux","Olympique Lyon","1-0",1,0,"1",1,1,1,"H"
"18045",1992-08-22,1992,"RC Lens","Le Havre AC","0-0",0,0,"1",1,0,0,"D"
"18046",1992-08-22,1992,"AS Saint-Etienne","Toulouse FC","3-2",3,2,"1",1,5,1,"H"
"18047",1992-08-22,1992,"SM Caen","US Valenciennes-Anzin","3-0",3,0,"1",1,3,3,"H"
"18048",1992-08-22,1992,"Girondins Bordeaux","Sporting Toulon Var","1-1",1,1,"1",1,2,0,"D"
"18049",1992-08-29,1992,"Paris Saint-Germain","SM Caen","2-0",2,0,"1",1,2,2,"H"
"18050",1992-08-29,1992,"AJ Auxerre","Girondins Bordeaux","1-0",1,0,"1",1,1,1,"H"
"18051",1992-08-29,1992,"Nimes Olympique","FC Nantes","1-1",1,1,"1",1,2,0,"D"
"18052",1992-08-29,1992,"Olympique Lyon","Olympique Marseille","2-2",2,2,"1",1,4,0,"D"
"18053",1992-08-29,1992,"Le Havre AC","AS Monaco","0-0",0,0,"1",1,0,0,"D"
"18054",1992-08-29,1992,"Toulouse FC","RC Strasbourg","1-1",1,1,"1",1,2,0,"D"
"18055",1992-08-29,1992,"FC Metz","FC Sochaux","5-1",5,1,"1",1,6,4,"H"
"18056",1992-08-29,1992,"RC Lens","AS Saint-Etienne","1-1",1,1,"1",1,2,0,"D"
"18057",1992-08-29,1992,"US Valenciennes-Anzin","Lille OSC","0-1",0,1,"1",1,1,-1,"D"
"18058",1992-08-29,1992,"Sporting Toulon Var","Montpellier HSC","1-0",1,0,"1",1,1,1,"H"
"18059",1992-09-01,1992,"Lille OSC","Paris Saint-Germain","0-0",0,0,"1",1,0,0,"D"
"18060",1992-09-02,1992,"FC Nantes","Le Havre AC","5-2",5,2,"1",1,7,3,"H"
"18061",1992-09-02,1992,"Olympique Marseille","AJ Auxerre","2-0",2,0,"1",1,2,2,"H"
"18062",1992-09-02,1992,"AS Monaco","RC Lens","2-1",2,1,"1",1,3,1,"H"
"18063",1992-09-02,1992,"Montpellier HSC","US Valenciennes-Anzin","1-3",1,3,"1",1,4,-2,"D"
"18064",1992-09-02,1992,"RC Strasbourg","FC Metz","1-1",1,1,"1",1,2,0,"D"
"18065",1992-09-02,1992,"FC Sochaux","Toulouse FC","1-0",1,0,"1",1,1,1,"H"
"18066",1992-09-02,1992,"SM Caen","Olympique Lyon","3-2",3,2,"1",1,5,1,"H"
"18067",1992-09-02,1992,"AS Saint-Etienne","Sporting Toulon Var","2-0",2,0,"1",1,2,2,"H"
"18068",1992-09-04,1992,"Girondins Bordeaux","Nimes Olympique","1-1",1,1,"1",1,2,0,"D"
"18069",1992-09-11,1992,"FC Metz","SM Caen","1-0",1,0,"1",1,1,1,"H"
"18070",1992-09-12,1992,"Paris Saint-Germain","US Valenciennes-Anzin","2-0",2,0,"1",1,2,2,"H"
"18071",1992-09-12,1992,"Nimes Olympique","Olympique Marseille","1-3",1,3,"1",1,4,-2,"D"
"18072",1992-09-12,1992,"AJ Auxerre","AS Saint-Etienne","1-0",1,0,"1",1,1,1,"H"
"18073",1992-09-12,1992,"AS Monaco","Montpellier HSC","0-0",0,0,"1",1,0,0,"D"
"18074",1992-09-12,1992,"RC Lens","Girondins Bordeaux","1-2",1,2,"1",1,3,-1,"D"
"18075",1992-09-12,1992,"Olympique Lyon","RC Strasbourg","2-2",2,2,"1",1,4,0,"D"
"18076",1992-09-12,1992,"Le Havre AC","FC Sochaux","0-0",0,0,"1",1,0,0,"D"
"18077",1992-09-12,1992,"Toulouse FC","Lille OSC","0-0",0,0,"1",1,0,0,"D"
"18078",1992-09-12,1992,"Sporting Toulon Var","FC Nantes","1-3",1,3,"1",1,4,-2,"D"
"18079",1992-09-19,1992,"Montpellier HSC","Paris Saint-Germain","0-0",0,0,"1",1,0,0,"D"
"18080",1992-09-19,1992,"FC Nantes","RC Lens","3-2",3,2,"1",1,5,1,"H"
"18081",1992-09-19,1992,"Olympique Marseille","Le Havre AC","1-1",1,1,"1",1,2,0,"D"
"18082",1992-09-19,1992,"FC Sochaux","AJ Auxerre","0-3",0,3,"1",1,3,-3,"D"
"18083",1992-09-19,1992,"Girondins Bordeaux","AS Monaco","1-0",1,0,"1",1,1,1,"H"
"18084",1992-09-19,1992,"Lille OSC","FC Metz","1-1",1,1,"1",1,2,0,"D"
"18085",1992-09-19,1992,"AS Saint-Etienne","Nimes Olympique","1-0",1,0,"1",1,1,1,"H"
"18086",1992-09-19,1992,"SM Caen","Toulouse FC","4-1",4,1,"1",1,5,3,"H"
"18087",1992-09-19,1992,"US Valenciennes-Anzin","Olympique Lyon","0-0",0,0,"1",1,0,0,"D"
"18088",1992-09-19,1992,"RC Strasbourg","Sporting Toulon Var","1-1",1,1,"1",1,2,0,"D"
"18089",1992-09-24,1992,"AJ Auxerre","Lille OSC","2-0",2,0,"1",1,2,2,"H"
"18090",1992-09-24,1992,"RC Lens","Olympique Marseille","2-2",2,2,"1",1,4,0,"D"
"18091",1992-09-25,1992,"Toulouse FC","Paris Saint-Germain","2-2",2,2,"1",1,4,0,"D"
"18092",1992-09-25,1992,"AS Monaco","FC Nantes","3-1",3,1,"1",1,4,2,"H"
"18093",1992-09-25,1992,"Le Havre AC","AS Saint-Etienne","0-1",0,1,"1",1,1,-1,"D"
"18094",1992-09-25,1992,"Girondins Bordeaux","RC Strasbourg","1-1",1,1,"1",1,2,0,"D"
"18095",1992-09-25,1992,"FC Metz","US Valenciennes-Anzin","0-0",0,0,"1",1,0,0,"D"
"18096",1992-09-25,1992,"Olympique Lyon","Montpellier HSC","2-1",2,1,"1",1,3,1,"H"
"18097",1992-09-25,1992,"Nimes Olympique","FC Sochaux","1-1",1,1,"1",1,2,0,"D"
"18098",1992-09-25,1992,"Sporting Toulon Var","SM Caen","1-1",1,1,"1",1,2,0,"D"
"18099",1992-10-03,1992,"FC Nantes","Girondins Bordeaux","1-0",1,0,"1",1,1,1,"H"
"18100",1992-10-03,1992,"Olympique Marseille","AS Monaco","1-0",1,0,"1",1,1,1,"H"
"18101",1992-10-03,1992,"Montpellier HSC","AJ Auxerre","1-0",1,0,"1",1,1,1,"H"
"18102",1992-10-03,1992,"AS Saint-Etienne","Olympique Lyon","0-0",0,0,"1",1,0,0,"D"
"18103",1992-10-03,1992,"RC Strasbourg","Nimes Olympique","1-1",1,1,"1",1,2,0,"D"
"18104",1992-10-03,1992,"Lille OSC","RC Lens","0-0",0,0,"1",1,0,0,"D"
"18105",1992-10-03,1992,"US Valenciennes-Anzin","Toulouse FC","1-1",1,1,"1",1,2,0,"D"
"18106",1992-10-03,1992,"FC Sochaux","Sporting Toulon Var","2-1",2,1,"1",1,3,1,"H"
"18107",1992-10-04,1992,"Paris Saint-Germain","FC Metz","5-1",5,1,"1",1,6,4,"H"
"18108",1992-10-04,1992,"SM Caen","Le Havre AC","3-3",3,3,"1",1,6,0,"D"
"18109",1992-10-06,1992,"Nimes Olympique","Montpellier HSC","0-0",0,0,"1",1,0,0,"D"
"18110",1992-10-07,1992,"Olympique Lyon","Paris Saint-Germain","1-1",1,1,"1",1,2,0,"D"
"18111",1992-10-07,1992,"FC Nantes","Lille OSC","4-0",4,0,"1",1,4,4,"H"
"18112",1992-10-07,1992,"AJ Auxerre","SM Caen","3-2",3,2,"1",1,5,1,"H"
"18113",1992-10-07,1992,"Girondins Bordeaux","Olympique Marseille","1-0",1,0,"1",1,1,1,"H"
"18114",1992-10-07,1992,"AS Monaco","AS Saint-Etienne","1-0",1,0,"1",1,1,1,"H"
"18115",1992-10-07,1992,"RC Lens","FC Sochaux","0-0",0,0,"1",1,0,0,"D"
"18116",1992-10-07,1992,"FC Metz","Toulouse FC","1-1",1,1,"1",1,2,0,"D"
"18117",1992-10-07,1992,"Le Havre AC","RC Strasbourg","3-0",3,0,"1",1,3,3,"H"
"18118",1992-10-07,1992,"Sporting Toulon Var","US Valenciennes-Anzin","1-2",1,2,"1",1,3,-1,"D"
"18119",1992-10-17,1992,"Olympique Marseille","FC Nantes","0-1",0,1,"1",1,1,-1,"D"
"18120",1992-10-17,1992,"Paris Saint-Germain","RC Lens","1-1",1,1,"1",1,2,0,"D"
"18121",1992-10-17,1992,"RC Strasbourg","AJ Auxerre","1-1",1,1,"1",1,2,0,"D"
"18122",1992-10-17,1992,"FC Sochaux","AS Monaco","1-2",1,2,"1",1,3,-1,"D"
"18123",1992-10-17,1992,"Montpellier HSC","FC Metz","1-0",1,0,"1",1,1,1,"H"
"18124",1992-10-17,1992,"AS Saint-Etienne","Girondins Bordeaux","2-1",2,1,"1",1,3,1,"H"
"18125",1992-10-17,1992,"SM Caen","Nimes Olympique","2-2",2,2,"1",1,4,0,"D"
"18126",1992-10-17,1992,"US Valenciennes-Anzin","Le Havre AC","4-1",4,1,"1",1,5,3,"H"
"18127",1992-10-17,1992,"Toulouse FC","Olympique Lyon","0-0",0,0,"1",1,0,0,"D"
"18128",1992-10-17,1992,"Lille OSC","Sporting Toulon Var","1-0",1,0,"1",1,1,1,"H"
"18129",1992-10-24,1992,"FC Nantes","Montpellier HSC","6-0",6,0,"1",1,6,6,"H"
"18130",1992-10-24,1992,"AJ Auxerre","Toulouse FC","0-0",0,0,"1",1,0,0,"D"
"18131",1992-10-24,1992,"AS Monaco","RC Strasbourg","2-1",2,1,"1",1,3,1,"H"
"18132",1992-10-24,1992,"Olympique Marseille","AS Saint-Etienne","1-0",1,0,"1",1,1,1,"H"
"18133",1992-10-24,1992,"Girondins Bordeaux","FC Sochaux","3-0",3,0,"1",1,3,3,"H"
"18134",1992-10-24,1992,"RC Lens","SM Caen","0-3",0,3,"1",1,3,-3,"D"
"18135",1992-10-24,1992,"Olympique Lyon","FC Metz","1-1",1,1,"1",1,2,0,"D"
"18136",1992-10-24,1992,"Le Havre AC","Lille OSC","1-0",1,0,"1",1,1,1,"H"
"18137",1992-10-24,1992,"Nimes Olympique","US Valenciennes-Anzin","2-1",2,1,"1",1,3,1,"H"
"18138",1992-10-24,1992,"Sporting Toulon Var","Paris Saint-Germain","0-2",0,2,"1",1,2,-2,"D"
"18139",1992-10-29,1992,"AS Saint-Etienne","FC Nantes","1-0",1,0,"1",1,1,1,"H"
"18140",1992-10-30,1992,"Paris Saint-Germain","Nimes Olympique","2-3",2,3,"1",1,5,-1,"D"
"18141",1992-10-30,1992,"US Valenciennes-Anzin","AJ Auxerre","3-3",3,3,"1",1,6,0,"D"
"18142",1992-10-30,1992,"FC Sochaux","Olympique Marseille","2-2",2,2,"1",1,4,0,"D"
"18143",1992-10-30,1992,"SM Caen","AS Monaco","1-0",1,0,"1",1,1,1,"H"
"18144",1992-10-30,1992,"Montpellier HSC","Girondins Bordeaux","2-0",2,0,"1",1,2,2,"H"
"18145",1992-10-30,1992,"RC Strasbourg","RC Lens","4-1",4,1,"1",1,5,3,"H"
"18146",1992-10-30,1992,"Toulouse FC","Le Havre AC","1-0",1,0,"1",1,1,1,"H"
"18147",1992-10-30,1992,"Lille OSC","Olympique Lyon","1-1",1,1,"1",1,2,0,"D"
"18148",1992-10-30,1992,"FC Metz","Sporting Toulon Var","0-0",0,0,"1",1,0,0,"D"
"18149",1992-11-07,1992,"FC Nantes","FC Sochaux","1-1",1,1,"1",1,2,0,"D"
"18150",1992-11-07,1992,"Le Havre AC","Paris Saint-Germain","1-1",1,1,"1",1,2,0,"D"
"18151",1992-11-07,1992,"AJ Auxerre","FC Metz","4-0",4,0,"1",1,4,4,"H"
"18152",1992-11-07,1992,"AS Monaco","Lille OSC","3-0",3,0,"1",1,3,3,"H"
"18153",1992-11-07,1992,"Olympique Marseille","Montpellier HSC","1-1",1,1,"1",1,2,0,"D"
"18154",1992-11-07,1992,"Girondins Bordeaux","SM Caen","2-0",2,0,"1",1,2,2,"H"
"18155",1992-11-07,1992,"AS Saint-Etienne","RC Strasbourg","1-2",1,2,"1",1,3,-1,"D"
"18156",1992-11-07,1992,"Nimes Olympique","Toulouse FC","1-1",1,1,"1",1,2,0,"D"
"18157",1992-11-07,1992,"RC Lens","US Valenciennes-Anzin","2-1",2,1,"1",1,3,1,"H"
"18158",1992-11-07,1992,"Sporting Toulon Var","Olympique Lyon","0-0",0,0,"1",1,0,0,"D"
"18159",1992-11-19,1992,"Paris Saint-Germain","AJ Auxerre","2-0",2,0,"1",1,2,2,"H"
"18160",1992-11-20,1992,"RC Strasbourg","Olympique Marseille","2-2",2,2,"1",1,4,0,"D"
"18161",1992-11-20,1992,"SM Caen","FC Nantes","1-1",1,1,"1",1,2,0,"D"
"18162",1992-11-20,1992,"Lille OSC","Girondins Bordeaux","0-2",0,2,"1",1,2,-2,"D"
"18163",1992-11-20,1992,"Montpellier HSC","RC Lens","1-2",1,2,"1",1,3,-1,"D"
"18164",1992-11-20,1992,"FC Sochaux","AS Saint-Etienne","1-0",1,0,"1",1,1,1,"H"
"18165",1992-11-20,1992,"FC Metz","Nimes Olympique","3-0",3,0,"1",1,3,3,"H"
"18166",1992-11-20,1992,"Olympique Lyon","Le Havre AC","1-1",1,1,"1",1,2,0,"D"
"18167",1992-11-20,1992,"US Valenciennes-Anzin","AS Monaco","1-1",1,1,"1",1,2,0,"D"
"18168",1992-11-20,1992,"Toulouse FC","Sporting Toulon Var","1-1",1,1,"1",1,2,0,"D"
"18169",1992-11-28,1992,"FC Nantes","RC Strasbourg","2-2",2,2,"1",1,4,0,"D"
"18170",1992-11-28,1992,"AS Monaco","Paris Saint-Germain","3-1",3,1,"1",1,4,2,"H"
"18171",1992-11-28,1992,"Olympique Marseille","SM Caen","2-1",2,1,"1",1,3,1,"H"
"18172",1992-11-28,1992,"Girondins Bordeaux","US Valenciennes-Anzin","3-0",3,0,"1",1,3,3,"H"
"18173",1992-11-28,1992,"AS Saint-Etienne","Montpellier HSC","1-0",1,0,"1",1,1,1,"H"
"18174",1992-11-28,1992,"FC Sochaux","Lille OSC","1-0",1,0,"1",1,1,1,"H"
"18175",1992-11-28,1992,"Le Havre AC","FC Metz","2-1",2,1,"1",1,3,1,"H"
"18176",1992-11-28,1992,"Nimes Olympique","Olympique Lyon","2-3",2,3,"1",1,5,-1,"D"
"18177",1992-11-28,1992,"RC Lens","Toulouse FC","0-2",0,2,"1",1,2,-2,"D"
"18178",1992-11-28,1992,"AJ Auxerre","Sporting Toulon Var","2-1",2,1,"1",1,3,1,"H"
"18179",1992-12-03,1992,"Olympique Lyon","AJ Auxerre","1-1",1,1,"1",1,2,0,"D"
"18180",1992-12-04,1992,"Paris Saint-Germain","Girondins Bordeaux","5-0",5,0,"1",1,5,5,"H"
"18181",1992-12-04,1992,"US Valenciennes-Anzin","FC Nantes","1-1",1,1,"1",1,2,0,"D"
"18182",1992-12-04,1992,"Toulouse FC","AS Monaco","0-2",0,2,"1",1,2,-2,"D"
"18183",1992-12-04,1992,"RC Strasbourg","FC Sochaux","6-1",6,1,"1",1,7,5,"H"
"18184",1992-12-04,1992,"SM Caen","AS Saint-Etienne","0-0",0,0,"1",1,0,0,"D"
"18185",1992-12-04,1992,"Montpellier HSC","Le Havre AC","2-0",2,0,"1",1,2,2,"H"
"18186",1992-12-04,1992,"FC Metz","RC Lens","1-2",1,2,"1",1,3,-1,"D"
"18187",1992-12-04,1992,"Lille OSC","Olympique Marseille","2-0",2,0,"1",1,2,2,"H"
"18188",1992-12-04,1992,"Sporting Toulon Var","Nimes Olympique","1-0",1,0,"1",1,1,1,"H"
"18189",1992-12-12,1992,"FC Nantes","Paris Saint-Germain","1-0",1,0,"1",1,1,1,"H"
"18190",1992-12-12,1992,"AS Monaco","FC Metz","2-0",2,0,"1",1,2,2,"H"
"18191",1992-12-12,1992,"Nimes Olympique","AJ Auxerre","1-2",1,2,"1",1,3,-1,"D"
"18192",1992-12-12,1992,"Olympique Marseille","US Valenciennes-Anzin","2-1",2,1,"1",1,3,1,"H"
"18193",1992-12-12,1992,"RC Strasbourg","Montpellier HSC","3-1",3,1,"1",1,4,2,"H"
"18194",1992-12-12,1992,"AS Saint-Etienne","Lille OSC","0-0",0,0,"1",1,0,0,"D"
"18195",1992-12-12,1992,"FC Sochaux","SM Caen","1-0",1,0,"1",1,1,1,"H"
"18196",1992-12-12,1992,"RC Lens","Olympique Lyon","0-3",0,3,"1",1,3,-3,"D"
"18197",1992-12-12,1992,"Le Havre AC","Sporting Toulon Var","2-1",2,1,"1",1,3,1,"H"
"18198",1992-12-18,1992,"Paris Saint-Germain","Olympique Marseille","0-1",0,1,"1",1,1,-1,"D"
"18199",1992-12-19,1992,"Toulouse FC","FC Nantes","2-0",2,0,"1",1,2,2,"H"
"18200",1992-12-19,1992,"AJ Auxerre","Le Havre AC","4-1",4,1,"1",1,5,3,"H"
"18201",1992-12-19,1992,"Olympique Lyon","AS Monaco","0-0",0,0,"1",1,0,0,"D"
"18202",1992-12-19,1992,"FC Metz","Girondins Bordeaux","1-1",1,1,"1",1,2,0,"D"
"18203",1992-12-19,1992,"SM Caen","RC Strasbourg","3-0",3,0,"1",1,3,3,"H"
"18204",1992-12-19,1992,"US Valenciennes-Anzin","AS Saint-Etienne","0-0",0,0,"1",1,0,0,"D"
"18205",1992-12-19,1992,"Montpellier HSC","FC Sochaux","1-0",1,0,"1",1,1,1,"H"
"18206",1992-12-19,1992,"Lille OSC","Nimes Olympique","2-2",2,2,"1",1,4,0,"D"
"18207",1992-12-19,1992,"Sporting Toulon Var","RC Lens","2-2",2,2,"1",1,4,0,"D"
"18208",1993-01-09,1992,"AS Monaco","AJ Auxerre","4-0",4,0,"1",1,4,4,"H"
"18209",1993-01-09,1992,"FC Nantes","Olympique Lyon","1-0",1,0,"1",1,1,1,"H"
"18210",1993-01-09,1992,"FC Sochaux","Paris Saint-Germain","1-3",1,3,"1",1,4,-2,"D"
"18211",1993-01-09,1992,"Girondins Bordeaux","Le Havre AC","3-0",3,0,"1",1,3,3,"H"
"18212",1993-01-09,1992,"AS Saint-Etienne","FC Metz","2-0",2,0,"1",1,2,2,"H"
"18213",1993-01-09,1992,"RC Strasbourg","US Valenciennes-Anzin","0-0",0,0,"1",1,0,0,"D"
"18214",1993-01-09,1992,"Montpellier HSC","Toulouse FC","0-1",0,1,"1",1,1,-1,"D"
"18215",1993-01-09,1992,"SM Caen","Lille OSC","4-3",4,3,"1",1,7,1,"H"
"18216",1993-01-09,1992,"RC Lens","Nimes Olympique","0-0",0,0,"1",1,0,0,"D"
"18217",1993-01-09,1992,"Olympique Marseille","Sporting Toulon Var","5-2",5,2,"1",1,7,3,"H"
"18218",1993-01-16,1992,"Nimes Olympique","AS Monaco","0-1",0,1,"1",1,1,-1,"D"
"18219",1993-01-16,1992,"AJ Auxerre","FC Nantes","1-1",1,1,"1",1,2,0,"D"
"18220",1993-01-16,1992,"Paris Saint-Germain","RC Strasbourg","1-1",1,1,"1",1,2,0,"D"
"18221",1993-01-16,1992,"FC Metz","Olympique Marseille","2-1",2,1,"1",1,3,1,"H"
"18222",1993-01-16,1992,"Toulouse FC","AS Saint-Etienne","0-0",0,0,"1",1,0,0,"D"
"18223",1993-01-16,1992,"Olympique Lyon","FC Sochaux","3-1",3,1,"1",1,4,2,"H"
"18224",1993-01-16,1992,"Lille OSC","Montpellier HSC","0-0",0,0,"1",1,0,0,"D"
"18225",1993-01-16,1992,"US Valenciennes-Anzin","SM Caen","3-2",3,2,"1",1,5,1,"H"
"18226",1993-01-16,1992,"Le Havre AC","RC Lens","0-1",0,1,"1",1,1,-1,"D"
"18227",1993-01-16,1992,"Sporting Toulon Var","Girondins Bordeaux","0-0",0,0,"1",1,0,0,"D"
"18228",1993-01-22,1992,"SM Caen","Paris Saint-Germain","0-2",0,2,"1",1,2,-2,"D"
"18229",1993-01-23,1992,"AS Monaco","Le Havre AC","2-0",2,0,"1",1,2,2,"H"
"18230",1993-01-23,1992,"FC Nantes","Nimes Olympique","2-0",2,0,"1",1,2,2,"H"
"18231",1993-01-23,1992,"Olympique Marseille","Olympique Lyon","2-1",2,1,"1",1,3,1,"H"
"18232",1993-01-23,1992,"Girondins Bordeaux","AJ Auxerre","1-0",1,0,"1",1,1,1,"H"
"18233",1993-01-23,1992,"AS Saint-Etienne","RC Lens","0-0",0,0,"1",1,0,0,"D"
"18234",1993-01-23,1992,"RC Strasbourg","Toulouse FC","0-0",0,0,"1",1,0,0,"D"
"18235",1993-01-23,1992,"FC Sochaux","FC Metz","2-0",2,0,"1",1,2,2,"H"
"18236",1993-01-23,1992,"Lille OSC","US Valenciennes-Anzin","1-2",1,2,"1",1,3,-1,"D"
"18237",1993-01-23,1992,"Montpellier HSC","Sporting Toulon Var","1-1",1,1,"1",1,2,0,"D"
"18238",1993-01-27,1992,"Girondins Bordeaux","Toulouse FC","2-0",2,0,"1",1,2,2,"H"
"18239",1993-01-29,1992,"FC Metz","RC Strasbourg","3-0",3,0,"1",1,3,3,"H"
"18240",1993-01-30,1992,"RC Lens","AS Monaco","0-0",0,0,"1",1,0,0,"D"
"18241",1993-01-30,1992,"Paris Saint-Germain","Lille OSC","3-0",3,0,"1",1,3,3,"H"
"18242",1993-01-30,1992,"Le Havre AC","FC Nantes","2-0",2,0,"1",1,2,2,"H"
"18243",1993-01-30,1992,"AJ Auxerre","Olympique Marseille","0-2",0,2,"1",1,2,-2,"D"
"18244",1993-01-30,1992,"Nimes Olympique","Girondins Bordeaux","0-0",0,0,"1",1,0,0,"D"
"18245",1993-01-30,1992,"US Valenciennes-Anzin","Montpellier HSC","1-3",1,3,"1",1,4,-2,"D"
"18246",1993-01-30,1992,"Olympique Lyon","SM Caen","1-0",1,0,"1",1,1,1,"H"
"18247",1993-01-30,1992,"Toulouse FC","FC Sochaux","1-0",1,0,"1",1,1,1,"H"
"18248",1993-01-30,1992,"Sporting Toulon Var","AS Saint-Etienne","0-0",0,0,"1",1,0,0,"D"
"18249",1993-02-05,1992,"Girondins Bordeaux","RC Lens","0-0",0,0,"1",1,0,0,"D"
"18250",1993-02-06,1992,"Montpellier HSC","AS Monaco","0-0",0,0,"1",1,0,0,"D"
"18251",1993-02-06,1992,"Olympique Marseille","Nimes Olympique","6-1",6,1,"1",1,7,5,"H"
"18252",1993-02-06,1992,"US Valenciennes-Anzin","Paris Saint-Germain","1-1",1,1,"1",1,2,0,"D"
"18253",1993-02-06,1992,"AS Saint-Etienne","AJ Auxerre","1-0",1,0,"1",1,1,1,"H"
"18254",1993-02-06,1992,"RC Strasbourg","Olympique Lyon","2-1",2,1,"1",1,3,1,"H"
"18255",1993-02-06,1992,"FC Sochaux","Le Havre AC","3-2",3,2,"1",1,5,1,"H"
"18256",1993-02-06,1992,"Lille OSC","Toulouse FC","2-2",2,2,"1",1,4,0,"D"
"18257",1993-02-06,1992,"SM Caen","FC Metz","0-1",0,1,"1",1,1,-1,"D"
"18258",1993-02-06,1992,"FC Nantes","Sporting Toulon Var","0-0",0,0,"1",1,0,0,"D"
"18259",1993-02-10,1992,"AS Monaco","Girondins Bordeaux","0-0",0,0,"1",1,0,0,"D"
"18260",1993-02-10,1992,"Le Havre AC","Olympique Marseille","1-3",1,3,"1",1,4,-2,"D"
"18261",1993-02-10,1992,"Paris Saint-Germain","Montpellier HSC","1-0",1,0,"1",1,1,1,"H"
"18262",1993-02-10,1992,"RC Lens","FC Nantes","1-0",1,0,"1",1,1,1,"H"
"18263",1993-02-10,1992,"Nimes Olympique","AS Saint-Etienne","1-1",1,1,"1",1,2,0,"D"
"18264",1993-02-10,1992,"AJ Auxerre","FC Sochaux","0-3",0,3,"1",1,3,-3,"D"
"18265",1993-02-10,1992,"Olympique Lyon","US Valenciennes-Anzin","2-1",2,1,"1",1,3,1,"H"
"18266",1993-02-10,1992,"Toulouse FC","SM Caen","1-1",1,1,"1",1,2,0,"D"
"18267",1993-02-10,1992,"FC Metz","Lille OSC","0-0",0,0,"1",1,0,0,"D"
"18268",1993-02-10,1992,"Sporting Toulon Var","RC Strasbourg","0-2",0,2,"1",1,2,-2,"D"
"18269",1993-02-21,1992,"Olympique Marseille","RC Lens","2-0",2,0,"1",1,2,2,"H"
"18270",1993-02-21,1992,"Paris Saint-Germain","Toulouse FC","0-0",0,0,"1",1,0,0,"D"
"18271",1993-02-21,1992,"FC Nantes","AS Monaco","1-0",1,0,"1",1,1,1,"H"
"18272",1993-02-21,1992,"RC Strasbourg","Girondins Bordeaux","0-1",0,1,"1",1,1,-1,"D"
"18273",1993-02-21,1992,"AS Saint-Etienne","Le Havre AC","0-0",0,0,"1",1,0,0,"D"
"18274",1993-02-21,1992,"Lille OSC","AJ Auxerre","1-0",1,0,"1",1,1,1,"H"
"18275",1993-02-21,1992,"Montpellier HSC","Olympique Lyon","0-2",0,2,"1",1,2,-2,"D"
"18276",1993-02-21,1992,"FC Sochaux","Nimes Olympique","1-1",1,1,"1",1,2,0,"D"
"18277",1993-02-21,1992,"US Valenciennes-Anzin","FC Metz","0-2",0,2,"1",1,2,-2,"D"
"18278",1993-02-21,1992,"SM Caen","Sporting Toulon Var","2-1",2,1,"1",1,3,1,"H"
"18279",1993-02-25,1992,"AS Monaco","Olympique Marseille","1-0",1,0,"1",1,1,1,"H"
"18280",1993-02-26,1992,"FC Metz","Paris Saint-Germain","2-1",2,1,"1",1,3,1,"H"
"18281",1993-02-26,1992,"Girondins Bordeaux","FC Nantes","3-0",3,0,"1",1,3,3,"H"
"18282",1993-02-26,1992,"Olympique Lyon","AS Saint-Etienne","0-2",0,2,"1",1,2,-2,"D"
"18283",1993-02-26,1992,"Nimes Olympique","RC Strasbourg","2-6",2,6,"1",1,8,-4,"D"
"18284",1993-02-26,1992,"AJ Auxerre","Montpellier HSC","2-0",2,0,"1",1,2,2,"H"
"18285",1993-02-26,1992,"Le Havre AC","SM Caen","2-3",2,3,"1",1,5,-1,"D"
"18286",1993-02-26,1992,"RC Lens","Lille OSC","0-0",0,0,"1",1,0,0,"D"
"18287",1993-02-26,1992,"Toulouse FC","US Valenciennes-Anzin","1-2",1,2,"1",1,3,-1,"D"
"18288",1993-02-26,1992,"Sporting Toulon Var","FC Sochaux","0-4",0,4,"1",1,4,-4,"D"
"18289",1993-03-11,1992,"SM Caen","AJ Auxerre","2-1",2,1,"1",1,3,1,"H"
"18290",1993-03-12,1992,"AS Saint-Etienne","AS Monaco","0-0",0,0,"1",1,0,0,"D"
"18291",1993-03-12,1992,"Olympique Marseille","Girondins Bordeaux","0-0",0,0,"1",1,0,0,"D"
"18292",1993-03-12,1992,"Paris Saint-Germain","Olympique Lyon","1-1",1,1,"1",1,2,0,"D"
"18293",1993-03-12,1992,"Lille OSC","FC Nantes","1-1",1,1,"1",1,2,0,"D"
"18294",1993-03-12,1992,"RC Strasbourg","Le Havre AC","3-1",3,1,"1",1,4,2,"H"
"18295",1993-03-12,1992,"FC Sochaux","RC Lens","1-1",1,1,"1",1,2,0,"D"
"18296",1993-03-12,1992,"Montpellier HSC","Nimes Olympique","1-0",1,0,"1",1,1,1,"H"
"18297",1993-03-12,1992,"Toulouse FC","FC Metz","0-0",0,0,"1",1,0,0,"D"
"18298",1993-03-12,1992,"US Valenciennes-Anzin","Sporting Toulon Var","3-1",3,1,"1",1,4,2,"H"
"18299",1993-03-20,1992,"AS Monaco","FC Sochaux","1-0",1,0,"1",1,1,1,"H"
"18300",1993-03-20,1992,"FC Nantes","Olympique Marseille","0-2",0,2,"1",1,2,-2,"D"
"18301",1993-03-20,1992,"Girondins Bordeaux","AS Saint-Etienne","0-0",0,0,"1",1,0,0,"D"
"18302",1993-03-20,1992,"Olympique Lyon","Toulouse FC","1-0",1,0,"1",1,1,1,"H"
"18303",1993-03-20,1992,"AJ Auxerre","RC Strasbourg","2-0",2,0,"1",1,2,2,"H"
"18304",1993-03-20,1992,"Le Havre AC","US Valenciennes-Anzin","0-0",0,0,"1",1,0,0,"D"
"18305",1993-03-20,1992,"Sporting Toulon Var","Lille OSC","1-0",1,0,"1",1,1,1,"H"
"18306",1993-03-21,1992,"RC Lens","Paris Saint-Germain","2-1",2,1,"1",1,3,1,"H"
"18307",1993-03-21,1992,"FC Metz","Montpellier HSC","1-1",1,1,"1",1,2,0,"D"
"18308",1993-03-21,1992,"Nimes Olympique","SM Caen","1-2",1,2,"1",1,3,-1,"D"
"18309",1993-04-02,1992,"AS Saint-Etienne","Olympique Marseille","0-2",0,2,"1",1,2,-2,"D"
"18310",1993-04-02,1992,"RC Strasbourg","AS Monaco","3-0",3,0,"1",1,3,3,"H"
"18311",1993-04-02,1992,"FC Sochaux","Girondins Bordeaux","0-1",0,1,"1",1,1,-1,"D"
"18312",1993-04-02,1992,"Montpellier HSC","FC Nantes","1-0",1,0,"1",1,1,1,"H"
"18313",1993-04-02,1992,"Toulouse FC","AJ Auxerre","2-1",2,1,"1",1,3,1,"H"
"18314",1993-04-02,1992,"FC Metz","Olympique Lyon","2-0",2,0,"1",1,2,2,"H"
"18315",1993-04-02,1992,"SM Caen","RC Lens","0-1",0,1,"1",1,1,-1,"D"
"18316",1993-04-02,1992,"US Valenciennes-Anzin","Nimes Olympique","1-1",1,1,"1",1,2,0,"D"
"18317",1993-04-02,1992,"Lille OSC","Le Havre AC","2-1",2,1,"1",1,3,1,"H"
"18318",1993-04-02,1992,"Paris Saint-Germain","Sporting Toulon Var","2-0",2,0,"1",1,2,2,"H"
"18319",1993-04-10,1992,"Olympique Marseille","FC Sochaux","2-0",2,0,"1",1,2,2,"H"
"18320",1993-04-10,1992,"AS Monaco","SM Caen","4-2",4,2,"1",1,6,2,"H"
"18321",1993-04-10,1992,"Girondins Bordeaux","Montpellier HSC","2-1",2,1,"1",1,3,1,"H"
"18322",1993-04-10,1992,"Nimes Olympique","Paris Saint-Germain","0-1",0,1,"1",1,1,-1,"D"
"18323",1993-04-10,1992,"FC Nantes","AS Saint-Etienne","0-0",0,0,"1",1,0,0,"D"
"18324",1993-04-10,1992,"RC Lens","RC Strasbourg","2-0",2,0,"1",1,2,2,"H"
"18325",1993-04-10,1992,"AJ Auxerre","US Valenciennes-Anzin","3-2",3,2,"1",1,5,1,"H"
"18326",1993-04-10,1992,"Olympique Lyon","Lille OSC","1-3",1,3,"1",1,4,-2,"D"
"18327",1993-04-10,1992,"Le Havre AC","Toulouse FC","3-2",3,2,"1",1,5,1,"H"
"18328",1993-04-10,1992,"Sporting Toulon Var","FC Metz","1-0",1,0,"1",1,1,1,"H"
"18329",1993-04-14,1992,"Montpellier HSC","Olympique Marseille","1-1",1,1,"1",1,2,0,"D"
"18330",1993-04-14,1992,"Lille OSC","AS Monaco","1-1",1,1,"1",1,2,0,"D"
"18331",1993-04-14,1992,"Paris Saint-Germain","Le Havre AC","1-0",1,0,"1",1,1,1,"H"
"18332",1993-04-14,1992,"SM Caen","Girondins Bordeaux","1-0",1,0,"1",1,1,1,"H"
"18333",1993-04-14,1992,"FC Metz","AJ Auxerre","0-1",0,1,"1",1,1,-1,"D"
"18334",1993-04-14,1992,"RC Strasbourg","AS Saint-Etienne","2-2",2,2,"1",1,4,0,"D"
"18335",1993-04-14,1992,"US Valenciennes-Anzin","RC Lens","0-2",0,2,"1",1,2,-2,"D"
"18336",1993-04-14,1992,"Olympique Lyon","Sporting Toulon Var","1-1",1,1,"1",1,2,0,"D"
"18337",1993-04-15,1992,"FC Sochaux","FC Nantes","0-1",0,1,"1",1,1,-1,"D"
"18338",1993-05-01,1992,"Olympique Marseille","RC Strasbourg","5-0",5,0,"1",1,5,5,"H"
"18339",1993-05-01,1992,"AS Monaco","US Valenciennes-Anzin","2-1",2,1,"1",1,3,1,"H"
"18340",1993-05-01,1992,"AJ Auxerre","Paris Saint-Germain","1-2",1,2,"1",1,3,-1,"D"
"18341",1993-05-01,1992,"Girondins Bordeaux","Lille OSC","3-0",3,0,"1",1,3,3,"H"
"18342",1993-05-01,1992,"FC Nantes","SM Caen","1-1",1,1,"1",1,2,0,"D"
"18343",1993-05-01,1992,"AS Saint-Etienne","FC Sochaux","2-0",2,0,"1",1,2,2,"H"
"18344",1993-05-01,1992,"RC Lens","Montpellier HSC","2-0",2,0,"1",1,2,2,"H"
"18345",1993-05-01,1992,"Le Havre AC","Olympique Lyon","2-0",2,0,"1",1,2,2,"H"
"18346",1993-05-01,1992,"Nimes Olympique","FC Metz","2-2",2,2,"1",1,4,0,"D"
"18347",1993-05-01,1992,"Sporting Toulon Var","Toulouse FC","2-0",2,0,"1",1,2,2,"H"
"18348",1993-05-08,1992,"SM Caen","Olympique Marseille","2-3",2,3,"1",1,5,-1,"D"
"18349",1993-05-08,1992,"Paris Saint-Germain","AS Monaco","1-0",1,0,"1",1,1,1,"H"
"18350",1993-05-08,1992,"US Valenciennes-Anzin","Girondins Bordeaux","1-0",1,0,"1",1,1,1,"H"
"18351",1993-05-08,1992,"RC Strasbourg","FC Nantes","2-4",2,4,"1",1,6,-2,"D"
"18352",1993-05-08,1992,"Montpellier HSC","AS Saint-Etienne","1-2",1,2,"1",1,3,-1,"D"
"18353",1993-05-08,1992,"Toulouse FC","RC Lens","0-0",0,0,"1",1,0,0,"D"
"18354",1993-05-08,1992,"FC Metz","Le Havre AC","2-3",2,3,"1",1,5,-1,"D"
"18355",1993-05-08,1992,"Olympique Lyon","Nimes Olympique","0-1",0,1,"1",1,1,-1,"D"
"18356",1993-05-08,1992,"Lille OSC","FC Sochaux","0-0",0,0,"1",1,0,0,"D"
"18357",1993-05-08,1992,"Sporting Toulon Var","AJ Auxerre","1-2",1,2,"1",1,3,-1,"D"
"18358",1993-05-12,1992,"Toulouse FC","Nimes Olympique","3-0",3,0,"1",1,3,3,"H"
"18359",1993-05-14,1992,"Girondins Bordeaux","Paris Saint-Germain","1-1",1,1,"1",1,2,0,"D"
"18360",1993-05-15,1992,"Olympique Marseille","Lille OSC","4-1",4,1,"1",1,5,3,"H"
"18361",1993-05-15,1992,"AS Monaco","Toulouse FC","4-0",4,0,"1",1,4,4,"H"
"18362",1993-05-15,1992,"FC Nantes","US Valenciennes-Anzin","3-1",3,1,"1",1,4,2,"H"
"18363",1993-05-15,1992,"AS Saint-Etienne","SM Caen","1-1",1,1,"1",1,2,0,"D"
"18364",1993-05-15,1992,"AJ Auxerre","Olympique Lyon","2-1",2,1,"1",1,3,1,"H"
"18365",1993-05-15,1992,"RC Lens","FC Metz","2-0",2,0,"1",1,2,2,"H"
"18366",1993-05-15,1992,"FC Sochaux","RC Strasbourg","0-0",0,0,"1",1,0,0,"D"
"18367",1993-05-15,1992,"Le Havre AC","Montpellier HSC","1-1",1,1,"1",1,2,0,"D"
"18368",1993-05-15,1992,"Nimes Olympique","Sporting Toulon Var","0-1",0,1,"1",1,1,-1,"D"
"18369",1993-05-20,1992,"US Valenciennes-Anzin","Olympique Marseille","0-0",0,0,"1",1,0,0,"D"
"18370",1993-05-22,1992,"Paris Saint-Germain","FC Nantes","1-0",1,0,"1",1,1,1,"H"
"18371",1993-05-22,1992,"FC Metz","AS Monaco","1-0",1,0,"1",1,1,1,"H"
"18372",1993-05-22,1992,"Toulouse FC","Girondins Bordeaux","2-0",2,0,"1",1,2,2,"H"
"18373",1993-05-22,1992,"AJ Auxerre","Nimes Olympique","5-2",5,2,"1",1,7,3,"H"
"18374",1993-05-22,1992,"Lille OSC","AS Saint-Etienne","0-0",0,0,"1",1,0,0,"D"
"18375",1993-05-22,1992,"Montpellier HSC","RC Strasbourg","1-1",1,1,"1",1,2,0,"D"
"18376",1993-05-22,1992,"Olympique Lyon","RC Lens","3-1",3,1,"1",1,4,2,"H"
"18377",1993-05-22,1992,"SM Caen","FC Sochaux","2-0",2,0,"1",1,2,2,"H"
"18378",1993-05-22,1992,"Sporting Toulon Var","Le Havre AC","1-2",1,2,"1",1,3,-1,"D"
"18379",1993-05-29,1992,"Olympique Marseille","Paris Saint-Germain","3-1",3,1,"1",1,4,2,"H"
"18380",1993-05-29,1992,"AS Monaco","Olympique Lyon","2-1",2,1,"1",1,3,1,"H"
"18381",1993-05-29,1992,"Girondins Bordeaux","FC Metz","2-1",2,1,"1",1,3,1,"H"
"18382",1993-05-29,1992,"FC Nantes","Toulouse FC","4-1",4,1,"1",1,5,3,"H"
"18383",1993-05-29,1992,"AS Saint-Etienne","US Valenciennes-Anzin","4-2",4,2,"1",1,6,2,"H"
"18384",1993-05-29,1992,"Le Havre AC","AJ Auxerre","0-0",0,0,"1",1,0,0,"D"
"18385",1993-05-29,1992,"RC Strasbourg","SM Caen","1-1",1,1,"1",1,2,0,"D"
"18386",1993-05-29,1992,"FC Sochaux","Montpellier HSC","1-1",1,1,"1",1,2,0,"D"
"18387",1993-05-29,1992,"Nimes Olympique","Lille OSC","0-0",0,0,"1",1,0,0,"D"
"18388",1993-05-29,1992,"RC Lens","Sporting Toulon Var","2-1",2,1,"1",1,3,1,"H"
"18389",1993-06-02,1992,"Toulouse FC","Olympique Marseille","3-1",3,1,"1",1,4,2,"H"
"18390",1993-06-02,1992,"Paris Saint-Germain","AS Saint-Etienne","3-1",3,1,"1",1,4,2,"H"
"18391",1993-06-02,1992,"Olympique Lyon","Girondins Bordeaux","2-3",2,3,"1",1,5,-1,"D"
"18392",1993-06-02,1992,"FC Metz","FC Nantes","4-0",4,0,"1",1,4,4,"H"
"18393",1993-06-02,1992,"AJ Auxerre","RC Lens","1-1",1,1,"1",1,2,0,"D"
"18394",1993-06-02,1992,"Lille OSC","RC Strasbourg","2-3",2,3,"1",1,5,-1,"D"
"18395",1993-06-02,1992,"SM Caen","Montpellier HSC","2-3",2,3,"1",1,5,-1,"D"
"18396",1993-06-02,1992,"Nimes Olympique","Le Havre AC","0-2",0,2,"1",1,2,-2,"D"
"18397",1993-06-02,1992,"US Valenciennes-Anzin","FC Sochaux","1-0",1,0,"1",1,1,1,"H"
"18398",1993-06-02,1992,"Sporting Toulon Var","AS Monaco","4-5",4,5,"1",1,9,-1,"D"
"18399",1993-07-23,1993,"FC Nantes","AS Monaco","1-0",1,0,"1",1,1,1,"H"
"18400",1993-07-24,1993,"Toulouse FC","Le Havre AC","0-0",0,0,"1",1,0,0,"D"
"18401",1993-07-24,1993,"Girondins Bordeaux","Paris Saint-Germain","1-0",1,0,"1",1,1,1,"H"
"18402",1993-07-24,1993,"SM Caen","FC Metz","1-1",1,1,"1",1,2,0,"D"
"18403",1993-07-24,1993,"Lille OSC","FC Martigues","1-1",1,1,"1",1,2,0,"D"
"18404",1993-07-24,1993,"Olympique Marseille","RC Lens","1-0",1,0,"1",1,1,1,"H"
"18405",1993-07-24,1993,"Montpellier HSC","Olympique Lyon","1-1",1,1,"1",1,2,0,"D"
"18406",1993-07-24,1993,"RC Strasbourg","AJ Auxerre","1-1",1,1,"1",1,2,0,"D"
"18407",1993-07-24,1993,"AS Saint-Etienne","AS Cannes","1-2",1,2,"1",1,3,-1,"D"
"18408",1993-07-24,1993,"FC Sochaux","Angers SCO","4-1",4,1,"1",1,5,3,"H"
"18409",1993-07-31,1993,"AS Monaco","Toulouse FC","3-0",3,0,"1",1,3,3,"H"
"18410",1993-07-31,1993,"Le Havre AC","Girondins Bordeaux","0-3",0,3,"1",1,3,-3,"D"
"18411",1993-07-31,1993,"RC Lens","RC Strasbourg","0-0",0,0,"1",1,0,0,"D"
"18412",1993-07-31,1993,"Olympique Lyon","SM Caen","2-0",2,0,"1",1,2,2,"H"
"18413",1993-07-31,1993,"FC Martigues","FC Sochaux","1-1",1,1,"1",1,2,0,"D"
"18414",1993-07-31,1993,"FC Metz","Angers SCO","2-0",2,0,"1",1,2,2,"H"
"18415",1993-07-31,1993,"FC Nantes","AS Saint-Etienne","1-0",1,0,"1",1,1,1,"H"
"18416",1993-07-31,1993,"AJ Auxerre","Montpellier HSC","3-1",3,1,"1",1,4,2,"H"
"18417",1993-07-31,1993,"Paris Saint-Germain","Lille OSC","2-1",2,1,"1",1,3,1,"H"
"18418",1993-08-01,1993,"AS Cannes","Olympique Marseille","2-1",2,1,"1",1,3,1,"H"
"18419",1993-08-06,1993,"Lille OSC","RC Lens","0-0",0,0,"1",1,0,0,"D"
"18420",1993-08-07,1993,"RC Strasbourg","Paris Saint-Germain","2-2",2,2,"1",1,4,0,"D"
"18421",1993-08-07,1993,"Toulouse FC","FC Nantes","0-3",0,3,"1",1,3,-3,"D"
"18422",1993-08-07,1993,"AS Saint-Etienne","AS Monaco","2-0",2,0,"1",1,2,2,"H"
"18423",1993-08-07,1993,"Montpellier HSC","FC Martigues","1-0",1,0,"1",1,1,1,"H"
"18424",1993-08-07,1993,"Olympique Marseille","Le Havre AC","1-1",1,1,"1",1,2,0,"D"
"18425",1993-08-07,1993,"SM Caen","AJ Auxerre","1-0",1,0,"1",1,1,1,"H"
"18426",1993-08-07,1993,"Girondins Bordeaux","AS Cannes","0-0",0,0,"1",1,0,0,"D"
"18427",1993-08-07,1993,"Angers SCO","Olympique Lyon","3-1",3,1,"1",1,4,2,"H"
"18428",1993-08-07,1993,"FC Sochaux","FC Metz","2-1",2,1,"1",1,3,1,"H"
"18429",1993-08-10,1993,"AS Monaco","Girondins Bordeaux","3-2",3,2,"1",1,5,1,"H"
"18430",1993-08-11,1993,"AJ Auxerre","Angers SCO","0-0",0,0,"1",1,0,0,"D"
"18431",1993-08-11,1993,"Toulouse FC","RC Strasbourg","0-0",0,0,"1",1,0,0,"D"
"18432",1993-08-11,1993,"Paris Saint-Germain","FC Sochaux","1-0",1,0,"1",1,1,1,"H"
"18433",1993-08-11,1993,"FC Nantes","Olympique Marseille","0-0",0,0,"1",1,0,0,"D"
"18434",1993-08-11,1993,"FC Martigues","SM Caen","4-1",4,1,"1",1,5,3,"H"
"18435",1993-08-11,1993,"Olympique Lyon","FC Metz","2-0",2,0,"1",1,2,2,"H"
"18436",1993-08-11,1993,"RC Lens","Montpellier HSC","2-1",2,1,"1",1,3,1,"H"
"18437",1993-08-11,1993,"AS Cannes","Lille OSC","2-1",2,1,"1",1,3,1,"H"
"18438",1993-08-11,1993,"Le Havre AC","AS Saint-Etienne","0-0",0,0,"1",1,0,0,"D"
"18439",1993-08-14,1993,"Montpellier HSC","AS Monaco","0-3",0,3,"1",1,3,-3,"D"
"18440",1993-08-14,1993,"Angers SCO","FC Martigues","1-3",1,3,"1",1,4,-2,"D"
"18441",1993-08-14,1993,"FC Sochaux","Olympique Lyon","0-1",0,1,"1",1,1,-1,"D"
"18442",1993-08-14,1993,"RC Strasbourg","AS Cannes","2-2",2,2,"1",1,4,0,"D"
"18443",1993-08-14,1993,"Girondins Bordeaux","FC Nantes","2-0",2,0,"1",1,2,2,"H"
"18444",1993-08-14,1993,"FC Metz","AJ Auxerre","0-0",0,0,"1",1,0,0,"D"
"18445",1993-08-14,1993,"Lille OSC","Le Havre AC","2-2",2,2,"1",1,4,0,"D"
"18446",1993-08-14,1993,"SM Caen","RC Lens","1-0",1,0,"1",1,1,1,"H"
"18447",1993-08-14,1993,"AS Saint-Etienne","Toulouse FC","2-2",2,2,"1",1,4,0,"D"
"18448",1993-08-15,1993,"Olympique Marseille","Paris Saint-Germain","1-0",1,0,"1",1,1,1,"H"
"18449",1993-08-27,1993,"AS Monaco","Olympique Marseille","0-0",0,0,"1",1,0,0,"D"
"18450",1993-08-28,1993,"RC Lens","Angers SCO","0-1",0,1,"1",1,1,-1,"D"
"18451",1993-08-28,1993,"AS Saint-Etienne","Girondins Bordeaux","0-0",0,0,"1",1,0,0,"D"
"18452",1993-08-28,1993,"AJ Auxerre","Olympique Lyon","3-2",3,2,"1",1,5,1,"H"
"18453",1993-08-28,1993,"Le Havre AC","RC Strasbourg","0-1",0,1,"1",1,1,-1,"D"
"18454",1993-08-28,1993,"FC Martigues","FC Metz","1-1",1,1,"1",1,2,0,"D"
"18455",1993-08-28,1993,"Toulouse FC","Lille OSC","1-1",1,1,"1",1,2,0,"D"
"18456",1993-08-28,1993,"FC Nantes","Montpellier HSC","0-0",0,0,"1",1,0,0,"D"
"18457",1993-08-28,1993,"Paris Saint-Germain","SM Caen","2-0",2,0,"1",1,2,2,"H"
"18458",1993-08-28,1993,"AS Cannes","FC Sochaux","1-1",1,1,"1",1,2,0,"D"
"18459",1993-08-31,1993,"Girondins Bordeaux","Toulouse FC","2-0",2,0,"1",1,2,2,"H"
"18460",1993-09-01,1993,"Angers SCO","Paris Saint-Germain","1-1",1,1,"1",1,2,0,"D"
"18461",1993-09-01,1993,"FC Sochaux","AJ Auxerre","1-0",1,0,"1",1,1,1,"H"
"18462",1993-09-01,1993,"FC Metz","RC Lens","2-1",2,1,"1",1,3,1,"H"
"18463",1993-09-01,1993,"RC Strasbourg","AS Monaco","1-1",1,1,"1",1,2,0,"D"
"18464",1993-09-01,1993,"Montpellier HSC","Le Havre AC","2-1",2,1,"1",1,3,1,"H"
"18465",1993-09-01,1993,"Olympique Marseille","AS Saint-Etienne","3-1",3,1,"1",1,4,2,"H"
"18466",1993-09-01,1993,"Olympique Lyon","FC Martigues","0-0",0,0,"1",1,0,0,"D"
"18467",1993-09-01,1993,"SM Caen","AS Cannes","1-1",1,1,"1",1,2,0,"D"
"18468",1993-09-01,1993,"Lille OSC","FC Nantes","0-0",0,0,"1",1,0,0,"D"
"18469",1993-09-10,1993,"Le Havre AC","SM Caen","1-2",1,2,"1",1,3,-1,"D"
"18470",1993-09-11,1993,"Girondins Bordeaux","FC Metz","2-0",2,0,"1",1,2,2,"H"
"18471",1993-09-11,1993,"FC Nantes","RC Strasbourg","2-2",2,2,"1",1,4,0,"D"
"18472",1993-09-11,1993,"Toulouse FC","Olympique Marseille","0-0",0,0,"1",1,0,0,"D"
"18473",1993-09-11,1993,"AS Saint-Etienne","FC Sochaux","0-0",0,0,"1",1,0,0,"D"
"18474",1993-09-11,1993,"Paris Saint-Germain","Montpellier HSC","1-0",1,0,"1",1,1,1,"H"
"18475",1993-09-11,1993,"FC Martigues","AJ Auxerre","0-1",0,1,"1",1,1,-1,"D"
"18476",1993-09-11,1993,"AS Cannes","Angers SCO","4-3",4,3,"1",1,7,1,"H"
"18477",1993-09-11,1993,"RC Lens","Olympique Lyon","2-0",2,0,"1",1,2,2,"H"
"18478",1993-09-11,1993,"AS Monaco","Lille OSC","1-0",1,0,"1",1,1,1,"H"
"18479",1993-09-18,1993,"Olympique Marseille","Girondins Bordeaux","3-1",3,1,"1",1,4,2,"H"
"18480",1993-09-18,1993,"FC Sochaux","AS Monaco","2-0",2,0,"1",1,2,2,"H"
"18481",1993-09-18,1993,"RC Strasbourg","FC Martigues","3-0",3,0,"1",1,3,3,"H"
"18482",1993-09-18,1993,"FC Metz","Le Havre AC","2-0",2,0,"1",1,2,2,"H"
"18483",1993-09-18,1993,"Olympique Lyon","Paris Saint-Germain","1-3",1,3,"1",1,4,-2,"D"
"18484",1993-09-18,1993,"Lille OSC","AS Saint-Etienne","0-2",0,2,"1",1,2,-2,"D"
"18485",1993-09-18,1993,"SM Caen","Toulouse FC","1-0",1,0,"1",1,1,1,"H"
"18486",1993-09-18,1993,"AJ Auxerre","RC Lens","1-0",1,0,"1",1,1,1,"H"
"18487",1993-09-18,1993,"Montpellier HSC","AS Cannes","2-1",2,1,"1",1,3,1,"H"
"18488",1993-09-19,1993,"Angers SCO","FC Nantes","0-0",0,0,"1",1,0,0,"D"
"18489",1993-09-23,1993,"Paris Saint-Germain","AJ Auxerre","4-0",4,0,"1",1,4,4,"H"
"18490",1993-09-24,1993,"RC Lens","FC Martigues","1-1",1,1,"1",1,2,0,"D"
"18491",1993-09-24,1993,"Olympique Marseille","FC Metz","0-3",0,3,"1",1,3,-3,"D"
"18492",1993-09-24,1993,"AS Saint-Etienne","RC Strasbourg","0-0",0,0,"1",1,0,0,"D"
"18493",1993-09-24,1993,"FC Nantes","SM Caen","1-0",1,0,"1",1,1,1,"H"
"18494",1993-09-24,1993,"Le Havre AC","FC Sochaux","0-0",0,0,"1",1,0,0,"D"
"18495",1993-09-24,1993,"AS Cannes","Olympique Lyon","1-0",1,0,"1",1,1,1,"H"
"18496",1993-09-24,1993,"Girondins Bordeaux","Lille OSC","2-1",2,1,"1",1,3,1,"H"
"18497",1993-09-24,1993,"AS Monaco","Angers SCO","3-0",3,0,"1",1,3,3,"H"
"18498",1993-10-02,1993,"FC Martigues","Paris Saint-Germain","1-1",1,1,"1",1,2,0,"D"
"18499",1993-10-02,1993,"FC Sochaux","RC Lens","1-1",1,1,"1",1,2,0,"D"
"18500",1993-10-02,1993,"RC Strasbourg","Girondins Bordeaux","0-2",0,2,"1",1,2,-2,"D"
"18501",1993-10-02,1993,"FC Metz","AS Cannes","0-0",0,0,"1",1,0,0,"D"
"18502",1993-10-02,1993,"Olympique Lyon","FC Nantes","2-1",2,1,"1",1,3,1,"H"
"18503",1993-10-02,1993,"Lille OSC","Olympique Marseille","1-2",1,2,"1",1,3,-1,"D"
"18504",1993-10-02,1993,"AJ Auxerre","Toulouse FC","5-1",5,1,"1",1,6,4,"H"
"18505",1993-10-02,1993,"Angers SCO","Le Havre AC","0-0",0,0,"1",1,0,0,"D"
"18506",1993-10-02,1993,"Montpellier HSC","AS Saint-Etienne","3-0",3,0,"1",1,3,3,"H"
"18507",1993-10-03,1993,"SM Caen","AS Monaco","0-1",0,1,"1",1,1,-1,"D"
"18508",1993-10-05,1993,"Girondins Bordeaux","Montpellier HSC","1-1",1,1,"1",1,2,0,"D"
"18509",1993-10-06,1993,"AS Monaco","Olympique Lyon","1-1",1,1,"1",1,2,0,"D"
"18510",1993-10-06,1993,"AS Saint-Etienne","SM Caen","5-0",5,0,"1",1,5,5,"H"
"18511",1993-10-06,1993,"Toulouse FC","Angers SCO","2-1",2,1,"1",1,3,1,"H"
"18512",1993-10-06,1993,"Paris Saint-Germain","RC Lens","1-0",1,0,"1",1,1,1,"H"
"18513",1993-10-06,1993,"FC Nantes","FC Metz","2-0",2,0,"1",1,2,2,"H"
"18514",1993-10-06,1993,"Lille OSC","FC Sochaux","3-1",3,1,"1",1,4,2,"H"
"18515",1993-10-06,1993,"Le Havre AC","AJ Auxerre","1-0",1,0,"1",1,1,1,"H"
"18516",1993-10-06,1993,"AS Cannes","FC Martigues","2-1",2,1,"1",1,3,1,"H"
"18517",1993-10-06,1993,"Olympique Marseille","RC Strasbourg","2-1",2,1,"1",1,3,1,"H"
"18518",1993-10-16,1993,"Olympique Lyon","Le Havre AC","1-1",1,1,"1",1,2,0,"D"
"18519",1993-10-16,1993,"RC Strasbourg","Lille OSC","1-1",1,1,"1",1,2,0,"D"
"18520",1993-10-16,1993,"FC Martigues","Toulouse FC","1-1",1,1,"1",1,2,0,"D"
"18521",1993-10-16,1993,"RC Lens","AS Cannes","2-1",2,1,"1",1,3,1,"H"
"18522",1993-10-16,1993,"SM Caen","Girondins Bordeaux","1-0",1,0,"1",1,1,1,"H"
"18523",1993-10-16,1993,"AJ Auxerre","AS Monaco","4-0",4,0,"1",1,4,4,"H"
"18524",1993-10-16,1993,"Angers SCO","AS Saint-Etienne","1-1",1,1,"1",1,2,0,"D"
"18525",1993-10-16,1993,"FC Metz","Paris Saint-Germain","0-1",0,1,"1",1,1,-1,"D"
"18526",1993-10-17,1993,"FC Sochaux","FC Nantes","1-1",1,1,"1",1,2,0,"D"
"18527",1993-10-22,1993,"RC Strasbourg","SM Caen","3-0",3,0,"1",1,3,3,"H"
"18528",1993-10-23,1993,"AS Monaco","FC Martigues","7-0",7,0,"1",1,7,7,"H"
"18529",1993-10-23,1993,"Toulouse FC","Olympique Lyon","2-0",2,0,"1",1,2,2,"H"
"18530",1993-10-23,1993,"AS Saint-Etienne","FC Metz","1-0",1,0,"1",1,1,1,"H"
"18531",1993-10-23,1993,"FC Nantes","AJ Auxerre","1-2",1,2,"1",1,3,-1,"D"
"18532",1993-10-23,1993,"Olympique Marseille","FC Sochaux","1-1",1,1,"1",1,2,0,"D"
"18533",1993-10-23,1993,"Lille OSC","Montpellier HSC","0-0",0,0,"1",1,0,0,"D"
"18534",1993-10-23,1993,"Le Havre AC","RC Lens","1-1",1,1,"1",1,2,0,"D"
"18535",1993-10-23,1993,"Girondins Bordeaux","Angers SCO","1-0",1,0,"1",1,1,1,"H"
"18536",1993-10-23,1993,"AS Cannes","Paris Saint-Germain","0-1",0,1,"1",1,1,-1,"D"
"18537",1993-10-28,1993,"AJ Auxerre","AS Cannes","0-0",0,0,"1",1,0,0,"D"
"18538",1993-10-29,1993,"SM Caen","Lille OSC","2-3",2,3,"1",1,5,-1,"D"
"18539",1993-10-29,1993,"Montpellier HSC","RC Strasbourg","4-0",4,0,"1",1,4,4,"H"
"18540",1993-10-29,1993,"FC Sochaux","Girondins Bordeaux","2-2",2,2,"1",1,4,0,"D"
"18541",1993-10-29,1993,"Paris Saint-Germain","FC Nantes","1-0",1,0,"1",1,1,1,"H"
"18542",1993-10-29,1993,"Olympique Lyon","AS Saint-Etienne","1-0",1,0,"1",1,1,1,"H"
"18543",1993-10-29,1993,"FC Martigues","Le Havre AC","3-0",3,0,"1",1,3,3,"H"
"18544",1993-10-29,1993,"Angers SCO","Olympique Marseille","0-1",0,1,"1",1,1,-1,"D"
"18545",1993-10-29,1993,"RC Lens","AS Monaco","3-3",3,3,"1",1,6,0,"D"
"18546",1993-10-29,1993,"FC Metz","Toulouse FC","1-0",1,0,"1",1,1,1,"H"
"18547",1993-11-02,1993,"Toulouse FC","Montpellier HSC","0-0",0,0,"1",1,0,0,"D"
"18548",1993-11-06,1993,"AS Monaco","Paris Saint-Germain","1-1",1,1,"1",1,2,0,"D"
"18549",1993-11-06,1993,"Toulouse FC","RC Lens","1-1",1,1,"1",1,2,0,"D"
"18550",1993-11-06,1993,"AS Saint-Etienne","AJ Auxerre","1-0",1,0,"1",1,1,1,"H"
"18551",1993-11-06,1993,"FC Nantes","FC Martigues","2-1",2,1,"1",1,3,1,"H"
"18552",1993-11-06,1993,"Olympique Marseille","SM Caen","2-0",2,0,"1",1,2,2,"H"
"18553",1993-11-06,1993,"Lille OSC","Angers SCO","1-1",1,1,"1",1,2,0,"D"
"18554",1993-11-06,1993,"Le Havre AC","AS Cannes","3-1",3,1,"1",1,4,2,"H"
"18555",1993-11-06,1993,"Girondins Bordeaux","Olympique Lyon","2-0",2,0,"1",1,2,2,"H"
"18556",1993-11-06,1993,"RC Strasbourg","FC Sochaux","2-0",2,0,"1",1,2,2,"H"
"18557",1993-11-07,1993,"Montpellier HSC","FC Metz","3-2",3,2,"1",1,5,1,"H"
"18558",1993-11-09,1993,"Olympique Lyon","Olympique Marseille","1-0",1,0,"1",1,1,1,"H"
"18559",1993-11-10,1993,"FC Metz","Lille OSC","1-1",1,1,"1",1,2,0,"D"
"18560",1993-11-10,1993,"FC Sochaux","Toulouse FC","0-0",0,0,"1",1,0,0,"D"
"18561",1993-11-10,1993,"Paris Saint-Germain","Le Havre AC","0-0",0,0,"1",1,0,0,"D"
"18562",1993-11-10,1993,"AJ Auxerre","Girondins Bordeaux","0-1",0,1,"1",1,1,-1,"D"
"18563",1993-11-10,1993,"RC Lens","FC Nantes","1-1",1,1,"1",1,2,0,"D"
"18564",1993-11-10,1993,"Angers SCO","RC Strasbourg","1-3",1,3,"1",1,4,-2,"D"
"18565",1993-11-10,1993,"AS Cannes","AS Monaco","0-2",0,2,"1",1,2,-2,"D"
"18566",1993-11-10,1993,"SM Caen","Montpellier HSC","0-0",0,0,"1",1,0,0,"D"
"18567",1993-11-10,1993,"FC Martigues","AS Saint-Etienne","2-1",2,1,"1",1,3,1,"H"
"18568",1993-11-19,1993,"Girondins Bordeaux","FC Martigues","1-1",1,1,"1",1,2,0,"D"
"18569",1993-11-20,1993,"FC Nantes","AS Cannes","0-0",0,0,"1",1,0,0,"D"
"18570",1993-11-20,1993,"Toulouse FC","Paris Saint-Germain","1-2",1,2,"1",1,3,-1,"D"
"18571",1993-11-20,1993,"AS Saint-Etienne","RC Lens","0-0",0,0,"1",1,0,0,"D"
"18572",1993-11-20,1993,"RC Strasbourg","FC Metz","0-0",0,0,"1",1,0,0,"D"
"18573",1993-11-20,1993,"AS Monaco","Le Havre AC","1-1",1,1,"1",1,2,0,"D"
"18574",1993-11-20,1993,"Olympique Marseille","AJ Auxerre","0-3",0,3,"1",1,3,-3,"D"
"18575",1993-11-20,1993,"Lille OSC","Olympique Lyon","2-1",2,1,"1",1,3,1,"H"
"18576",1993-11-20,1993,"SM Caen","FC Sochaux","2-1",2,1,"1",1,3,1,"H"
"18577",1993-11-20,1993,"Montpellier HSC","Angers SCO","2-1",2,1,"1",1,3,1,"H"
"18578",1993-11-27,1993,"AJ Auxerre","Lille OSC","5-0",5,0,"1",1,5,5,"H"
"18579",1993-11-27,1993,"FC Sochaux","Montpellier HSC","2-1",2,1,"1",1,3,1,"H"
"18580",1993-11-27,1993,"Paris Saint-Germain","AS Saint-Etienne","1-0",1,0,"1",1,1,1,"H"
"18581",1993-11-27,1993,"FC Metz","AS Monaco","1-1",1,1,"1",1,2,0,"D"
"18582",1993-11-27,1993,"RC Lens","Girondins Bordeaux","1-0",1,0,"1",1,1,1,"H"
"18583",1993-11-27,1993,"Le Havre AC","FC Nantes","0-0",0,0,"1",1,0,0,"D"
"18584",1993-11-27,1993,"Angers SCO","SM Caen","2-0",2,0,"1",1,2,2,"H"
"18585",1993-11-27,1993,"AS Cannes","Toulouse FC","2-1",2,1,"1",1,3,1,"H"
"18586",1993-11-27,1993,"Olympique Lyon","RC Strasbourg","2-1",2,1,"1",1,3,1,"H"
"18587",1993-11-28,1993,"FC Martigues","Olympique Marseille","0-3",0,3,"1",1,3,-3,"D"
"18588",1993-12-02,1993,"AS Saint-Etienne","FC Nantes","1-1",1,1,"1",1,2,0,"D"
"18589",1993-12-03,1993,"Olympique Marseille","AS Cannes","3-1",3,1,"1",1,4,2,"H"
"18590",1993-12-03,1993,"Toulouse FC","AS Monaco","2-1",2,1,"1",1,3,1,"H"
"18591",1993-12-03,1993,"FC Sochaux","FC Martigues","1-0",1,0,"1",1,1,1,"H"
"18592",1993-12-03,1993,"Montpellier HSC","AJ Auxerre","1-0",1,0,"1",1,1,1,"H"
"18593",1993-12-03,1993,"Lille OSC","Paris Saint-Germain","0-2",0,2,"1",1,2,-2,"D"
"18594",1993-12-03,1993,"SM Caen","Olympique Lyon","1-0",1,0,"1",1,1,1,"H"
"18595",1993-12-03,1993,"Girondins Bordeaux","Le Havre AC","2-1",2,1,"1",1,3,1,"H"
"18596",1993-12-03,1993,"Angers SCO","FC Metz","1-2",1,2,"1",1,3,-1,"D"
"18597",1993-12-03,1993,"RC Strasbourg","RC Lens","2-0",2,0,"1",1,2,2,"H"
"18598",1993-12-10,1993,"RC Lens","Lille OSC","1-1",1,1,"1",1,2,0,"D"
"18599",1993-12-11,1993,"FC Metz","FC Sochaux","1-1",1,1,"1",1,2,0,"D"
"18600",1993-12-11,1993,"Paris Saint-Germain","RC Strasbourg","2-0",2,0,"1",1,2,2,"H"
"18601",1993-12-11,1993,"FC Nantes","Toulouse FC","4-0",4,0,"1",1,4,4,"H"
"18602",1993-12-11,1993,"AS Monaco","AS Saint-Etienne","1-1",1,1,"1",1,2,0,"D"
"18603",1993-12-11,1993,"FC Martigues","Montpellier HSC","1-1",1,1,"1",1,2,0,"D"
"18604",1993-12-11,1993,"Olympique Lyon","Angers SCO","1-1",1,1,"1",1,2,0,"D"
"18605",1993-12-11,1993,"Le Havre AC","Olympique Marseille","1-3",1,3,"1",1,4,-2,"D"
"18606",1993-12-11,1993,"AJ Auxerre","SM Caen","1-0",1,0,"1",1,1,1,"H"
"18607",1993-12-11,1993,"AS Cannes","Girondins Bordeaux","2-1",2,1,"1",1,3,1,"H"
"18608",1993-12-15,1993,"Montpellier HSC","Olympique Marseille","0-2",0,2,"1",1,2,-2,"D"
"18609",1993-12-18,1993,"FC Metz","Olympique Lyon","0-1",0,1,"1",1,1,-1,"D"
"18610",1993-12-18,1993,"FC Sochaux","Paris Saint-Germain","1-2",1,2,"1",1,3,-1,"D"
"18611",1993-12-18,1993,"AS Saint-Etienne","Le Havre AC","0-0",0,0,"1",1,0,0,"D"
"18612",1993-12-18,1993,"Montpellier HSC","RC Lens","0-0",0,0,"1",1,0,0,"D"
"18613",1993-12-18,1993,"Lille OSC","AS Cannes","1-0",1,0,"1",1,1,1,"H"
"18614",1993-12-18,1993,"SM Caen","FC Martigues","4-1",4,1,"1",1,5,3,"H"
"18615",1993-12-18,1993,"Angers SCO","AJ Auxerre","2-2",2,2,"1",1,4,0,"D"
"18616",1993-12-18,1993,"RC Strasbourg","Toulouse FC","1-0",1,0,"1",1,1,1,"H"
"18617",1993-12-18,1993,"Olympique Marseille","FC Nantes","3-1",3,1,"1",1,4,2,"H"
"18618",1993-12-19,1993,"Girondins Bordeaux","AS Monaco","1-0",1,0,"1",1,1,1,"H"
"18619",1994-01-14,1993,"Paris Saint-Germain","Olympique Marseille","1-1",1,1,"1",1,2,0,"D"
"18620",1994-01-15,1993,"RC Lens","SM Caen","2-0",2,0,"1",1,2,2,"H"
"18621",1994-01-15,1993,"Toulouse FC","AS Saint-Etienne","1-2",1,2,"1",1,3,-1,"D"
"18622",1994-01-15,1993,"FC Nantes","Girondins Bordeaux","4-1",4,1,"1",1,5,3,"H"
"18623",1994-01-15,1993,"AS Monaco","Montpellier HSC","1-2",1,2,"1",1,3,-1,"D"
"18624",1994-01-15,1993,"Olympique Lyon","FC Sochaux","1-0",1,0,"1",1,1,1,"H"
"18625",1994-01-15,1993,"Le Havre AC","Lille OSC","1-0",1,0,"1",1,1,1,"H"
"18626",1994-01-15,1993,"AS Cannes","RC Strasbourg","1-1",1,1,"1",1,2,0,"D"
"18627",1994-01-15,1993,"AJ Auxerre","FC Metz","2-0",2,0,"1",1,2,2,"H"
"18628",1994-01-15,1993,"FC Martigues","Angers SCO","0-0",0,0,"1",1,0,0,"D"
"18629",1994-01-28,1993,"Olympique Marseille","AS Monaco","2-1",2,1,"1",1,3,1,"H"
"18630",1994-01-29,1993,"Lille OSC","Toulouse FC","3-0",3,0,"1",1,3,3,"H"
"18631",1994-01-29,1993,"Olympique Lyon","AJ Auxerre","1-0",1,0,"1",1,1,1,"H"
"18632",1994-01-29,1993,"FC Sochaux","AS Cannes","1-1",1,1,"1",1,2,0,"D"
"18633",1994-01-29,1993,"RC Strasbourg","Le Havre AC","0-3",0,3,"1",1,3,-3,"D"
"18634",1994-01-29,1993,"Montpellier HSC","FC Nantes","1-0",1,0,"1",1,1,1,"H"
"18635",1994-01-29,1993,"SM Caen","Paris Saint-Germain","0-2",0,2,"1",1,2,-2,"D"
"18636",1994-01-29,1993,"Girondins Bordeaux","AS Saint-Etienne","1-2",1,2,"1",1,3,-1,"D"
"18637",1994-01-29,1993,"Angers SCO","RC Lens","1-2",1,2,"1",1,3,-1,"D"
"18638",1994-01-29,1993,"FC Metz","FC Martigues","0-0",0,0,"1",1,0,0,"D"
"18639",1994-02-04,1993,"Toulouse FC","Girondins Bordeaux","0-0",0,0,"1",1,0,0,"D"
"18640",1994-02-05,1993,"RC Lens","FC Metz","2-0",2,0,"1",1,2,2,"H"
"18641",1994-02-05,1993,"AS Saint-Etienne","Olympique Marseille","0-0",0,0,"1",1,0,0,"D"
"18642",1994-02-05,1993,"Paris Saint-Germain","Angers SCO","3-0",3,0,"1",1,3,3,"H"
"18643",1994-02-05,1993,"FC Martigues","Olympique Lyon","0-1",0,1,"1",1,1,-1,"D"
"18644",1994-02-05,1993,"AS Monaco","RC Strasbourg","2-1",2,1,"1",1,3,1,"H"
"18645",1994-02-05,1993,"Le Havre AC","Montpellier HSC","0-0",0,0,"1",1,0,0,"D"
"18646",1994-02-05,1993,"AS Cannes","SM Caen","3-0",3,0,"1",1,3,3,"H"
"18647",1994-02-05,1993,"AJ Auxerre","FC Sochaux","1-0",1,0,"1",1,1,1,"H"
"18648",1994-02-05,1993,"FC Nantes","Lille OSC","2-0",2,0,"1",1,2,2,"H"
"18649",1994-02-08,1993,"SM Caen","Le Havre AC","1-1",1,1,"1",1,2,0,"D"
"18650",1994-02-09,1993,"Olympique Marseille","Toulouse FC","5-1",5,1,"1",1,6,4,"H"
"18651",1994-02-09,1993,"RC Strasbourg","FC Nantes","0-3",0,3,"1",1,3,-3,"D"
"18652",1994-02-09,1993,"FC Sochaux","AS Saint-Etienne","3-2",3,2,"1",1,5,1,"H"
"18653",1994-02-09,1993,"Montpellier HSC","Paris Saint-Germain","0-0",0,0,"1",1,0,0,"D"
"18654",1994-02-09,1993,"FC Metz","Girondins Bordeaux","1-0",1,0,"1",1,1,1,"H"
"18655",1994-02-09,1993,"Lille OSC","AS Monaco","1-1",1,1,"1",1,2,0,"D"
"18656",1994-02-09,1993,"AJ Auxerre","FC Martigues","3-0",3,0,"1",1,3,3,"H"
"18657",1994-02-09,1993,"Angers SCO","AS Cannes","1-1",1,1,"1",1,2,0,"D"
"18658",1994-02-09,1993,"Olympique Lyon","RC Lens","1-2",1,2,"1",1,3,-1,"D"
"18659",1994-02-19,1993,"AS Monaco","FC Sochaux","2-0",2,0,"1",1,2,2,"H"
"18660",1994-02-19,1993,"Toulouse FC","SM Caen","0-1",0,1,"1",1,1,-1,"D"
"18661",1994-02-19,1993,"AS Saint-Etienne","Lille OSC","2-1",2,1,"1",1,3,1,"H"
"18662",1994-02-19,1993,"FC Nantes","Angers SCO","2-1",2,1,"1",1,3,1,"H"
"18663",1994-02-19,1993,"FC Martigues","RC Strasbourg","0-3",0,3,"1",1,3,-3,"D"
"18664",1994-02-19,1993,"RC Lens","AJ Auxerre","1-1",1,1,"1",1,2,0,"D"
"18665",1994-02-19,1993,"Le Havre AC","FC Metz","0-1",0,1,"1",1,1,-1,"D"
"18666",1994-02-19,1993,"AS Cannes","Montpellier HSC","2-0",2,0,"1",1,2,2,"H"
"18667",1994-02-19,1993,"Paris Saint-Germain","Olympique Lyon","0-0",0,0,"1",1,0,0,"D"
"18668",1994-02-20,1993,"Girondins Bordeaux","Olympique Marseille","1-0",1,0,"1",1,1,1,"H"
"18669",1994-02-24,1993,"AJ Auxerre","Paris Saint-Germain","0-0",0,0,"1",1,0,0,"D"
"18670",1994-02-25,1993,"FC Martigues","RC Lens","1-2",1,2,"1",1,3,-1,"D"
"18671",1994-02-25,1993,"RC Strasbourg","AS Saint-Etienne","2-0",2,0,"1",1,2,2,"H"
"18672",1994-02-25,1993,"FC Sochaux","Le Havre AC","4-2",4,2,"1",1,6,2,"H"
"18673",1994-02-25,1993,"Montpellier HSC","Toulouse FC","3-1",3,1,"1",1,4,2,"H"
"18674",1994-02-25,1993,"FC Metz","Olympique Marseille","0-0",0,0,"1",1,0,0,"D"
"18675",1994-02-25,1993,"Olympique Lyon","AS Cannes","2-2",2,2,"1",1,4,0,"D"
"18676",1994-02-25,1993,"Lille OSC","Girondins Bordeaux","1-1",1,1,"1",1,2,0,"D"
"18677",1994-02-25,1993,"SM Caen","FC Nantes","0-0",0,0,"1",1,0,0,"D"
"18678",1994-02-25,1993,"Angers SCO","AS Monaco","1-1",1,1,"1",1,2,0,"D"
"18679",1994-03-05,1993,"Olympique Marseille","Lille OSC","3-2",3,2,"1",1,5,1,"H"
"18680",1994-03-05,1993,"AS Monaco","SM Caen","3-0",3,0,"1",1,3,3,"H"
"18681",1994-03-05,1993,"Toulouse FC","AJ Auxerre","0-0",0,0,"1",1,0,0,"D"
"18682",1994-03-05,1993,"AS Saint-Etienne","Montpellier HSC","2-0",2,0,"1",1,2,2,"H"
"18683",1994-03-05,1993,"Girondins Bordeaux","RC Strasbourg","2-0",2,0,"1",1,2,2,"H"
"18684",1994-03-05,1993,"RC Lens","FC Sochaux","2-0",2,0,"1",1,2,2,"H"
"18685",1994-03-05,1993,"Le Havre AC","Angers SCO","2-1",2,1,"1",1,3,1,"H"
"18686",1994-03-05,1993,"AS Cannes","FC Metz","2-0",2,0,"1",1,2,2,"H"
"18687",1994-03-05,1993,"FC Nantes","Olympique Lyon","1-0",1,0,"1",1,1,1,"H"
"18688",1994-03-06,1993,"Paris Saint-Germain","FC Martigues","2-2",2,2,"1",1,4,0,"D"
"18689",1994-03-11,1993,"Olympique Lyon","AS Monaco","1-0",1,0,"1",1,1,1,"H"
"18690",1994-03-11,1993,"FC Sochaux","Lille OSC","1-0",1,0,"1",1,1,1,"H"
"18691",1994-03-11,1993,"RC Strasbourg","Olympique Marseille","1-1",1,1,"1",1,2,0,"D"
"18692",1994-03-11,1993,"FC Martigues","AS Cannes","4-0",4,0,"1",1,4,4,"H"
"18693",1994-03-11,1993,"RC Lens","Paris Saint-Germain","1-2",1,2,"1",1,3,-1,"D"
"18694",1994-03-11,1993,"SM Caen","AS Saint-Etienne","1-0",1,0,"1",1,1,1,"H"
"18695",1994-03-11,1993,"AJ Auxerre","Le Havre AC","3-0",3,0,"1",1,3,3,"H"
"18696",1994-03-11,1993,"Angers SCO","Toulouse FC","0-0",0,0,"1",1,0,0,"D"
"18697",1994-03-11,1993,"Montpellier HSC","Girondins Bordeaux","1-0",1,0,"1",1,1,1,"H"
"18698",1994-03-13,1993,"FC Metz","FC Nantes","2-0",2,0,"1",1,2,2,"H"
"18699",1994-03-25,1993,"AS Monaco","AJ Auxerre","0-1",0,1,"1",1,1,-1,"D"
"18700",1994-03-26,1993,"Le Havre AC","Olympique Lyon","0-1",0,1,"1",1,1,-1,"D"
"18701",1994-03-26,1993,"Lille OSC","RC Strasbourg","1-1",1,1,"1",1,2,0,"D"
"18702",1994-03-26,1993,"Toulouse FC","FC Martigues","2-2",2,2,"1",1,4,0,"D"
"18703",1994-03-26,1993,"AS Saint-Etienne","Angers SCO","2-0",2,0,"1",1,2,2,"H"
"18704",1994-03-26,1993,"FC Nantes","FC Sochaux","2-0",2,0,"1",1,2,2,"H"
"18705",1994-03-26,1993,"AS Cannes","RC Lens","3-1",3,1,"1",1,4,2,"H"
"18706",1994-03-26,1993,"Girondins Bordeaux","SM Caen","3-0",3,0,"1",1,3,3,"H"
"18707",1994-03-26,1993,"Paris Saint-Germain","FC Metz","1-0",1,0,"1",1,1,1,"H"
"18708",1994-03-26,1993,"Olympique Marseille","Montpellier HSC","1-1",1,1,"1",1,2,0,"D"
"18709",1994-04-01,1993,"AJ Auxerre","FC Nantes","3-1",3,1,"1",1,4,2,"H"
"18710",1994-04-02,1993,"Olympique Lyon","Toulouse FC","1-0",1,0,"1",1,1,1,"H"
"18711",1994-04-02,1993,"Paris Saint-Germain","AS Cannes","2-1",2,1,"1",1,3,1,"H"
"18712",1994-04-02,1993,"Montpellier HSC","Lille OSC","1-3",1,3,"1",1,4,-2,"D"
"18713",1994-04-02,1993,"FC Martigues","AS Monaco","1-3",1,3,"1",1,4,-2,"D"
"18714",1994-04-02,1993,"FC Sochaux","Olympique Marseille","1-1",1,1,"1",1,2,0,"D"
"18715",1994-04-02,1993,"RC Lens","Le Havre AC","5-1",5,1,"1",1,6,4,"H"
"18716",1994-04-02,1993,"SM Caen","RC Strasbourg","3-1",3,1,"1",1,4,2,"H"
"18717",1994-04-02,1993,"Angers SCO","Girondins Bordeaux","1-3",1,3,"1",1,4,-2,"D"
"18718",1994-04-02,1993,"FC Metz","AS Saint-Etienne","0-1",0,1,"1",1,1,-1,"D"
"18719",1994-04-05,1993,"AS Monaco","RC Lens","0-0",0,0,"1",1,0,0,"D"
"18720",1994-04-05,1993,"Toulouse FC","FC Metz","2-2",2,2,"1",1,4,0,"D"
"18721",1994-04-05,1993,"RC Strasbourg","Montpellier HSC","0-1",0,1,"1",1,1,-1,"D"
"18722",1994-04-05,1993,"FC Nantes","Paris Saint-Germain","3-0",3,0,"1",1,3,3,"H"
"18723",1994-04-05,1993,"Lille OSC","SM Caen","3-1",3,1,"1",1,4,2,"H"
"18724",1994-04-05,1993,"Le Havre AC","FC Martigues","2-0",2,0,"1",1,2,2,"H"
"18725",1994-04-05,1993,"AS Cannes","AJ Auxerre","2-1",2,1,"1",1,3,1,"H"
"18726",1994-04-05,1993,"Girondins Bordeaux","FC Sochaux","4-1",4,1,"1",1,5,3,"H"
"18727",1994-04-05,1993,"Olympique Marseille","Angers SCO","2-1",2,1,"1",1,3,1,"H"
"18728",1994-04-06,1993,"AS Saint-Etienne","Olympique Lyon","3-0",3,0,"1",1,3,3,"H"
"18729",1994-04-09,1993,"RC Lens","Toulouse FC","4-0",4,0,"1",1,4,4,"H"
"18730",1994-04-09,1993,"FC Metz","Montpellier HSC","1-1",1,1,"1",1,2,0,"D"
"18731",1994-04-09,1993,"Olympique Lyon","Girondins Bordeaux","4-2",4,2,"1",1,6,2,"H"
"18732",1994-04-09,1993,"FC Sochaux","RC Strasbourg","1-3",1,3,"1",1,4,-2,"D"
"18733",1994-04-09,1993,"AS Cannes","Le Havre AC","1-0",1,0,"1",1,1,1,"H"
"18734",1994-04-09,1993,"SM Caen","Olympique Marseille","1-0",1,0,"1",1,1,1,"H"
"18735",1994-04-09,1993,"AJ Auxerre","AS Saint-Etienne","3-0",3,0,"1",1,3,3,"H"
"18736",1994-04-09,1993,"Angers SCO","Lille OSC","1-2",1,2,"1",1,3,-1,"D"
"18737",1994-04-09,1993,"FC Martigues","FC Nantes","1-2",1,2,"1",1,3,-1,"D"
"18738",1994-04-17,1993,"Paris Saint-Germain","AS Monaco","1-1",1,1,"1",1,2,0,"D"
"18739",1994-04-22,1993,"AS Monaco","AS Cannes","2-0",2,0,"1",1,2,2,"H"
"18740",1994-04-26,1993,"Montpellier HSC","SM Caen","0-0",0,0,"1",1,0,0,"D"
"18741",1994-04-26,1993,"AS Saint-Etienne","FC Martigues","1-1",1,1,"1",1,2,0,"D"
"18742",1994-04-26,1993,"Toulouse FC","FC Sochaux","3-2",3,2,"1",1,5,1,"H"
"18743",1994-04-26,1993,"RC Strasbourg","Angers SCO","2-2",2,2,"1",1,4,0,"D"
"18744",1994-04-26,1993,"FC Nantes","RC Lens","2-1",2,1,"1",1,3,1,"H"
"18745",1994-04-26,1993,"Olympique Marseille","Olympique Lyon","3-0",3,0,"1",1,3,3,"H"
"18746",1994-04-26,1993,"Lille OSC","FC Metz","0-4",0,4,"1",1,4,-4,"D"
"18747",1994-04-26,1993,"Le Havre AC","Paris Saint-Germain","0-2",0,2,"1",1,2,-2,"D"
"18748",1994-04-26,1993,"Girondins Bordeaux","AJ Auxerre","2-0",2,0,"1",1,2,2,"H"
"18749",1994-04-29,1993,"AS Cannes","FC Nantes","4-0",4,0,"1",1,4,4,"H"
"18750",1994-04-30,1993,"FC Martigues","Girondins Bordeaux","0-0",0,0,"1",1,0,0,"D"
"18751",1994-04-30,1993,"Le Havre AC","AS Monaco","1-0",1,0,"1",1,1,1,"H"
"18752",1994-04-30,1993,"FC Sochaux","SM Caen","0-0",0,0,"1",1,0,0,"D"
"18753",1994-04-30,1993,"Paris Saint-Germain","Toulouse FC","1-0",1,0,"1",1,1,1,"H"
"18754",1994-04-30,1993,"FC Metz","RC Strasbourg","2-1",2,1,"1",1,3,1,"H"
"18755",1994-04-30,1993,"RC Lens","AS Saint-Etienne","3-1",3,1,"1",1,4,2,"H"
"18756",1994-04-30,1993,"AJ Auxerre","Olympique Marseille","2-2",2,2,"1",1,4,0,"D"
"18757",1994-04-30,1993,"Angers SCO","Montpellier HSC","2-3",2,3,"1",1,5,-1,"D"
"18758",1994-04-30,1993,"Olympique Lyon","Lille OSC","0-0",0,0,"1",1,0,0,"D"
"18759",1994-05-07,1993,"Girondins Bordeaux","RC Lens","4-2",4,2,"1",1,6,2,"H"
"18760",1994-05-07,1993,"Montpellier HSC","FC Sochaux","1-0",1,0,"1",1,1,1,"H"
"18761",1994-05-07,1993,"AS Monaco","FC Metz","1-1",1,1,"1",1,2,0,"D"
"18762",1994-05-07,1993,"RC Strasbourg","Olympique Lyon","0-1",0,1,"1",1,1,-1,"D"
"18763",1994-05-07,1993,"AS Saint-Etienne","Paris Saint-Germain","1-2",1,2,"1",1,3,-1,"D"
"18764",1994-05-07,1993,"FC Nantes","Le Havre AC","3-1",3,1,"1",1,4,2,"H"
"18765",1994-05-07,1993,"Toulouse FC","AS Cannes","1-2",1,2,"1",1,3,-1,"D"
"18766",1994-05-07,1993,"Lille OSC","AJ Auxerre","1-1",1,1,"1",1,2,0,"D"
"18767",1994-05-07,1993,"SM Caen","Angers SCO","2-3",2,3,"1",1,5,-1,"D"
"18768",1994-05-07,1993,"Olympique Marseille","FC Martigues","0-0",0,0,"1",1,0,0,"D"
"18769",1994-05-21,1993,"AS Monaco","FC Nantes","1-0",1,0,"1",1,1,1,"H"
"18770",1994-05-21,1993,"Le Havre AC","Toulouse FC","1-1",1,1,"1",1,2,0,"D"
"18771",1994-05-21,1993,"Angers SCO","FC Sochaux","1-2",1,2,"1",1,3,-1,"D"
"18772",1994-05-21,1993,"AS Cannes","AS Saint-Etienne","0-0",0,0,"1",1,0,0,"D"
"18773",1994-05-21,1993,"AJ Auxerre","RC Strasbourg","2-1",2,1,"1",1,3,1,"H"
"18774",1994-05-21,1993,"Olympique Lyon","Montpellier HSC","3-2",3,2,"1",1,5,1,"H"
"18775",1994-05-21,1993,"RC Lens","Olympique Marseille","2-3",2,3,"1",1,5,-1,"D"
"18776",1994-05-21,1993,"FC Martigues","Lille OSC","2-2",2,2,"1",1,4,0,"D"
"18777",1994-05-21,1993,"Paris Saint-Germain","Girondins Bordeaux","4-1",4,1,"1",1,5,3,"H"
"18778",1994-05-21,1993,"FC Metz","SM Caen","2-1",2,1,"1",1,3,1,"H"
"18779",1995-07-18,1995,"SC Bastia","Paris Saint-Germain","2-2",2,2,"1",1,4,0,"D"
"18780",1995-07-19,1995,"EA Guingamp","FC Martigues","2-0",2,0,"1",1,2,2,"H"
"18781",1995-07-19,1995,"Montpellier HSC","RC Strasbourg","2-2",2,2,"1",1,4,0,"D"
"18782",1995-07-19,1995,"AS Cannes","Olympique Lyon","3-0",3,0,"1",1,3,3,"H"
"18783",1995-07-19,1995,"FC Gueugnon","FC Metz","0-0",0,0,"1",1,0,0,"D"
"18784",1995-07-19,1995,"RC Lens","Le Havre AC","2-0",2,0,"1",1,2,2,"H"
"18785",1995-07-19,1995,"AS Saint-Etienne","OGC Nice","1-1",1,1,"1",1,2,0,"D"
"18786",1995-07-19,1995,"Girondins Bordeaux","Lille OSC","1-0",1,0,"1",1,1,1,"H"
"18787",1995-07-19,1995,"FC Nantes","AJ Auxerre","1-0",1,0,"1",1,1,1,"H"
"18788",1995-07-19,1995,"AS Monaco","Stade Rennes","3-1",3,1,"1",1,4,2,"H"
"18789",1995-07-25,1995,"OGC Nice","AS Monaco","1-2",1,2,"1",1,3,-1,"D"
"18790",1995-07-26,1995,"FC Martigues","FC Nantes","0-4",0,4,"1",1,4,-4,"D"
"18791",1995-07-26,1995,"Olympique Lyon","Montpellier HSC","3-2",3,2,"1",1,5,1,"H"
"18792",1995-07-26,1995,"RC Strasbourg","Le Havre AC","3-0",3,0,"1",1,3,3,"H"
"18793",1995-07-26,1995,"Stade Rennes","AS Cannes","3-2",3,2,"1",1,5,1,"H"
"18794",1995-07-26,1995,"FC Metz","RC Lens","2-0",2,0,"1",1,2,2,"H"
"18795",1995-07-26,1995,"Paris Saint-Germain","EA Guingamp","1-1",1,1,"1",1,2,0,"D"
"18796",1995-07-26,1995,"Lille OSC","SC Bastia","0-2",0,2,"1",1,2,-2,"D"
"18797",1995-07-26,1995,"AJ Auxerre","FC Gueugnon","4-0",4,0,"1",1,4,4,"H"
"18798",1995-07-26,1995,"Girondins Bordeaux","AS Saint-Etienne","2-0",2,0,"1",1,2,2,"H"
"18799",1995-08-04,1995,"FC Nantes","Paris Saint-Germain","1-2",1,2,"1",1,3,-1,"D"
"18800",1995-08-05,1995,"FC Gueugnon","FC Martigues","0-0",0,0,"1",1,0,0,"D"
"18801",1995-08-05,1995,"RC Lens","RC Strasbourg","0-0",0,0,"1",1,0,0,"D"
"18802",1995-08-05,1995,"Montpellier HSC","Stade Rennes","3-1",3,1,"1",1,4,2,"H"
"18803",1995-08-05,1995,"Le Havre AC","Olympique Lyon","2-1",2,1,"1",1,3,1,"H"
"18804",1995-08-05,1995,"AS Monaco","AJ Auxerre","2-2",2,2,"1",1,4,0,"D"
"18805",1995-08-05,1995,"AS Saint-Etienne","Lille OSC","1-1",1,1,"1",1,2,0,"D"
"18806",1995-08-05,1995,"SC Bastia","Girondins Bordeaux","2-0",2,0,"1",1,2,2,"H"
"18807",1995-08-05,1995,"AS Cannes","FC Metz","1-2",1,2,"1",1,3,-1,"D"
"18808",1995-08-05,1995,"EA Guingamp","OGC Nice","0-0",0,0,"1",1,0,0,"D"
"18809",1995-08-09,1995,"Paris Saint-Germain","AS Saint-Etienne","4-0",4,0,"1",1,4,4,"H"
"18810",1995-08-09,1995,"Stade Rennes","Le Havre AC","1-0",1,0,"1",1,1,1,"H"
"18811",1995-08-09,1995,"FC Metz","Montpellier HSC","1-0",1,0,"1",1,1,1,"H"
"18812",1995-08-09,1995,"OGC Nice","FC Gueugnon","3-1",3,1,"1",1,4,2,"H"
"18813",1995-08-09,1995,"SC Bastia","AS Monaco","2-1",2,1,"1",1,3,1,"H"
"18814",1995-08-09,1995,"Lille OSC","EA Guingamp","0-3",0,3,"1",1,3,-3,"D"
"18815",1995-08-09,1995,"AJ Auxerre","RC Lens","0-1",0,1,"1",1,1,-1,"D"
"18816",1995-08-09,1995,"FC Martigues","AS Cannes","2-1",2,1,"1",1,3,1,"H"
"18817",1995-08-19,1995,"FC Nantes","OGC Nice","1-0",1,0,"1",1,1,1,"H"
"18818",1995-08-19,1995,"Le Havre AC","FC Metz","0-0",0,0,"1",1,0,0,"D"
"18819",1995-08-19,1995,"Montpellier HSC","AJ Auxerre","3-1",3,1,"1",1,4,2,"H"
"18820",1995-08-19,1995,"RC Lens","Olympique Lyon","2-2",2,2,"1",1,4,0,"D"
"18821",1995-08-19,1995,"AS Cannes","Lille OSC","2-1",2,1,"1",1,3,1,"H"
"18822",1995-08-19,1995,"AS Monaco","FC Martigues","0-1",0,1,"1",1,1,-1,"D"
"18823",1995-08-19,1995,"FC Gueugnon","Paris Saint-Germain","1-3",1,3,"1",1,4,-2,"D"
"18824",1995-08-19,1995,"AS Saint-Etienne","SC Bastia","3-0",3,0,"1",1,3,3,"H"
"18825",1995-08-19,1995,"RC Strasbourg","Stade Rennes","3-1",3,1,"1",1,4,2,"H"
"18826",1995-08-20,1995,"EA Guingamp","Girondins Bordeaux","1-0",1,0,"1",1,1,1,"H"
"18827",1995-08-25,1995,"Lille OSC","FC Nantes","0-0",0,0,"1",1,0,0,"D"
"18828",1995-08-26,1995,"OGC Nice","RC Lens","1-1",1,1,"1",1,2,0,"D"
"18829",1995-08-26,1995,"Stade Rennes","Olympique Lyon","1-0",1,0,"1",1,1,1,"H"
"18830",1995-08-26,1995,"FC Metz","RC Strasbourg","3-2",3,2,"1",1,5,1,"H"
"18831",1995-08-26,1995,"AS Saint-Etienne","EA Guingamp","4-0",4,0,"1",1,4,4,"H"
"18832",1995-08-26,1995,"Paris Saint-Germain","Le Havre AC","2-0",2,0,"1",1,2,2,"H"
"18833",1995-08-26,1995,"SC Bastia","FC Gueugnon","1-2",1,2,"1",1,3,-1,"D"
"18834",1995-08-26,1995,"Girondins Bordeaux","AS Monaco","2-4",2,4,"1",1,6,-2,"D"
"18835",1995-08-26,1995,"AJ Auxerre","AS Cannes","5-1",5,1,"1",1,6,4,"H"
"18836",1995-08-26,1995,"FC Martigues","Montpellier HSC","0-1",0,1,"1",1,1,-1,"D"
"18837",1995-08-29,1995,"Montpellier HSC","OGC Nice","0-1",0,1,"1",1,1,-1,"D"
"18838",1995-08-29,1995,"AS Monaco","Lille OSC","2-1",2,1,"1",1,3,1,"H"
"18839",1995-08-29,1995,"Le Havre AC","AJ Auxerre","0-4",0,4,"1",1,4,-4,"D"
"18840",1995-08-29,1995,"RC Lens","Stade Rennes","1-0",1,0,"1",1,1,1,"H"
"18841",1995-08-29,1995,"Olympique Lyon","FC Metz","1-1",1,1,"1",1,2,0,"D"
"18842",1995-08-29,1995,"FC Gueugnon","Girondins Bordeaux","2-2",2,2,"1",1,4,0,"D"
"18843",1995-08-29,1995,"FC Nantes","AS Saint-Etienne","2-2",2,2,"1",1,4,0,"D"
"18844",1995-08-29,1995,"AS Cannes","Paris Saint-Germain","0-2",0,2,"1",1,2,-2,"D"
"18845",1995-08-29,1995,"RC Strasbourg","FC Martigues","2-0",2,0,"1",1,2,2,"H"
"18846",1995-08-30,1995,"EA Guingamp","SC Bastia","1-0",1,0,"1",1,1,1,"H"
"18847",1995-09-01,1995,"Girondins Bordeaux","FC Nantes","3-0",3,0,"1",1,3,3,"H"
"18848",1995-09-01,1995,"Olympique Lyon","RC Strasbourg","1-1",1,1,"1",1,2,0,"D"
"18849",1995-09-09,1995,"Paris Saint-Germain","AS Monaco","2-1",2,1,"1",1,3,1,"H"
"18850",1995-09-09,1995,"FC Martigues","Olympique Lyon","1-2",1,2,"1",1,3,-1,"D"
"18851",1995-09-09,1995,"EA Guingamp","Montpellier HSC","0-0",0,0,"1",1,0,0,"D"
"18852",1995-09-09,1995,"AS Saint-Etienne","FC Gueugnon","2-0",2,0,"1",1,2,2,"H"
"18853",1995-09-09,1995,"SC Bastia","FC Nantes","4-1",4,1,"1",1,5,3,"H"
"18854",1995-09-09,1995,"Lille OSC","RC Lens","1-3",1,3,"1",1,4,-2,"D"
"18855",1995-09-09,1995,"Girondins Bordeaux","AS Cannes","2-1",2,1,"1",1,3,1,"H"
"18856",1995-09-09,1995,"AJ Auxerre","RC Strasbourg","1-0",1,0,"1",1,1,1,"H"
"18857",1995-09-09,1995,"OGC Nice","Le Havre AC","1-2",1,2,"1",1,3,-1,"D"
"18858",1995-09-10,1995,"FC Metz","Stade Rennes","0-0",0,0,"1",1,0,0,"D"
"18859",1995-09-16,1995,"Olympique Lyon","AJ Auxerre","0-1",0,1,"1",1,1,-1,"D"
"18860",1995-09-16,1995,"RC Strasbourg","OGC Nice","1-1",1,1,"1",1,2,0,"D"
"18861",1995-09-16,1995,"AS Cannes","AS Saint-Etienne","2-0",2,0,"1",1,2,2,"H"
"18862",1995-09-16,1995,"Stade Rennes","FC Martigues","1-3",1,3,"1",1,4,-2,"D"
"18863",1995-09-16,1995,"AS Monaco","FC Metz","0-1",0,1,"1",1,1,-1,"D"
"18864",1995-09-16,1995,"FC Nantes","EA Guingamp","0-0",0,0,"1",1,0,0,"D"
"18865",1995-09-16,1995,"FC Gueugnon","Lille OSC","3-1",3,1,"1",1,4,2,"H"
"18866",1995-09-17,1995,"RC Lens","SC Bastia","3-1",3,1,"1",1,4,2,"H"
"18867",1995-09-17,1995,"Le Havre AC","Girondins Bordeaux","1-0",1,0,"1",1,1,1,"H"
"18868",1995-09-17,1995,"Montpellier HSC","Paris Saint-Germain","1-0",1,0,"1",1,1,1,"H"
"18869",1995-09-21,1995,"AS Saint-Etienne","AS Monaco","2-4",2,4,"1",1,6,-2,"D"
"18870",1995-09-22,1995,"Lille OSC","Le Havre AC","2-0",2,0,"1",1,2,2,"H"
"18871",1995-09-22,1995,"FC Martigues","FC Metz","0-1",0,1,"1",1,1,-1,"D"
"18872",1995-09-22,1995,"EA Guingamp","FC Gueugnon","0-0",0,0,"1",1,0,0,"D"
"18873",1995-09-22,1995,"OGC Nice","Olympique Lyon","1-0",1,0,"1",1,1,1,"H"
"18874",1995-09-22,1995,"SC Bastia","AS Cannes","2-1",2,1,"1",1,3,1,"H"
"18875",1995-09-22,1995,"Girondins Bordeaux","Montpellier HSC","3-0",3,0,"1",1,3,3,"H"
"18876",1995-09-22,1995,"AJ Auxerre","Stade Rennes","2-1",2,1,"1",1,3,1,"H"
"18877",1995-09-22,1995,"FC Nantes","RC Lens","1-1",1,1,"1",1,2,0,"D"
"18878",1995-09-22,1995,"Paris Saint-Germain","RC Strasbourg","2-0",2,0,"1",1,2,2,"H"
"18879",1995-09-30,1995,"AS Cannes","OGC Nice","1-3",1,3,"1",1,4,-2,"D"
"18880",1995-09-30,1995,"Le Havre AC","FC Martigues","1-0",1,0,"1",1,1,1,"H"
"18881",1995-09-30,1995,"Olympique Lyon","AS Saint-Etienne","2-1",2,1,"1",1,3,1,"H"
"18882",1995-09-30,1995,"Stade Rennes","SC Bastia","2-0",2,0,"1",1,2,2,"H"
"18883",1995-09-30,1995,"AS Monaco","EA Guingamp","1-0",1,0,"1",1,1,1,"H"
"18884",1995-09-30,1995,"FC Metz","AJ Auxerre","3-1",3,1,"1",1,4,2,"H"
"18885",1995-09-30,1995,"FC Gueugnon","FC Nantes","0-1",0,1,"1",1,1,-1,"D"
"18886",1995-09-30,1995,"Montpellier HSC","Lille OSC","0-0",0,0,"1",1,0,0,"D"
"18887",1995-10-01,1995,"RC Lens","Paris Saint-Germain","3-1",3,1,"1",1,4,2,"H"
"18888",1995-10-01,1995,"RC Strasbourg","Girondins Bordeaux","3-0",3,0,"1",1,3,3,"H"
"18889",1995-10-03,1995,"FC Nantes","AS Monaco","2-2",2,2,"1",1,4,0,"D"
"18890",1995-10-04,1995,"Paris Saint-Germain","Stade Rennes","1-1",1,1,"1",1,2,0,"D"
"18891",1995-10-04,1995,"AS Saint-Etienne","Montpellier HSC","0-2",0,2,"1",1,2,-2,"D"
"18892",1995-10-04,1995,"FC Gueugnon","RC Lens","0-1",0,1,"1",1,1,-1,"D"
"18893",1995-10-04,1995,"FC Martigues","AJ Auxerre","1-2",1,2,"1",1,3,-1,"D"
"18894",1995-10-04,1995,"EA Guingamp","AS Cannes","2-0",2,0,"1",1,2,2,"H"
"18895",1995-10-04,1995,"SC Bastia","Le Havre AC","1-0",1,0,"1",1,1,1,"H"
"18896",1995-10-04,1995,"Lille OSC","RC Strasbourg","2-0",2,0,"1",1,2,2,"H"
"18897",1995-10-04,1995,"Girondins Bordeaux","Olympique Lyon","1-1",1,1,"1",1,2,0,"D"
"18898",1995-10-04,1995,"OGC Nice","FC Metz","0-1",0,1,"1",1,1,-1,"D"
"18899",1995-10-13,1995,"RC Lens","FC Martigues","1-0",1,0,"1",1,1,1,"H"
"18900",1995-10-14,1995,"Stade Rennes","Lille OSC","3-1",3,1,"1",1,4,2,"H"
"18901",1995-10-14,1995,"RC Strasbourg","EA Guingamp","0-0",0,0,"1",1,0,0,"D"
"18902",1995-10-14,1995,"Montpellier HSC","SC Bastia","4-3",4,3,"1",1,7,1,"H"
"18903",1995-10-14,1995,"AS Cannes","FC Nantes","0-2",0,2,"1",1,2,-2,"D"
"18904",1995-10-14,1995,"AS Monaco","FC Gueugnon","0-0",0,0,"1",1,0,0,"D"
"18905",1995-10-14,1995,"FC Metz","Girondins Bordeaux","2-0",2,0,"1",1,2,2,"H"
"18906",1995-10-14,1995,"AJ Auxerre","OGC Nice","2-1",2,1,"1",1,3,1,"H"
"18907",1995-10-14,1995,"Olympique Lyon","Paris Saint-Germain","0-0",0,0,"1",1,0,0,"D"
"18908",1995-10-15,1995,"Le Havre AC","AS Saint-Etienne","2-2",2,2,"1",1,4,0,"D"
"18909",1995-10-21,1995,"OGC Nice","FC Martigues","1-0",1,0,"1",1,1,1,"H"
"18910",1995-10-21,1995,"AS Monaco","Montpellier HSC","3-1",3,1,"1",1,4,2,"H"
"18911",1995-10-21,1995,"FC Gueugnon","AS Cannes","1-1",1,1,"1",1,2,0,"D"
"18912",1995-10-21,1995,"EA Guingamp","Le Havre AC","2-2",2,2,"1",1,4,0,"D"
"18913",1995-10-21,1995,"SC Bastia","RC Strasbourg","1-1",1,1,"1",1,2,0,"D"
"18914",1995-10-21,1995,"Lille OSC","FC Metz","0-0",0,0,"1",1,0,0,"D"
"18915",1995-10-21,1995,"Girondins Bordeaux","Stade Rennes","0-0",0,0,"1",1,0,0,"D"
"18916",1995-10-21,1995,"FC Nantes","Olympique Lyon","0-0",0,0,"1",1,0,0,"D"
"18917",1995-10-21,1995,"AS Saint-Etienne","RC Lens","1-1",1,1,"1",1,2,0,"D"
"18918",1995-10-22,1995,"Paris Saint-Germain","AJ Auxerre","3-1",3,1,"1",1,4,2,"H"
"18919",1995-10-26,1995,"FC Metz","Paris Saint-Germain","0-3",0,3,"1",1,3,-3,"D"
"18920",1995-10-27,1995,"AS Cannes","AS Monaco","1-1",1,1,"1",1,2,0,"D"
"18921",1995-10-27,1995,"RC Lens","EA Guingamp","0-1",0,1,"1",1,1,-1,"D"
"18922",1995-10-27,1995,"RC Strasbourg","AS Saint-Etienne","3-1",3,1,"1",1,4,2,"H"
"18923",1995-10-27,1995,"Olympique Lyon","SC Bastia","1-1",1,1,"1",1,2,0,"D"
"18924",1995-10-27,1995,"Le Havre AC","FC Nantes","0-1",0,1,"1",1,1,-1,"D"
"18925",1995-10-27,1995,"Stade Rennes","OGC Nice","1-0",1,0,"1",1,1,1,"H"
"18926",1995-10-27,1995,"FC Martigues","Girondins Bordeaux","3-1",3,1,"1",1,4,2,"H"
"18927",1995-10-27,1995,"AJ Auxerre","Lille OSC","1-2",1,2,"1",1,3,-1,"D"
"18928",1995-10-27,1995,"Montpellier HSC","FC Gueugnon","2-2",2,2,"1",1,4,0,"D"
"18929",1995-11-04,1995,"FC Gueugnon","Le Havre AC","0-1",0,1,"1",1,1,-1,"D"
"18930",1995-11-04,1995,"AS Monaco","RC Lens","1-1",1,1,"1",1,2,0,"D"
"18931",1995-11-04,1995,"AS Saint-Etienne","Stade Rennes","0-0",0,0,"1",1,0,0,"D"
"18932",1995-11-04,1995,"EA Guingamp","Olympique Lyon","1-0",1,0,"1",1,1,1,"H"
"18933",1995-11-04,1995,"SC Bastia","FC Metz","1-0",1,0,"1",1,1,1,"H"
"18934",1995-11-04,1995,"Lille OSC","FC Martigues","0-0",0,0,"1",1,0,0,"D"
"18935",1995-11-04,1995,"FC Nantes","Montpellier HSC","1-0",1,0,"1",1,1,1,"H"
"18936",1995-11-04,1995,"Girondins Bordeaux","AJ Auxerre","0-1",0,1,"1",1,1,-1,"D"
"18937",1995-11-05,1995,"Paris Saint-Germain","OGC Nice","3-2",3,2,"1",1,5,1,"H"
"18938",1995-11-05,1995,"AS Cannes","RC Strasbourg","0-3",0,3,"1",1,3,-3,"D"
"18939",1995-11-07,1995,"Stade Rennes","EA Guingamp","3-0",3,0,"1",1,3,3,"H"
"18940",1995-11-08,1995,"Montpellier HSC","AS Cannes","3-1",3,1,"1",1,4,2,"H"
"18941",1995-11-08,1995,"FC Martigues","Paris Saint-Germain","2-4",2,4,"1",1,6,-2,"D"
"18942",1995-11-08,1995,"Le Havre AC","AS Monaco","2-1",2,1,"1",1,3,1,"H"
"18943",1995-11-08,1995,"RC Lens","Girondins Bordeaux","0-0",0,0,"1",1,0,0,"D"
"18944",1995-11-08,1995,"RC Strasbourg","FC Nantes","1-1",1,1,"1",1,2,0,"D"
"18945",1995-11-08,1995,"FC Metz","AS Saint-Etienne","1-2",1,2,"1",1,3,-1,"D"
"18946",1995-11-08,1995,"OGC Nice","Lille OSC","2-1",2,1,"1",1,3,1,"H"
"18947",1995-11-08,1995,"AJ Auxerre","SC Bastia","3-0",3,0,"1",1,3,3,"H"
"18948",1995-11-08,1995,"Olympique Lyon","FC Gueugnon","0-0",0,0,"1",1,0,0,"D"
"18949",1995-11-18,1995,"SC Bastia","FC Martigues","2-0",2,0,"1",1,2,2,"H"
"18950",1995-11-18,1995,"AS Cannes","Le Havre AC","0-0",0,0,"1",1,0,0,"D"
"18951",1995-11-18,1995,"AS Monaco","Olympique Lyon","0-2",0,2,"1",1,2,-2,"D"
"18952",1995-11-18,1995,"EA Guingamp","FC Metz","0-0",0,0,"1",1,0,0,"D"
"18953",1995-11-18,1995,"Lille OSC","Paris Saint-Germain","0-0",0,0,"1",1,0,0,"D"
"18954",1995-11-18,1995,"Girondins Bordeaux","OGC Nice","4-1",4,1,"1",1,5,3,"H"
"18955",1995-11-18,1995,"FC Nantes","Stade Rennes","2-2",2,2,"1",1,4,0,"D"
"18956",1995-11-18,1995,"Montpellier HSC","RC Lens","0-0",0,0,"1",1,0,0,"D"
"18957",1995-11-18,1995,"FC Gueugnon","RC Strasbourg","0-1",0,1,"1",1,1,-1,"D"
"18958",1995-11-19,1995,"AS Saint-Etienne","AJ Auxerre","0-5",0,5,"1",1,5,-5,"D"
"18959",1995-11-24,1995,"RC Strasbourg","AS Monaco","2-0",2,0,"1",1,2,2,"H"
"18960",1995-11-25,1995,"FC Metz","FC Nantes","0-0",0,0,"1",1,0,0,"D"
"18961",1995-11-25,1995,"Le Havre AC","Montpellier HSC","2-2",2,2,"1",1,4,0,"D"
"18962",1995-11-25,1995,"RC Lens","AS Cannes","1-1",1,1,"1",1,2,0,"D"
"18963",1995-11-25,1995,"Olympique Lyon","Lille OSC","1-1",1,1,"1",1,2,0,"D"
"18964",1995-11-25,1995,"Stade Rennes","FC Gueugnon","2-1",2,1,"1",1,3,1,"H"
"18965",1995-11-25,1995,"FC Martigues","AS Saint-Etienne","1-1",1,1,"1",1,2,0,"D"
"18966",1995-11-25,1995,"OGC Nice","SC Bastia","3-1",3,1,"1",1,4,2,"H"
"18967",1995-11-25,1995,"Paris Saint-Germain","Girondins Bordeaux","3-0",3,0,"1",1,3,3,"H"
"18968",1995-11-25,1995,"AJ Auxerre","EA Guingamp","1-2",1,2,"1",1,3,-1,"D"
"18969",1995-11-30,1995,"FC Gueugnon","AJ Auxerre","0-0",0,0,"1",1,0,0,"D"
"18970",1995-12-01,1995,"AS Monaco","OGC Nice","1-0",1,0,"1",1,1,1,"H"
"18971",1995-12-01,1995,"RC Lens","FC Metz","2-0",2,0,"1",1,2,2,"H"
"18972",1995-12-01,1995,"Le Havre AC","RC Strasbourg","2-0",2,0,"1",1,2,2,"H"
"18973",1995-12-01,1995,"Montpellier HSC","Olympique Lyon","2-1",2,1,"1",1,3,1,"H"
"18974",1995-12-01,1995,"AS Cannes","Stade Rennes","3-0",3,0,"1",1,3,3,"H"
"18975",1995-12-01,1995,"AS Saint-Etienne","Girondins Bordeaux","2-0",2,0,"1",1,2,2,"H"
"18976",1995-12-01,1995,"SC Bastia","Lille OSC","4-0",4,0,"1",1,4,4,"H"
"18977",1995-12-01,1995,"EA Guingamp","Paris Saint-Germain","0-0",0,0,"1",1,0,0,"D"
"18978",1995-12-01,1995,"FC Nantes","FC Martigues","3-0",3,0,"1",1,3,3,"H"
"18979",1995-12-09,1995,"OGC Nice","EA Guingamp","2-1",2,1,"1",1,3,1,"H"
"18980",1995-12-09,1995,"Olympique Lyon","Le Havre AC","3-2",3,2,"1",1,5,1,"H"
"18981",1995-12-09,1995,"Stade Rennes","Montpellier HSC","1-1",1,1,"1",1,2,0,"D"
"18982",1995-12-09,1995,"AJ Auxerre","AS Monaco","1-2",1,2,"1",1,3,-1,"D"
"18983",1995-12-09,1995,"FC Martigues","FC Gueugnon","3-0",3,0,"1",1,3,3,"H"
"18984",1995-12-09,1995,"Paris Saint-Germain","FC Nantes","5-0",5,0,"1",1,5,5,"H"
"18985",1995-12-09,1995,"Lille OSC","AS Saint-Etienne","1-1",1,1,"1",1,2,0,"D"
"18986",1995-12-09,1995,"Girondins Bordeaux","SC Bastia","1-3",1,3,"1",1,4,-2,"D"
"18987",1995-12-09,1995,"FC Metz","AS Cannes","0-0",0,0,"1",1,0,0,"D"
"18988",1995-12-10,1995,"RC Strasbourg","RC Lens","1-2",1,2,"1",1,3,-1,"D"
"18989",1995-12-16,1995,"FC Gueugnon","OGC Nice","1-0",1,0,"1",1,1,1,"H"
"18990",1995-12-16,1995,"Le Havre AC","Stade Rennes","0-0",0,0,"1",1,0,0,"D"
"18991",1995-12-16,1995,"RC Lens","AJ Auxerre","0-0",0,0,"1",1,0,0,"D"
"18992",1995-12-16,1995,"RC Strasbourg","Olympique Lyon","2-2",2,2,"1",1,4,0,"D"
"18993",1995-12-16,1995,"EA Guingamp","Lille OSC","0-1",0,1,"1",1,1,-1,"D"
"18994",1995-12-16,1995,"AS Saint-Etienne","Paris Saint-Germain","1-1",1,1,"1",1,2,0,"D"
"18995",1995-12-16,1995,"FC Nantes","Girondins Bordeaux","2-0",2,0,"1",1,2,2,"H"
"18996",1995-12-16,1995,"AS Monaco","SC Bastia","0-0",0,0,"1",1,0,0,"D"
"18997",1995-12-16,1995,"AS Cannes","FC Martigues","2-1",2,1,"1",1,3,1,"H"
"18998",1996-01-03,1995,"Montpellier HSC","FC Metz","1-2",1,2,"1",1,3,-1,"D"
"18999",1996-01-09,1995,"FC Martigues","AS Monaco","0-4",0,4,"1",1,4,-4,"D"
"19000",1996-01-10,1995,"Lille OSC","AS Cannes","0-2",0,2,"1",1,2,-2,"D"
"19001",1996-01-10,1995,"OGC Nice","FC Nantes","1-0",1,0,"1",1,1,1,"H"
"19002",1996-01-10,1995,"Olympique Lyon","RC Lens","0-0",0,0,"1",1,0,0,"D"
"19003",1996-01-10,1995,"Stade Rennes","RC Strasbourg","0-0",0,0,"1",1,0,0,"D"
"19004",1996-01-10,1995,"FC Metz","Le Havre AC","2-1",2,1,"1",1,3,1,"H"
"19005",1996-01-10,1995,"SC Bastia","AS Saint-Etienne","0-0",0,0,"1",1,0,0,"D"
"19006",1996-01-10,1995,"Girondins Bordeaux","EA Guingamp","2-0",2,0,"1",1,2,2,"H"
"19007",1996-01-10,1995,"AJ Auxerre","Montpellier HSC","1-0",1,0,"1",1,1,1,"H"
"19008",1996-01-10,1995,"Paris Saint-Germain","FC Gueugnon","1-1",1,1,"1",1,2,0,"D"
"19009",1996-01-19,1995,"Le Havre AC","Paris Saint-Germain","1-1",1,1,"1",1,2,0,"D"
"19010",1996-01-20,1995,"AS Cannes","AJ Auxerre","0-1",0,1,"1",1,1,-1,"D"
"19011",1996-01-20,1995,"RC Lens","OGC Nice","0-0",0,0,"1",1,0,0,"D"
"19012",1996-01-20,1995,"Olympique Lyon","Stade Rennes","2-2",2,2,"1",1,4,0,"D"
"19013",1996-01-20,1995,"Montpellier HSC","FC Martigues","2-0",2,0,"1",1,2,2,"H"
"19014",1996-01-20,1995,"FC Gueugnon","SC Bastia","1-0",1,0,"1",1,1,1,"H"
"19015",1996-01-20,1995,"RC Strasbourg","FC Metz","1-2",1,2,"1",1,3,-1,"D"
"19016",1996-01-20,1995,"EA Guingamp","AS Saint-Etienne","3-0",3,0,"1",1,3,3,"H"
"19017",1996-01-20,1995,"FC Nantes","Lille OSC","1-2",1,2,"1",1,3,-1,"D"
"19018",1996-01-20,1995,"AS Monaco","Girondins Bordeaux","2-0",2,0,"1",1,2,2,"H"
"19019",1996-01-27,1995,"SC Bastia","EA Guingamp","0-1",0,1,"1",1,1,-1,"D"
"19020",1996-01-27,1995,"Stade Rennes","RC Lens","2-1",2,1,"1",1,3,1,"H"
"19021",1996-01-27,1995,"FC Martigues","RC Strasbourg","2-0",2,0,"1",1,2,2,"H"
"19022",1996-01-27,1995,"Paris Saint-Germain","AS Cannes","2-1",2,1,"1",1,3,1,"H"
"19023",1996-01-27,1995,"Lille OSC","AS Monaco","0-0",0,0,"1",1,0,0,"D"
"19024",1996-01-27,1995,"Girondins Bordeaux","FC Gueugnon","3-1",3,1,"1",1,4,2,"H"
"19025",1996-01-27,1995,"AJ Auxerre","Le Havre AC","1-0",1,0,"1",1,1,1,"H"
"19026",1996-01-27,1995,"OGC Nice","Montpellier HSC","1-2",1,2,"1",1,3,-1,"D"
"19027",1996-01-28,1995,"AS Saint-Etienne","FC Nantes","0-0",0,0,"1",1,0,0,"D"
"19028",1996-02-06,1995,"RC Lens","Lille OSC","1-1",1,1,"1",1,2,0,"D"
"19029",1996-02-07,1995,"Le Havre AC","OGC Nice","0-0",0,0,"1",1,0,0,"D"
"19030",1996-02-07,1995,"FC Nantes","SC Bastia","3-1",3,1,"1",1,4,2,"H"
"19031",1996-02-07,1995,"Olympique Lyon","FC Martigues","5-1",5,1,"1",1,6,4,"H"
"19032",1996-02-07,1995,"AS Cannes","Girondins Bordeaux","1-1",1,1,"1",1,2,0,"D"
"19033",1996-02-07,1995,"AS Monaco","Paris Saint-Germain","1-0",1,0,"1",1,1,1,"H"
"19034",1996-02-10,1995,"AJ Auxerre","Olympique Lyon","2-0",2,0,"1",1,2,2,"H"
"19035",1996-02-10,1995,"FC Martigues","Stade Rennes","1-2",1,2,"1",1,3,-1,"D"
"19036",1996-02-10,1995,"SC Bastia","RC Lens","3-2",3,2,"1",1,5,1,"H"
"19037",1996-02-10,1995,"Lille OSC","FC Gueugnon","2-0",2,0,"1",1,2,2,"H"
"19038",1996-02-10,1995,"Girondins Bordeaux","Le Havre AC","3-1",3,1,"1",1,4,2,"H"
"19039",1996-02-10,1995,"EA Guingamp","FC Nantes","3-1",3,1,"1",1,4,2,"H"
"19040",1996-02-10,1995,"OGC Nice","RC Strasbourg","2-2",2,2,"1",1,4,0,"D"
"19041",1996-02-11,1995,"Paris Saint-Germain","Montpellier HSC","2-3",2,3,"1",1,5,-1,"D"
"19042",1996-02-17,1995,"Le Havre AC","Lille OSC","4-1",4,1,"1",1,5,3,"H"
"19043",1996-02-17,1995,"RC Strasbourg","Paris Saint-Germain","1-0",1,0,"1",1,1,1,"H"
"19044",1996-02-17,1995,"Montpellier HSC","Girondins Bordeaux","3-0",3,0,"1",1,3,3,"H"
"19045",1996-02-17,1995,"Olympique Lyon","OGC Nice","1-0",1,0,"1",1,1,1,"H"
"19046",1996-02-17,1995,"AS Cannes","SC Bastia","1-0",1,0,"1",1,1,1,"H"
"19047",1996-02-17,1995,"Stade Rennes","AJ Auxerre","2-1",2,1,"1",1,3,1,"H"
"19048",1996-02-17,1995,"FC Gueugnon","EA Guingamp","2-2",2,2,"1",1,4,0,"D"
"19049",1996-02-17,1995,"FC Metz","FC Martigues","2-0",2,0,"1",1,2,2,"H"
"19050",1996-02-17,1995,"RC Lens","FC Nantes","2-1",2,1,"1",1,3,1,"H"
"19051",1996-02-17,1995,"AS Monaco","AS Saint-Etienne","2-0",2,0,"1",1,2,2,"H"
"19052",1996-02-23,1995,"FC Gueugnon","AS Saint-Etienne","1-0",1,0,"1",1,1,1,"H"
"19053",1996-02-26,1995,"OGC Nice","AS Cannes","1-2",1,2,"1",1,3,-1,"D"
"19054",1996-02-27,1995,"EA Guingamp","AS Monaco","0-0",0,0,"1",1,0,0,"D"
"19055",1996-02-27,1995,"Lille OSC","Montpellier HSC","1-1",1,1,"1",1,2,0,"D"
"19056",1996-02-27,1995,"AS Saint-Etienne","Olympique Lyon","1-1",1,1,"1",1,2,0,"D"
"19057",1996-02-27,1995,"Paris Saint-Germain","RC Lens","1-0",1,0,"1",1,1,1,"H"
"19058",1996-02-27,1995,"FC Martigues","Le Havre AC","0-1",0,1,"1",1,1,-1,"D"
"19059",1996-02-27,1995,"FC Nantes","FC Gueugnon","1-0",1,0,"1",1,1,1,"H"
"19060",1996-02-27,1995,"AJ Auxerre","FC Metz","0-0",0,0,"1",1,0,0,"D"
"19061",1996-02-27,1995,"Girondins Bordeaux","RC Strasbourg","1-1",1,1,"1",1,2,0,"D"
"19062",1996-03-01,1995,"Olympique Lyon","Girondins Bordeaux","1-0",1,0,"1",1,1,1,"H"
"19063",1996-03-01,1995,"AS Monaco","FC Nantes","4-1",4,1,"1",1,5,3,"H"
"19064",1996-03-02,1995,"Montpellier HSC","AS Saint-Etienne","1-0",1,0,"1",1,1,1,"H"
"19065",1996-03-02,1995,"Le Havre AC","SC Bastia","1-0",1,0,"1",1,1,1,"H"
"19066",1996-03-02,1995,"RC Strasbourg","Lille OSC","2-0",2,0,"1",1,2,2,"H"
"19067",1996-03-02,1995,"Stade Rennes","Paris Saint-Germain","0-1",0,1,"1",1,1,-1,"D"
"19068",1996-03-02,1995,"RC Lens","FC Gueugnon","2-0",2,0,"1",1,2,2,"H"
"19069",1996-03-02,1995,"AJ Auxerre","FC Martigues","4-0",4,0,"1",1,4,4,"H"
"19070",1996-03-02,1995,"AS Cannes","EA Guingamp","3-0",3,0,"1",1,3,3,"H"
"19071",1996-03-02,1995,"FC Metz","OGC Nice","4-0",4,0,"1",1,4,4,"H"
"19072",1996-03-05,1995,"FC Metz","Olympique Lyon","0-1",0,1,"1",1,1,-1,"D"
"19073",1996-03-05,1995,"RC Strasbourg","AJ Auxerre","1-0",1,0,"1",1,1,1,"H"
"19074",1996-03-09,1995,"FC Martigues","RC Lens","0-1",0,1,"1",1,1,-1,"D"
"19075",1996-03-09,1995,"FC Gueugnon","AS Monaco","2-2",2,2,"1",1,4,0,"D"
"19076",1996-03-09,1995,"SC Bastia","Montpellier HSC","1-0",1,0,"1",1,1,1,"H"
"19077",1996-03-09,1995,"AS Saint-Etienne","Le Havre AC","1-1",1,1,"1",1,2,0,"D"
"19078",1996-03-09,1995,"OGC Nice","AJ Auxerre","1-3",1,3,"1",1,4,-2,"D"
"19079",1996-03-09,1995,"EA Guingamp","RC Strasbourg","3-0",3,0,"1",1,3,3,"H"
"19080",1996-03-09,1995,"Lille OSC","Stade Rennes","0-0",0,0,"1",1,0,0,"D"
"19081",1996-03-09,1995,"FC Nantes","AS Cannes","2-0",2,0,"1",1,2,2,"H"
"19082",1996-03-09,1995,"Girondins Bordeaux","FC Metz","4-0",4,0,"1",1,4,4,"H"
"19083",1996-03-10,1995,"Paris Saint-Germain","Olympique Lyon","2-0",2,0,"1",1,2,2,"H"
"19084",1996-03-16,1995,"Stade Rennes","FC Metz","0-0",0,0,"1",1,0,0,"D"
"19085",1996-03-16,1995,"AS Saint-Etienne","AS Cannes","2-2",2,2,"1",1,4,0,"D"
"19086",1996-03-23,1995,"Stade Rennes","Girondins Bordeaux","4-3",4,3,"1",1,7,1,"H"
"19087",1996-03-23,1995,"Montpellier HSC","AS Monaco","0-0",0,0,"1",1,0,0,"D"
"19088",1996-03-23,1995,"Le Havre AC","EA Guingamp","1-0",1,0,"1",1,1,1,"H"
"19089",1996-03-23,1995,"RC Strasbourg","SC Bastia","4-3",4,3,"1",1,7,1,"H"
"19090",1996-03-23,1995,"Olympique Lyon","FC Nantes","1-1",1,1,"1",1,2,0,"D"
"19091",1996-03-23,1995,"FC Metz","Lille OSC","2-0",2,0,"1",1,2,2,"H"
"19092",1996-03-23,1995,"RC Lens","AS Saint-Etienne","3-0",3,0,"1",1,3,3,"H"
"19093",1996-03-23,1995,"AS Cannes","FC Gueugnon","2-0",2,0,"1",1,2,2,"H"
"19094",1996-03-23,1995,"FC Martigues","OGC Nice","0-0",0,0,"1",1,0,0,"D"
"19095",1996-03-24,1995,"AJ Auxerre","Paris Saint-Germain","3-0",3,0,"1",1,3,3,"H"
"19096",1996-03-30,1995,"OGC Nice","Stade Rennes","0-0",0,0,"1",1,0,0,"D"
"19097",1996-03-30,1995,"AS Monaco","AS Cannes","1-0",1,0,"1",1,1,1,"H"
"19098",1996-03-30,1995,"AS Saint-Etienne","RC Strasbourg","2-0",2,0,"1",1,2,2,"H"
"19099",1996-03-30,1995,"FC Gueugnon","Montpellier HSC","0-2",0,2,"1",1,2,-2,"D"
"19100",1996-03-30,1995,"Paris Saint-Germain","FC Metz","2-3",2,3,"1",1,5,-1,"D"
"19101",1996-03-30,1995,"SC Bastia","Olympique Lyon","0-0",0,0,"1",1,0,0,"D"
"19102",1996-03-30,1995,"Lille OSC","AJ Auxerre","0-4",0,4,"1",1,4,-4,"D"
"19103",1996-03-30,1995,"FC Nantes","Le Havre AC","1-1",1,1,"1",1,2,0,"D"
"19104",1996-03-31,1995,"EA Guingamp","RC Lens","1-0",1,0,"1",1,1,1,"H"
"19105",1996-04-05,1995,"Montpellier HSC","EA Guingamp","2-1",2,1,"1",1,3,1,"H"
"19106",1996-04-05,1995,"SC Bastia","Stade Rennes","0-0",0,0,"1",1,0,0,"D"
"19107",1996-04-08,1995,"RC Lens","AS Monaco","2-1",2,1,"1",1,3,1,"H"
"19108",1996-04-09,1995,"Montpellier HSC","FC Nantes","1-0",1,0,"1",1,1,1,"H"
"19109",1996-04-09,1995,"Le Havre AC","FC Gueugnon","0-2",0,2,"1",1,2,-2,"D"
"19110",1996-04-09,1995,"AJ Auxerre","Girondins Bordeaux","2-0",2,0,"1",1,2,2,"H"
"19111",1996-04-09,1995,"RC Strasbourg","AS Cannes","1-0",1,0,"1",1,1,1,"H"
"19112",1996-04-09,1995,"Stade Rennes","AS Saint-Etienne","3-0",3,0,"1",1,3,3,"H"
"19113",1996-04-09,1995,"OGC Nice","Paris Saint-Germain","1-2",1,2,"1",1,3,-1,"D"
"19114",1996-04-09,1995,"FC Martigues","Lille OSC","1-0",1,0,"1",1,1,1,"H"
"19115",1996-04-10,1995,"Olympique Lyon","EA Guingamp","1-1",1,1,"1",1,2,0,"D"
"19116",1996-04-10,1995,"FC Metz","SC Bastia","2-0",2,0,"1",1,2,2,"H"
"19117",1996-04-14,1995,"FC Metz","AS Monaco","0-3",0,3,"1",1,3,-3,"D"
"19118",1996-04-20,1995,"SC Bastia","AJ Auxerre","1-1",1,1,"1",1,2,0,"D"
"19119",1996-04-20,1995,"AS Cannes","Montpellier HSC","2-1",2,1,"1",1,3,1,"H"
"19120",1996-04-20,1995,"FC Gueugnon","Olympique Lyon","0-0",0,0,"1",1,0,0,"D"
"19121",1996-04-20,1995,"AS Monaco","Le Havre AC","2-1",2,1,"1",1,3,1,"H"
"19122",1996-04-20,1995,"AS Saint-Etienne","FC Metz","1-1",1,1,"1",1,2,0,"D"
"19123",1996-04-20,1995,"Lille OSC","OGC Nice","1-0",1,0,"1",1,1,1,"H"
"19124",1996-04-20,1995,"Girondins Bordeaux","RC Lens","0-0",0,0,"1",1,0,0,"D"
"19125",1996-04-20,1995,"FC Nantes","RC Strasbourg","2-0",2,0,"1",1,2,2,"H"
"19126",1996-04-20,1995,"EA Guingamp","Stade Rennes","0-0",0,0,"1",1,0,0,"D"
"19127",1996-04-23,1995,"Paris Saint-Germain","FC Martigues","0-0",0,0,"1",1,0,0,"D"
"19128",1996-04-26,1995,"OGC Nice","Girondins Bordeaux","1-0",1,0,"1",1,1,1,"H"
"19129",1996-04-26,1995,"AJ Auxerre","AS Saint-Etienne","2-0",2,0,"1",1,2,2,"H"
"19130",1996-04-27,1995,"Stade Rennes","FC Nantes","2-2",2,2,"1",1,4,0,"D"
"19131",1996-04-27,1995,"Le Havre AC","AS Cannes","0-0",0,0,"1",1,0,0,"D"
"19132",1996-04-27,1995,"RC Lens","Montpellier HSC","2-1",2,1,"1",1,3,1,"H"
"19133",1996-04-27,1995,"Olympique Lyon","AS Monaco","3-3",3,3,"1",1,6,0,"D"
"19134",1996-04-27,1995,"FC Metz","EA Guingamp","3-0",3,0,"1",1,3,3,"H"
"19135",1996-04-27,1995,"FC Martigues","SC Bastia","3-1",3,1,"1",1,4,2,"H"
"19136",1996-04-27,1995,"Paris Saint-Germain","Lille OSC","0-1",0,1,"1",1,1,-1,"D"
"19137",1996-04-27,1995,"RC Strasbourg","FC Gueugnon","0-0",0,0,"1",1,0,0,"D"
"19138",1996-05-05,1995,"Girondins Bordeaux","FC Martigues","1-1",1,1,"1",1,2,0,"D"
"19139",1996-05-11,1995,"FC Gueugnon","Stade Rennes","1-0",1,0,"1",1,1,1,"H"
"19140",1996-05-11,1995,"Girondins Bordeaux","Paris Saint-Germain","2-2",2,2,"1",1,4,0,"D"
"19141",1996-05-11,1995,"AS Cannes","RC Lens","5-2",5,2,"1",1,7,3,"H"
"19142",1996-05-11,1995,"AS Monaco","RC Strasbourg","5-1",5,1,"1",1,6,4,"H"
"19143",1996-05-11,1995,"Montpellier HSC","Le Havre AC","2-0",2,0,"1",1,2,2,"H"
"19144",1996-05-11,1995,"EA Guingamp","AJ Auxerre","1-1",1,1,"1",1,2,0,"D"
"19145",1996-05-11,1995,"AS Saint-Etienne","FC Martigues","2-2",2,2,"1",1,4,0,"D"
"19146",1996-05-11,1995,"Lille OSC","Olympique Lyon","2-1",2,1,"1",1,3,1,"H"
"19147",1996-05-11,1995,"FC Nantes","FC Metz","1-0",1,0,"1",1,1,1,"H"
"19148",1996-05-11,1995,"SC Bastia","OGC Nice","1-2",1,2,"1",1,3,-1,"D"
"19149",1996-05-18,1995,"Le Havre AC","RC Lens","1-1",1,1,"1",1,2,0,"D"
"19150",1996-05-18,1995,"AJ Auxerre","FC Nantes","2-1",2,1,"1",1,3,1,"H"
"19151",1996-05-18,1995,"Lille OSC","Girondins Bordeaux","0-2",0,2,"1",1,2,-2,"D"
"19152",1996-05-18,1995,"Paris Saint-Germain","SC Bastia","5-1",5,1,"1",1,6,4,"H"
"19153",1996-05-18,1995,"OGC Nice","AS Saint-Etienne","2-0",2,0,"1",1,2,2,"H"
"19154",1996-05-18,1995,"FC Martigues","EA Guingamp","2-1",2,1,"1",1,3,1,"H"
"19155",1996-05-18,1995,"FC Metz","FC Gueugnon","1-2",1,2,"1",1,3,-1,"D"
"19156",1996-05-18,1995,"Stade Rennes","AS Monaco","2-3",2,3,"1",1,5,-1,"D"
"19157",1996-05-18,1995,"Olympique Lyon","AS Cannes","1-0",1,0,"1",1,1,1,"H"
"19158",1996-05-18,1995,"RC Strasbourg","Montpellier HSC","1-0",1,0,"1",1,1,1,"H"
"19159",1996-08-11,1996,"SC Bastia","Stade Rennes","2-0",2,0,"1",1,2,2,"H"
"19160",1996-08-11,1996,"OGC Nice","AJ Auxerre","0-1",0,1,"1",1,1,-1,"D"
"19161",1996-08-11,1996,"Lille OSC","FC Metz","1-0",1,0,"1",1,1,1,"H"
"19162",1996-08-11,1996,"Girondins Bordeaux","Le Havre AC","1-0",1,0,"1",1,1,1,"H"
"19163",1996-08-11,1996,"RC Strasbourg","Paris Saint-Germain","0-1",0,1,"1",1,1,-1,"D"
"19164",1996-08-11,1996,"SM Caen","RC Lens","0-2",0,2,"1",1,2,-2,"D"
"19165",1996-08-11,1996,"AS Nancy","AS Cannes","1-2",1,2,"1",1,3,-1,"D"
"19166",1996-08-11,1996,"EA Guingamp","Montpellier HSC","0-0",0,0,"1",1,0,0,"D"
"19167",1996-08-11,1996,"Olympique Marseille","Olympique Lyon","3-1",3,1,"1",1,4,2,"H"
"19168",1996-08-11,1996,"FC Nantes","AS Monaco","1-3",1,3,"1",1,4,-2,"D"
"19169",1996-08-17,1996,"AS Monaco","Montpellier HSC","1-1",1,1,"1",1,2,0,"D"
"19170",1996-08-17,1996,"Stade Rennes","OGC Nice","3-1",3,1,"1",1,4,2,"H"
"19171",1996-08-17,1996,"AJ Auxerre","Lille OSC","2-0",2,0,"1",1,2,2,"H"
"19172",1996-08-17,1996,"FC Metz","Girondins Bordeaux","1-1",1,1,"1",1,2,0,"D"
"19173",1996-08-17,1996,"Le Havre AC","Olympique Marseille","1-1",1,1,"1",1,2,0,"D"
"19174",1996-08-17,1996,"Olympique Lyon","RC Strasbourg","2-0",2,0,"1",1,2,2,"H"
"19175",1996-08-17,1996,"Paris Saint-Germain","SM Caen","2-0",2,0,"1",1,2,2,"H"
"19176",1996-08-17,1996,"AS Cannes","FC Nantes","1-1",1,1,"1",1,2,0,"D"
"19177",1996-08-17,1996,"SC Bastia","EA Guingamp","1-0",1,0,"1",1,1,1,"H"
"19178",1996-08-17,1996,"RC Lens","AS Nancy","3-1",3,1,"1",1,4,2,"H"
"19179",1996-08-23,1996,"AS Nancy","Paris Saint-Germain","0-0",0,0,"1",1,0,0,"D"
"19180",1996-08-24,1996,"RC Strasbourg","Le Havre AC","1-0",1,0,"1",1,1,1,"H"
"19181",1996-08-24,1996,"Montpellier HSC","AS Cannes","0-1",0,1,"1",1,1,-1,"D"
"19182",1996-08-24,1996,"EA Guingamp","AS Monaco","2-1",2,1,"1",1,3,1,"H"
"19183",1996-08-24,1996,"FC Nantes","RC Lens","0-1",0,1,"1",1,1,-1,"D"
"19184",1996-08-24,1996,"SM Caen","Olympique Lyon","1-1",1,1,"1",1,2,0,"D"
"19185",1996-08-24,1996,"Girondins Bordeaux","AJ Auxerre","0-0",0,0,"1",1,0,0,"D"
"19186",1996-08-24,1996,"OGC Nice","SC Bastia","1-1",1,1,"1",1,2,0,"D"
"19187",1996-08-24,1996,"Olympique Marseille","FC Metz","1-2",1,2,"1",1,3,-1,"D"
"19188",1996-08-24,1996,"Lille OSC","Stade Rennes","3-1",3,1,"1",1,4,2,"H"
"19189",1996-08-27,1996,"AJ Auxerre","Olympique Marseille","0-0",0,0,"1",1,0,0,"D"
"19190",1996-08-28,1996,"AS Cannes","AS Monaco","0-2",0,2,"1",1,2,-2,"D"
"19191",1996-08-28,1996,"Stade Rennes","Girondins Bordeaux","1-1",1,1,"1",1,2,0,"D"
"19192",1996-08-28,1996,"FC Metz","RC Strasbourg","3-1",3,1,"1",1,4,2,"H"
"19193",1996-08-28,1996,"Le Havre AC","SM Caen","1-1",1,1,"1",1,2,0,"D"
"19194",1996-08-28,1996,"Olympique Lyon","AS Nancy","2-0",2,0,"1",1,2,2,"H"
"19195",1996-08-28,1996,"RC Lens","Montpellier HSC","3-2",3,2,"1",1,5,1,"H"
"19196",1996-08-28,1996,"OGC Nice","EA Guingamp","1-2",1,2,"1",1,3,-1,"D"
"19197",1996-08-28,1996,"SC Bastia","Lille OSC","0-0",0,0,"1",1,0,0,"D"
"19198",1996-08-28,1996,"Paris Saint-Germain","FC Nantes","1-0",1,0,"1",1,1,1,"H"
"19199",1996-09-02,1996,"FC Nantes","Olympique Lyon","2-2",2,2,"1",1,4,0,"D"
"19200",1996-09-03,1996,"RC Strasbourg","AJ Auxerre","2-1",2,1,"1",1,3,1,"H"
"19201",1996-09-03,1996,"Olympique Marseille","Stade Rennes","3-1",3,1,"1",1,4,2,"H"
"19202",1996-09-03,1996,"EA Guingamp","AS Cannes","0-1",0,1,"1",1,1,-1,"D"
"19203",1996-09-03,1996,"SM Caen","FC Metz","0-0",0,0,"1",1,0,0,"D"
"19204",1996-09-03,1996,"Lille OSC","OGC Nice","3-2",3,2,"1",1,5,1,"H"
"19205",1996-09-03,1996,"AS Monaco","RC Lens","5-1",5,1,"1",1,6,4,"H"
"19206",1996-09-03,1996,"AS Nancy","Le Havre AC","0-1",0,1,"1",1,1,-1,"D"
"19207",1996-09-03,1996,"Montpellier HSC","Paris Saint-Germain","0-3",0,3,"1",1,3,-3,"D"
"19208",1996-09-03,1996,"Girondins Bordeaux","SC Bastia","3-1",3,1,"1",1,4,2,"H"
"19209",1996-09-06,1996,"Olympique Lyon","Montpellier HSC","1-1",1,1,"1",1,2,0,"D"
"19210",1996-09-06,1996,"Stade Rennes","RC Strasbourg","2-0",2,0,"1",1,2,2,"H"
"19211",1996-09-06,1996,"AJ Auxerre","SM Caen","2-0",2,0,"1",1,2,2,"H"
"19212",1996-09-06,1996,"Le Havre AC","FC Nantes","3-1",3,1,"1",1,4,2,"H"
"19213",1996-09-06,1996,"Paris Saint-Germain","AS Monaco","0-0",0,0,"1",1,0,0,"D"
"19214",1996-09-06,1996,"RC Lens","AS Cannes","0-0",0,0,"1",1,0,0,"D"
"19215",1996-09-06,1996,"Lille OSC","EA Guingamp","1-1",1,1,"1",1,2,0,"D"
"19216",1996-09-06,1996,"FC Metz","AS Nancy","1-0",1,0,"1",1,1,1,"H"
"19217",1996-09-08,1996,"SC Bastia","Olympique Marseille","2-0",2,0,"1",1,2,2,"H"
"19218",1996-09-09,1996,"OGC Nice","Girondins Bordeaux","0-1",0,1,"1",1,1,-1,"D"
"19219",1996-09-14,1996,"SM Caen","Stade Rennes","0-0",0,0,"1",1,0,0,"D"
"19220",1996-09-14,1996,"EA Guingamp","RC Lens","1-0",1,0,"1",1,1,1,"H"
"19221",1996-09-14,1996,"FC Nantes","FC Metz","0-1",0,1,"1",1,1,-1,"D"
"19222",1996-09-14,1996,"AS Nancy","AJ Auxerre","0-0",0,0,"1",1,0,0,"D"
"19223",1996-09-14,1996,"Olympique Marseille","OGC Nice","1-0",1,0,"1",1,1,1,"H"
"19224",1996-09-14,1996,"Girondins Bordeaux","Lille OSC","3-0",3,0,"1",1,3,3,"H"
"19225",1996-09-14,1996,"AS Monaco","Olympique Lyon","0-0",0,0,"1",1,0,0,"D"
"19226",1996-09-14,1996,"Montpellier HSC","Le Havre AC","2-1",2,1,"1",1,3,1,"H"
"19227",1996-09-14,1996,"RC Strasbourg","SC Bastia","1-3",1,3,"1",1,4,-2,"D"
"19228",1996-09-15,1996,"AS Cannes","Paris Saint-Germain","0-1",0,1,"1",1,1,-1,"D"
"19229",1996-09-19,1996,"AJ Auxerre","FC Nantes","2-2",2,2,"1",1,4,0,"D"
"19230",1996-09-20,1996,"Girondins Bordeaux","EA Guingamp","0-0",0,0,"1",1,0,0,"D"
"19231",1996-09-20,1996,"FC Metz","Montpellier HSC","1-1",1,1,"1",1,2,0,"D"
"19232",1996-09-20,1996,"Le Havre AC","AS Monaco","1-2",1,2,"1",1,3,-1,"D"
"19233",1996-09-20,1996,"Paris Saint-Germain","RC Lens","4-0",4,0,"1",1,4,4,"H"
"19234",1996-09-20,1996,"Stade Rennes","AS Nancy","1-0",1,0,"1",1,1,1,"H"
"19235",1996-09-20,1996,"Lille OSC","Olympique Marseille","1-1",1,1,"1",1,2,0,"D"
"19236",1996-09-20,1996,"OGC Nice","RC Strasbourg","1-1",1,1,"1",1,2,0,"D"
"19237",1996-09-20,1996,"SC Bastia","SM Caen","4-2",4,2,"1",1,6,2,"H"
"19238",1996-09-20,1996,"Olympique Lyon","AS Cannes","3-1",3,1,"1",1,4,2,"H"
"19239",1996-09-28,1996,"RC Strasbourg","Lille OSC","3-0",3,0,"1",1,3,3,"H"
"19240",1996-09-28,1996,"FC Nantes","Stade Rennes","3-3",3,3,"1",1,6,0,"D"
"19241",1996-09-28,1996,"AS Nancy","SC Bastia","2-2",2,2,"1",1,4,0,"D"
"19242",1996-09-28,1996,"SM Caen","OGC Nice","1-2",1,2,"1",1,3,-1,"D"
"19243",1996-09-28,1996,"Olympique Marseille","Girondins Bordeaux","0-0",0,0,"1",1,0,0,"D"
"19244",1996-09-28,1996,"RC Lens","Olympique Lyon","0-1",0,1,"1",1,1,-1,"D"
"19245",1996-09-28,1996,"AS Cannes","Le Havre AC","2-0",2,0,"1",1,2,2,"H"
"19246",1996-09-28,1996,"Montpellier HSC","AJ Auxerre","0-0",0,0,"1",1,0,0,"D"
"19247",1996-09-28,1996,"AS Monaco","FC Metz","1-1",1,1,"1",1,2,0,"D"
"19248",1996-09-29,1996,"EA Guingamp","Paris Saint-Germain","2-2",2,2,"1",1,4,0,"D"
"19249",1996-10-01,1996,"Le Havre AC","RC Lens","0-0",0,0,"1",1,0,0,"D"
"19250",1996-10-02,1996,"Olympique Marseille","EA Guingamp","2-1",2,1,"1",1,3,1,"H"
"19251",1996-10-02,1996,"Girondins Bordeaux","RC Strasbourg","1-2",1,2,"1",1,3,-1,"D"
"19252",1996-10-02,1996,"Stade Rennes","Montpellier HSC","2-0",2,0,"1",1,2,2,"H"
"19253",1996-10-02,1996,"AJ Auxerre","AS Monaco","2-0",2,0,"1",1,2,2,"H"
"19254",1996-10-02,1996,"FC Metz","AS Cannes","0-0",0,0,"1",1,0,0,"D"
"19255",1996-10-02,1996,"Lille OSC","SM Caen","1-0",1,0,"1",1,1,1,"H"
"19256",1996-10-02,1996,"OGC Nice","AS Nancy","1-0",1,0,"1",1,1,1,"H"
"19257",1996-10-02,1996,"SC Bastia","FC Nantes","0-0",0,0,"1",1,0,0,"D"
"19258",1996-10-02,1996,"Olympique Lyon","Paris Saint-Germain","1-1",1,1,"1",1,2,0,"D"
"19259",1996-10-05,1996,"RC Lens","FC Metz","2-2",2,2,"1",1,4,0,"D"
"19260",1996-10-05,1996,"EA Guingamp","Olympique Lyon","1-0",1,0,"1",1,1,1,"H"
"19261",1996-10-05,1996,"FC Nantes","OGC Nice","7-0",7,0,"1",1,7,7,"H"
"19262",1996-10-05,1996,"AS Nancy","Lille OSC","2-2",2,2,"1",1,4,0,"D"
"19263",1996-10-05,1996,"Paris Saint-Germain","Le Havre AC","2-0",2,0,"1",1,2,2,"H"
"19264",1996-10-05,1996,"RC Strasbourg","Olympique Marseille","2-1",2,1,"1",1,3,1,"H"
"19265",1996-10-05,1996,"AS Cannes","AJ Auxerre","1-1",1,1,"1",1,2,0,"D"
"19266",1996-10-05,1996,"AS Monaco","Stade Rennes","3-1",3,1,"1",1,4,2,"H"
"19267",1996-10-05,1996,"Montpellier HSC","SC Bastia","3-1",3,1,"1",1,4,2,"H"
"19268",1996-10-05,1996,"SM Caen","Girondins Bordeaux","0-0",0,0,"1",1,0,0,"D"
"19269",1996-10-12,1996,"RC Strasbourg","EA Guingamp","2-1",2,1,"1",1,3,1,"H"
"19270",1996-10-12,1996,"AJ Auxerre","RC Lens","1-0",1,0,"1",1,1,1,"H"
"19271",1996-10-12,1996,"FC Metz","Paris Saint-Germain","0-1",0,1,"1",1,1,-1,"D"
"19272",1996-10-12,1996,"Le Havre AC","Olympique Lyon","4-1",4,1,"1",1,5,3,"H"
"19273",1996-10-12,1996,"Olympique Marseille","SM Caen","0-1",0,1,"1",1,1,-1,"D"
"19274",1996-10-12,1996,"Girondins Bordeaux","AS Nancy","0-1",0,1,"1",1,1,-1,"D"
"19275",1996-10-12,1996,"Lille OSC","FC Nantes","3-3",3,3,"1",1,6,0,"D"
"19276",1996-10-12,1996,"SC Bastia","AS Monaco","0-0",0,0,"1",1,0,0,"D"
"19277",1996-10-12,1996,"OGC Nice","Montpellier HSC","1-1",1,1,"1",1,2,0,"D"
"19278",1996-10-13,1996,"Stade Rennes","AS Cannes","3-0",3,0,"1",1,3,3,"H"
"19279",1996-10-19,1996,"Olympique Lyon","FC Metz","0-0",0,0,"1",1,0,0,"D"
"19280",1996-10-19,1996,"EA Guingamp","Le Havre AC","2-2",2,2,"1",1,4,0,"D"
"19281",1996-10-19,1996,"FC Nantes","Girondins Bordeaux","3-1",3,1,"1",1,4,2,"H"
"19282",1996-10-19,1996,"AS Nancy","Olympique Marseille","0-0",0,0,"1",1,0,0,"D"
"19283",1996-10-19,1996,"SM Caen","RC Strasbourg","3-0",3,0,"1",1,3,3,"H"
"19284",1996-10-19,1996,"RC Lens","Stade Rennes","2-0",2,0,"1",1,2,2,"H"
"19285",1996-10-19,1996,"AS Cannes","SC Bastia","1-1",1,1,"1",1,2,0,"D"
"19286",1996-10-19,1996,"Montpellier HSC","Lille OSC","0-1",0,1,"1",1,1,-1,"D"
"19287",1996-10-19,1996,"AS Monaco","OGC Nice","4-1",4,1,"1",1,5,3,"H"
"19288",1996-10-19,1996,"Paris Saint-Germain","AJ Auxerre","1-1",1,1,"1",1,2,0,"D"
"19289",1996-10-25,1996,"Girondins Bordeaux","Montpellier HSC","3-1",3,1,"1",1,4,2,"H"
"19290",1996-10-26,1996,"Olympique Marseille","FC Nantes","0-1",0,1,"1",1,1,-1,"D"
"19291",1996-10-26,1996,"Stade Rennes","Paris Saint-Germain","2-1",2,1,"1",1,3,1,"H"
"19292",1996-10-26,1996,"AJ Auxerre","Olympique Lyon","7-0",7,0,"1",1,7,7,"H"
"19293",1996-10-26,1996,"FC Metz","Le Havre AC","1-2",1,2,"1",1,3,-1,"D"
"19294",1996-10-26,1996,"RC Strasbourg","AS Nancy","3-1",3,1,"1",1,4,2,"H"
"19295",1996-10-26,1996,"Lille OSC","AS Monaco","1-4",1,4,"1",1,5,-3,"D"
"19296",1996-10-26,1996,"OGC Nice","AS Cannes","0-0",0,0,"1",1,0,0,"D"
"19297",1996-10-26,1996,"SC Bastia","RC Lens","0-1",0,1,"1",1,1,-1,"D"
"19298",1996-10-26,1996,"SM Caen","EA Guingamp","0-1",0,1,"1",1,1,-1,"D"
"19299",1996-11-02,1996,"AS Nancy","SM Caen","1-2",1,2,"1",1,3,-1,"D"
"19300",1996-11-02,1996,"EA Guingamp","FC Metz","0-1",0,1,"1",1,1,-1,"D"
"19301",1996-11-02,1996,"FC Nantes","RC Strasbourg","3-0",3,0,"1",1,3,3,"H"
"19302",1996-11-02,1996,"AS Monaco","Girondins Bordeaux","3-1",3,1,"1",1,4,2,"H"
"19303",1996-11-02,1996,"Olympique Lyon","Stade Rennes","2-0",2,0,"1",1,2,2,"H"
"19304",1996-11-02,1996,"AS Cannes","Lille OSC","0-1",0,1,"1",1,1,-1,"D"
"19305",1996-11-02,1996,"Le Havre AC","AJ Auxerre","0-2",0,2,"1",1,2,-2,"D"
"19306",1996-11-02,1996,"Montpellier HSC","Olympique Marseille","2-0",2,0,"1",1,2,2,"H"
"19307",1996-11-02,1996,"RC Lens","OGC Nice","3-2",3,2,"1",1,5,1,"H"
"19308",1996-11-03,1996,"Paris Saint-Germain","SC Bastia","3-0",3,0,"1",1,3,3,"H"
"19309",1996-11-05,1996,"Olympique Marseille","AS Monaco","3-1",3,1,"1",1,4,2,"H"
"19310",1996-11-06,1996,"Lille OSC","RC Lens","2-1",2,1,"1",1,3,1,"H"
"19311",1996-11-06,1996,"Stade Rennes","Le Havre AC","1-1",1,1,"1",1,2,0,"D"
"19312",1996-11-06,1996,"AJ Auxerre","FC Metz","2-3",2,3,"1",1,5,-1,"D"
"19313",1996-11-06,1996,"AS Nancy","EA Guingamp","2-0",2,0,"1",1,2,2,"H"
"19314",1996-11-06,1996,"SM Caen","FC Nantes","0-0",0,0,"1",1,0,0,"D"
"19315",1996-11-06,1996,"Girondins Bordeaux","AS Cannes","1-0",1,0,"1",1,1,1,"H"
"19316",1996-11-06,1996,"OGC Nice","Paris Saint-Germain","0-1",0,1,"1",1,1,-1,"D"
"19317",1996-11-06,1996,"SC Bastia","Olympique Lyon","3-1",3,1,"1",1,4,2,"H"
"19318",1996-11-06,1996,"RC Strasbourg","Montpellier HSC","2-1",2,1,"1",1,3,1,"H"
"19319",1996-11-12,1996,"FC Nantes","AS Nancy","2-0",2,0,"1",1,2,2,"H"
"19320",1996-11-13,1996,"Paris Saint-Germain","Lille OSC","3-1",3,1,"1",1,4,2,"H"
"19321",1996-11-13,1996,"Olympique Lyon","OGC Nice","3-1",3,1,"1",1,4,2,"H"
"19322",1996-11-13,1996,"Le Havre AC","SC Bastia","0-1",0,1,"1",1,1,-1,"D"
"19323",1996-11-13,1996,"EA Guingamp","AJ Auxerre","0-0",0,0,"1",1,0,0,"D"
"19324",1996-11-13,1996,"AS Cannes","Olympique Marseille","0-0",0,0,"1",1,0,0,"D"
"19325",1996-11-13,1996,"AS Monaco","RC Strasbourg","2-0",2,0,"1",1,2,2,"H"
"19326",1996-11-13,1996,"Montpellier HSC","SM Caen","0-0",0,0,"1",1,0,0,"D"
"19327",1996-11-13,1996,"FC Metz","Stade Rennes","2-0",2,0,"1",1,2,2,"H"
"19328",1996-11-13,1996,"RC Lens","Girondins Bordeaux","3-4",3,4,"1",1,7,-1,"D"
"19329",1996-11-16,1996,"AS Nancy","Montpellier HSC","0-0",0,0,"1",1,0,0,"D"
"19330",1996-11-16,1996,"FC Nantes","EA Guingamp","1-1",1,1,"1",1,2,0,"D"
"19331",1996-11-16,1996,"SM Caen","AS Monaco","0-1",0,1,"1",1,1,-1,"D"
"19332",1996-11-16,1996,"Olympique Marseille","RC Lens","2-1",2,1,"1",1,3,1,"H"
"19333",1996-11-16,1996,"Girondins Bordeaux","Paris Saint-Germain","5-3",5,3,"1",1,8,2,"H"
"19334",1996-11-16,1996,"OGC Nice","Le Havre AC","0-3",0,3,"1",1,3,-3,"D"
"19335",1996-11-16,1996,"SC Bastia","FC Metz","2-1",2,1,"1",1,3,1,"H"
"19336",1996-11-16,1996,"RC Strasbourg","AS Cannes","2-0",2,0,"1",1,2,2,"H"
"19337",1996-11-16,1996,"Stade Rennes","AJ Auxerre","1-0",1,0,"1",1,1,1,"H"
"19338",1996-11-17,1996,"Lille OSC","Olympique Lyon","1-1",1,1,"1",1,2,0,"D"
"19339",1996-11-22,1996,"Paris Saint-Germain","Olympique Marseille","0-0",0,0,"1",1,0,0,"D"
"19340",1996-11-23,1996,"Montpellier HSC","FC Nantes","2-2",2,2,"1",1,4,0,"D"
"19341",1996-11-23,1996,"AJ Auxerre","SC Bastia","1-2",1,2,"1",1,3,-1,"D"
"19342",1996-11-23,1996,"FC Metz","OGC Nice","1-0",1,0,"1",1,1,1,"H"
"19343",1996-11-23,1996,"Le Havre AC","Lille OSC","0-0",0,0,"1",1,0,0,"D"
"19344",1996-11-23,1996,"Olympique Lyon","Girondins Bordeaux","2-2",2,2,"1",1,4,0,"D"
"19345",1996-11-23,1996,"RC Lens","RC Strasbourg","1-2",1,2,"1",1,3,-1,"D"
"19346",1996-11-23,1996,"AS Monaco","AS Nancy","2-0",2,0,"1",1,2,2,"H"
"19347",1996-11-23,1996,"EA Guingamp","Stade Rennes","1-0",1,0,"1",1,1,1,"H"
"19348",1996-11-23,1996,"AS Cannes","SM Caen","2-0",2,0,"1",1,2,2,"H"
"19349",1996-11-28,1996,"Montpellier HSC","AS Monaco","0-1",0,1,"1",1,1,-1,"D"
"19350",1996-11-28,1996,"Girondins Bordeaux","FC Metz","1-0",1,0,"1",1,1,1,"H"
"19351",1996-11-29,1996,"EA Guingamp","SC Bastia","2-1",2,1,"1",1,3,1,"H"
"19352",1996-11-29,1996,"FC Nantes","AS Cannes","5-1",5,1,"1",1,6,4,"H"
"19353",1996-11-29,1996,"AS Nancy","RC Lens","1-1",1,1,"1",1,2,0,"D"
"19354",1996-11-29,1996,"SM Caen","Paris Saint-Germain","1-3",1,3,"1",1,4,-2,"D"
"19355",1996-11-29,1996,"RC Strasbourg","Olympique Lyon","3-0",3,0,"1",1,3,3,"H"
"19356",1996-11-29,1996,"Olympique Marseille","Le Havre AC","0-0",0,0,"1",1,0,0,"D"
"19357",1996-11-29,1996,"Lille OSC","AJ Auxerre","0-1",0,1,"1",1,1,-1,"D"
"19358",1996-11-29,1996,"OGC Nice","Stade Rennes","3-1",3,1,"1",1,4,2,"H"
"19359",1996-12-06,1996,"RC Lens","FC Nantes","0-4",0,4,"1",1,4,-4,"D"
"19360",1996-12-06,1996,"Paris Saint-Germain","AS Nancy","1-2",1,2,"1",1,3,-1,"D"
"19361",1996-12-07,1996,"AS Monaco","EA Guingamp","0-0",0,0,"1",1,0,0,"D"
"19362",1996-12-07,1996,"Olympique Lyon","SM Caen","3-0",3,0,"1",1,3,3,"H"
"19363",1996-12-07,1996,"Le Havre AC","RC Strasbourg","2-0",2,0,"1",1,2,2,"H"
"19364",1996-12-07,1996,"FC Metz","Olympique Marseille","1-1",1,1,"1",1,2,0,"D"
"19365",1996-12-07,1996,"AJ Auxerre","Girondins Bordeaux","2-1",2,1,"1",1,3,1,"H"
"19366",1996-12-07,1996,"Stade Rennes","Lille OSC","2-0",2,0,"1",1,2,2,"H"
"19367",1996-12-07,1996,"AS Cannes","Montpellier HSC","1-0",1,0,"1",1,1,1,"H"
"19368",1996-12-07,1996,"SC Bastia","OGC Nice","1-0",1,0,"1",1,1,1,"H"
"19369",1996-12-14,1996,"SM Caen","Le Havre AC","4-0",4,0,"1",1,4,4,"H"
"19370",1996-12-14,1996,"EA Guingamp","OGC Nice","0-1",0,1,"1",1,1,-1,"D"
"19371",1996-12-14,1996,"Girondins Bordeaux","Stade Rennes","2-0",2,0,"1",1,2,2,"H"
"19372",1996-12-14,1996,"RC Strasbourg","FC Metz","0-1",0,1,"1",1,1,-1,"D"
"19373",1996-12-14,1996,"FC Nantes","Paris Saint-Germain","0-0",0,0,"1",1,0,0,"D"
"19374",1996-12-14,1996,"Lille OSC","SC Bastia","1-2",1,2,"1",1,3,-1,"D"
"19375",1996-12-14,1996,"AS Monaco","AS Cannes","1-0",1,0,"1",1,1,1,"H"
"19376",1996-12-14,1996,"AS Nancy","Olympique Lyon","2-3",2,3,"1",1,5,-1,"D"
"19377",1996-12-14,1996,"Montpellier HSC","RC Lens","1-0",1,0,"1",1,1,1,"H"
"19378",1996-12-15,1996,"Olympique Marseille","AJ Auxerre","3-0",3,0,"1",1,3,3,"H"
"19379",1996-12-19,1996,"SC Bastia","Girondins Bordeaux","3-1",3,1,"1",1,4,2,"H"
"19380",1996-12-20,1996,"OGC Nice","Lille OSC","1-1",1,1,"1",1,2,0,"D"
"19381",1996-12-20,1996,"AS Cannes","EA Guingamp","1-0",1,0,"1",1,1,1,"H"
"19382",1996-12-20,1996,"Olympique Lyon","FC Nantes","0-1",0,1,"1",1,1,-1,"D"
"19383",1996-12-20,1996,"Le Havre AC","AS Nancy","1-3",1,3,"1",1,4,-2,"D"
"19384",1996-12-20,1996,"FC Metz","SM Caen","2-2",2,2,"1",1,4,0,"D"
"19385",1996-12-20,1996,"Stade Rennes","Olympique Marseille","4-2",4,2,"1",1,6,2,"H"
"19386",1996-12-20,1996,"RC Lens","AS Monaco","1-3",1,3,"1",1,4,-2,"D"
"19387",1996-12-20,1996,"Paris Saint-Germain","Montpellier HSC","1-1",1,1,"1",1,2,0,"D"
"19388",1996-12-20,1996,"AJ Auxerre","RC Strasbourg","0-1",0,1,"1",1,1,-1,"D"
"19389",1997-01-25,1996,"AS Nancy","FC Metz","2-3",2,3,"1",1,5,-1,"D"
"19390",1997-01-25,1996,"FC Nantes","Le Havre AC","1-1",1,1,"1",1,2,0,"D"
"19391",1997-01-25,1996,"RC Strasbourg","Stade Rennes","3-0",3,0,"1",1,3,3,"H"
"19392",1997-01-25,1996,"AS Cannes","RC Lens","0-0",0,0,"1",1,0,0,"D"
"19393",1997-01-25,1996,"Olympique Marseille","SC Bastia","1-0",1,0,"1",1,1,1,"H"
"19394",1997-01-25,1996,"EA Guingamp","Lille OSC","1-0",1,0,"1",1,1,1,"H"
"19395",1997-01-25,1996,"Girondins Bordeaux","OGC Nice","4-1",4,1,"1",1,5,3,"H"
"19396",1997-01-25,1996,"Montpellier HSC","Olympique Lyon","2-1",2,1,"1",1,3,1,"H"
"19397",1997-01-26,1996,"AS Monaco","Paris Saint-Germain","2-0",2,0,"1",1,2,2,"H"
"19398",1997-01-26,1996,"SM Caen","AJ Auxerre","2-3",2,3,"1",1,5,-1,"D"
"19399",1997-02-01,1996,"OGC Nice","Olympique Marseille","0-0",0,0,"1",1,0,0,"D"
"19400",1997-02-01,1996,"RC Lens","EA Guingamp","2-1",2,1,"1",1,3,1,"H"
"19401",1997-02-01,1996,"FC Metz","FC Nantes","0-1",0,1,"1",1,1,-1,"D"
"19402",1997-02-01,1996,"Stade Rennes","SM Caen","1-1",1,1,"1",1,2,0,"D"
"19403",1997-02-01,1996,"Lille OSC","Girondins Bordeaux","0-0",0,0,"1",1,0,0,"D"
"19404",1997-02-01,1996,"Paris Saint-Germain","AS Cannes","1-1",1,1,"1",1,2,0,"D"
"19405",1997-02-01,1996,"Le Havre AC","Montpellier HSC","0-0",0,0,"1",1,0,0,"D"
"19406",1997-02-01,1996,"AJ Auxerre","AS Nancy","1-0",1,0,"1",1,1,1,"H"
"19407",1997-02-02,1996,"SC Bastia","RC Strasbourg","3-1",3,1,"1",1,4,2,"H"
"19408",1997-02-02,1996,"Olympique Lyon","AS Monaco","3-3",3,3,"1",1,6,0,"D"
"19409",1997-02-11,1996,"SM Caen","SC Bastia","2-2",2,2,"1",1,4,0,"D"
"19410",1997-02-13,1996,"RC Lens","Paris Saint-Germain","1-2",1,2,"1",1,3,-1,"D"
"19411",1997-02-13,1996,"FC Nantes","AJ Auxerre","0-0",0,0,"1",1,0,0,"D"
"19412",1997-02-14,1996,"AS Cannes","Olympique Lyon","0-1",0,1,"1",1,1,-1,"D"
"19413",1997-02-14,1996,"AS Nancy","Stade Rennes","1-0",1,0,"1",1,1,1,"H"
"19414",1997-02-14,1996,"Montpellier HSC","FC Metz","1-0",1,0,"1",1,1,1,"H"
"19415",1997-02-14,1996,"AS Monaco","Le Havre AC","3-0",3,0,"1",1,3,3,"H"
"19416",1997-02-14,1996,"Olympique Marseille","Lille OSC","5-1",5,1,"1",1,6,4,"H"
"19417",1997-02-14,1996,"RC Strasbourg","OGC Nice","3-1",3,1,"1",1,4,2,"H"
"19418",1997-02-14,1996,"EA Guingamp","Girondins Bordeaux","2-2",2,2,"1",1,4,0,"D"
"19419",1997-02-21,1996,"Olympique Lyon","RC Lens","0-0",0,0,"1",1,0,0,"D"
"19420",1997-02-21,1996,"Stade Rennes","FC Nantes","0-1",0,1,"1",1,1,-1,"D"
"19421",1997-02-22,1996,"Girondins Bordeaux","Olympique Marseille","4-0",4,0,"1",1,4,4,"H"
"19422",1997-02-22,1996,"Paris Saint-Germain","EA Guingamp","1-1",1,1,"1",1,2,0,"D"
"19423",1997-02-22,1996,"SC Bastia","AS Nancy","2-0",2,0,"1",1,2,2,"H"
"19424",1997-02-22,1996,"Lille OSC","RC Strasbourg","2-4",2,4,"1",1,6,-2,"D"
"19425",1997-02-22,1996,"Le Havre AC","AS Cannes","0-0",0,0,"1",1,0,0,"D"
"19426",1997-02-22,1996,"FC Metz","AS Monaco","2-0",2,0,"1",1,2,2,"H"
"19427",1997-02-22,1996,"AJ Auxerre","Montpellier HSC","0-2",0,2,"1",1,2,-2,"D"
"19428",1997-02-22,1996,"OGC Nice","SM Caen","1-1",1,1,"1",1,2,0,"D"
"19429",1997-03-08,1996,"RC Strasbourg","Girondins Bordeaux","1-1",1,1,"1",1,2,0,"D"
"19430",1997-03-08,1996,"Montpellier HSC","Stade Rennes","0-0",0,0,"1",1,0,0,"D"
"19431",1997-03-08,1996,"FC Nantes","SC Bastia","3-0",3,0,"1",1,3,3,"H"
"19432",1997-03-08,1996,"AS Cannes","FC Metz","0-0",0,0,"1",1,0,0,"D"
"19433",1997-03-08,1996,"RC Lens","Le Havre AC","0-1",0,1,"1",1,1,-1,"D"
"19434",1997-03-08,1996,"EA Guingamp","Olympique Marseille","3-1",3,1,"1",1,4,2,"H"
"19435",1997-03-08,1996,"AS Nancy","OGC Nice","1-0",1,0,"1",1,1,1,"H"
"19436",1997-03-08,1996,"SM Caen","Lille OSC","1-0",1,0,"1",1,1,1,"H"
"19437",1997-03-09,1996,"AS Monaco","AJ Auxerre","0-0",0,0,"1",1,0,0,"D"
"19438",1997-03-09,1996,"Paris Saint-Germain","Olympique Lyon","3-1",3,1,"1",1,4,2,"H"
"19439",1997-03-14,1996,"Olympique Marseille","RC Strasbourg","0-1",0,1,"1",1,1,-1,"D"
"19440",1997-03-14,1996,"Lille OSC","AS Nancy","2-0",2,0,"1",1,2,2,"H"
"19441",1997-03-14,1996,"OGC Nice","FC Nantes","1-2",1,2,"1",1,3,-1,"D"
"19442",1997-03-14,1996,"Le Havre AC","Paris Saint-Germain","1-0",1,0,"1",1,1,1,"H"
"19443",1997-03-14,1996,"AJ Auxerre","AS Cannes","3-1",3,1,"1",1,4,2,"H"
"19444",1997-03-14,1996,"Stade Rennes","AS Monaco","0-3",0,3,"1",1,3,-3,"D"
"19445",1997-03-14,1996,"SC Bastia","Montpellier HSC","2-2",2,2,"1",1,4,0,"D"
"19446",1997-03-15,1996,"Olympique Lyon","EA Guingamp","2-1",2,1,"1",1,3,1,"H"
"19447",1997-03-15,1996,"Girondins Bordeaux","SM Caen","3-1",3,1,"1",1,4,2,"H"
"19448",1997-03-15,1996,"FC Metz","RC Lens","2-0",2,0,"1",1,2,2,"H"
"19449",1997-03-22,1996,"AS Nancy","Girondins Bordeaux","1-1",1,1,"1",1,2,0,"D"
"19450",1997-03-22,1996,"EA Guingamp","RC Strasbourg","2-1",2,1,"1",1,3,1,"H"
"19451",1997-03-22,1996,"AS Cannes","Stade Rennes","1-0",1,0,"1",1,1,1,"H"
"19452",1997-03-22,1996,"Olympique Lyon","Le Havre AC","2-1",2,1,"1",1,3,1,"H"
"19453",1997-03-22,1996,"FC Nantes","Lille OSC","1-0",1,0,"1",1,1,1,"H"
"19454",1997-03-22,1996,"Montpellier HSC","OGC Nice","2-1",2,1,"1",1,3,1,"H"
"19455",1997-03-22,1996,"AS Monaco","SC Bastia","3-1",3,1,"1",1,4,2,"H"
"19456",1997-03-22,1996,"RC Lens","AJ Auxerre","2-1",2,1,"1",1,3,1,"H"
"19457",1997-03-23,1996,"SM Caen","Olympique Marseille","1-0",1,0,"1",1,1,1,"H"
"19458",1997-03-23,1996,"Paris Saint-Germain","FC Metz","2-0",2,0,"1",1,2,2,"H"
"19459",1997-03-25,1996,"Lille OSC","Montpellier HSC","0-4",0,4,"1",1,4,-4,"D"
"19460",1997-03-25,1996,"Girondins Bordeaux","FC Nantes","0-0",0,0,"1",1,0,0,"D"
"19461",1997-03-26,1996,"FC Metz","Olympique Lyon","0-1",0,1,"1",1,1,-1,"D"
"19462",1997-03-26,1996,"Le Havre AC","EA Guingamp","0-1",0,1,"1",1,1,-1,"D"
"19463",1997-03-26,1996,"Olympique Marseille","AS Nancy","4-1",4,1,"1",1,5,3,"H"
"19464",1997-03-26,1996,"RC Strasbourg","SM Caen","2-0",2,0,"1",1,2,2,"H"
"19465",1997-03-26,1996,"AJ Auxerre","Paris Saint-Germain","2-1",2,1,"1",1,3,1,"H"
"19466",1997-03-26,1996,"Stade Rennes","RC Lens","2-2",2,2,"1",1,4,0,"D"
"19467",1997-03-26,1996,"SC Bastia","AS Cannes","1-0",1,0,"1",1,1,1,"H"
"19468",1997-03-26,1996,"OGC Nice","AS Monaco","0-2",0,2,"1",1,2,-2,"D"
"19469",1997-04-04,1996,"AS Monaco","Lille OSC","2-0",2,0,"1",1,2,2,"H"
"19470",1997-04-05,1996,"Olympique Lyon","AJ Auxerre","2-0",2,0,"1",1,2,2,"H"
"19471",1997-04-05,1996,"Paris Saint-Germain","Stade Rennes","1-1",1,1,"1",1,2,0,"D"
"19472",1997-04-05,1996,"AS Nancy","RC Strasbourg","2-0",2,0,"1",1,2,2,"H"
"19473",1997-04-05,1996,"FC Nantes","Olympique Marseille","1-1",1,1,"1",1,2,0,"D"
"19474",1997-04-05,1996,"AS Cannes","OGC Nice","1-1",1,1,"1",1,2,0,"D"
"19475",1997-04-05,1996,"Montpellier HSC","Girondins Bordeaux","2-0",2,0,"1",1,2,2,"H"
"19476",1997-04-05,1996,"Le Havre AC","FC Metz","0-0",0,0,"1",1,0,0,"D"
"19477",1997-04-06,1996,"EA Guingamp","SM Caen","1-1",1,1,"1",1,2,0,"D"
"19478",1997-04-06,1996,"RC Lens","SC Bastia","1-1",1,1,"1",1,2,0,"D"
"19479",1997-04-15,1996,"SC Bastia","Paris Saint-Germain","1-1",1,1,"1",1,2,0,"D"
"19480",1997-04-16,1996,"Stade Rennes","Olympique Lyon","2-1",2,1,"1",1,3,1,"H"
"19481",1997-04-16,1996,"FC Metz","EA Guingamp","2-0",2,0,"1",1,2,2,"H"
"19482",1997-04-16,1996,"RC Strasbourg","FC Nantes","0-1",0,1,"1",1,1,-1,"D"
"19483",1997-04-16,1996,"AJ Auxerre","Le Havre AC","2-0",2,0,"1",1,2,2,"H"
"19484",1997-04-16,1996,"OGC Nice","RC Lens","1-2",1,2,"1",1,3,-1,"D"
"19485",1997-04-16,1996,"Girondins Bordeaux","AS Monaco","2-1",2,1,"1",1,3,1,"H"
"19486",1997-04-16,1996,"Olympique Marseille","Montpellier HSC","2-2",2,2,"1",1,4,0,"D"
"19487",1997-04-16,1996,"SM Caen","AS Nancy","1-1",1,1,"1",1,2,0,"D"
"19488",1997-04-17,1996,"Lille OSC","AS Cannes","1-2",1,2,"1",1,3,-1,"D"
"19489",1997-04-26,1996,"EA Guingamp","AS Nancy","0-1",0,1,"1",1,1,-1,"D"
"19490",1997-04-26,1996,"Le Havre AC","Stade Rennes","1-1",1,1,"1",1,2,0,"D"
"19491",1997-04-26,1996,"FC Metz","AJ Auxerre","1-0",1,0,"1",1,1,1,"H"
"19492",1997-04-26,1996,"RC Lens","Lille OSC","1-0",1,0,"1",1,1,1,"H"
"19493",1997-04-26,1996,"Montpellier HSC","RC Strasbourg","1-4",1,4,"1",1,5,-3,"D"
"19494",1997-04-26,1996,"AS Cannes","Girondins Bordeaux","1-1",1,1,"1",1,2,0,"D"
"19495",1997-04-26,1996,"FC Nantes","SM Caen","1-1",1,1,"1",1,2,0,"D"
"19496",1997-04-26,1996,"Olympique Lyon","SC Bastia","4-2",4,2,"1",1,6,2,"H"
"19497",1997-04-26,1996,"AS Monaco","Olympique Marseille","1-1",1,1,"1",1,2,0,"D"
"19498",1997-04-27,1996,"Paris Saint-Germain","OGC Nice","5-0",5,0,"1",1,5,5,"H"
"19499",1997-04-29,1996,"RC Strasbourg","AS Monaco","0-2",0,2,"1",1,2,-2,"D"
"19500",1997-04-29,1996,"SM Caen","Montpellier HSC","0-1",0,1,"1",1,1,-1,"D"
"19501",1997-04-30,1996,"Girondins Bordeaux","RC Lens","2-1",2,1,"1",1,3,1,"H"
"19502",1997-04-30,1996,"AJ Auxerre","EA Guingamp","1-0",1,0,"1",1,1,1,"H"
"19503",1997-04-30,1996,"AS Nancy","FC Nantes","1-3",1,3,"1",1,4,-2,"D"
"19504",1997-04-30,1996,"Stade Rennes","FC Metz","1-3",1,3,"1",1,4,-2,"D"
"19505",1997-04-30,1996,"SC Bastia","Le Havre AC","1-2",1,2,"1",1,3,-1,"D"
"19506",1997-04-30,1996,"Lille OSC","Paris Saint-Germain","0-1",0,1,"1",1,1,-1,"D"
"19507",1997-04-30,1996,"Olympique Marseille","AS Cannes","3-1",3,1,"1",1,4,2,"H"
"19508",1997-04-30,1996,"OGC Nice","Olympique Lyon","0-1",0,1,"1",1,1,-1,"D"
"19509",1997-05-03,1996,"Montpellier HSC","AS Nancy","1-1",1,1,"1",1,2,0,"D"
"19510",1997-05-03,1996,"EA Guingamp","FC Nantes","0-0",0,0,"1",1,0,0,"D"
"19511",1997-05-03,1996,"AJ Auxerre","Stade Rennes","4-1",4,1,"1",1,5,3,"H"
"19512",1997-05-03,1996,"Paris Saint-Germain","Girondins Bordeaux","2-2",2,2,"1",1,4,0,"D"
"19513",1997-05-03,1996,"Olympique Lyon","Lille OSC","0-0",0,0,"1",1,0,0,"D"
"19514",1997-05-03,1996,"Le Havre AC","OGC Nice","1-0",1,0,"1",1,1,1,"H"
"19515",1997-05-03,1996,"FC Metz","SC Bastia","1-0",1,0,"1",1,1,1,"H"
"19516",1997-05-03,1996,"RC Lens","Olympique Marseille","2-0",2,0,"1",1,2,2,"H"
"19517",1997-05-04,1996,"AS Monaco","SM Caen","2-2",2,2,"1",1,4,0,"D"
"19518",1997-05-04,1996,"AS Cannes","RC Strasbourg","2-2",2,2,"1",1,4,0,"D"
"19519",1997-05-17,1996,"Lille OSC","Le Havre AC","2-2",2,2,"1",1,4,0,"D"
"19520",1997-05-17,1996,"Stade Rennes","EA Guingamp","1-1",1,1,"1",1,2,0,"D"
"19521",1997-05-17,1996,"OGC Nice","FC Metz","3-0",3,0,"1",1,3,3,"H"
"19522",1997-05-17,1996,"Girondins Bordeaux","Olympique Lyon","2-2",2,2,"1",1,4,0,"D"
"19523",1997-05-17,1996,"RC Strasbourg","RC Lens","1-0",1,0,"1",1,1,1,"H"
"19524",1997-05-17,1996,"SM Caen","AS Cannes","3-0",3,0,"1",1,3,3,"H"
"19525",1997-05-17,1996,"AS Nancy","AS Monaco","1-3",1,3,"1",1,4,-2,"D"
"19526",1997-05-17,1996,"FC Nantes","Montpellier HSC","3-0",3,0,"1",1,3,3,"H"
"19527",1997-05-17,1996,"Olympique Marseille","Paris Saint-Germain","1-0",1,0,"1",1,1,1,"H"
"19528",1997-05-17,1996,"SC Bastia","AJ Auxerre","2-1",2,1,"1",1,3,1,"H"
"19529",1997-05-24,1996,"AJ Auxerre","OGC Nice","3-1",3,1,"1",1,4,2,"H"
"19530",1997-05-24,1996,"AS Monaco","FC Nantes","2-1",2,1,"1",1,3,1,"H"
"19531",1997-05-24,1996,"AS Cannes","AS Nancy","0-1",0,1,"1",1,1,-1,"D"
"19532",1997-05-24,1996,"RC Lens","SM Caen","0-0",0,0,"1",1,0,0,"D"
"19533",1997-05-24,1996,"Paris Saint-Germain","RC Strasbourg","2-1",2,1,"1",1,3,1,"H"
"19534",1997-05-24,1996,"Olympique Lyon","Olympique Marseille","8-0",8,0,"1",1,8,8,"H"
"19535",1997-05-24,1996,"FC Metz","Lille OSC","1-0",1,0,"1",1,1,1,"H"
"19536",1997-05-24,1996,"Stade Rennes","SC Bastia","1-3",1,3,"1",1,4,-2,"D"
"19537",1997-05-24,1996,"Montpellier HSC","EA Guingamp","1-0",1,0,"1",1,1,1,"H"
"19538",1997-05-24,1996,"Le Havre AC","Girondins Bordeaux","1-2",1,2,"1",1,3,-1,"D"
"19539",1997-08-01,1997,"Toulouse FC","Stade Rennes","1-0",1,0,"1",1,1,1,"H"
"19540",1997-08-01,1997,"Girondins Bordeaux","AS Monaco","1-0",1,0,"1",1,1,1,"H"
"19541",1997-08-02,1997,"FC Nantes","SC Bastia","0-1",0,1,"1",1,1,-1,"D"
"19542",1997-08-02,1997,"EA Guingamp","AS Cannes","3-1",3,1,"1",1,4,2,"H"
"19543",1997-08-02,1997,"RC Lens","AJ Auxerre","3-0",3,0,"1",1,3,3,"H"
"19544",1997-08-02,1997,"Olympique Lyon","FC Metz","0-1",0,1,"1",1,1,-1,"D"
"19545",1997-08-02,1997,"Olympique Marseille","Le Havre AC","3-1",3,1,"1",1,4,2,"H"
"19546",1997-08-02,1997,"Montpellier HSC","RC Strasbourg","1-1",1,1,"1",1,2,0,"D"
"19547",1997-08-02,1997,"Paris Saint-Germain","LB Chateauroux","2-0",2,0,"1",1,2,2,"H"
"19548",1997-08-08,1997,"Stade Rennes","Olympique Lyon","0-3",0,3,"1",1,3,-3,"D"
"19549",1997-08-08,1997,"AJ Auxerre","Paris Saint-Germain","2-3",2,3,"1",1,5,-1,"D"
"19550",1997-08-09,1997,"SC Bastia","EA Guingamp","1-0",1,0,"1",1,1,1,"H"
"19551",1997-08-09,1997,"AS Monaco","LB Chateauroux","2-2",2,2,"1",1,4,0,"D"
"19552",1997-08-09,1997,"AS Cannes","Toulouse FC","0-1",0,1,"1",1,1,-1,"D"
"19553",1997-08-09,1997,"FC Metz","Girondins Bordeaux","4-1",4,1,"1",1,5,3,"H"
"19554",1997-08-09,1997,"Olympique Marseille","FC Nantes","1-0",1,0,"1",1,1,1,"H"
"19555",1997-08-09,1997,"Le Havre AC","Montpellier HSC","4-0",4,0,"1",1,4,4,"H"
"19556",1997-08-09,1997,"RC Strasbourg","RC Lens","2-1",2,1,"1",1,3,1,"H"
"19557",1997-08-15,1997,"RC Lens","Le Havre AC","0-0",0,0,"1",1,0,0,"D"
"19558",1997-08-15,1997,"LB Chateauroux","FC Metz","1-2",1,2,"1",1,3,-1,"D"
"19559",1997-08-16,1997,"FC Nantes","AJ Auxerre","0-2",0,2,"1",1,2,-2,"D"
"19560",1997-08-16,1997,"Girondins Bordeaux","Stade Rennes","2-2",2,2,"1",1,4,0,"D"
"19561",1997-08-16,1997,"EA Guingamp","RC Strasbourg","0-0",0,0,"1",1,0,0,"D"
"19562",1997-08-16,1997,"Olympique Lyon","AS Monaco","0-3",0,3,"1",1,3,-3,"D"
"19563",1997-08-16,1997,"Montpellier HSC","Olympique Marseille","0-0",0,0,"1",1,0,0,"D"
"19564",1997-08-16,1997,"Paris Saint-Germain","AS Cannes","3-1",3,1,"1",1,4,2,"H"
"19565",1997-08-16,1997,"Toulouse FC","SC Bastia","1-1",1,1,"1",1,2,0,"D"
"19566",1997-08-21,1997,"AS Cannes","Girondins Bordeaux","0-2",0,2,"1",1,2,-2,"D"
"19567",1997-08-21,1997,"RC Strasbourg","FC Nantes","1-2",1,2,"1",1,3,-1,"D"
"19568",1997-08-22,1997,"AJ Auxerre","EA Guingamp","1-0",1,0,"1",1,1,1,"H"
"19569",1997-08-22,1997,"FC Metz","Paris Saint-Germain","2-1",2,1,"1",1,3,1,"H"
"19570",1997-08-22,1997,"Olympique Marseille","RC Lens","2-3",2,3,"1",1,5,-1,"D"
"19571",1997-08-22,1997,"Le Havre AC","Olympique Lyon","1-3",1,3,"1",1,4,-2,"D"
"19572",1997-08-22,1997,"Montpellier HSC","Toulouse FC","4-0",4,0,"1",1,4,4,"H"
"19573",1997-08-22,1997,"Stade Rennes","AS Monaco","2-1",2,1,"1",1,3,1,"H"
"19574",1997-08-22,1997,"SC Bastia","LB Chateauroux","1-1",1,1,"1",1,2,0,"D"
"19575",1997-08-29,1997,"AS Monaco","FC Metz","1-2",1,2,"1",1,3,-1,"D"
"19576",1997-08-29,1997,"EA Guingamp","Olympique Marseille","1-1",1,1,"1",1,2,0,"D"
"19577",1997-08-30,1997,"FC Nantes","Le Havre AC","2-0",2,0,"1",1,2,2,"H"
"19578",1997-08-30,1997,"Girondins Bordeaux","AJ Auxerre","3-2",3,2,"1",1,5,1,"H"
"19579",1997-08-30,1997,"RC Lens","Montpellier HSC","0-0",0,0,"1",1,0,0,"D"
"19580",1997-08-30,1997,"Olympique Lyon","SC Bastia","0-2",0,2,"1",1,2,-2,"D"
"19581",1997-08-30,1997,"Paris Saint-Germain","Stade Rennes","4-1",4,1,"1",1,5,3,"H"
"19582",1997-08-30,1997,"LB Chateauroux","AS Cannes","1-2",1,2,"1",1,3,-1,"D"
"19583",1997-08-30,1997,"Toulouse FC","RC Strasbourg","1-1",1,1,"1",1,2,0,"D"
"19584",1997-09-04,1997,"Olympique Marseille","Olympique Lyon","1-0",1,0,"1",1,1,1,"H"
"19585",1997-09-04,1997,"Le Havre AC","Toulouse FC","1-1",1,1,"1",1,2,0,"D"
"19586",1997-09-05,1997,"SC Bastia","Girondins Bordeaux","4-1",4,1,"1",1,5,3,"H"
"19587",1997-09-05,1997,"AS Cannes","AS Monaco","1-2",1,2,"1",1,3,-1,"D"
"19588",1997-09-05,1997,"RC Lens","FC Nantes","0-0",0,0,"1",1,0,0,"D"
"19589",1997-09-05,1997,"AJ Auxerre","LB Chateauroux","5-0",5,0,"1",1,5,5,"H"
"19590",1997-09-05,1997,"Montpellier HSC","EA Guingamp","2-3",2,3,"1",1,5,-1,"D"
"19591",1997-09-05,1997,"RC Strasbourg","Paris Saint-Germain","0-3",0,3,"1",1,3,-3,"D"
"19592",1997-09-05,1997,"Stade Rennes","FC Metz","2-2",2,2,"1",1,4,0,"D"
"19593",1997-09-11,1997,"LB Chateauroux","Stade Rennes","1-0",1,0,"1",1,1,1,"H"
"19594",1997-09-11,1997,"EA Guingamp","RC Lens","2-1",2,1,"1",1,3,1,"H"
"19595",1997-09-12,1997,"FC Nantes","Montpellier HSC","1-1",1,1,"1",1,2,0,"D"
"19596",1997-09-12,1997,"Girondins Bordeaux","Le Havre AC","2-1",2,1,"1",1,3,1,"H"
"19597",1997-09-12,1997,"AS Monaco","Olympique Marseille","2-0",2,0,"1",1,2,2,"H"
"19598",1997-09-12,1997,"Olympique Lyon","RC Strasbourg","3-1",3,1,"1",1,4,2,"H"
"19599",1997-09-12,1997,"FC Metz","AS Cannes","2-0",2,0,"1",1,2,2,"H"
"19600",1997-09-12,1997,"Paris Saint-Germain","SC Bastia","2-0",2,0,"1",1,2,2,"H"
"19601",1997-09-12,1997,"Toulouse FC","AJ Auxerre","2-1",2,1,"1",1,3,1,"H"
"19602",1997-09-20,1997,"EA Guingamp","FC Nantes","1-0",1,0,"1",1,1,1,"H"
"19603",1997-09-20,1997,"AS Cannes","Stade Rennes","1-1",1,1,"1",1,2,0,"D"
"19604",1997-09-20,1997,"RC Lens","Toulouse FC","2-0",2,0,"1",1,2,2,"H"
"19605",1997-09-20,1997,"AJ Auxerre","Olympique Lyon","1-2",1,2,"1",1,3,-1,"D"
"19606",1997-09-20,1997,"Olympique Marseille","LB Chateauroux","2-0",2,0,"1",1,2,2,"H"
"19607",1997-09-20,1997,"Le Havre AC","Paris Saint-Germain","1-1",1,1,"1",1,2,0,"D"
"19608",1997-09-20,1997,"RC Strasbourg","Girondins Bordeaux","0-0",0,0,"1",1,0,0,"D"
"19609",1997-09-21,1997,"SC Bastia","FC Metz","0-0",0,0,"1",1,0,0,"D"
"19610",1997-09-21,1997,"Montpellier HSC","AS Monaco","0-2",0,2,"1",1,2,-2,"D"
"19611",1997-09-25,1997,"Olympique Lyon","RC Lens","1-3",1,3,"1",1,4,-2,"D"
"19612",1997-09-25,1997,"Girondins Bordeaux","Olympique Marseille","2-0",2,0,"1",1,2,2,"H"
"19613",1997-09-26,1997,"FC Nantes","AS Cannes","1-2",1,2,"1",1,3,-1,"D"
"19614",1997-09-26,1997,"AS Monaco","RC Strasbourg","3-2",3,2,"1",1,5,1,"H"
"19615",1997-09-26,1997,"FC Metz","AJ Auxerre","3-0",3,0,"1",1,3,3,"H"
"19616",1997-09-26,1997,"Paris Saint-Germain","Montpellier HSC","1-1",1,1,"1",1,2,0,"D"
"19617",1997-09-26,1997,"Toulouse FC","EA Guingamp","3-0",3,0,"1",1,3,3,"H"
"19618",1997-09-26,1997,"Stade Rennes","SC Bastia","2-0",2,0,"1",1,2,2,"H"
"19619",1997-09-26,1997,"LB Chateauroux","Le Havre AC","2-1",2,1,"1",1,3,1,"H"
"19620",1997-10-04,1997,"SC Bastia","AS Cannes","5-1",5,1,"1",1,6,4,"H"
"19621",1997-10-04,1997,"EA Guingamp","Olympique Lyon","0-1",0,1,"1",1,1,-1,"D"
"19622",1997-10-04,1997,"RC Lens","LB Chateauroux","1-0",1,0,"1",1,1,1,"H"
"19623",1997-10-04,1997,"AJ Auxerre","Stade Rennes","4-0",4,0,"1",1,4,4,"H"
"19624",1997-10-04,1997,"Le Havre AC","AS Monaco","1-1",1,1,"1",1,2,0,"D"
"19625",1997-10-04,1997,"Montpellier HSC","Girondins Bordeaux","0-1",0,1,"1",1,1,-1,"D"
"19626",1997-10-04,1997,"Olympique Marseille","Toulouse FC","2-0",2,0,"1",1,2,2,"H"
"19627",1997-10-05,1997,"FC Nantes","Paris Saint-Germain","0-0",0,0,"1",1,0,0,"D"
"19628",1997-10-05,1997,"RC Strasbourg","FC Metz","2-0",2,0,"1",1,2,2,"H"
"19629",1997-10-07,1997,"AS Cannes","AJ Auxerre","2-3",2,3,"1",1,5,-1,"D"
"19630",1997-10-07,1997,"AS Monaco","SC Bastia","1-0",1,0,"1",1,1,1,"H"
"19631",1997-10-08,1997,"Girondins Bordeaux","RC Lens","3-0",3,0,"1",1,3,3,"H"
"19632",1997-10-08,1997,"Olympique Lyon","Montpellier HSC","1-2",1,2,"1",1,3,-1,"D"
"19633",1997-10-08,1997,"FC Metz","Le Havre AC","2-0",2,0,"1",1,2,2,"H"
"19634",1997-10-08,1997,"Paris Saint-Germain","EA Guingamp","4-2",4,2,"1",1,6,2,"H"
"19635",1997-10-08,1997,"LB Chateauroux","RC Strasbourg","2-0",2,0,"1",1,2,2,"H"
"19636",1997-10-08,1997,"Toulouse FC","FC Nantes","1-0",1,0,"1",1,1,1,"H"
"19637",1997-10-08,1997,"Stade Rennes","Olympique Marseille","0-2",0,2,"1",1,2,-2,"D"
"19638",1997-10-16,1997,"EA Guingamp","Girondins Bordeaux","0-1",0,1,"1",1,1,-1,"D"
"19639",1997-10-16,1997,"Olympique Marseille","FC Metz","2-0",2,0,"1",1,2,2,"H"
"19640",1997-10-17,1997,"FC Nantes","Olympique Lyon","3-2",3,2,"1",1,5,1,"H"
"19641",1997-10-17,1997,"RC Lens","AS Monaco","1-0",1,0,"1",1,1,1,"H"
"19642",1997-10-17,1997,"AJ Auxerre","SC Bastia","2-0",2,0,"1",1,2,2,"H"
"19643",1997-10-17,1997,"Le Havre AC","Stade Rennes","1-1",1,1,"1",1,2,0,"D"
"19644",1997-10-17,1997,"Montpellier HSC","LB Chateauroux","1-0",1,0,"1",1,1,1,"H"
"19645",1997-10-17,1997,"RC Strasbourg","AS Cannes","2-0",2,0,"1",1,2,2,"H"
"19646",1997-10-17,1997,"Toulouse FC","Paris Saint-Germain","0-2",0,2,"1",1,2,-2,"D"
"19647",1997-10-25,1997,"SC Bastia","Olympique Marseille","1-1",1,1,"1",1,2,0,"D"
"19648",1997-10-25,1997,"AS Cannes","Le Havre AC","1-1",1,1,"1",1,2,0,"D"
"19649",1997-10-25,1997,"Olympique Lyon","Toulouse FC","0-0",0,0,"1",1,0,0,"D"
"19650",1997-10-25,1997,"FC Metz","Montpellier HSC","0-1",0,1,"1",1,1,-1,"D"
"19651",1997-10-25,1997,"Paris Saint-Germain","RC Lens","2-0",2,0,"1",1,2,2,"H"
"19652",1997-10-25,1997,"LB Chateauroux","EA Guingamp","2-2",2,2,"1",1,4,0,"D"
"19653",1997-10-25,1997,"Stade Rennes","RC Strasbourg","3-1",3,1,"1",1,4,2,"H"
"19654",1997-10-26,1997,"Girondins Bordeaux","FC Nantes","1-1",1,1,"1",1,2,0,"D"
"19655",1997-10-26,1997,"AS Monaco","AJ Auxerre","0-1",0,1,"1",1,1,-1,"D"
"19656",1997-10-31,1997,"FC Nantes","LB Chateauroux","3-1",3,1,"1",1,4,2,"H"
"19657",1997-10-31,1997,"EA Guingamp","AS Monaco","1-2",1,2,"1",1,3,-1,"D"
"19658",1997-10-31,1997,"RC Lens","FC Metz","1-1",1,1,"1",1,2,0,"D"
"19659",1997-10-31,1997,"Olympique Lyon","Paris Saint-Germain","1-0",1,0,"1",1,1,1,"H"
"19660",1997-10-31,1997,"Olympique Marseille","AS Cannes","2-0",2,0,"1",1,2,2,"H"
"19661",1997-10-31,1997,"Le Havre AC","SC Bastia","2-1",2,1,"1",1,3,1,"H"
"19662",1997-10-31,1997,"RC Strasbourg","AJ Auxerre","1-1",1,1,"1",1,2,0,"D"
"19663",1997-11-02,1997,"Montpellier HSC","Stade Rennes","2-0",2,0,"1",1,2,2,"H"
"19664",1997-11-02,1997,"Toulouse FC","Girondins Bordeaux","2-2",2,2,"1",1,4,0,"D"
"19665",1997-11-08,1997,"Girondins Bordeaux","Olympique Lyon","0-0",0,0,"1",1,0,0,"D"
"19666",1997-11-08,1997,"AS Cannes","Montpellier HSC","1-0",1,0,"1",1,1,1,"H"
"19667",1997-11-08,1997,"AJ Auxerre","Le Havre AC","0-0",0,0,"1",1,0,0,"D"
"19668",1997-11-08,1997,"FC Metz","EA Guingamp","2-1",2,1,"1",1,3,1,"H"
"19669",1997-11-08,1997,"LB Chateauroux","Toulouse FC","2-1",2,1,"1",1,3,1,"H"
"19670",1997-11-08,1997,"Stade Rennes","RC Lens","2-3",2,3,"1",1,5,-1,"D"
"19671",1997-11-08,1997,"SC Bastia","RC Strasbourg","2-0",2,0,"1",1,2,2,"H"
"19672",1997-11-09,1997,"AS Monaco","FC Nantes","3-2",3,2,"1",1,5,1,"H"
"19673",1997-11-09,1997,"Paris Saint-Germain","Olympique Marseille","1-2",1,2,"1",1,3,-1,"D"
"19674",1997-11-14,1997,"Olympique Lyon","LB Chateauroux","2-1",2,1,"1",1,3,1,"H"
"19675",1997-11-15,1997,"FC Nantes","FC Metz","1-1",1,1,"1",1,2,0,"D"
"19676",1997-11-15,1997,"Girondins Bordeaux","Paris Saint-Germain","0-0",0,0,"1",1,0,0,"D"
"19677",1997-11-15,1997,"Olympique Marseille","AJ Auxerre","4-0",4,0,"1",1,4,4,"H"
"19678",1997-11-15,1997,"Montpellier HSC","SC Bastia","1-1",1,1,"1",1,2,0,"D"
"19679",1997-11-15,1997,"Toulouse FC","AS Monaco","1-3",1,3,"1",1,4,-2,"D"
"19680",1997-11-15,1997,"RC Lens","AS Cannes","5-4",5,4,"1",1,9,1,"H"
"19681",1997-11-16,1997,"Le Havre AC","RC Strasbourg","1-1",1,1,"1",1,2,0,"D"
"19682",1997-11-16,1997,"EA Guingamp","Stade Rennes","1-0",1,0,"1",1,1,1,"H"
"19683",1997-11-20,1997,"AJ Auxerre","Montpellier HSC","3-1",3,1,"1",1,4,2,"H"
"19684",1997-11-20,1997,"RC Strasbourg","Olympique Marseille","2-0",2,0,"1",1,2,2,"H"
"19685",1997-11-20,1997,"AS Monaco","Paris Saint-Germain","3-0",3,0,"1",1,3,3,"H"
"19686",1997-11-21,1997,"SC Bastia","RC Lens","1-0",1,0,"1",1,1,1,"H"
"19687",1997-11-21,1997,"AS Cannes","Olympique Lyon","1-0",1,0,"1",1,1,1,"H"
"19688",1997-11-21,1997,"FC Metz","Toulouse FC","2-1",2,1,"1",1,3,1,"H"
"19689",1997-11-21,1997,"Le Havre AC","EA Guingamp","0-0",0,0,"1",1,0,0,"D"
"19690",1997-11-21,1997,"LB Chateauroux","Girondins Bordeaux","1-0",1,0,"1",1,1,1,"H"
"19691",1997-11-21,1997,"Stade Rennes","FC Nantes","3-0",3,0,"1",1,3,3,"H"
"19692",1997-11-29,1997,"FC Nantes","Olympique Marseille","1-0",1,0,"1",1,1,1,"H"
"19693",1997-11-29,1997,"EA Guingamp","SC Bastia","0-0",0,0,"1",1,0,0,"D"
"19694",1997-11-29,1997,"RC Lens","RC Strasbourg","3-2",3,2,"1",1,5,1,"H"
"19695",1997-11-29,1997,"Olympique Lyon","Stade Rennes","3-1",3,1,"1",1,4,2,"H"
"19696",1997-11-29,1997,"Montpellier HSC","Le Havre AC","1-1",1,1,"1",1,2,0,"D"
"19697",1997-11-29,1997,"LB Chateauroux","AS Monaco","0-2",0,2,"1",1,2,-2,"D"
"19698",1997-11-29,1997,"Toulouse FC","AS Cannes","1-0",1,0,"1",1,1,1,"H"
"19699",1997-11-30,1997,"Paris Saint-Germain","AJ Auxerre","1-0",1,0,"1",1,1,1,"H"
"19700",1997-11-30,1997,"Girondins Bordeaux","FC Metz","2-2",2,2,"1",1,4,0,"D"
"19701",1997-12-04,1997,"AJ Auxerre","FC Nantes","3-1",3,1,"1",1,4,2,"H"
"19702",1997-12-05,1997,"AS Monaco","Olympique Lyon","2-1",2,1,"1",1,3,1,"H"
"19703",1997-12-05,1997,"AS Cannes","Paris Saint-Germain","0-1",0,1,"1",1,1,-1,"D"
"19704",1997-12-05,1997,"FC Metz","LB Chateauroux","2-0",2,0,"1",1,2,2,"H"
"19705",1997-12-06,1997,"Le Havre AC","RC Lens","0-1",0,1,"1",1,1,-1,"D"
"19706",1997-12-06,1997,"RC Strasbourg","EA Guingamp","0-1",0,1,"1",1,1,-1,"D"
"19707",1997-12-06,1997,"Stade Rennes","Girondins Bordeaux","0-0",0,0,"1",1,0,0,"D"
"19708",1997-12-07,1997,"SC Bastia","Toulouse FC","0-0",0,0,"1",1,0,0,"D"
"19709",1997-12-07,1997,"Olympique Marseille","Montpellier HSC","0-0",0,0,"1",1,0,0,"D"
"19710",1997-12-13,1997,"RC Lens","Olympique Marseille","0-1",0,1,"1",1,1,-1,"D"
"19711",1997-12-13,1997,"FC Nantes","RC Strasbourg","2-1",2,1,"1",1,3,1,"H"
"19712",1997-12-13,1997,"Girondins Bordeaux","AS Cannes","0-1",0,1,"1",1,1,-1,"D"
"19713",1997-12-13,1997,"EA Guingamp","AJ Auxerre","1-1",1,1,"1",1,2,0,"D"
"19714",1997-12-13,1997,"Olympique Lyon","Le Havre AC","0-1",0,1,"1",1,1,-1,"D"
"19715",1997-12-13,1997,"Toulouse FC","Montpellier HSC","1-1",1,1,"1",1,2,0,"D"
"19716",1997-12-13,1997,"LB Chateauroux","SC Bastia","1-1",1,1,"1",1,2,0,"D"
"19717",1997-12-14,1997,"AS Monaco","Stade Rennes","1-0",1,0,"1",1,1,1,"H"
"19718",1997-12-14,1997,"Paris Saint-Germain","FC Metz","1-1",1,1,"1",1,2,0,"D"
"19719",1997-12-19,1997,"SC Bastia","Olympique Lyon","0-1",0,1,"1",1,1,-1,"D"
"19720",1997-12-19,1997,"AJ Auxerre","Girondins Bordeaux","4-2",4,2,"1",1,6,2,"H"
"19721",1997-12-19,1997,"FC Metz","AS Monaco","3-0",3,0,"1",1,3,3,"H"
"19722",1997-12-19,1997,"Le Havre AC","FC Nantes","1-0",1,0,"1",1,1,1,"H"
"19723",1997-12-19,1997,"Montpellier HSC","RC Lens","1-2",1,2,"1",1,3,-1,"D"
"19724",1997-12-19,1997,"RC Strasbourg","Toulouse FC","2-0",2,0,"1",1,2,2,"H"
"19725",1997-12-19,1997,"Stade Rennes","Paris Saint-Germain","1-2",1,2,"1",1,3,-1,"D"
"19726",1997-12-19,1997,"AS Cannes","LB Chateauroux","2-2",2,2,"1",1,4,0,"D"
"19727",1998-01-10,1997,"Girondins Bordeaux","SC Bastia","2-0",2,0,"1",1,2,2,"H"
"19728",1998-01-10,1997,"AS Monaco","AS Cannes","0-1",0,1,"1",1,1,-1,"D"
"19729",1998-01-10,1997,"EA Guingamp","Montpellier HSC","1-2",1,2,"1",1,3,-1,"D"
"19730",1998-01-10,1997,"Olympique Lyon","Olympique Marseille","2-1",2,1,"1",1,3,1,"H"
"19731",1998-01-10,1997,"FC Metz","Stade Rennes","1-0",1,0,"1",1,1,1,"H"
"19732",1998-01-10,1997,"LB Chateauroux","AJ Auxerre","3-2",3,2,"1",1,5,1,"H"
"19733",1998-01-10,1997,"Toulouse FC","Le Havre AC","1-0",1,0,"1",1,1,1,"H"
"19734",1998-01-11,1997,"FC Nantes","RC Lens","1-0",1,0,"1",1,1,1,"H"
"19735",1998-01-11,1997,"Paris Saint-Germain","RC Strasbourg","2-1",2,1,"1",1,3,1,"H"
"19736",1998-01-14,1997,"Olympique Marseille","EA Guingamp","3-0",3,0,"1",1,3,3,"H"
"19737",1998-01-20,1997,"AS Cannes","FC Metz","1-1",1,1,"1",1,2,0,"D"
"19738",1998-01-20,1997,"Olympique Marseille","AS Monaco","1-1",1,1,"1",1,2,0,"D"
"19739",1998-01-21,1997,"SC Bastia","Paris Saint-Germain","2-0",2,0,"1",1,2,2,"H"
"19740",1998-01-21,1997,"RC Lens","EA Guingamp","1-0",1,0,"1",1,1,1,"H"
"19741",1998-01-21,1997,"AJ Auxerre","Toulouse FC","3-1",3,1,"1",1,4,2,"H"
"19742",1998-01-21,1997,"Le Havre AC","Girondins Bordeaux","0-0",0,0,"1",1,0,0,"D"
"19743",1998-01-21,1997,"Montpellier HSC","FC Nantes","2-0",2,0,"1",1,2,2,"H"
"19744",1998-01-21,1997,"RC Strasbourg","Olympique Lyon","1-2",1,2,"1",1,3,-1,"D"
"19745",1998-01-21,1997,"Stade Rennes","LB Chateauroux","3-0",3,0,"1",1,3,3,"H"
"19746",1998-01-24,1997,"FC Nantes","EA Guingamp","2-0",2,0,"1",1,2,2,"H"
"19747",1998-01-24,1997,"Girondins Bordeaux","RC Strasbourg","4-4",4,4,"1",1,8,0,"D"
"19748",1998-01-24,1997,"AS Monaco","Montpellier HSC","4-0",4,0,"1",1,4,4,"H"
"19749",1998-01-24,1997,"Olympique Lyon","AJ Auxerre","1-0",1,0,"1",1,1,1,"H"
"19750",1998-01-24,1997,"FC Metz","SC Bastia","0-1",0,1,"1",1,1,-1,"D"
"19751",1998-01-24,1997,"Paris Saint-Germain","Le Havre AC","0-2",0,2,"1",1,2,-2,"D"
"19752",1998-01-24,1997,"LB Chateauroux","Olympique Marseille","0-3",0,3,"1",1,3,-3,"D"
"19753",1998-01-24,1997,"Toulouse FC","RC Lens","1-2",1,2,"1",1,3,-1,"D"
"19754",1998-01-24,1997,"Stade Rennes","AS Cannes","2-0",2,0,"1",1,2,2,"H"
"19755",1998-02-03,1997,"SC Bastia","Stade Rennes","0-0",0,0,"1",1,0,0,"D"
"19756",1998-02-03,1997,"RC Strasbourg","AS Monaco","0-0",0,0,"1",1,0,0,"D"
"19757",1998-02-04,1997,"EA Guingamp","Toulouse FC","2-0",2,0,"1",1,2,2,"H"
"19758",1998-02-04,1997,"RC Lens","Olympique Lyon","3-0",3,0,"1",1,3,3,"H"
"19759",1998-02-04,1997,"AJ Auxerre","FC Metz","0-0",0,0,"1",1,0,0,"D"
"19760",1998-02-04,1997,"Olympique Marseille","Girondins Bordeaux","1-0",1,0,"1",1,1,1,"H"
"19761",1998-02-04,1997,"Montpellier HSC","Paris Saint-Germain","2-1",2,1,"1",1,3,1,"H"
"19762",1998-02-05,1997,"AS Cannes","FC Nantes","2-3",2,3,"1",1,5,-1,"D"
"19763",1998-02-05,1997,"Le Havre AC","LB Chateauroux","5-0",5,0,"1",1,5,5,"H"
"19764",1998-02-12,1997,"LB Chateauroux","RC Lens","2-1",2,1,"1",1,3,1,"H"
"19765",1998-02-12,1997,"Stade Rennes","AJ Auxerre","1-1",1,1,"1",1,2,0,"D"
"19766",1998-02-13,1997,"Girondins Bordeaux","Montpellier HSC","3-1",3,1,"1",1,4,2,"H"
"19767",1998-02-13,1997,"AS Monaco","Le Havre AC","2-0",2,0,"1",1,2,2,"H"
"19768",1998-02-13,1997,"AS Cannes","SC Bastia","1-1",1,1,"1",1,2,0,"D"
"19769",1998-02-13,1997,"Olympique Lyon","EA Guingamp","1-0",1,0,"1",1,1,1,"H"
"19770",1998-02-13,1997,"FC Metz","RC Strasbourg","1-0",1,0,"1",1,1,1,"H"
"19771",1998-02-13,1997,"Paris Saint-Germain","FC Nantes","0-1",0,1,"1",1,1,-1,"D"
"19772",1998-02-13,1997,"Toulouse FC","Olympique Marseille","0-4",0,4,"1",1,4,-4,"D"
"19773",1998-02-20,1997,"SC Bastia","AS Monaco","1-0",1,0,"1",1,1,1,"H"
"19774",1998-02-20,1997,"RC Strasbourg","LB Chateauroux","2-0",2,0,"1",1,2,2,"H"
"19775",1998-02-21,1997,"FC Nantes","Toulouse FC","0-1",0,1,"1",1,1,-1,"D"
"19776",1998-02-21,1997,"EA Guingamp","Paris Saint-Germain","0-0",0,0,"1",1,0,0,"D"
"19777",1998-02-21,1997,"AJ Auxerre","AS Cannes","1-1",1,1,"1",1,2,0,"D"
"19778",1998-02-21,1997,"Olympique Marseille","Stade Rennes","0-1",0,1,"1",1,1,-1,"D"
"19779",1998-02-21,1997,"Montpellier HSC","Olympique Lyon","1-1",1,1,"1",1,2,0,"D"
"19780",1998-02-21,1997,"RC Lens","Girondins Bordeaux","1-0",1,0,"1",1,1,1,"H"
"19781",1998-02-21,1997,"Le Havre AC","FC Metz","2-1",2,1,"1",1,3,1,"H"
"19782",1998-03-07,1997,"SC Bastia","AJ Auxerre","1-2",1,2,"1",1,3,-1,"D"
"19783",1998-03-07,1997,"Girondins Bordeaux","EA Guingamp","4-2",4,2,"1",1,6,2,"H"
"19784",1998-03-07,1997,"AS Monaco","RC Lens","0-1",0,1,"1",1,1,-1,"D"
"19785",1998-03-07,1997,"AS Cannes","RC Strasbourg","1-0",1,0,"1",1,1,1,"H"
"19786",1998-03-07,1997,"Olympique Lyon","FC Nantes","0-0",0,0,"1",1,0,0,"D"
"19787",1998-03-07,1997,"FC Metz","Olympique Marseille","3-2",3,2,"1",1,5,1,"H"
"19788",1998-03-07,1997,"Paris Saint-Germain","Toulouse FC","1-1",1,1,"1",1,2,0,"D"
"19789",1998-03-07,1997,"LB Chateauroux","Montpellier HSC","0-1",0,1,"1",1,1,-1,"D"
"19790",1998-03-07,1997,"Stade Rennes","Le Havre AC","2-2",2,2,"1",1,4,0,"D"
"19791",1998-03-13,1997,"FC Nantes","Girondins Bordeaux","1-2",1,2,"1",1,3,-1,"D"
"19792",1998-03-13,1997,"EA Guingamp","LB Chateauroux","0-0",0,0,"1",1,0,0,"D"
"19793",1998-03-13,1997,"AJ Auxerre","AS Monaco","3-1",3,1,"1",1,4,2,"H"
"19794",1998-03-13,1997,"Le Havre AC","AS Cannes","2-0",2,0,"1",1,2,2,"H"
"19795",1998-03-13,1997,"Montpellier HSC","FC Metz","0-1",0,1,"1",1,1,-1,"D"
"19796",1998-03-13,1997,"RC Strasbourg","Stade Rennes","3-1",3,1,"1",1,4,2,"H"
"19797",1998-03-13,1997,"Toulouse FC","Olympique Lyon","0-2",0,2,"1",1,2,-2,"D"
"19798",1998-03-15,1997,"RC Lens","Paris Saint-Germain","3-0",3,0,"1",1,3,3,"H"
"19799",1998-03-15,1997,"Olympique Marseille","SC Bastia","1-0",1,0,"1",1,1,1,"H"
"19800",1998-03-28,1997,"SC Bastia","Le Havre AC","2-0",2,0,"1",1,2,2,"H"
"19801",1998-03-28,1997,"Girondins Bordeaux","Toulouse FC","3-1",3,1,"1",1,4,2,"H"
"19802",1998-03-28,1997,"AS Monaco","EA Guingamp","1-0",1,0,"1",1,1,1,"H"
"19803",1998-03-28,1997,"Paris Saint-Germain","Olympique Lyon","3-0",3,0,"1",1,3,3,"H"
"19804",1998-03-28,1997,"LB Chateauroux","FC Nantes","1-2",1,2,"1",1,3,-1,"D"
"19805",1998-03-28,1997,"Stade Rennes","Montpellier HSC","2-0",2,0,"1",1,2,2,"H"
"19806",1998-03-28,1997,"AJ Auxerre","RC Strasbourg","1-2",1,2,"1",1,3,-1,"D"
"19807",1998-03-29,1997,"AS Cannes","Olympique Marseille","3-3",3,3,"1",1,6,0,"D"
"19808",1998-03-29,1997,"FC Metz","RC Lens","0-2",0,2,"1",1,2,-2,"D"
"19809",1998-04-07,1997,"FC Nantes","AS Monaco","1-1",1,1,"1",1,2,0,"D"
"19810",1998-04-07,1997,"RC Lens","Stade Rennes","3-0",3,0,"1",1,3,3,"H"
"19811",1998-04-07,1997,"Olympique Lyon","Girondins Bordeaux","1-1",1,1,"1",1,2,0,"D"
"19812",1998-04-07,1997,"Le Havre AC","AJ Auxerre","2-2",2,2,"1",1,4,0,"D"
"19813",1998-04-07,1997,"Montpellier HSC","AS Cannes","1-0",1,0,"1",1,1,1,"H"
"19814",1998-04-07,1997,"RC Strasbourg","SC Bastia","1-1",1,1,"1",1,2,0,"D"
"19815",1998-04-07,1997,"Toulouse FC","LB Chateauroux","1-1",1,1,"1",1,2,0,"D"
"19816",1998-04-08,1997,"Olympique Marseille","Paris Saint-Germain","0-0",0,0,"1",1,0,0,"D"
"19817",1998-04-08,1997,"EA Guingamp","FC Metz","0-1",0,1,"1",1,1,-1,"D"
"19818",1998-04-17,1997,"FC Metz","FC Nantes","3-2",3,2,"1",1,5,1,"H"
"19819",1998-04-17,1997,"AS Cannes","RC Lens","0-2",0,2,"1",1,2,-2,"D"
"19820",1998-04-18,1997,"AS Monaco","Toulouse FC","0-1",0,1,"1",1,1,-1,"D"
"19821",1998-04-18,1997,"AJ Auxerre","Olympique Marseille","2-1",2,1,"1",1,3,1,"H"
"19822",1998-04-18,1997,"RC Strasbourg","Le Havre AC","0-1",0,1,"1",1,1,-1,"D"
"19823",1998-04-18,1997,"Paris Saint-Germain","Girondins Bordeaux","0-1",0,1,"1",1,1,-1,"D"
"19824",1998-04-18,1997,"LB Chateauroux","Olympique Lyon","2-3",2,3,"1",1,5,-1,"D"
"19825",1998-04-18,1997,"Stade Rennes","EA Guingamp","1-2",1,2,"1",1,3,-1,"D"
"19826",1998-04-18,1997,"SC Bastia","Montpellier HSC","2-1",2,1,"1",1,3,1,"H"
"19827",1998-04-25,1997,"FC Nantes","Stade Rennes","1-1",1,1,"1",1,2,0,"D"
"19828",1998-04-25,1997,"Girondins Bordeaux","LB Chateauroux","1-0",1,0,"1",1,1,1,"H"
"19829",1998-04-25,1997,"EA Guingamp","Le Havre AC","1-2",1,2,"1",1,3,-1,"D"
"19830",1998-04-25,1997,"RC Lens","SC Bastia","5-1",5,1,"1",1,6,4,"H"
"19831",1998-04-25,1997,"Olympique Lyon","AS Cannes","2-0",2,0,"1",1,2,2,"H"
"19832",1998-04-25,1997,"Olympique Marseille","RC Strasbourg","0-0",0,0,"1",1,0,0,"D"
"19833",1998-04-25,1997,"Montpellier HSC","AJ Auxerre","1-1",1,1,"1",1,2,0,"D"
"19834",1998-04-25,1997,"Paris Saint-Germain","AS Monaco","1-2",1,2,"1",1,3,-1,"D"
"19835",1998-04-25,1997,"Toulouse FC","FC Metz","0-1",0,1,"1",1,1,-1,"D"
"19836",1998-05-09,1997,"SC Bastia","FC Nantes","2-1",2,1,"1",1,3,1,"H"
"19837",1998-05-09,1997,"AS Monaco","Girondins Bordeaux","5-2",5,2,"1",1,7,3,"H"
"19838",1998-05-09,1997,"AS Cannes","EA Guingamp","1-3",1,3,"1",1,4,-2,"D"
"19839",1998-05-09,1997,"AJ Auxerre","RC Lens","1-1",1,1,"1",1,2,0,"D"
"19840",1998-05-09,1997,"FC Metz","Olympique Lyon","1-0",1,0,"1",1,1,1,"H"
"19841",1998-05-09,1997,"Le Havre AC","Olympique Marseille","1-1",1,1,"1",1,2,0,"D"
"19842",1998-05-09,1997,"RC Strasbourg","Montpellier HSC","3-0",3,0,"1",1,3,3,"H"
"19843",1998-05-09,1997,"LB Chateauroux","Paris Saint-Germain","2-1",2,1,"1",1,3,1,"H"
"19844",1998-05-09,1997,"Stade Rennes","Toulouse FC","1-0",1,0,"1",1,1,1,"H"
"19845",1998-08-07,1998,"Le Havre AC","FC Metz","0-0",0,0,"1",1,0,0,"D"
"19846",1998-08-07,1998,"Stade Rennes","AJ Auxerre","1-0",1,0,"1",1,1,1,"H"
"19847",1998-08-07,1998,"FC Lorient","AS Monaco","1-2",1,2,"1",1,3,-1,"D"
"19848",1998-08-08,1998,"Olympique Marseille","FC Nantes","2-0",2,0,"1",1,2,2,"H"
"19849",1998-08-08,1998,"SC Bastia","Montpellier HSC","2-2",2,2,"1",1,4,0,"D"
"19850",1998-08-08,1998,"Girondins Bordeaux","Paris Saint-Germain","3-1",3,1,"1",1,4,2,"H"
"19851",1998-08-08,1998,"RC Strasbourg","Olympique Lyon","0-0",0,0,"1",1,0,0,"D"
"19852",1998-08-08,1998,"Toulouse FC","RC Lens","3-2",3,2,"1",1,5,1,"H"
"19853",1998-08-08,1998,"AS Nancy","FC Sochaux","1-1",1,1,"1",1,2,0,"D"
"19854",1998-08-14,1998,"RC Lens","FC Lorient","1-1",1,1,"1",1,2,0,"D"
"19855",1998-08-14,1998,"Olympique Lyon","Toulouse FC","6-1",6,1,"1",1,7,5,"H"
"19856",1998-08-15,1998,"Le Havre AC","Girondins Bordeaux","2-3",2,3,"1",1,5,-1,"D"
"19857",1998-08-15,1998,"AS Monaco","FC Sochaux","4-1",4,1,"1",1,5,3,"H"
"19858",1998-08-15,1998,"Paris Saint-Germain","SC Bastia","2-0",2,0,"1",1,2,2,"H"
"19859",1998-08-15,1998,"FC Nantes","RC Strasbourg","1-0",1,0,"1",1,1,1,"H"
"19860",1998-08-15,1998,"AJ Auxerre","AS Nancy","3-2",3,2,"1",1,5,1,"H"
"19861",1998-08-15,1998,"Montpellier HSC","Stade Rennes","3-1",3,1,"1",1,4,2,"H"
"19862",1998-08-15,1998,"FC Metz","Olympique Marseille","0-1",0,1,"1",1,1,-1,"D"
"19863",1998-08-22,1998,"Stade Rennes","Le Havre AC","2-1",2,1,"1",1,3,1,"H"
"19864",1998-08-22,1998,"Olympique Marseille","Montpellier HSC","5-4",5,4,"1",1,9,1,"H"
"19865",1998-08-22,1998,"Girondins Bordeaux","AJ Auxerre","1-0",1,0,"1",1,1,1,"H"
"19866",1998-08-22,1998,"RC Strasbourg","Paris Saint-Germain","0-1",0,1,"1",1,1,-1,"D"
"19867",1998-08-22,1998,"Toulouse FC","AS Monaco","0-0",0,0,"1",1,0,0,"D"
"19868",1998-08-22,1998,"FC Lorient","Olympique Lyon","0-1",0,1,"1",1,1,-1,"D"
"19869",1998-08-22,1998,"SC Bastia","FC Metz","3-0",3,0,"1",1,3,3,"H"
"19870",1998-08-23,1998,"FC Sochaux","RC Lens","0-4",0,4,"1",1,4,-4,"D"
"19871",1998-08-23,1998,"AS Nancy","FC Nantes","1-0",1,0,"1",1,1,1,"H"
"19872",1998-08-29,1998,"Le Havre AC","Olympique Marseille","0-0",0,0,"1",1,0,0,"D"
"19873",1998-08-29,1998,"RC Lens","AS Nancy","2-1",2,1,"1",1,3,1,"H"
"19874",1998-08-29,1998,"Olympique Lyon","AS Monaco","1-1",1,1,"1",1,2,0,"D"
"19875",1998-08-29,1998,"Paris Saint-Germain","FC Lorient","1-2",1,2,"1",1,3,-1,"D"
"19876",1998-08-29,1998,"FC Nantes","FC Sochaux","2-0",2,0,"1",1,2,2,"H"
"19877",1998-08-29,1998,"Montpellier HSC","Toulouse FC","3-0",3,0,"1",1,3,3,"H"
"19878",1998-08-29,1998,"FC Metz","Girondins Bordeaux","0-2",0,2,"1",1,2,-2,"D"
"19879",1998-08-30,1998,"Stade Rennes","RC Strasbourg","1-1",1,1,"1",1,2,0,"D"
"19880",1998-08-30,1998,"AJ Auxerre","SC Bastia","1-0",1,0,"1",1,1,1,"H"
"19881",1998-09-10,1998,"AS Monaco","RC Lens","2-0",2,0,"1",1,2,2,"H"
"19882",1998-09-10,1998,"FC Lorient","AJ Auxerre","1-1",1,1,"1",1,2,0,"D"
"19883",1998-09-11,1998,"FC Sochaux","Olympique Lyon","1-2",1,2,"1",1,3,-1,"D"
"19884",1998-09-11,1998,"Olympique Marseille","Stade Rennes","1-1",1,1,"1",1,2,0,"D"
"19885",1998-09-11,1998,"SC Bastia","Le Havre AC","2-0",2,0,"1",1,2,2,"H"
"19886",1998-09-11,1998,"Girondins Bordeaux","Montpellier HSC","3-1",3,1,"1",1,4,2,"H"
"19887",1998-09-11,1998,"RC Strasbourg","FC Metz","0-0",0,0,"1",1,0,0,"D"
"19888",1998-09-11,1998,"Toulouse FC","FC Nantes","2-3",2,3,"1",1,5,-1,"D"
"19889",1998-09-11,1998,"AS Nancy","Paris Saint-Germain","0-0",0,0,"1",1,0,0,"D"
"19890",1998-09-19,1998,"Le Havre AC","RC Strasbourg","0-1",0,1,"1",1,1,-1,"D"
"19891",1998-09-19,1998,"Stade Rennes","SC Bastia","2-0",2,0,"1",1,2,2,"H"
"19892",1998-09-19,1998,"Olympique Lyon","RC Lens","3-1",3,1,"1",1,4,2,"H"
"19893",1998-09-19,1998,"FC Nantes","FC Lorient","1-1",1,1,"1",1,2,0,"D"
"19894",1998-09-19,1998,"AJ Auxerre","FC Sochaux","3-1",3,1,"1",1,4,2,"H"
"19895",1998-09-19,1998,"Montpellier HSC","AS Nancy","1-1",1,1,"1",1,2,0,"D"
"19896",1998-09-19,1998,"FC Metz","Toulouse FC","0-0",0,0,"1",1,0,0,"D"
"19897",1998-09-20,1998,"Olympique Marseille","Girondins Bordeaux","2-2",2,2,"1",1,4,0,"D"
"19898",1998-09-20,1998,"Paris Saint-Germain","AS Monaco","1-0",1,0,"1",1,1,1,"H"
"19899",1998-09-24,1998,"SC Bastia","Olympique Marseille","0-2",0,2,"1",1,2,-2,"D"
"19900",1998-09-24,1998,"Toulouse FC","AJ Auxerre","0-0",0,0,"1",1,0,0,"D"
"19901",1998-09-25,1998,"FC Sochaux","Paris Saint-Germain","1-0",1,0,"1",1,1,1,"H"
"19902",1998-09-25,1998,"AS Monaco","Le Havre AC","3-0",3,0,"1",1,3,3,"H"
"19903",1998-09-25,1998,"RC Lens","FC Nantes","2-4",2,4,"1",1,6,-2,"D"
"19904",1998-09-25,1998,"Girondins Bordeaux","Stade Rennes","4-0",4,0,"1",1,4,4,"H"
"19905",1998-09-25,1998,"RC Strasbourg","Montpellier HSC","2-1",2,1,"1",1,3,1,"H"
"19906",1998-09-25,1998,"FC Lorient","FC Metz","1-1",1,1,"1",1,2,0,"D"
"19907",1998-09-25,1998,"AS Nancy","Olympique Lyon","0-0",0,0,"1",1,0,0,"D"
"19908",1998-10-03,1998,"Le Havre AC","FC Sochaux","3-0",3,0,"1",1,3,3,"H"
"19909",1998-10-03,1998,"Stade Rennes","AS Monaco","2-1",2,1,"1",1,3,1,"H"
"19910",1998-10-03,1998,"Olympique Marseille","Toulouse FC","2-0",2,0,"1",1,2,2,"H"
"19911",1998-10-03,1998,"SC Bastia","Girondins Bordeaux","2-0",2,0,"1",1,2,2,"H"
"19912",1998-10-03,1998,"FC Nantes","Olympique Lyon","2-0",2,0,"1",1,2,2,"H"
"19913",1998-10-03,1998,"AJ Auxerre","RC Strasbourg","3-1",3,1,"1",1,4,2,"H"
"19914",1998-10-03,1998,"Montpellier HSC","FC Lorient","5-1",5,1,"1",1,6,4,"H"
"19915",1998-10-04,1998,"Paris Saint-Germain","RC Lens","0-1",0,1,"1",1,1,-1,"D"
"19916",1998-10-04,1998,"FC Metz","AS Nancy","2-3",2,3,"1",1,5,-1,"D"
"19917",1998-10-16,1998,"Olympique Lyon","Paris Saint-Germain","1-1",1,1,"1",1,2,0,"D"
"19918",1998-10-16,1998,"Girondins Bordeaux","FC Nantes","2-0",2,0,"1",1,2,2,"H"
"19919",1998-10-16,1998,"RC Strasbourg","Olympique Marseille","0-2",0,2,"1",1,2,-2,"D"
"19920",1998-10-17,1998,"FC Sochaux","FC Metz","1-1",1,1,"1",1,2,0,"D"
"19921",1998-10-17,1998,"AS Monaco","Montpellier HSC","2-0",2,0,"1",1,2,2,"H"
"19922",1998-10-17,1998,"RC Lens","AJ Auxerre","2-2",2,2,"1",1,4,0,"D"
"19923",1998-10-17,1998,"FC Lorient","Le Havre AC","0-0",0,0,"1",1,0,0,"D"
"19924",1998-10-17,1998,"AS Nancy","Stade Rennes","0-1",0,1,"1",1,1,-1,"D"
"19925",1998-10-18,1998,"Toulouse FC","SC Bastia","2-1",2,1,"1",1,3,1,"H"
"19926",1998-10-24,1998,"Le Havre AC","Toulouse FC","0-0",0,0,"1",1,0,0,"D"
"19927",1998-10-24,1998,"Stade Rennes","FC Lorient","1-0",1,0,"1",1,1,1,"H"
"19928",1998-10-24,1998,"Olympique Marseille","FC Sochaux","4-0",4,0,"1",1,4,4,"H"
"19929",1998-10-24,1998,"SC Bastia","RC Strasbourg","0-0",0,0,"1",1,0,0,"D"
"19930",1998-10-24,1998,"FC Nantes","Paris Saint-Germain","0-0",0,0,"1",1,0,0,"D"
"19931",1998-10-24,1998,"AJ Auxerre","Olympique Lyon","1-0",1,0,"1",1,1,1,"H"
"19932",1998-10-24,1998,"FC Metz","AS Monaco","1-0",1,0,"1",1,1,1,"H"
"19933",1998-10-25,1998,"Girondins Bordeaux","AS Nancy","2-0",2,0,"1",1,2,2,"H"
"19934",1998-10-25,1998,"Montpellier HSC","RC Lens","1-0",1,0,"1",1,1,1,"H"
"19935",1998-10-29,1998,"AS Monaco","FC Nantes","3-1",3,1,"1",1,4,2,"H"
"19936",1998-10-29,1998,"Olympique Lyon","Le Havre AC","0-0",0,0,"1",1,0,0,"D"
"19937",1998-10-29,1998,"FC Lorient","Olympique Marseille","1-3",1,3,"1",1,4,-2,"D"
"19938",1998-10-30,1998,"RC Lens","FC Metz","2-0",2,0,"1",1,2,2,"H"
"19939",1998-10-30,1998,"Paris Saint-Germain","AJ Auxerre","2-0",2,0,"1",1,2,2,"H"
"19940",1998-10-30,1998,"RC Strasbourg","Girondins Bordeaux","3-2",3,2,"1",1,5,1,"H"
"19941",1998-10-30,1998,"Toulouse FC","Stade Rennes","0-1",0,1,"1",1,1,-1,"D"
"19942",1998-10-30,1998,"AS Nancy","SC Bastia","1-2",1,2,"1",1,3,-1,"D"
"19943",1998-10-31,1998,"FC Sochaux","Montpellier HSC","4-0",4,0,"1",1,4,4,"H"
"19944",1998-11-06,1998,"Olympique Marseille","AS Monaco","1-0",1,0,"1",1,1,1,"H"
"19945",1998-11-06,1998,"SC Bastia","FC Lorient","2-1",2,1,"1",1,3,1,"H"
"19946",1998-11-07,1998,"Le Havre AC","RC Lens","3-1",3,1,"1",1,4,2,"H"
"19947",1998-11-07,1998,"Stade Rennes","FC Sochaux","4-0",4,0,"1",1,4,4,"H"
"19948",1998-11-07,1998,"Girondins Bordeaux","Toulouse FC","3-1",3,1,"1",1,4,2,"H"
"19949",1998-11-07,1998,"RC Strasbourg","AS Nancy","1-2",1,2,"1",1,3,-1,"D"
"19950",1998-11-07,1998,"AJ Auxerre","FC Nantes","1-1",1,1,"1",1,2,0,"D"
"19951",1998-11-07,1998,"Montpellier HSC","Paris Saint-Germain","2-1",2,1,"1",1,3,1,"H"
"19952",1998-11-07,1998,"FC Metz","Olympique Lyon","3-2",3,2,"1",1,5,1,"H"
"19953",1998-11-10,1998,"FC Nantes","Le Havre AC","1-1",1,1,"1",1,2,0,"D"
"19954",1998-11-10,1998,"AS Nancy","Olympique Marseille","2-3",2,3,"1",1,5,-1,"D"
"19955",1998-11-11,1998,"FC Sochaux","SC Bastia","2-1",2,1,"1",1,3,1,"H"
"19956",1998-11-11,1998,"AS Monaco","AJ Auxerre","3-2",3,2,"1",1,5,1,"H"
"19957",1998-11-11,1998,"RC Lens","Stade Rennes","3-1",3,1,"1",1,4,2,"H"
"19958",1998-11-11,1998,"Olympique Lyon","Montpellier HSC","2-0",2,0,"1",1,2,2,"H"
"19959",1998-11-11,1998,"Paris Saint-Germain","FC Metz","2-2",2,2,"1",1,4,0,"D"
"19960",1998-11-11,1998,"Toulouse FC","RC Strasbourg","0-1",0,1,"1",1,1,-1,"D"
"19961",1998-11-11,1998,"FC Lorient","Girondins Bordeaux","0-2",0,2,"1",1,2,-2,"D"
"19962",1998-11-14,1998,"Stade Rennes","Olympique Lyon","0-0",0,0,"1",1,0,0,"D"
"19963",1998-11-14,1998,"Olympique Marseille","RC Lens","1-0",1,0,"1",1,1,1,"H"
"19964",1998-11-14,1998,"SC Bastia","AS Monaco","3-1",3,1,"1",1,4,2,"H"
"19965",1998-11-14,1998,"Girondins Bordeaux","FC Sochaux","0-0",0,0,"1",1,0,0,"D"
"19966",1998-11-14,1998,"Toulouse FC","AS Nancy","1-1",1,1,"1",1,2,0,"D"
"19967",1998-11-14,1998,"Montpellier HSC","AJ Auxerre","3-0",3,0,"1",1,3,3,"H"
"19968",1998-11-14,1998,"FC Metz","FC Nantes","1-0",1,0,"1",1,1,1,"H"
"19969",1998-11-15,1998,"Le Havre AC","Paris Saint-Germain","0-4",0,4,"1",1,4,-4,"D"
"19970",1998-11-15,1998,"RC Strasbourg","FC Lorient","2-0",2,0,"1",1,2,2,"H"
"19971",1998-11-19,1998,"AS Monaco","Girondins Bordeaux","0-2",0,2,"1",1,2,-2,"D"
"19972",1998-11-19,1998,"Olympique Lyon","Olympique Marseille","2-1",2,1,"1",1,3,1,"H"
"19973",1998-11-20,1998,"FC Sochaux","RC Strasbourg","1-1",1,1,"1",1,2,0,"D"
"19974",1998-11-20,1998,"RC Lens","SC Bastia","1-0",1,0,"1",1,1,1,"H"
"19975",1998-11-20,1998,"Paris Saint-Germain","Stade Rennes","2-1",2,1,"1",1,3,1,"H"
"19976",1998-11-20,1998,"FC Nantes","Montpellier HSC","1-1",1,1,"1",1,2,0,"D"
"19977",1998-11-20,1998,"AJ Auxerre","FC Metz","1-0",1,0,"1",1,1,1,"H"
"19978",1998-11-20,1998,"FC Lorient","Toulouse FC","1-0",1,0,"1",1,1,1,"H"
"19979",1998-11-20,1998,"AS Nancy","Le Havre AC","1-0",1,0,"1",1,1,1,"H"
"19980",1998-11-28,1998,"Le Havre AC","AJ Auxerre","2-1",2,1,"1",1,3,1,"H"
"19981",1998-11-28,1998,"Stade Rennes","FC Nantes","2-3",2,3,"1",1,5,-1,"D"
"19982",1998-11-28,1998,"SC Bastia","Olympique Lyon","4-1",4,1,"1",1,5,3,"H"
"19983",1998-11-28,1998,"RC Strasbourg","AS Monaco","1-1",1,1,"1",1,2,0,"D"
"19984",1998-11-28,1998,"Toulouse FC","FC Sochaux","1-1",1,1,"1",1,2,0,"D"
"19985",1998-11-28,1998,"FC Lorient","AS Nancy","0-1",0,1,"1",1,1,-1,"D"
"19986",1998-11-28,1998,"FC Metz","Montpellier HSC","3-1",3,1,"1",1,4,2,"H"
"19987",1998-11-29,1998,"Olympique Marseille","Paris Saint-Germain","0-0",0,0,"1",1,0,0,"D"
"19988",1998-11-29,1998,"Girondins Bordeaux","RC Lens","1-0",1,0,"1",1,1,1,"H"
"19989",1998-12-03,1998,"AS Monaco","AS Nancy","3-0",3,0,"1",1,3,3,"H"
"19990",1998-12-03,1998,"Olympique Lyon","Girondins Bordeaux","2-1",2,1,"1",1,3,1,"H"
"19991",1998-12-03,1998,"AJ Auxerre","Olympique Marseille","1-1",1,1,"1",1,2,0,"D"
"19992",1998-12-04,1998,"FC Sochaux","FC Lorient","0-1",0,1,"1",1,1,-1,"D"
"19993",1998-12-04,1998,"RC Lens","RC Strasbourg","3-0",3,0,"1",1,3,3,"H"
"19994",1998-12-04,1998,"Paris Saint-Germain","Toulouse FC","0-0",0,0,"1",1,0,0,"D"
"19995",1998-12-04,1998,"FC Nantes","SC Bastia","2-0",2,0,"1",1,2,2,"H"
"19996",1998-12-04,1998,"Montpellier HSC","Le Havre AC","2-0",2,0,"1",1,2,2,"H"
"19997",1998-12-04,1998,"FC Metz","Stade Rennes","0-0",0,0,"1",1,0,0,"D"
"19998",1998-12-11,1998,"Stade Rennes","Montpellier HSC","3-2",3,2,"1",1,5,1,"H"
"19999",1998-12-11,1998,"RC Strasbourg","FC Nantes","2-2",2,2,"1",1,4,0,"D"
"20000",1998-12-12,1998,"Olympique Marseille","FC Metz","3-0",3,0,"1",1,3,3,"H"
"20001",1998-12-12,1998,"SC Bastia","Paris Saint-Germain","2-0",2,0,"1",1,2,2,"H"
"20002",1998-12-12,1998,"Girondins Bordeaux","Le Havre AC","3-0",3,0,"1",1,3,3,"H"
"20003",1998-12-12,1998,"Toulouse FC","Olympique Lyon","0-0",0,0,"1",1,0,0,"D"
"20004",1998-12-12,1998,"FC Lorient","RC Lens","1-1",1,1,"1",1,2,0,"D"
"20005",1998-12-12,1998,"AS Nancy","AJ Auxerre","1-1",1,1,"1",1,2,0,"D"
"20006",1998-12-15,1998,"AJ Auxerre","Girondins Bordeaux","3-1",3,1,"1",1,4,2,"H"
"20007",1998-12-15,1998,"FC Metz","SC Bastia","4-0",4,0,"1",1,4,4,"H"
"20008",1998-12-16,1998,"Le Havre AC","Stade Rennes","2-0",2,0,"1",1,2,2,"H"
"20009",1998-12-16,1998,"AS Monaco","Toulouse FC","1-1",1,1,"1",1,2,0,"D"
"20010",1998-12-16,1998,"RC Lens","FC Sochaux","1-1",1,1,"1",1,2,0,"D"
"20011",1998-12-16,1998,"Olympique Lyon","FC Lorient","2-2",2,2,"1",1,4,0,"D"
"20012",1998-12-16,1998,"Paris Saint-Germain","RC Strasbourg","0-0",0,0,"1",1,0,0,"D"
"20013",1998-12-16,1998,"FC Nantes","AS Nancy","2-0",2,0,"1",1,2,2,"H"
"20014",1998-12-16,1998,"Montpellier HSC","Olympique Marseille","0-1",0,1,"1",1,1,-1,"D"
"20015",1998-12-19,1998,"FC Sochaux","FC Nantes","1-1",1,1,"1",1,2,0,"D"
"20016",1998-12-19,1998,"AS Monaco","Olympique Lyon","0-1",0,1,"1",1,1,-1,"D"
"20017",1998-12-19,1998,"Olympique Marseille","Le Havre AC","2-0",2,0,"1",1,2,2,"H"
"20018",1998-12-19,1998,"SC Bastia","AJ Auxerre","2-0",2,0,"1",1,2,2,"H"
"20019",1998-12-19,1998,"Girondins Bordeaux","FC Metz","6-0",6,0,"1",1,6,6,"H"
"20020",1998-12-19,1998,"RC Strasbourg","Stade Rennes","1-1",1,1,"1",1,2,0,"D"
"20021",1998-12-19,1998,"Toulouse FC","Montpellier HSC","2-5",2,5,"1",1,7,-3,"D"
"20022",1998-12-19,1998,"FC Lorient","Paris Saint-Germain","2-0",2,0,"1",1,2,2,"H"
"20023",1998-12-19,1998,"AS Nancy","RC Lens","0-1",0,1,"1",1,1,-1,"D"
"20024",1999-01-16,1998,"Le Havre AC","SC Bastia","1-1",1,1,"1",1,2,0,"D"
"20025",1999-01-16,1998,"Stade Rennes","Olympique Marseille","1-1",1,1,"1",1,2,0,"D"
"20026",1999-01-16,1998,"RC Lens","AS Monaco","1-1",1,1,"1",1,2,0,"D"
"20027",1999-01-16,1998,"FC Nantes","Toulouse FC","2-0",2,0,"1",1,2,2,"H"
"20028",1999-01-16,1998,"AJ Auxerre","FC Lorient","5-0",5,0,"1",1,5,5,"H"
"20029",1999-01-16,1998,"Montpellier HSC","Girondins Bordeaux","1-1",1,1,"1",1,2,0,"D"
"20030",1999-01-17,1998,"Paris Saint-Germain","AS Nancy","1-2",1,2,"1",1,3,-1,"D"
"20031",1999-01-17,1998,"FC Metz","RC Strasbourg","1-0",1,0,"1",1,1,1,"H"
"20032",1999-01-29,1998,"AS Monaco","Paris Saint-Germain","2-1",2,1,"1",1,3,1,"H"
"20033",1999-01-29,1998,"SC Bastia","Stade Rennes","0-1",0,1,"1",1,1,-1,"D"
"20034",1999-01-29,1998,"Girondins Bordeaux","Olympique Marseille","4-1",4,1,"1",1,5,3,"H"
"20035",1999-01-30,1998,"FC Sochaux","AJ Auxerre","1-1",1,1,"1",1,2,0,"D"
"20036",1999-01-30,1998,"RC Lens","Olympique Lyon","0-3",0,3,"1",1,3,-3,"D"
"20037",1999-01-30,1998,"RC Strasbourg","Le Havre AC","0-1",0,1,"1",1,1,-1,"D"
"20038",1999-01-30,1998,"Toulouse FC","FC Metz","1-0",1,0,"1",1,1,1,"H"
"20039",1999-01-30,1998,"FC Lorient","FC Nantes","1-1",1,1,"1",1,2,0,"D"
"20040",1999-01-30,1998,"AS Nancy","Montpellier HSC","0-1",0,1,"1",1,1,-1,"D"
"20041",1999-02-06,1998,"Le Havre AC","AS Monaco","1-2",1,2,"1",1,3,-1,"D"
"20042",1999-02-06,1998,"Stade Rennes","Girondins Bordeaux","1-1",1,1,"1",1,2,0,"D"
"20043",1999-02-06,1998,"Olympique Marseille","SC Bastia","3-1",3,1,"1",1,4,2,"H"
"20044",1999-02-06,1998,"Olympique Lyon","AS Nancy","2-1",2,1,"1",1,3,1,"H"
"20045",1999-02-06,1998,"Paris Saint-Germain","FC Sochaux","2-1",2,1,"1",1,3,1,"H"
"20046",1999-02-06,1998,"FC Nantes","RC Lens","2-0",2,0,"1",1,2,2,"H"
"20047",1999-02-06,1998,"FC Metz","FC Lorient","3-0",3,0,"1",1,3,3,"H"
"20048",1999-02-07,1998,"AJ Auxerre","Toulouse FC","1-2",1,2,"1",1,3,-1,"D"
"20049",1999-02-07,1998,"Montpellier HSC","RC Strasbourg","1-1",1,1,"1",1,2,0,"D"
"20050",1999-02-13,1998,"AS Monaco","Stade Rennes","4-2",4,2,"1",1,6,2,"H"
"20051",1999-02-13,1998,"RC Lens","Paris Saint-Germain","2-1",2,1,"1",1,3,1,"H"
"20052",1999-02-13,1998,"Olympique Lyon","FC Nantes","2-1",2,1,"1",1,3,1,"H"
"20053",1999-02-13,1998,"Girondins Bordeaux","SC Bastia","2-0",2,0,"1",1,2,2,"H"
"20054",1999-02-13,1998,"FC Lorient","Montpellier HSC","1-1",1,1,"1",1,2,0,"D"
"20055",1999-02-14,1998,"Toulouse FC","Olympique Marseille","1-0",1,0,"1",1,1,1,"H"
"20056",1999-02-25,1998,"Olympique Marseille","RC Strasbourg","1-0",1,0,"1",1,1,1,"H"
"20057",1999-02-25,1998,"Paris Saint-Germain","Olympique Lyon","0-1",0,1,"1",1,1,-1,"D"
"20058",1999-02-25,1998,"FC Nantes","Girondins Bordeaux","0-0",0,0,"1",1,0,0,"D"
"20059",1999-02-25,1998,"Montpellier HSC","AS Monaco","2-3",2,3,"1",1,5,-1,"D"
"20060",1999-02-26,1998,"Le Havre AC","FC Lorient","0-1",0,1,"1",1,1,-1,"D"
"20061",1999-02-26,1998,"Stade Rennes","AS Nancy","2-1",2,1,"1",1,3,1,"H"
"20062",1999-02-26,1998,"SC Bastia","Toulouse FC","1-1",1,1,"1",1,2,0,"D"
"20063",1999-02-26,1998,"AJ Auxerre","RC Lens","1-2",1,2,"1",1,3,-1,"D"
"20064",1999-02-26,1998,"FC Metz","FC Sochaux","1-1",1,1,"1",1,2,0,"D"
"20065",1999-03-09,1998,"FC Sochaux","Olympique Marseille","0-0",0,0,"1",1,0,0,"D"
"20066",1999-03-09,1998,"AS Nancy","Girondins Bordeaux","2-3",2,3,"1",1,5,-1,"D"
"20067",1999-03-10,1998,"AS Monaco","FC Metz","0-0",0,0,"1",1,0,0,"D"
"20068",1999-03-10,1998,"RC Lens","Montpellier HSC","1-0",1,0,"1",1,1,1,"H"
"20069",1999-03-10,1998,"Olympique Lyon","AJ Auxerre","2-1",2,1,"1",1,3,1,"H"
"20070",1999-03-10,1998,"Paris Saint-Germain","FC Nantes","0-0",0,0,"1",1,0,0,"D"
"20071",1999-03-10,1998,"RC Strasbourg","SC Bastia","1-1",1,1,"1",1,2,0,"D"
"20072",1999-03-10,1998,"Toulouse FC","Le Havre AC","0-0",0,0,"1",1,0,0,"D"
"20073",1999-03-10,1998,"FC Lorient","Stade Rennes","1-1",1,1,"1",1,2,0,"D"
"20074",1999-03-14,1998,"FC Sochaux","AS Monaco","1-1",1,1,"1",1,2,0,"D"
"20075",1999-03-14,1998,"RC Strasbourg","AJ Auxerre","2-1",2,1,"1",1,3,1,"H"
"20076",1999-03-19,1998,"SC Bastia","AS Nancy","1-2",1,2,"1",1,3,-1,"D"
"20077",1999-03-19,1998,"FC Nantes","AS Monaco","0-1",0,1,"1",1,1,-1,"D"
"20078",1999-03-20,1998,"Le Havre AC","Olympique Lyon","1-0",1,0,"1",1,1,1,"H"
"20079",1999-03-20,1998,"Stade Rennes","Toulouse FC","1-0",1,0,"1",1,1,1,"H"
"20080",1999-03-20,1998,"Olympique Marseille","FC Lorient","4-1",4,1,"1",1,5,3,"H"
"20081",1999-03-20,1998,"Girondins Bordeaux","RC Strasbourg","1-0",1,0,"1",1,1,1,"H"
"20082",1999-03-20,1998,"AJ Auxerre","Paris Saint-Germain","0-1",0,1,"1",1,1,-1,"D"
"20083",1999-03-20,1998,"Montpellier HSC","FC Sochaux","0-0",0,0,"1",1,0,0,"D"
"20084",1999-03-20,1998,"FC Metz","RC Lens","0-1",0,1,"1",1,1,-1,"D"
"20085",1999-04-02,1998,"FC Sochaux","Stade Rennes","0-3",0,3,"1",1,3,-3,"D"
"20086",1999-04-02,1998,"AS Monaco","Olympique Marseille","1-2",1,2,"1",1,3,-1,"D"
"20087",1999-04-03,1998,"RC Lens","Le Havre AC","0-1",0,1,"1",1,1,-1,"D"
"20088",1999-04-03,1998,"Olympique Lyon","FC Metz","2-0",2,0,"1",1,2,2,"H"
"20089",1999-04-03,1998,"Paris Saint-Germain","Montpellier HSC","0-1",0,1,"1",1,1,-1,"D"
"20090",1999-04-03,1998,"FC Nantes","AJ Auxerre","2-2",2,2,"1",1,4,0,"D"
"20091",1999-04-03,1998,"Toulouse FC","Girondins Bordeaux","0-3",0,3,"1",1,3,-3,"D"
"20092",1999-04-03,1998,"FC Lorient","SC Bastia","3-1",3,1,"1",1,4,2,"H"
"20093",1999-04-03,1998,"AS Nancy","RC Strasbourg","1-1",1,1,"1",1,2,0,"D"
"20094",1999-04-08,1998,"Olympique Lyon","FC Sochaux","4-1",4,1,"1",1,5,3,"H"
"20095",1999-04-09,1998,"AS Nancy","FC Metz","1-0",1,0,"1",1,1,1,"H"
"20096",1999-04-13,1998,"Stade Rennes","RC Lens","2-0",2,0,"1",1,2,2,"H"
"20097",1999-04-13,1998,"SC Bastia","FC Sochaux","1-1",1,1,"1",1,2,0,"D"
"20098",1999-04-14,1998,"Le Havre AC","FC Nantes","2-1",2,1,"1",1,3,1,"H"
"20099",1999-04-14,1998,"Girondins Bordeaux","FC Lorient","0-0",0,0,"1",1,0,0,"D"
"20100",1999-04-14,1998,"RC Strasbourg","Toulouse FC","2-0",2,0,"1",1,2,2,"H"
"20101",1999-04-14,1998,"AJ Auxerre","AS Monaco","0-3",0,3,"1",1,3,-3,"D"
"20102",1999-04-14,1998,"Montpellier HSC","Olympique Lyon","1-3",1,3,"1",1,4,-2,"D"
"20103",1999-04-14,1998,"FC Metz","Paris Saint-Germain","1-1",1,1,"1",1,2,0,"D"
"20104",1999-04-15,1998,"Olympique Marseille","AS Nancy","4-0",4,0,"1",1,4,4,"H"
"20105",1999-04-24,1998,"FC Sochaux","Girondins Bordeaux","2-0",2,0,"1",1,2,2,"H"
"20106",1999-04-24,1998,"AS Monaco","SC Bastia","1-1",1,1,"1",1,2,0,"D"
"20107",1999-04-24,1998,"RC Lens","Olympique Marseille","4-0",4,0,"1",1,4,4,"H"
"20108",1999-04-24,1998,"FC Nantes","FC Metz","0-0",0,0,"1",1,0,0,"D"
"20109",1999-04-24,1998,"AJ Auxerre","Montpellier HSC","2-2",2,2,"1",1,4,0,"D"
"20110",1999-04-24,1998,"FC Lorient","RC Strasbourg","0-1",0,1,"1",1,1,-1,"D"
"20111",1999-04-24,1998,"AS Nancy","Toulouse FC","2-0",2,0,"1",1,2,2,"H"
"20112",1999-04-25,1998,"Olympique Lyon","Stade Rennes","1-2",1,2,"1",1,3,-1,"D"
"20113",1999-04-25,1998,"Paris Saint-Germain","Le Havre AC","3-0",3,0,"1",1,3,3,"H"
"20114",1999-04-30,1998,"Olympique Marseille","Olympique Lyon","0-0",0,0,"1",1,0,0,"D"
"20115",1999-04-30,1998,"Girondins Bordeaux","AS Monaco","0-1",0,1,"1",1,1,-1,"D"
"20116",1999-04-30,1998,"Toulouse FC","FC Lorient","1-4",1,4,"1",1,5,-3,"D"
"20117",1999-05-01,1998,"Le Havre AC","AS Nancy","1-1",1,1,"1",1,2,0,"D"
"20118",1999-05-01,1998,"Stade Rennes","Paris Saint-Germain","2-1",2,1,"1",1,3,1,"H"
"20119",1999-05-01,1998,"SC Bastia","RC Lens","1-1",1,1,"1",1,2,0,"D"
"20120",1999-05-01,1998,"RC Strasbourg","FC Sochaux","1-1",1,1,"1",1,2,0,"D"
"20121",1999-05-01,1998,"Montpellier HSC","FC Nantes","1-2",1,2,"1",1,3,-1,"D"
"20122",1999-05-01,1998,"FC Metz","AJ Auxerre","2-0",2,0,"1",1,2,2,"H"
"20123",1999-05-04,1998,"RC Lens","Girondins Bordeaux","2-4",2,4,"1",1,6,-2,"D"
"20124",1999-05-04,1998,"Paris Saint-Germain","Olympique Marseille","2-1",2,1,"1",1,3,1,"H"
"20125",1999-05-04,1998,"Montpellier HSC","FC Metz","1-1",1,1,"1",1,2,0,"D"
"20126",1999-05-05,1998,"FC Sochaux","Toulouse FC","2-1",2,1,"1",1,3,1,"H"
"20127",1999-05-05,1998,"AS Monaco","RC Strasbourg","2-1",2,1,"1",1,3,1,"H"
"20128",1999-05-05,1998,"Olympique Lyon","SC Bastia","2-1",2,1,"1",1,3,1,"H"
"20129",1999-05-05,1998,"FC Nantes","Stade Rennes","2-1",2,1,"1",1,3,1,"H"
"20130",1999-05-05,1998,"AJ Auxerre","Le Havre AC","0-0",0,0,"1",1,0,0,"D"
"20131",1999-05-05,1998,"AS Nancy","FC Lorient","2-0",2,0,"1",1,2,2,"H"
"20132",1999-05-14,1998,"FC Sochaux","Le Havre AC","1-0",1,0,"1",1,1,1,"H"
"20133",1999-05-22,1998,"Le Havre AC","Montpellier HSC","1-1",1,1,"1",1,2,0,"D"
"20134",1999-05-22,1998,"Stade Rennes","FC Metz","1-0",1,0,"1",1,1,1,"H"
"20135",1999-05-22,1998,"Olympique Marseille","AJ Auxerre","1-0",1,0,"1",1,1,1,"H"
"20136",1999-05-22,1998,"SC Bastia","FC Nantes","1-0",1,0,"1",1,1,1,"H"
"20137",1999-05-22,1998,"Girondins Bordeaux","Olympique Lyon","1-0",1,0,"1",1,1,1,"H"
"20138",1999-05-22,1998,"RC Strasbourg","RC Lens","1-1",1,1,"1",1,2,0,"D"
"20139",1999-05-22,1998,"Toulouse FC","Paris Saint-Germain","2-1",2,1,"1",1,3,1,"H"
"20140",1999-05-22,1998,"FC Lorient","FC Sochaux","4-1",4,1,"1",1,5,3,"H"
"20141",1999-05-22,1998,"AS Nancy","AS Monaco","1-2",1,2,"1",1,3,-1,"D"
"20142",1999-05-29,1998,"FC Sochaux","AS Nancy","1-1",1,1,"1",1,2,0,"D"
"20143",1999-05-29,1998,"AS Monaco","FC Lorient","1-0",1,0,"1",1,1,1,"H"
"20144",1999-05-29,1998,"RC Lens","Toulouse FC","3-1",3,1,"1",1,4,2,"H"
"20145",1999-05-29,1998,"Olympique Lyon","RC Strasbourg","3-2",3,2,"1",1,5,1,"H"
"20146",1999-05-29,1998,"Paris Saint-Germain","Girondins Bordeaux","2-3",2,3,"1",1,5,-1,"D"
"20147",1999-05-29,1998,"FC Nantes","Olympique Marseille","0-1",0,1,"1",1,1,-1,"D"
"20148",1999-05-29,1998,"AJ Auxerre","Stade Rennes","2-0",2,0,"1",1,2,2,"H"
"20149",1999-05-29,1998,"Montpellier HSC","SC Bastia","3-0",3,0,"1",1,3,3,"H"
"20150",1999-05-29,1998,"FC Metz","Le Havre AC","1-0",1,0,"1",1,1,1,"H"
"20151",1999-07-30,1999,"Girondins Bordeaux","SC Bastia","3-2",3,2,"1",1,5,1,"H"
"20152",1999-07-31,1999,"FC Metz","Stade Rennes","0-0",0,0,"1",1,0,0,"D"
"20153",1999-07-31,1999,"Paris Saint-Germain","ATAC Troyes","1-0",1,0,"1",1,1,1,"H"
"20154",1999-07-31,1999,"FC Nantes","Le Havre AC","1-0",1,0,"1",1,1,1,"H"
"20155",1999-07-31,1999,"Olympique Marseille","CS Sedan","3-0",3,0,"1",1,3,3,"H"
"20156",1999-07-31,1999,"AJ Auxerre","AS Nancy","2-1",2,1,"1",1,3,1,"H"
"20157",1999-07-31,1999,"Olympique Lyon","Montpellier HSC","1-2",1,2,"1",1,3,-1,"D"
"20158",1999-07-31,1999,"RC Strasbourg","RC Lens","1-0",1,0,"1",1,1,1,"H"
"20159",1999-07-31,1999,"AS Monaco","AS Saint-Etienne","2-2",2,2,"1",1,4,0,"D"
"20160",1999-08-06,1999,"RC Lens","AS Monaco","1-0",1,0,"1",1,1,1,"H"
"20161",1999-08-06,1999,"SC Bastia","RC Strasbourg","3-0",3,0,"1",1,3,3,"H"
"20162",1999-08-06,1999,"ATAC Troyes","Olympique Lyon","1-2",1,2,"1",1,3,-1,"D"
"20163",1999-08-06,1999,"CS Sedan","AS Nancy","3-1",3,1,"1",1,4,2,"H"
"20164",1999-08-06,1999,"Le Havre AC","Olympique Marseille","0-0",0,0,"1",1,0,0,"D"
"20165",1999-08-06,1999,"AS Saint-Etienne","FC Nantes","0-2",0,2,"1",1,2,-2,"D"
"20166",1999-08-08,1999,"FC Metz","AJ Auxerre","3-0",3,0,"1",1,3,3,"H"
"20167",1999-08-08,1999,"Montpellier HSC","Girondins Bordeaux","2-2",2,2,"1",1,4,0,"D"
"20168",1999-08-08,1999,"Stade Rennes","Paris Saint-Germain","1-3",1,3,"1",1,4,-2,"D"
"20169",1999-08-14,1999,"RC Strasbourg","Montpellier HSC","2-0",2,0,"1",1,2,2,"H"
"20170",1999-08-14,1999,"AS Monaco","SC Bastia","4-0",4,0,"1",1,4,4,"H"
"20171",1999-08-14,1999,"FC Nantes","RC Lens","0-1",0,1,"1",1,1,-1,"D"
"20172",1999-08-14,1999,"AS Nancy","Le Havre AC","3-0",3,0,"1",1,3,3,"H"
"20173",1999-08-14,1999,"Paris Saint-Germain","FC Metz","2-1",2,1,"1",1,3,1,"H"
"20174",1999-08-14,1999,"Girondins Bordeaux","ATAC Troyes","4-0",4,0,"1",1,4,4,"H"
"20175",1999-08-14,1999,"AJ Auxerre","CS Sedan","3-1",3,1,"1",1,4,2,"H"
"20176",1999-08-15,1999,"Olympique Lyon","Stade Rennes","2-2",2,2,"1",1,4,0,"D"
"20177",1999-08-15,1999,"Olympique Marseille","AS Saint-Etienne","3-3",3,3,"1",1,6,0,"D"
"20178",1999-08-20,1999,"AS Saint-Etienne","AS Nancy","2-1",2,1,"1",1,3,1,"H"
"20179",1999-08-20,1999,"Montpellier HSC","AS Monaco","2-3",2,3,"1",1,5,-1,"D"
"20180",1999-08-20,1999,"ATAC Troyes","RC Strasbourg","2-1",2,1,"1",1,3,1,"H"
"20181",1999-08-20,1999,"FC Metz","Olympique Lyon","0-1",0,1,"1",1,1,-1,"D"
"20182",1999-08-20,1999,"Paris Saint-Germain","AJ Auxerre","1-1",1,1,"1",1,2,0,"D"
"20183",1999-08-20,1999,"Le Havre AC","CS Sedan","2-1",2,1,"1",1,3,1,"H"
"20184",1999-08-20,1999,"Stade Rennes","Girondins Bordeaux","2-1",2,1,"1",1,3,1,"H"
"20185",1999-08-22,1999,"RC Lens","Olympique Marseille","0-0",0,0,"1",1,0,0,"D"
"20186",1999-08-22,1999,"SC Bastia","FC Nantes","2-1",2,1,"1",1,3,1,"H"
"20187",1999-08-28,1999,"RC Strasbourg","Stade Rennes","2-1",2,1,"1",1,3,1,"H"
"20188",1999-08-28,1999,"FC Nantes","Montpellier HSC","3-0",3,0,"1",1,3,3,"H"
"20189",1999-08-28,1999,"Olympique Marseille","SC Bastia","1-1",1,1,"1",1,2,0,"D"
"20190",1999-08-28,1999,"AS Nancy","RC Lens","2-1",2,1,"1",1,3,1,"H"
"20191",1999-08-28,1999,"CS Sedan","AS Saint-Etienne","3-2",3,2,"1",1,5,1,"H"
"20192",1999-08-28,1999,"Girondins Bordeaux","FC Metz","0-0",0,0,"1",1,0,0,"D"
"20193",1999-08-28,1999,"AJ Auxerre","Le Havre AC","2-1",2,1,"1",1,3,1,"H"
"20194",1999-08-29,1999,"Olympique Lyon","Paris Saint-Germain","1-0",1,0,"1",1,1,1,"H"
"20195",1999-08-29,1999,"AS Monaco","ATAC Troyes","3-0",3,0,"1",1,3,3,"H"
"20196",1999-09-11,1999,"RC Lens","CS Sedan","0-3",0,3,"1",1,3,-3,"D"
"20197",1999-09-11,1999,"SC Bastia","AS Nancy","1-1",1,1,"1",1,2,0,"D"
"20198",1999-09-11,1999,"Montpellier HSC","Olympique Marseille","3-1",3,1,"1",1,4,2,"H"
"20199",1999-09-11,1999,"FC Metz","RC Strasbourg","0-0",0,0,"1",1,0,0,"D"
"20200",1999-09-11,1999,"Olympique Lyon","AJ Auxerre","0-0",0,0,"1",1,0,0,"D"
"20201",1999-09-11,1999,"AS Saint-Etienne","Le Havre AC","3-3",3,3,"1",1,6,0,"D"
"20202",1999-09-11,1999,"ATAC Troyes","FC Nantes","1-0",1,0,"1",1,1,1,"H"
"20203",1999-09-12,1999,"Paris Saint-Germain","Girondins Bordeaux","2-1",2,1,"1",1,3,1,"H"
"20204",1999-09-12,1999,"Stade Rennes","AS Monaco","2-1",2,1,"1",1,3,1,"H"
"20205",1999-09-18,1999,"Girondins Bordeaux","Olympique Lyon","1-3",1,3,"1",1,4,-2,"D"
"20206",1999-09-18,1999,"AJ Auxerre","AS Saint-Etienne","2-1",2,1,"1",1,3,1,"H"
"20207",1999-09-19,1999,"AS Nancy","Montpellier HSC","1-2",1,2,"1",1,3,-1,"D"
"20208",1999-09-19,1999,"AS Monaco","FC Metz","2-2",2,2,"1",1,4,0,"D"
"20209",1999-09-19,1999,"FC Nantes","Stade Rennes","3-0",3,0,"1",1,3,3,"H"
"20210",1999-09-19,1999,"Olympique Marseille","ATAC Troyes","1-0",1,0,"1",1,1,1,"H"
"20211",1999-09-19,1999,"CS Sedan","SC Bastia","2-0",2,0,"1",1,2,2,"H"
"20212",1999-09-19,1999,"Le Havre AC","RC Lens","1-1",1,1,"1",1,2,0,"D"
"20213",1999-09-19,1999,"RC Strasbourg","Paris Saint-Germain","1-1",1,1,"1",1,2,0,"D"
"20214",1999-09-25,1999,"Girondins Bordeaux","AJ Auxerre","1-0",1,0,"1",1,1,1,"H"
"20215",1999-09-25,1999,"SC Bastia","Le Havre AC","1-1",1,1,"1",1,2,0,"D"
"20216",1999-09-25,1999,"Montpellier HSC","CS Sedan","1-1",1,1,"1",1,2,0,"D"
"20217",1999-09-25,1999,"FC Metz","FC Nantes","2-1",2,1,"1",1,3,1,"H"
"20218",1999-09-25,1999,"Paris Saint-Germain","AS Monaco","0-3",0,3,"1",1,3,-3,"D"
"20219",1999-09-25,1999,"Olympique Lyon","RC Strasbourg","0-0",0,0,"1",1,0,0,"D"
"20220",1999-09-25,1999,"ATAC Troyes","AS Nancy","2-0",2,0,"1",1,2,2,"H"
"20221",1999-09-26,1999,"RC Lens","AS Saint-Etienne","0-2",0,2,"1",1,2,-2,"D"
"20222",1999-09-26,1999,"Stade Rennes","Olympique Marseille","1-2",1,2,"1",1,3,-1,"D"
"20223",1999-10-02,1999,"CS Sedan","ATAC Troyes","2-1",2,1,"1",1,3,1,"H"
"20224",1999-10-02,1999,"Le Havre AC","Montpellier HSC","2-1",2,1,"1",1,3,1,"H"
"20225",1999-10-02,1999,"AS Saint-Etienne","SC Bastia","1-1",1,1,"1",1,2,0,"D"
"20226",1999-10-02,1999,"AS Nancy","Stade Rennes","3-0",3,0,"1",1,3,3,"H"
"20227",1999-10-02,1999,"RC Strasbourg","Girondins Bordeaux","2-2",2,2,"1",1,4,0,"D"
"20228",1999-10-02,1999,"Olympique Marseille","FC Metz","1-1",1,1,"1",1,2,0,"D"
"20229",1999-10-03,1999,"AS Monaco","Olympique Lyon","1-0",1,0,"1",1,1,1,"H"
"20230",1999-10-03,1999,"FC Nantes","Paris Saint-Germain","0-4",0,4,"1",1,4,-4,"D"
"20231",1999-10-03,1999,"AJ Auxerre","RC Lens","3-2",3,2,"1",1,5,1,"H"
"20232",1999-10-12,1999,"Paris Saint-Germain","Olympique Marseille","0-2",0,2,"1",1,2,-2,"D"
"20233",1999-10-12,1999,"Olympique Lyon","FC Nantes","2-0",2,0,"1",1,2,2,"H"
"20234",1999-10-13,1999,"FC Metz","AS Nancy","2-2",2,2,"1",1,4,0,"D"
"20235",1999-10-13,1999,"Montpellier HSC","AS Saint-Etienne","0-1",0,1,"1",1,1,-1,"D"
"20236",1999-10-13,1999,"ATAC Troyes","Le Havre AC","3-1",3,1,"1",1,4,2,"H"
"20237",1999-10-13,1999,"Stade Rennes","CS Sedan","5-0",5,0,"1",1,5,5,"H"
"20238",1999-10-13,1999,"Girondins Bordeaux","AS Monaco","3-2",3,2,"1",1,5,1,"H"
"20239",1999-10-13,1999,"RC Strasbourg","AJ Auxerre","1-3",1,3,"1",1,4,-2,"D"
"20240",1999-10-13,1999,"SC Bastia","RC Lens","2-0",2,0,"1",1,2,2,"H"
"20241",1999-10-15,1999,"Olympique Marseille","Olympique Lyon","0-1",0,1,"1",1,1,-1,"D"
"20242",1999-10-16,1999,"AS Nancy","Paris Saint-Germain","1-1",1,1,"1",1,2,0,"D"
"20243",1999-10-16,1999,"Le Havre AC","Stade Rennes","0-1",0,1,"1",1,1,-1,"D"
"20244",1999-10-16,1999,"FC Nantes","Girondins Bordeaux","0-1",0,1,"1",1,1,-1,"D"
"20245",1999-10-16,1999,"AJ Auxerre","SC Bastia","3-1",3,1,"1",1,4,2,"H"
"20246",1999-10-16,1999,"AS Saint-Etienne","ATAC Troyes","1-0",1,0,"1",1,1,1,"H"
"20247",1999-10-16,1999,"RC Lens","Montpellier HSC","1-0",1,0,"1",1,1,1,"H"
"20248",1999-10-16,1999,"AS Monaco","RC Strasbourg","3-0",3,0,"1",1,3,3,"H"
"20249",1999-10-17,1999,"CS Sedan","FC Metz","0-2",0,2,"1",1,2,-2,"D"
"20250",1999-10-23,1999,"Girondins Bordeaux","Olympique Marseille","2-1",2,1,"1",1,3,1,"H"
"20251",1999-10-23,1999,"Stade Rennes","AS Saint-Etienne","4-1",4,1,"1",1,5,3,"H"
"20252",1999-10-24,1999,"FC Metz","Le Havre AC","3-0",3,0,"1",1,3,3,"H"
"20253",1999-10-24,1999,"Montpellier HSC","SC Bastia","1-1",1,1,"1",1,2,0,"D"
"20254",1999-10-24,1999,"ATAC Troyes","RC Lens","0-1",0,1,"1",1,1,-1,"D"
"20255",1999-10-24,1999,"Paris Saint-Germain","CS Sedan","3-2",3,2,"1",1,5,1,"H"
"20256",1999-10-24,1999,"Olympique Lyon","AS Nancy","2-1",2,1,"1",1,3,1,"H"
"20257",1999-10-24,1999,"RC Strasbourg","FC Nantes","3-2",3,2,"1",1,5,1,"H"
"20258",1999-10-29,1999,"CS Sedan","Olympique Lyon","2-0",2,0,"1",1,2,2,"H"
"20259",1999-10-29,1999,"FC Nantes","AS Monaco","0-3",0,3,"1",1,3,-3,"D"
"20260",1999-10-30,1999,"AS Nancy","Girondins Bordeaux","2-2",2,2,"1",1,4,0,"D"
"20261",1999-10-30,1999,"Olympique Marseille","RC Strasbourg","4-1",4,1,"1",1,5,3,"H"
"20262",1999-10-30,1999,"AJ Auxerre","Montpellier HSC","2-1",2,1,"1",1,3,1,"H"
"20263",1999-10-30,1999,"Le Havre AC","Paris Saint-Germain","3-1",3,1,"1",1,4,2,"H"
"20264",1999-10-30,1999,"AS Saint-Etienne","FC Metz","2-0",2,0,"1",1,2,2,"H"
"20265",1999-10-30,1999,"SC Bastia","ATAC Troyes","5-0",5,0,"1",1,5,5,"H"
"20266",1999-10-31,1999,"RC Lens","Stade Rennes","1-1",1,1,"1",1,2,0,"D"
"20267",1999-11-06,1999,"Stade Rennes","SC Bastia","0-0",0,0,"1",1,0,0,"D"
"20268",1999-11-06,1999,"Paris Saint-Germain","AS Saint-Etienne","2-0",2,0,"1",1,2,2,"H"
"20269",1999-11-06,1999,"Girondins Bordeaux","CS Sedan","1-1",1,1,"1",1,2,0,"D"
"20270",1999-11-06,1999,"RC Strasbourg","AS Nancy","0-2",0,2,"1",1,2,-2,"D"
"20271",1999-11-07,1999,"FC Metz","RC Lens","0-0",0,0,"1",1,0,0,"D"
"20272",1999-11-07,1999,"Olympique Lyon","Le Havre AC","3-0",3,0,"1",1,3,3,"H"
"20273",1999-11-07,1999,"AS Monaco","Olympique Marseille","1-1",1,1,"1",1,2,0,"D"
"20274",1999-11-07,1999,"FC Nantes","AJ Auxerre","3-1",3,1,"1",1,4,2,"H"
"20275",1999-11-07,1999,"ATAC Troyes","Montpellier HSC","2-1",2,1,"1",1,3,1,"H"
"20276",1999-11-09,1999,"CS Sedan","RC Strasbourg","2-1",2,1,"1",1,3,1,"H"
"20277",1999-11-10,1999,"AS Nancy","AS Monaco","1-2",1,2,"1",1,3,-1,"D"
"20278",1999-11-10,1999,"Le Havre AC","Girondins Bordeaux","3-0",3,0,"1",1,3,3,"H"
"20279",1999-11-10,1999,"Montpellier HSC","Stade Rennes","1-2",1,2,"1",1,3,-1,"D"
"20280",1999-11-10,1999,"Olympique Marseille","FC Nantes","1-1",1,1,"1",1,2,0,"D"
"20281",1999-11-10,1999,"AJ Auxerre","ATAC Troyes","0-1",0,1,"1",1,1,-1,"D"
"20282",1999-11-10,1999,"AS Saint-Etienne","Olympique Lyon","1-1",1,1,"1",1,2,0,"D"
"20283",1999-11-10,1999,"RC Lens","Paris Saint-Germain","3-2",3,2,"1",1,5,1,"H"
"20284",1999-11-10,1999,"SC Bastia","FC Metz","0-0",0,0,"1",1,0,0,"D"
"20285",1999-11-19,1999,"RC Strasbourg","Le Havre AC","0-1",0,1,"1",1,1,-1,"D"
"20286",1999-11-19,1999,"Stade Rennes","ATAC Troyes","2-2",2,2,"1",1,4,0,"D"
"20287",1999-11-19,1999,"FC Metz","Montpellier HSC","2-2",2,2,"1",1,4,0,"D"
"20288",1999-11-19,1999,"Paris Saint-Germain","SC Bastia","2-0",2,0,"1",1,2,2,"H"
"20289",1999-11-19,1999,"Girondins Bordeaux","AS Saint-Etienne","1-2",1,2,"1",1,3,-1,"D"
"20290",1999-11-20,1999,"Olympique Lyon","RC Lens","1-0",1,0,"1",1,1,1,"H"
"20291",1999-11-20,1999,"AS Monaco","CS Sedan","2-1",2,1,"1",1,3,1,"H"
"20292",1999-11-20,1999,"FC Nantes","AS Nancy","2-0",2,0,"1",1,2,2,"H"
"20293",1999-11-20,1999,"Olympique Marseille","AJ Auxerre","0-1",0,1,"1",1,1,-1,"D"
"20294",1999-11-27,1999,"Montpellier HSC","Paris Saint-Germain","0-1",0,1,"1",1,1,-1,"D"
"20295",1999-11-27,1999,"ATAC Troyes","FC Metz","2-2",2,2,"1",1,4,0,"D"
"20296",1999-11-27,1999,"Stade Rennes","AJ Auxerre","1-0",1,0,"1",1,1,1,"H"
"20297",1999-11-27,1999,"AS Nancy","Olympique Marseille","2-2",2,2,"1",1,4,0,"D"
"20298",1999-11-27,1999,"Le Havre AC","AS Monaco","1-4",1,4,"1",1,5,-3,"D"
"20299",1999-11-27,1999,"AS Saint-Etienne","RC Strasbourg","0-1",0,1,"1",1,1,-1,"D"
"20300",1999-11-28,1999,"CS Sedan","FC Nantes","0-0",0,0,"1",1,0,0,"D"
"20301",1999-11-28,1999,"RC Lens","Girondins Bordeaux","3-3",3,3,"1",1,6,0,"D"
"20302",1999-11-28,1999,"SC Bastia","Olympique Lyon","3-0",3,0,"1",1,3,3,"H"
"20303",1999-12-01,1999,"AS Monaco","AJ Auxerre","2-0",2,0,"1",1,2,2,"H"
"20304",1999-12-03,1999,"RC Strasbourg","SC Bastia","2-0",2,0,"1",1,2,2,"H"
"20305",1999-12-03,1999,"FC Nantes","AS Saint-Etienne","0-1",0,1,"1",1,1,-1,"D"
"20306",1999-12-03,1999,"Olympique Marseille","Le Havre AC","2-0",2,0,"1",1,2,2,"H"
"20307",1999-12-03,1999,"AS Nancy","CS Sedan","0-2",0,2,"1",1,2,-2,"D"
"20308",1999-12-03,1999,"Olympique Lyon","ATAC Troyes","1-3",1,3,"1",1,4,-2,"D"
"20309",1999-12-03,1999,"Girondins Bordeaux","Montpellier HSC","2-0",2,0,"1",1,2,2,"H"
"20310",1999-12-05,1999,"Paris Saint-Germain","Stade Rennes","1-0",1,0,"1",1,1,1,"H"
"20311",1999-12-05,1999,"AS Monaco","RC Lens","2-0",2,0,"1",1,2,2,"H"
"20312",1999-12-05,1999,"AJ Auxerre","FC Metz","1-1",1,1,"1",1,2,0,"D"
"20313",1999-12-11,1999,"ATAC Troyes","Girondins Bordeaux","2-0",2,0,"1",1,2,2,"H"
"20314",1999-12-11,1999,"Stade Rennes","Olympique Lyon","1-2",1,2,"1",1,3,-1,"D"
"20315",1999-12-11,1999,"CS Sedan","AJ Auxerre","1-1",1,1,"1",1,2,0,"D"
"20316",1999-12-11,1999,"Le Havre AC","AS Nancy","0-1",0,1,"1",1,1,-1,"D"
"20317",1999-12-11,1999,"Montpellier HSC","RC Strasbourg","1-1",1,1,"1",1,2,0,"D"
"20318",1999-12-12,1999,"FC Metz","Paris Saint-Germain","1-3",1,3,"1",1,4,-2,"D"
"20319",1999-12-12,1999,"AS Saint-Etienne","Olympique Marseille","5-1",5,1,"1",1,6,4,"H"
"20320",1999-12-12,1999,"SC Bastia","AS Monaco","1-0",1,0,"1",1,1,1,"H"
"20321",1999-12-14,1999,"RC Lens","FC Nantes","1-2",1,2,"1",1,3,-1,"D"
"20322",1999-12-17,1999,"Olympique Lyon","FC Metz","2-0",2,0,"1",1,2,2,"H"
"20323",1999-12-17,1999,"Girondins Bordeaux","Stade Rennes","1-0",1,0,"1",1,1,1,"H"
"20324",1999-12-17,1999,"AJ Auxerre","Paris Saint-Germain","1-0",1,0,"1",1,1,1,"H"
"20325",1999-12-18,1999,"Olympique Marseille","RC Lens","1-2",1,2,"1",1,3,-1,"D"
"20326",1999-12-18,1999,"AS Nancy","AS Saint-Etienne","1-0",1,0,"1",1,1,1,"H"
"20327",1999-12-18,1999,"AS Monaco","Montpellier HSC","1-0",1,0,"1",1,1,1,"H"
"20328",1999-12-18,1999,"FC Nantes","SC Bastia","1-1",1,1,"1",1,2,0,"D"
"20329",2000-01-11,1999,"FC Metz","Girondins Bordeaux","2-1",2,1,"1",1,3,1,"H"
"20330",2000-01-11,1999,"Paris Saint-Germain","Olympique Lyon","2-2",2,2,"1",1,4,0,"D"
"20331",2000-01-12,1999,"Le Havre AC","AJ Auxerre","0-0",0,0,"1",1,0,0,"D"
"20332",2000-01-12,1999,"Montpellier HSC","FC Nantes","3-0",3,0,"1",1,3,3,"H"
"20333",2000-01-12,1999,"ATAC Troyes","AS Monaco","1-4",1,4,"1",1,5,-3,"D"
"20334",2000-01-12,1999,"Stade Rennes","RC Strasbourg","2-1",2,1,"1",1,3,1,"H"
"20335",2000-01-12,1999,"AS Saint-Etienne","CS Sedan","2-3",2,3,"1",1,5,-1,"D"
"20336",2000-01-12,1999,"RC Lens","AS Nancy","0-1",0,1,"1",1,1,-1,"D"
"20337",2000-01-12,1999,"SC Bastia","Olympique Marseille","0-0",0,0,"1",1,0,0,"D"
"20338",2000-01-19,1999,"FC Nantes","ATAC Troyes","3-0",3,0,"1",1,3,3,"H"
"20339",2000-01-19,1999,"Olympique Marseille","Montpellier HSC","0-0",0,0,"1",1,0,0,"D"
"20340",2000-01-19,1999,"AJ Auxerre","Olympique Lyon","2-0",2,0,"1",1,2,2,"H"
"20341",2000-01-19,1999,"Girondins Bordeaux","Paris Saint-Germain","1-1",1,1,"1",1,2,0,"D"
"20342",2000-01-19,1999,"RC Strasbourg","FC Metz","1-1",1,1,"1",1,2,0,"D"
"20343",2000-01-19,1999,"AS Monaco","Stade Rennes","3-1",3,1,"1",1,4,2,"H"
"20344",2000-01-19,1999,"AS Nancy","SC Bastia","1-0",1,0,"1",1,1,1,"H"
"20345",2000-01-19,1999,"CS Sedan","RC Lens","0-0",0,0,"1",1,0,0,"D"
"20346",2000-01-19,1999,"Le Havre AC","AS Saint-Etienne","1-0",1,0,"1",1,1,1,"H"
"20347",2000-01-20,1999,"CS Sedan","Le Havre AC","0-1",0,1,"1",1,1,-1,"D"
"20348",2000-01-20,1999,"RC Strasbourg","ATAC Troyes","2-0",2,0,"1",1,2,2,"H"
"20349",2000-01-25,1999,"FC Metz","AS Monaco","1-1",1,1,"1",1,2,0,"D"
"20350",2000-01-25,1999,"ATAC Troyes","Olympique Marseille","1-2",1,2,"1",1,3,-1,"D"
"20351",2000-01-26,1999,"Paris Saint-Germain","RC Strasbourg","4-2",4,2,"1",1,6,2,"H"
"20352",2000-01-26,1999,"SC Bastia","CS Sedan","1-0",1,0,"1",1,1,1,"H"
"20353",2000-01-26,1999,"Montpellier HSC","AS Nancy","1-0",1,0,"1",1,1,1,"H"
"20354",2000-01-26,1999,"Stade Rennes","FC Nantes","0-0",0,0,"1",1,0,0,"D"
"20355",2000-01-26,1999,"Olympique Lyon","Girondins Bordeaux","1-1",1,1,"1",1,2,0,"D"
"20356",2000-01-26,1999,"AS Saint-Etienne","AJ Auxerre","0-0",0,0,"1",1,0,0,"D"
"20357",2000-01-26,1999,"RC Lens","Le Havre AC","4-0",4,0,"1",1,4,4,"H"
"20358",2000-02-01,1999,"AS Monaco","Paris Saint-Germain","1-0",1,0,"1",1,1,1,"H"
"20359",2000-02-01,1999,"AJ Auxerre","Girondins Bordeaux","1-0",1,0,"1",1,1,1,"H"
"20360",2000-02-02,1999,"AS Nancy","ATAC Troyes","1-2",1,2,"1",1,3,-1,"D"
"20361",2000-02-02,1999,"RC Strasbourg","Olympique Lyon","4-2",4,2,"1",1,6,2,"H"
"20362",2000-02-02,1999,"FC Nantes","FC Metz","1-3",1,3,"1",1,4,-2,"D"
"20363",2000-02-02,1999,"Olympique Marseille","Stade Rennes","1-1",1,1,"1",1,2,0,"D"
"20364",2000-02-02,1999,"CS Sedan","Montpellier HSC","2-1",2,1,"1",1,3,1,"H"
"20365",2000-02-02,1999,"Le Havre AC","SC Bastia","2-2",2,2,"1",1,4,0,"D"
"20366",2000-02-02,1999,"AS Saint-Etienne","RC Lens","0-2",0,2,"1",1,2,-2,"D"
"20367",2000-02-05,1999,"Montpellier HSC","Le Havre AC","0-0",0,0,"1",1,0,0,"D"
"20368",2000-02-05,1999,"ATAC Troyes","CS Sedan","0-2",0,2,"1",1,2,-2,"D"
"20369",2000-02-05,1999,"Stade Rennes","AS Nancy","3-1",3,1,"1",1,4,2,"H"
"20370",2000-02-05,1999,"Girondins Bordeaux","RC Strasbourg","3-0",3,0,"1",1,3,3,"H"
"20371",2000-02-05,1999,"RC Lens","AJ Auxerre","2-1",2,1,"1",1,3,1,"H"
"20372",2000-02-05,1999,"SC Bastia","AS Saint-Etienne","4-0",4,0,"1",1,4,4,"H"
"20373",2000-02-05,1999,"FC Metz","Olympique Marseille","2-0",2,0,"1",1,2,2,"H"
"20374",2000-02-05,1999,"Paris Saint-Germain","FC Nantes","0-0",0,0,"1",1,0,0,"D"
"20375",2000-02-05,1999,"Olympique Lyon","AS Monaco","2-1",2,1,"1",1,3,1,"H"
"20376",2000-02-15,1999,"FC Nantes","Olympique Lyon","6-1",6,1,"1",1,7,5,"H"
"20377",2000-02-15,1999,"Olympique Marseille","Paris Saint-Germain","4-1",4,1,"1",1,5,3,"H"
"20378",2000-02-16,1999,"AS Nancy","FC Metz","0-0",0,0,"1",1,0,0,"D"
"20379",2000-02-16,1999,"RC Lens","SC Bastia","4-0",4,0,"1",1,4,4,"H"
"20380",2000-02-16,1999,"AS Monaco","Girondins Bordeaux","1-0",1,0,"1",1,1,1,"H"
"20381",2000-02-16,1999,"AJ Auxerre","RC Strasbourg","0-1",0,1,"1",1,1,-1,"D"
"20382",2000-02-16,1999,"CS Sedan","Stade Rennes","2-1",2,1,"1",1,3,1,"H"
"20383",2000-02-16,1999,"Le Havre AC","ATAC Troyes","2-0",2,0,"1",1,2,2,"H"
"20384",2000-02-16,1999,"AS Saint-Etienne","Montpellier HSC","5-4",5,4,"1",1,9,1,"H"
"20385",2000-02-26,1999,"Girondins Bordeaux","FC Nantes","3-0",3,0,"1",1,3,3,"H"
"20386",2000-02-26,1999,"SC Bastia","AJ Auxerre","2-0",2,0,"1",1,2,2,"H"
"20387",2000-02-26,1999,"Montpellier HSC","RC Lens","1-1",1,1,"1",1,2,0,"D"
"20388",2000-02-26,1999,"FC Metz","CS Sedan","1-1",1,1,"1",1,2,0,"D"
"20389",2000-02-26,1999,"Paris Saint-Germain","AS Nancy","1-1",1,1,"1",1,2,0,"D"
"20390",2000-02-26,1999,"Olympique Lyon","Olympique Marseille","2-0",2,0,"1",1,2,2,"H"
"20391",2000-02-26,1999,"ATAC Troyes","AS Saint-Etienne","0-1",0,1,"1",1,1,-1,"D"
"20392",2000-02-26,1999,"Stade Rennes","Le Havre AC","2-1",2,1,"1",1,3,1,"H"
"20393",2000-02-27,1999,"RC Strasbourg","AS Monaco","3-2",3,2,"1",1,5,1,"H"
"20394",2000-03-11,1999,"SC Bastia","Montpellier HSC","1-0",1,0,"1",1,1,1,"H"
"20395",2000-03-11,1999,"FC Nantes","RC Strasbourg","3-1",3,1,"1",1,4,2,"H"
"20396",2000-03-11,1999,"Olympique Marseille","Girondins Bordeaux","0-2",0,2,"1",1,2,-2,"D"
"20397",2000-03-11,1999,"CS Sedan","Paris Saint-Germain","1-1",1,1,"1",1,2,0,"D"
"20398",2000-03-11,1999,"Le Havre AC","FC Metz","1-0",1,0,"1",1,1,1,"H"
"20399",2000-03-11,1999,"AS Saint-Etienne","Stade Rennes","1-0",1,0,"1",1,1,1,"H"
"20400",2000-03-12,1999,"AS Nancy","Olympique Lyon","1-0",1,0,"1",1,1,1,"H"
"20401",2000-03-12,1999,"RC Lens","ATAC Troyes","0-1",0,1,"1",1,1,-1,"D"
"20402",2000-03-12,1999,"AJ Auxerre","AS Monaco","0-2",0,2,"1",1,2,-2,"D"
"20403",2000-03-25,1999,"RC Strasbourg","Olympique Marseille","3-1",3,1,"1",1,4,2,"H"
"20404",2000-03-25,1999,"Montpellier HSC","AJ Auxerre","2-0",2,0,"1",1,2,2,"H"
"20405",2000-03-25,1999,"ATAC Troyes","SC Bastia","1-0",1,0,"1",1,1,1,"H"
"20406",2000-03-25,1999,"FC Metz","AS Saint-Etienne","1-1",1,1,"1",1,2,0,"D"
"20407",2000-03-25,1999,"Paris Saint-Germain","Le Havre AC","2-1",2,1,"1",1,3,1,"H"
"20408",2000-03-25,1999,"Girondins Bordeaux","AS Nancy","2-1",2,1,"1",1,3,1,"H"
"20409",2000-03-25,1999,"Stade Rennes","RC Lens","3-0",3,0,"1",1,3,3,"H"
"20410",2000-03-26,1999,"Olympique Lyon","CS Sedan","2-0",2,0,"1",1,2,2,"H"
"20411",2000-03-26,1999,"AS Monaco","FC Nantes","2-0",2,0,"1",1,2,2,"H"
"20412",2000-04-07,1999,"CS Sedan","Girondins Bordeaux","0-1",0,1,"1",1,1,-1,"D"
"20413",2000-04-07,1999,"Olympique Marseille","AS Monaco","4-2",4,2,"1",1,6,2,"H"
"20414",2000-04-08,1999,"AS Nancy","RC Strasbourg","2-3",2,3,"1",1,5,-1,"D"
"20415",2000-04-08,1999,"Montpellier HSC","ATAC Troyes","2-2",2,2,"1",1,4,0,"D"
"20416",2000-04-08,1999,"AJ Auxerre","FC Nantes","1-1",1,1,"1",1,2,0,"D"
"20417",2000-04-08,1999,"Le Havre AC","Olympique Lyon","0-1",0,1,"1",1,1,-1,"D"
"20418",2000-04-08,1999,"AS Saint-Etienne","Paris Saint-Germain","1-1",1,1,"1",1,2,0,"D"
"20419",2000-04-08,1999,"SC Bastia","Stade Rennes","4-2",4,2,"1",1,6,2,"H"
"20420",2000-04-09,1999,"RC Lens","FC Metz","1-0",1,0,"1",1,1,1,"H"
"20421",2000-04-14,1999,"Paris Saint-Germain","RC Lens","4-1",4,1,"1",1,5,3,"H"
"20422",2000-04-14,1999,"Olympique Lyon","AS Saint-Etienne","0-0",0,0,"1",1,0,0,"D"
"20423",2000-04-15,1999,"FC Metz","SC Bastia","1-1",1,1,"1",1,2,0,"D"
"20424",2000-04-15,1999,"FC Nantes","Olympique Marseille","0-0",0,0,"1",1,0,0,"D"
"20425",2000-04-15,1999,"ATAC Troyes","AJ Auxerre","2-0",2,0,"1",1,2,2,"H"
"20426",2000-04-15,1999,"Stade Rennes","Montpellier HSC","1-3",1,3,"1",1,4,-2,"D"
"20427",2000-04-15,1999,"Girondins Bordeaux","Le Havre AC","3-0",3,0,"1",1,3,3,"H"
"20428",2000-04-15,1999,"RC Strasbourg","CS Sedan","1-1",1,1,"1",1,2,0,"D"
"20429",2000-04-15,1999,"AS Monaco","AS Nancy","2-2",2,2,"1",1,4,0,"D"
"20430",2000-04-29,1999,"AS Saint-Etienne","Girondins Bordeaux","1-2",1,2,"1",1,3,-1,"D"
"20431",2000-04-29,1999,"RC Lens","Olympique Lyon","4-3",4,3,"1",1,7,1,"H"
"20432",2000-04-29,1999,"Montpellier HSC","FC Metz","0-1",0,1,"1",1,1,-1,"D"
"20433",2000-04-29,1999,"AS Nancy","FC Nantes","2-1",2,1,"1",1,3,1,"H"
"20434",2000-04-29,1999,"CS Sedan","AS Monaco","2-1",2,1,"1",1,3,1,"H"
"20435",2000-04-29,1999,"Le Havre AC","RC Strasbourg","0-1",0,1,"1",1,1,-1,"D"
"20436",2000-04-29,1999,"ATAC Troyes","Stade Rennes","1-0",1,0,"1",1,1,1,"H"
"20437",2000-04-30,1999,"SC Bastia","Paris Saint-Germain","1-2",1,2,"1",1,3,-1,"D"
"20438",2000-04-30,1999,"AJ Auxerre","Olympique Marseille","2-2",2,2,"1",1,4,0,"D"
"20439",2000-05-04,1999,"FC Nantes","CS Sedan","1-0",1,0,"1",1,1,1,"H"
"20440",2000-05-04,1999,"Olympique Marseille","AS Nancy","2-2",2,2,"1",1,4,0,"D"
"20441",2000-05-04,1999,"AJ Auxerre","Stade Rennes","4-0",4,0,"1",1,4,4,"H"
"20442",2000-05-04,1999,"Girondins Bordeaux","RC Lens","1-2",1,2,"1",1,3,-1,"D"
"20443",2000-05-04,1999,"RC Strasbourg","AS Saint-Etienne","0-1",0,1,"1",1,1,-1,"D"
"20444",2000-05-04,1999,"AS Monaco","Le Havre AC","5-2",5,2,"1",1,7,3,"H"
"20445",2000-05-04,1999,"FC Metz","ATAC Troyes","3-1",3,1,"1",1,4,2,"H"
"20446",2000-05-04,1999,"Paris Saint-Germain","Montpellier HSC","3-0",3,0,"1",1,3,3,"H"
"20447",2000-05-04,1999,"Olympique Lyon","SC Bastia","2-1",2,1,"1",1,3,1,"H"
"20448",2000-05-13,1999,"Montpellier HSC","Olympique Lyon","2-2",2,2,"1",1,4,0,"D"
"20449",2000-05-13,1999,"ATAC Troyes","Paris Saint-Germain","2-2",2,2,"1",1,4,0,"D"
"20450",2000-05-13,1999,"Stade Rennes","FC Metz","2-0",2,0,"1",1,2,2,"H"
"20451",2000-05-13,1999,"AS Saint-Etienne","AS Monaco","3-1",3,1,"1",1,4,2,"H"
"20452",2000-05-13,1999,"RC Lens","RC Strasbourg","3-0",3,0,"1",1,3,3,"H"
"20453",2000-05-13,1999,"SC Bastia","Girondins Bordeaux","1-1",1,1,"1",1,2,0,"D"
"20454",2000-05-13,1999,"AS Nancy","AJ Auxerre","2-0",2,0,"1",1,2,2,"H"
"20455",2000-05-13,1999,"CS Sedan","Olympique Marseille","2-2",2,2,"1",1,4,0,"D"
"20456",2000-05-13,1999,"Le Havre AC","FC Nantes","0-1",0,1,"1",1,1,-1,"D"
"20457",2000-07-28,2000,"Olympique Marseille","ESTAC Troyes","3-1",3,1,"1",1,4,2,"H"
"20458",2000-07-28,2000,"Paris Saint-Germain","RC Strasbourg","3-1",3,1,"1",1,4,2,"H"
"20459",2000-07-29,2000,"AJ Auxerre","CS Sedan","0-1",0,1,"1",1,1,-1,"D"
"20460",2000-07-29,2000,"Girondins Bordeaux","FC Metz","1-1",1,1,"1",1,2,0,"D"
"20461",2000-07-29,2000,"EA Guingamp","AS Saint-Etienne","2-2",2,2,"1",1,4,0,"D"
"20462",2000-07-29,2000,"Lille OSC","AS Monaco","1-1",1,1,"1",1,2,0,"D"
"20463",2000-07-29,2000,"Olympique Lyon","Stade Rennes","2-2",2,2,"1",1,4,0,"D"
"20464",2000-07-29,2000,"FC Nantes","RC Lens","0-2",0,2,"1",1,2,-2,"D"
"20465",2000-07-29,2000,"Toulouse FC","SC Bastia","0-1",0,1,"1",1,1,-1,"D"
"20466",2000-08-03,2000,"CS Sedan","Olympique Lyon","1-1",1,1,"1",1,2,0,"D"
"20467",2000-08-04,2000,"AS Monaco","FC Nantes","2-5",2,5,"1",1,7,-3,"D"
"20468",2000-08-04,2000,"AS Saint-Etienne","Olympique Marseille","3-0",3,0,"1",1,3,3,"H"
"20469",2000-08-05,2000,"SC Bastia","Girondins Bordeaux","2-0",2,0,"1",1,2,2,"H"
"20470",2000-08-05,2000,"RC Lens","EA Guingamp","3-2",3,2,"1",1,5,1,"H"
"20471",2000-08-05,2000,"FC Metz","AJ Auxerre","1-2",1,2,"1",1,3,-1,"D"
"20472",2000-08-05,2000,"Stade Rennes","Paris Saint-Germain","1-1",1,1,"1",1,2,0,"D"
"20473",2000-08-05,2000,"RC Strasbourg","Lille OSC","0-4",0,4,"1",1,4,-4,"D"
"20474",2000-08-05,2000,"ESTAC Troyes","Toulouse FC","1-1",1,1,"1",1,2,0,"D"
"20475",2000-08-12,2000,"AJ Auxerre","SC Bastia","1-0",1,0,"1",1,1,1,"H"
"20476",2000-08-12,2000,"Girondins Bordeaux","ESTAC Troyes","2-2",2,2,"1",1,4,0,"D"
"20477",2000-08-12,2000,"EA Guingamp","FC Nantes","0-1",0,1,"1",1,1,-1,"D"
"20478",2000-08-12,2000,"Lille OSC","Stade Rennes","1-0",1,0,"1",1,1,1,"H"
"20479",2000-08-12,2000,"Olympique Lyon","FC Metz","0-0",0,0,"1",1,0,0,"D"
"20480",2000-08-12,2000,"RC Strasbourg","AS Monaco","1-3",1,3,"1",1,4,-2,"D"
"20481",2000-08-12,2000,"Toulouse FC","AS Saint-Etienne","1-1",1,1,"1",1,2,0,"D"
"20482",2000-08-13,2000,"Paris Saint-Germain","CS Sedan","2-1",2,1,"1",1,3,1,"H"
"20483",2000-08-13,2000,"Olympique Marseille","RC Lens","0-0",0,0,"1",1,0,0,"D"
"20484",2000-08-18,2000,"SC Bastia","Olympique Lyon","2-0",2,0,"1",1,2,2,"H"
"20485",2000-08-19,2000,"AS Saint-Etienne","Girondins Bordeaux","1-0",1,0,"1",1,1,1,"H"
"20486",2000-08-19,2000,"RC Lens","Toulouse FC","2-1",2,1,"1",1,3,1,"H"
"20487",2000-08-19,2000,"FC Metz","Paris Saint-Germain","1-0",1,0,"1",1,1,1,"H"
"20488",2000-08-19,2000,"FC Nantes","Olympique Marseille","3-2",3,2,"1",1,5,1,"H"
"20489",2000-08-19,2000,"Stade Rennes","RC Strasbourg","3-0",3,0,"1",1,3,3,"H"
"20490",2000-08-19,2000,"CS Sedan","Lille OSC","1-0",1,0,"1",1,1,1,"H"
"20491",2000-08-19,2000,"ESTAC Troyes","AJ Auxerre","1-0",1,0,"1",1,1,1,"H"
"20492",2000-08-20,2000,"AS Monaco","EA Guingamp","1-0",1,0,"1",1,1,1,"H"
"20493",2000-08-26,2000,"Girondins Bordeaux","RC Lens","1-1",1,1,"1",1,2,0,"D"
"20494",2000-08-26,2000,"Lille OSC","FC Metz","2-1",2,1,"1",1,3,1,"H"
"20495",2000-08-26,2000,"Olympique Lyon","ESTAC Troyes","1-0",1,0,"1",1,1,1,"H"
"20496",2000-08-26,2000,"Olympique Marseille","EA Guingamp","3-1",3,1,"1",1,4,2,"H"
"20497",2000-08-26,2000,"Stade Rennes","AS Monaco","1-1",1,1,"1",1,2,0,"D"
"20498",2000-08-26,2000,"RC Strasbourg","CS Sedan","3-2",3,2,"1",1,5,1,"H"
"20499",2000-08-26,2000,"Toulouse FC","FC Nantes","1-1",1,1,"1",1,2,0,"D"
"20500",2000-08-27,2000,"AJ Auxerre","AS Saint-Etienne","4-3",4,3,"1",1,7,1,"H"
"20501",2000-08-27,2000,"Paris Saint-Germain","SC Bastia","3-1",3,1,"1",1,4,2,"H"
"20502",2000-09-05,2000,"AS Monaco","Olympique Marseille","0-2",0,2,"1",1,2,-2,"D"
"20503",2000-09-06,2000,"FC Nantes","Girondins Bordeaux","0-5",0,5,"1",1,5,-5,"D"
"20504",2000-09-06,2000,"AS Saint-Etienne","Olympique Lyon","2-2",2,2,"1",1,4,0,"D"
"20505",2000-09-06,2000,"SC Bastia","Lille OSC","1-0",1,0,"1",1,1,1,"H"
"20506",2000-09-06,2000,"EA Guingamp","Toulouse FC","2-1",2,1,"1",1,3,1,"H"
"20507",2000-09-06,2000,"RC Lens","AJ Auxerre","1-0",1,0,"1",1,1,1,"H"
"20508",2000-09-06,2000,"FC Metz","RC Strasbourg","1-0",1,0,"1",1,1,1,"H"
"20509",2000-09-06,2000,"ESTAC Troyes","Paris Saint-Germain","5-3",5,3,"1",1,8,2,"H"
"20510",2000-09-09,2000,"CS Sedan","AS Monaco","1-0",1,0,"1",1,1,1,"H"
"20511",2000-09-09,2000,"Paris Saint-Germain","AS Saint-Etienne","5-1",5,1,"1",1,6,4,"H"
"20512",2000-09-09,2000,"Stade Rennes","FC Metz","0-1",0,1,"1",1,1,-1,"D"
"20513",2000-09-09,2000,"RC Strasbourg","SC Bastia","1-4",1,4,"1",1,5,-3,"D"
"20514",2000-09-09,2000,"AJ Auxerre","FC Nantes","2-2",2,2,"1",1,4,0,"D"
"20515",2000-09-09,2000,"Girondins Bordeaux","EA Guingamp","0-2",0,2,"1",1,2,-2,"D"
"20516",2000-09-09,2000,"Lille OSC","ESTAC Troyes","1-2",1,2,"1",1,3,-1,"D"
"20517",2000-09-09,2000,"Olympique Lyon","RC Lens","3-0",3,0,"1",1,3,3,"H"
"20518",2000-09-10,2000,"Toulouse FC","Olympique Marseille","2-0",2,0,"1",1,2,2,"H"
"20519",2000-09-16,2000,"RC Lens","Paris Saint-Germain","1-1",1,1,"1",1,2,0,"D"
"20520",2000-09-16,2000,"Olympique Marseille","Girondins Bordeaux","0-1",0,1,"1",1,1,-1,"D"
"20521",2000-09-16,2000,"FC Metz","CS Sedan","1-0",1,0,"1",1,1,1,"H"
"20522",2000-09-16,2000,"AS Monaco","Toulouse FC","3-0",3,0,"1",1,3,3,"H"
"20523",2000-09-16,2000,"SC Bastia","Stade Rennes","0-2",0,2,"1",1,2,-2,"D"
"20524",2000-09-16,2000,"EA Guingamp","AJ Auxerre","1-0",1,0,"1",1,1,1,"H"
"20525",2000-09-16,2000,"ESTAC Troyes","RC Strasbourg","0-1",0,1,"1",1,1,-1,"D"
"20526",2000-09-17,2000,"FC Nantes","Olympique Lyon","0-1",0,1,"1",1,1,-1,"D"
"20527",2000-09-17,2000,"AS Saint-Etienne","Lille OSC","1-1",1,1,"1",1,2,0,"D"
"20528",2000-09-23,2000,"AJ Auxerre","Olympique Marseille","0-1",0,1,"1",1,1,-1,"D"
"20529",2000-09-23,2000,"Girondins Bordeaux","Toulouse FC","2-1",2,1,"1",1,3,1,"H"
"20530",2000-09-23,2000,"Olympique Lyon","EA Guingamp","0-1",0,1,"1",1,1,-1,"D"
"20531",2000-09-23,2000,"FC Metz","AS Monaco","1-3",1,3,"1",1,4,-2,"D"
"20532",2000-09-23,2000,"Paris Saint-Germain","FC Nantes","2-1",2,1,"1",1,3,1,"H"
"20533",2000-09-23,2000,"Stade Rennes","ESTAC Troyes","0-2",0,2,"1",1,2,-2,"D"
"20534",2000-09-23,2000,"CS Sedan","SC Bastia","3-3",3,3,"1",1,6,0,"D"
"20535",2000-09-23,2000,"RC Strasbourg","AS Saint-Etienne","3-2",3,2,"1",1,5,1,"H"
"20536",2000-09-24,2000,"Lille OSC","RC Lens","2-1",2,1,"1",1,3,1,"H"
"20537",2000-09-30,2000,"EA Guingamp","Paris Saint-Germain","1-1",1,1,"1",1,2,0,"D"
"20538",2000-09-30,2000,"RC Lens","RC Strasbourg","0-0",0,0,"1",1,0,0,"D"
"20539",2000-09-30,2000,"AS Monaco","Girondins Bordeaux","2-2",2,2,"1",1,4,0,"D"
"20540",2000-09-30,2000,"AS Saint-Etienne","Stade Rennes","0-2",0,2,"1",1,2,-2,"D"
"20541",2000-09-30,2000,"Toulouse FC","AJ Auxerre","0-1",0,1,"1",1,1,-1,"D"
"20542",2000-09-30,2000,"ESTAC Troyes","CS Sedan","1-1",1,1,"1",1,2,0,"D"
"20543",2000-09-30,2000,"SC Bastia","FC Metz","1-0",1,0,"1",1,1,1,"H"
"20544",2000-10-01,2000,"FC Nantes","Lille OSC","0-0",0,0,"1",1,0,0,"D"
"20545",2000-10-01,2000,"Olympique Marseille","Olympique Lyon","1-1",1,1,"1",1,2,0,"D"
"20546",2000-10-10,2000,"CS Sedan","Stade Rennes","2-1",2,1,"1",1,3,1,"H"
"20547",2000-10-13,2000,"SC Bastia","AS Monaco","0-2",0,2,"1",1,2,-2,"D"
"20548",2000-10-13,2000,"Paris Saint-Germain","Olympique Marseille","2-0",2,0,"1",1,2,2,"H"
"20549",2000-10-14,2000,"Stade Rennes","RC Lens","1-0",1,0,"1",1,1,1,"H"
"20550",2000-10-14,2000,"CS Sedan","AS Saint-Etienne","2-1",2,1,"1",1,3,1,"H"
"20551",2000-10-14,2000,"RC Strasbourg","FC Nantes","0-5",0,5,"1",1,5,-5,"D"
"20552",2000-10-14,2000,"Lille OSC","EA Guingamp","1-1",1,1,"1",1,2,0,"D"
"20553",2000-10-14,2000,"FC Metz","ESTAC Troyes","2-2",2,2,"1",1,4,0,"D"
"20554",2000-10-15,2000,"AJ Auxerre","Girondins Bordeaux","0-2",0,2,"1",1,2,-2,"D"
"20555",2000-10-21,2000,"Toulouse FC","Paris Saint-Germain","2-3",2,3,"1",1,5,-1,"D"
"20556",2000-10-21,2000,"ESTAC Troyes","SC Bastia","0-0",0,0,"1",1,0,0,"D"
"20557",2000-10-21,2000,"AS Monaco","AJ Auxerre","1-1",1,1,"1",1,2,0,"D"
"20558",2000-10-21,2000,"FC Nantes","Stade Rennes","1-0",1,0,"1",1,1,1,"H"
"20559",2000-10-21,2000,"AS Saint-Etienne","FC Metz","2-0",2,0,"1",1,2,2,"H"
"20560",2000-10-21,2000,"Girondins Bordeaux","Olympique Lyon","1-1",1,1,"1",1,2,0,"D"
"20561",2000-10-21,2000,"EA Guingamp","RC Strasbourg","2-1",2,1,"1",1,3,1,"H"
"20562",2000-10-21,2000,"RC Lens","CS Sedan","1-1",1,1,"1",1,2,0,"D"
"20563",2000-10-22,2000,"Olympique Marseille","Lille OSC","0-1",0,1,"1",1,1,-1,"D"
"20564",2000-10-28,2000,"RC Strasbourg","Olympique Marseille","1-1",1,1,"1",1,2,0,"D"
"20565",2000-10-29,2000,"ESTAC Troyes","AS Monaco","1-0",1,0,"1",1,1,1,"H"
"20566",2000-10-29,2000,"SC Bastia","AS Saint-Etienne","0-0",0,0,"1",1,0,0,"D"
"20567",2000-10-29,2000,"Lille OSC","Toulouse FC","1-0",1,0,"1",1,1,1,"H"
"20568",2000-10-29,2000,"Olympique Lyon","AJ Auxerre","2-2",2,2,"1",1,4,0,"D"
"20569",2000-10-29,2000,"FC Metz","RC Lens","2-1",2,1,"1",1,3,1,"H"
"20570",2000-10-29,2000,"Paris Saint-Germain","Girondins Bordeaux","1-2",1,2,"1",1,3,-1,"D"
"20571",2000-10-29,2000,"Stade Rennes","EA Guingamp","1-2",1,2,"1",1,3,-1,"D"
"20572",2000-10-29,2000,"CS Sedan","FC Nantes","2-0",2,0,"1",1,2,2,"H"
"20573",2000-11-03,2000,"AS Monaco","Olympique Lyon","0-2",0,2,"1",1,2,-2,"D"
"20574",2000-11-04,2000,"AJ Auxerre","Paris Saint-Germain","1-0",1,0,"1",1,1,1,"H"
"20575",2000-11-04,2000,"Girondins Bordeaux","Lille OSC","1-0",1,0,"1",1,1,1,"H"
"20576",2000-11-04,2000,"EA Guingamp","CS Sedan","0-3",0,3,"1",1,3,-3,"D"
"20577",2000-11-04,2000,"RC Lens","SC Bastia","4-0",4,0,"1",1,4,4,"H"
"20578",2000-11-04,2000,"Olympique Marseille","Stade Rennes","0-1",0,1,"1",1,1,-1,"D"
"20579",2000-11-04,2000,"FC Nantes","FC Metz","2-0",2,0,"1",1,2,2,"H"
"20580",2000-11-04,2000,"AS Saint-Etienne","ESTAC Troyes","4-1",4,1,"1",1,5,3,"H"
"20581",2000-11-04,2000,"Toulouse FC","RC Strasbourg","0-0",0,0,"1",1,0,0,"D"
"20582",2000-11-10,2000,"AS Saint-Etienne","AS Monaco","1-0",1,0,"1",1,1,1,"H"
"20583",2000-11-11,2000,"Paris Saint-Germain","Olympique Lyon","1-1",1,1,"1",1,2,0,"D"
"20584",2000-11-11,2000,"Stade Rennes","Toulouse FC","1-1",1,1,"1",1,2,0,"D"
"20585",2000-11-11,2000,"Lille OSC","AJ Auxerre","1-1",1,1,"1",1,2,0,"D"
"20586",2000-11-11,2000,"FC Metz","EA Guingamp","1-1",1,1,"1",1,2,0,"D"
"20587",2000-11-11,2000,"CS Sedan","Olympique Marseille","2-0",2,0,"1",1,2,2,"H"
"20588",2000-11-11,2000,"ESTAC Troyes","RC Lens","1-0",1,0,"1",1,1,1,"H"
"20589",2000-11-12,2000,"RC Strasbourg","Girondins Bordeaux","0-2",0,2,"1",1,2,-2,"D"
"20590",2000-11-17,2000,"Olympique Marseille","FC Metz","4-1",4,1,"1",1,5,3,"H"
"20591",2000-11-18,2000,"AS Monaco","Paris Saint-Germain","2-0",2,0,"1",1,2,2,"H"
"20592",2000-11-18,2000,"FC Nantes","ESTAC Troyes","4-0",4,0,"1",1,4,4,"H"
"20593",2000-11-18,2000,"Toulouse FC","CS Sedan","2-0",2,0,"1",1,2,2,"H"
"20594",2000-11-18,2000,"EA Guingamp","SC Bastia","1-0",1,0,"1",1,1,1,"H"
"20595",2000-11-18,2000,"RC Lens","AS Saint-Etienne","0-0",0,0,"1",1,0,0,"D"
"20596",2000-11-18,2000,"Olympique Lyon","Lille OSC","0-1",0,1,"1",1,1,-1,"D"
"20597",2000-11-19,2000,"AJ Auxerre","RC Strasbourg","1-2",1,2,"1",1,3,-1,"D"
"20598",2000-11-19,2000,"Girondins Bordeaux","Stade Rennes","3-0",3,0,"1",1,3,3,"H"
"20599",2000-11-25,2000,"SC Bastia","Olympique Marseille","3-0",3,0,"1",1,3,3,"H"
"20600",2000-11-25,2000,"RC Lens","AS Monaco","4-3",4,3,"1",1,7,1,"H"
"20601",2000-11-25,2000,"RC Strasbourg","Olympique Lyon","0-3",0,3,"1",1,3,-3,"D"
"20602",2000-11-25,2000,"ESTAC Troyes","EA Guingamp","0-1",0,1,"1",1,1,-1,"D"
"20603",2000-11-25,2000,"FC Metz","Toulouse FC","1-1",1,1,"1",1,2,0,"D"
"20604",2000-11-25,2000,"Stade Rennes","AJ Auxerre","0-1",0,1,"1",1,1,-1,"D"
"20605",2000-11-26,2000,"AS Saint-Etienne","FC Nantes","0-2",0,2,"1",1,2,-2,"D"
"20606",2000-11-26,2000,"CS Sedan","Girondins Bordeaux","0-0",0,0,"1",1,0,0,"D"
"20607",2000-11-28,2000,"EA Guingamp","RC Lens","0-1",0,1,"1",1,1,-1,"D"
"20608",2000-11-28,2000,"Paris Saint-Germain","Stade Rennes","0-1",0,1,"1",1,1,-1,"D"
"20609",2000-11-29,2000,"Toulouse FC","ESTAC Troyes","2-1",2,1,"1",1,3,1,"H"
"20610",2000-11-29,2000,"AJ Auxerre","FC Metz","1-0",1,0,"1",1,1,1,"H"
"20611",2000-11-29,2000,"Girondins Bordeaux","SC Bastia","0-0",0,0,"1",1,0,0,"D"
"20612",2000-11-29,2000,"Lille OSC","RC Strasbourg","1-1",1,1,"1",1,2,0,"D"
"20613",2000-11-29,2000,"Olympique Lyon","CS Sedan","2-2",2,2,"1",1,4,0,"D"
"20614",2000-11-29,2000,"Olympique Marseille","AS Saint-Etienne","2-1",2,1,"1",1,3,1,"H"
"20615",2000-11-29,2000,"FC Nantes","AS Monaco","3-1",3,1,"1",1,4,2,"H"
"20616",2000-12-02,2000,"FC Metz","Olympique Lyon","0-0",0,0,"1",1,0,0,"D"
"20617",2000-12-02,2000,"AS Monaco","RC Strasbourg","1-0",1,0,"1",1,1,1,"H"
"20618",2000-12-02,2000,"FC Nantes","EA Guingamp","2-1",2,1,"1",1,3,1,"H"
"20619",2000-12-02,2000,"Stade Rennes","Lille OSC","2-0",2,0,"1",1,2,2,"H"
"20620",2000-12-02,2000,"AS Saint-Etienne","Toulouse FC","1-0",1,0,"1",1,1,1,"H"
"20621",2000-12-02,2000,"CS Sedan","Paris Saint-Germain","5-1",5,1,"1",1,6,4,"H"
"20622",2000-12-02,2000,"ESTAC Troyes","Girondins Bordeaux","1-0",1,0,"1",1,1,1,"H"
"20623",2000-12-02,2000,"SC Bastia","AJ Auxerre","3-1",3,1,"1",1,4,2,"H"
"20624",2000-12-03,2000,"RC Lens","Olympique Marseille","1-0",1,0,"1",1,1,1,"H"
"20625",2000-12-09,2000,"Paris Saint-Germain","FC Metz","1-0",1,0,"1",1,1,1,"H"
"20626",2000-12-09,2000,"RC Strasbourg","Stade Rennes","1-1",1,1,"1",1,2,0,"D"
"20627",2000-12-09,2000,"Toulouse FC","RC Lens","1-0",1,0,"1",1,1,1,"H"
"20628",2000-12-09,2000,"AJ Auxerre","ESTAC Troyes","2-2",2,2,"1",1,4,0,"D"
"20629",2000-12-09,2000,"EA Guingamp","AS Monaco","2-2",2,2,"1",1,4,0,"D"
"20630",2000-12-09,2000,"Lille OSC","CS Sedan","2-0",2,0,"1",1,2,2,"H"
"20631",2000-12-09,2000,"Olympique Lyon","SC Bastia","1-0",1,0,"1",1,1,1,"H"
"20632",2000-12-10,2000,"Olympique Marseille","FC Nantes","2-0",2,0,"1",1,2,2,"H"
"20633",2000-12-10,2000,"Girondins Bordeaux","AS Saint-Etienne","2-1",2,1,"1",1,3,1,"H"
"20634",2000-12-13,2000,"Olympique Lyon","Toulouse FC","4-1",4,1,"1",1,5,3,"H"
"20635",2000-12-13,2000,"SC Bastia","FC Nantes","3-1",3,1,"1",1,4,2,"H"
"20636",2000-12-13,2000,"Lille OSC","Paris Saint-Germain","2-0",2,0,"1",1,2,2,"H"
"20637",2000-12-16,2000,"EA Guingamp","Olympique Marseille","1-0",1,0,"1",1,1,1,"H"
"20638",2000-12-16,2000,"RC Lens","Girondins Bordeaux","2-2",2,2,"1",1,4,0,"D"
"20639",2000-12-16,2000,"FC Metz","Lille OSC","1-1",1,1,"1",1,2,0,"D"
"20640",2000-12-16,2000,"AS Monaco","Stade Rennes","1-2",1,2,"1",1,3,-1,"D"
"20641",2000-12-16,2000,"AS Saint-Etienne","AJ Auxerre","2-0",2,0,"1",1,2,2,"H"
"20642",2000-12-16,2000,"CS Sedan","RC Strasbourg","1-0",1,0,"1",1,1,1,"H"
"20643",2000-12-16,2000,"ESTAC Troyes","Olympique Lyon","1-0",1,0,"1",1,1,1,"H"
"20644",2000-12-17,2000,"FC Nantes","Toulouse FC","3-2",3,2,"1",1,5,1,"H"
"20645",2000-12-17,2000,"SC Bastia","Paris Saint-Germain","1-1",1,1,"1",1,2,0,"D"
"20646",2000-12-20,2000,"Olympique Marseille","AS Monaco","2-1",2,1,"1",1,3,1,"H"
"20647",2000-12-21,2000,"Girondins Bordeaux","FC Nantes","0-2",0,2,"1",1,2,-2,"D"
"20648",2000-12-21,2000,"Lille OSC","SC Bastia","1-0",1,0,"1",1,1,1,"H"
"20649",2000-12-21,2000,"Olympique Lyon","AS Saint-Etienne","2-1",2,1,"1",1,3,1,"H"
"20650",2000-12-21,2000,"AJ Auxerre","RC Lens","3-2",3,2,"1",1,5,1,"H"
"20651",2000-12-21,2000,"Toulouse FC","EA Guingamp","1-1",1,1,"1",1,2,0,"D"
"20652",2000-12-21,2000,"Paris Saint-Germain","ESTAC Troyes","0-0",0,0,"1",1,0,0,"D"
"20653",2000-12-21,2000,"Stade Rennes","CS Sedan","2-0",2,0,"1",1,2,2,"H"
"20654",2001-01-12,2000,"RC Lens","Olympique Lyon","0-0",0,0,"1",1,0,0,"D"
"20655",2001-01-13,2000,"FC Nantes","AJ Auxerre","1-1",1,1,"1",1,2,0,"D"
"20656",2001-01-13,2000,"AS Saint-Etienne","Paris Saint-Germain","1-0",1,0,"1",1,1,1,"H"
"20657",2001-01-13,2000,"ESTAC Troyes","Lille OSC","2-1",2,1,"1",1,3,1,"H"
"20658",2001-01-13,2000,"SC Bastia","RC Strasbourg","3-1",3,1,"1",1,4,2,"H"
"20659",2001-01-13,2000,"EA Guingamp","Girondins Bordeaux","1-1",1,1,"1",1,2,0,"D"
"20660",2001-01-13,2000,"Olympique Marseille","Toulouse FC","1-1",1,1,"1",1,2,0,"D"
"20661",2001-01-13,2000,"FC Metz","Stade Rennes","2-2",2,2,"1",1,4,0,"D"
"20662",2001-01-13,2000,"AS Monaco","CS Sedan","1-0",1,0,"1",1,1,1,"H"
"20663",2001-01-26,2000,"Girondins Bordeaux","Olympique Marseille","3-0",3,0,"1",1,3,3,"H"
"20664",2001-01-27,2000,"Olympique Lyon","FC Nantes","3-1",3,1,"1",1,4,2,"H"
"20665",2001-01-27,2000,"Paris Saint-Germain","RC Lens","1-0",1,0,"1",1,1,1,"H"
"20666",2001-01-27,2000,"Stade Rennes","SC Bastia","1-2",1,2,"1",1,3,-1,"D"
"20667",2001-01-27,2000,"CS Sedan","FC Metz","0-0",0,0,"1",1,0,0,"D"
"20668",2001-01-27,2000,"RC Strasbourg","ESTAC Troyes","3-3",3,3,"1",1,6,0,"D"
"20669",2001-01-27,2000,"Toulouse FC","AS Monaco","2-1",2,1,"1",1,3,1,"H"
"20670",2001-01-27,2000,"Lille OSC","AS Saint-Etienne","4-1",4,1,"1",1,5,3,"H"
"20671",2001-01-27,2000,"AJ Auxerre","EA Guingamp","1-1",1,1,"1",1,2,0,"D"
"20672",2001-02-03,2000,"FC Nantes","Paris Saint-Germain","1-0",1,0,"1",1,1,1,"H"
"20673",2001-02-03,2000,"AS Saint-Etienne","RC Strasbourg","3-3",3,3,"1",1,6,0,"D"
"20674",2001-02-03,2000,"Toulouse FC","Girondins Bordeaux","1-1",1,1,"1",1,2,0,"D"
"20675",2001-02-03,2000,"SC Bastia","CS Sedan","0-1",0,1,"1",1,1,-1,"D"
"20676",2001-02-03,2000,"EA Guingamp","Olympique Lyon","2-3",2,3,"1",1,5,-1,"D"
"20677",2001-02-03,2000,"Olympique Marseille","AJ Auxerre","0-1",0,1,"1",1,1,-1,"D"
"20678",2001-02-03,2000,"AS Monaco","FC Metz","6-1",6,1,"1",1,7,5,"H"
"20679",2001-02-04,2000,"RC Lens","Lille OSC","0-1",0,1,"1",1,1,-1,"D"
"20680",2001-02-06,2000,"Stade Rennes","AS Saint-Etienne","3-0",3,0,"1",1,3,3,"H"
"20681",2001-02-06,2000,"Paris Saint-Germain","EA Guingamp","1-3",1,3,"1",1,4,-2,"D"
"20682",2001-02-06,2000,"Olympique Lyon","Olympique Marseille","1-1",1,1,"1",1,2,0,"D"
"20683",2001-02-07,2000,"FC Metz","SC Bastia","3-2",3,2,"1",1,5,1,"H"
"20684",2001-02-07,2000,"AJ Auxerre","Toulouse FC","2-0",2,0,"1",1,2,2,"H"
"20685",2001-02-07,2000,"Girondins Bordeaux","AS Monaco","2-1",2,1,"1",1,3,1,"H"
"20686",2001-02-07,2000,"Lille OSC","FC Nantes","1-1",1,1,"1",1,2,0,"D"
"20687",2001-02-07,2000,"CS Sedan","ESTAC Troyes","2-1",2,1,"1",1,3,1,"H"
"20688",2001-02-07,2000,"RC Strasbourg","RC Lens","1-0",1,0,"1",1,1,1,"H"
"20689",2001-02-17,2000,"Olympique Marseille","Paris Saint-Germain","1-0",1,0,"1",1,1,1,"H"
"20690",2001-02-17,2000,"AS Monaco","SC Bastia","2-1",2,1,"1",1,3,1,"H"
"20691",2001-02-17,2000,"EA Guingamp","Lille OSC","0-1",0,1,"1",1,1,-1,"D"
"20692",2001-02-17,2000,"RC Lens","Stade Rennes","1-2",1,2,"1",1,3,-1,"D"
"20693",2001-02-17,2000,"AS Saint-Etienne","CS Sedan","0-2",0,2,"1",1,2,-2,"D"
"20694",2001-02-17,2000,"Toulouse FC","Olympique Lyon","1-1",1,1,"1",1,2,0,"D"
"20695",2001-02-17,2000,"ESTAC Troyes","FC Metz","3-2",3,2,"1",1,5,1,"H"
"20696",2001-02-18,2000,"FC Nantes","RC Strasbourg","1-0",1,0,"1",1,1,1,"H"
"20697",2001-02-18,2000,"Girondins Bordeaux","AJ Auxerre","1-0",1,0,"1",1,1,1,"H"
"20698",2001-02-23,2000,"ESTAC Troyes","Stade Rennes","3-1",3,1,"1",1,4,2,"H"
"20699",2001-03-03,2000,"Olympique Lyon","Girondins Bordeaux","2-1",2,1,"1",1,3,1,"H"
"20700",2001-03-03,2000,"FC Metz","AS Saint-Etienne","3-0",3,0,"1",1,3,3,"H"
"20701",2001-03-03,2000,"Paris Saint-Germain","Toulouse FC","3-0",3,0,"1",1,3,3,"H"
"20702",2001-03-03,2000,"AJ Auxerre","AS Monaco","1-0",1,0,"1",1,1,1,"H"
"20703",2001-03-03,2000,"SC Bastia","ESTAC Troyes","2-2",2,2,"1",1,4,0,"D"
"20704",2001-03-03,2000,"Lille OSC","Olympique Marseille","1-0",1,0,"1",1,1,1,"H"
"20705",2001-03-03,2000,"CS Sedan","RC Lens","2-2",2,2,"1",1,4,0,"D"
"20706",2001-03-03,2000,"RC Strasbourg","EA Guingamp","0-1",0,1,"1",1,1,-1,"D"
"20707",2001-03-04,2000,"Stade Rennes","FC Nantes","0-2",0,2,"1",1,2,-2,"D"
"20708",2001-03-17,2000,"Toulouse FC","Lille OSC","0-2",0,2,"1",1,2,-2,"D"
"20709",2001-03-17,2000,"AJ Auxerre","Olympique Lyon","0-3",0,3,"1",1,3,-3,"D"
"20710",2001-03-17,2000,"EA Guingamp","Stade Rennes","1-6",1,6,"1",1,7,-5,"D"
"20711",2001-03-17,2000,"RC Lens","FC Metz","1-1",1,1,"1",1,2,0,"D"
"20712",2001-03-17,2000,"Olympique Marseille","RC Strasbourg","0-0",0,0,"1",1,0,0,"D"
"20713",2001-03-17,2000,"AS Monaco","ESTAC Troyes","4-3",4,3,"1",1,7,1,"H"
"20714",2001-03-17,2000,"FC Nantes","CS Sedan","4-1",4,1,"1",1,5,3,"H"
"20715",2001-03-17,2000,"AS Saint-Etienne","SC Bastia","2-1",2,1,"1",1,3,1,"H"
"20716",2001-03-18,2000,"Girondins Bordeaux","Paris Saint-Germain","2-0",2,0,"1",1,2,2,"H"
"20717",2001-04-06,2000,"Lille OSC","Girondins Bordeaux","2-2",2,2,"1",1,4,0,"D"
"20718",2001-04-07,2000,"Olympique Lyon","AS Monaco","2-1",2,1,"1",1,3,1,"H"
"20719",2001-04-07,2000,"FC Metz","FC Nantes","1-2",1,2,"1",1,3,-1,"D"
"20720",2001-04-07,2000,"Paris Saint-Germain","AJ Auxerre","3-0",3,0,"1",1,3,3,"H"
"20721",2001-04-07,2000,"Stade Rennes","Olympique Marseille","2-0",2,0,"1",1,2,2,"H"
"20722",2001-04-07,2000,"CS Sedan","EA Guingamp","2-2",2,2,"1",1,4,0,"D"
"20723",2001-04-07,2000,"RC Strasbourg","Toulouse FC","1-0",1,0,"1",1,1,1,"H"
"20724",2001-04-07,2000,"ESTAC Troyes","AS Saint-Etienne","0-0",0,0,"1",1,0,0,"D"
"20725",2001-04-07,2000,"SC Bastia","RC Lens","1-3",1,3,"1",1,4,-2,"D"
"20726",2001-04-11,2000,"RC Strasbourg","FC Metz","0-1",0,1,"1",1,1,-1,"D"
"20727",2001-04-14,2000,"FC Nantes","SC Bastia","1-0",1,0,"1",1,1,1,"H"
"20728",2001-04-14,2000,"Toulouse FC","Stade Rennes","2-0",2,0,"1",1,2,2,"H"
"20729",2001-04-14,2000,"Olympique Marseille","CS Sedan","2-1",2,1,"1",1,3,1,"H"
"20730",2001-04-14,2000,"AS Monaco","AS Saint-Etienne","5-3",5,3,"1",1,8,2,"H"
"20731",2001-04-14,2000,"AJ Auxerre","Lille OSC","1-1",1,1,"1",1,2,0,"D"
"20732",2001-04-14,2000,"Girondins Bordeaux","RC Strasbourg","2-1",2,1,"1",1,3,1,"H"
"20733",2001-04-14,2000,"EA Guingamp","FC Metz","1-3",1,3,"1",1,4,-2,"D"
"20734",2001-04-15,2000,"Olympique Lyon","Paris Saint-Germain","2-0",2,0,"1",1,2,2,"H"
"20735",2001-04-28,2000,"FC Metz","Olympique Marseille","1-0",1,0,"1",1,1,1,"H"
"20736",2001-04-28,2000,"Paris Saint-Germain","AS Monaco","1-1",1,1,"1",1,2,0,"D"
"20737",2001-04-28,2000,"Stade Rennes","Girondins Bordeaux","1-2",1,2,"1",1,3,-1,"D"
"20738",2001-04-28,2000,"AS Saint-Etienne","RC Lens","1-1",1,1,"1",1,2,0,"D"
"20739",2001-04-28,2000,"CS Sedan","Toulouse FC","2-3",2,3,"1",1,5,-1,"D"
"20740",2001-04-28,2000,"RC Strasbourg","AJ Auxerre","1-0",1,0,"1",1,1,1,"H"
"20741",2001-04-28,2000,"SC Bastia","EA Guingamp","2-0",2,0,"1",1,2,2,"H"
"20742",2001-04-28,2000,"Lille OSC","Olympique Lyon","1-2",1,2,"1",1,3,-1,"D"
"20743",2001-04-29,2000,"ESTAC Troyes","FC Nantes","0-1",0,1,"1",1,1,-1,"D"
"20744",2001-05-04,2000,"RC Lens","ESTAC Troyes","1-1",1,1,"1",1,2,0,"D"
"20745",2001-05-12,2000,"AJ Auxerre","Stade Rennes","0-1",0,1,"1",1,1,-1,"D"
"20746",2001-05-12,2000,"Girondins Bordeaux","CS Sedan","2-2",2,2,"1",1,4,0,"D"
"20747",2001-05-12,2000,"EA Guingamp","ESTAC Troyes","1-1",1,1,"1",1,2,0,"D"
"20748",2001-05-12,2000,"Olympique Lyon","RC Strasbourg","5-0",5,0,"1",1,5,5,"H"
"20749",2001-05-12,2000,"Olympique Marseille","SC Bastia","2-1",2,1,"1",1,3,1,"H"
"20750",2001-05-12,2000,"AS Monaco","RC Lens","0-0",0,0,"1",1,0,0,"D"
"20751",2001-05-12,2000,"FC Nantes","AS Saint-Etienne","1-0",1,0,"1",1,1,1,"H"
"20752",2001-05-12,2000,"Paris Saint-Germain","Lille OSC","2-2",2,2,"1",1,4,0,"D"
"20753",2001-05-12,2000,"Toulouse FC","FC Metz","2-1",2,1,"1",1,3,1,"H"
"20754",2001-05-19,2000,"SC Bastia","Toulouse FC","5-1",5,1,"1",1,6,4,"H"
"20755",2001-05-19,2000,"RC Lens","FC Nantes","1-4",1,4,"1",1,5,-3,"D"
"20756",2001-05-19,2000,"FC Metz","Girondins Bordeaux","2-0",2,0,"1",1,2,2,"H"
"20757",2001-05-19,2000,"AS Monaco","Lille OSC","1-2",1,2,"1",1,3,-1,"D"
"20758",2001-05-19,2000,"Stade Rennes","Olympique Lyon","3-4",3,4,"1",1,7,-1,"D"
"20759",2001-05-19,2000,"AS Saint-Etienne","EA Guingamp","2-2",2,2,"1",1,4,0,"D"
"20760",2001-05-19,2000,"CS Sedan","AJ Auxerre","1-0",1,0,"1",1,1,1,"H"
"20761",2001-05-19,2000,"RC Strasbourg","Paris Saint-Germain","1-2",1,2,"1",1,3,-1,"D"
"20762",2001-05-19,2000,"ESTAC Troyes","Olympique Marseille","1-1",1,1,"1",1,2,0,"D"
"20763",2001-07-27,2001,"Girondins Bordeaux","FC Nantes","2-0",2,0,"1",1,2,2,"H"
"20764",2001-07-28,2001,"Paris Saint-Germain","Lille OSC","0-0",0,0,"1",1,0,0,"D"
"20765",2001-07-28,2001,"AS Monaco","FC Sochaux","0-1",0,1,"1",1,1,-1,"D"
"20766",2001-07-28,2001,"SC Bastia","CS Sedan","1-1",1,1,"1",1,2,0,"D"
"20767",2001-07-28,2001,"RC Lens","Olympique Lyon","2-0",2,0,"1",1,2,2,"H"
"20768",2001-07-28,2001,"Stade Rennes","AJ Auxerre","0-5",0,5,"1",1,5,-5,"D"
"20769",2001-07-28,2001,"Montpellier HSC","Olympique Marseille","1-1",1,1,"1",1,2,0,"D"
"20770",2001-07-28,2001,"ESTAC Troyes","EA Guingamp","3-0",3,0,"1",1,3,3,"H"
"20771",2001-07-28,2001,"FC Lorient","FC Metz","1-0",1,0,"1",1,1,1,"H"
"20772",2001-08-03,2001,"Olympique Marseille","Girondins Bordeaux","0-0",0,0,"1",1,0,0,"D"
"20773",2001-08-04,2001,"FC Nantes","RC Lens","1-2",1,2,"1",1,3,-1,"D"
"20774",2001-08-04,2001,"EA Guingamp","SC Bastia","1-0",1,0,"1",1,1,1,"H"
"20775",2001-08-04,2001,"FC Sochaux","Stade Rennes","4-3",4,3,"1",1,7,1,"H"
"20776",2001-08-04,2001,"Olympique Lyon","CS Sedan","2-0",2,0,"1",1,2,2,"H"
"20777",2001-08-04,2001,"FC Metz","ESTAC Troyes","2-1",2,1,"1",1,3,1,"H"
"20778",2001-08-04,2001,"AJ Auxerre","Paris Saint-Germain","1-1",1,1,"1",1,2,0,"D"
"20779",2001-08-04,2001,"AS Monaco","Montpellier HSC","0-0",0,0,"1",1,0,0,"D"
"20780",2001-08-04,2001,"Lille OSC","FC Lorient","3-1",3,1,"1",1,4,2,"H"
"20781",2001-08-11,2001,"Stade Rennes","AS Monaco","3-0",3,0,"1",1,3,3,"H"
"20782",2001-08-11,2001,"Paris Saint-Germain","FC Sochaux","1-0",1,0,"1",1,1,1,"H"
"20783",2001-08-11,2001,"Girondins Bordeaux","Lille OSC","0-0",0,0,"1",1,0,0,"D"
"20784",2001-08-11,2001,"RC Lens","Olympique Marseille","2-0",2,0,"1",1,2,2,"H"
"20785",2001-08-11,2001,"Montpellier HSC","FC Metz","3-0",3,0,"1",1,3,3,"H"
"20786",2001-08-11,2001,"CS Sedan","EA Guingamp","1-1",1,1,"1",1,2,0,"D"
"20787",2001-08-11,2001,"ESTAC Troyes","FC Nantes","0-0",0,0,"1",1,0,0,"D"
"20788",2001-08-12,2001,"FC Lorient","AJ Auxerre","0-1",0,1,"1",1,1,-1,"D"
"20789",2001-08-12,2001,"SC Bastia","Olympique Lyon","1-2",1,2,"1",1,3,-1,"D"
"20790",2001-08-18,2001,"AS Monaco","Paris Saint-Germain","2-2",2,2,"1",1,4,0,"D"
"20791",2001-08-18,2001,"Lille OSC","Montpellier HSC","2-1",2,1,"1",1,3,1,"H"
"20792",2001-08-18,2001,"FC Metz","RC Lens","0-1",0,1,"1",1,1,-1,"D"
"20793",2001-08-18,2001,"Olympique Lyon","EA Guingamp","3-0",3,0,"1",1,3,3,"H"
"20794",2001-08-18,2001,"FC Nantes","SC Bastia","1-2",1,2,"1",1,3,-1,"D"
"20795",2001-08-18,2001,"Olympique Marseille","ESTAC Troyes","0-1",0,1,"1",1,1,-1,"D"
"20796",2001-08-18,2001,"Stade Rennes","Girondins Bordeaux","1-0",1,0,"1",1,1,1,"H"
"20797",2001-08-18,2001,"FC Sochaux","FC Lorient","2-2",2,2,"1",1,4,0,"D"
"20798",2001-08-19,2001,"AJ Auxerre","CS Sedan","2-1",2,1,"1",1,3,1,"H"
"20799",2001-08-25,2001,"Girondins Bordeaux","AJ Auxerre","1-1",1,1,"1",1,2,0,"D"
"20800",2001-08-25,2001,"Paris Saint-Germain","Stade Rennes","3-0",3,0,"1",1,3,3,"H"
"20801",2001-08-25,2001,"SC Bastia","Olympique Marseille","1-0",1,0,"1",1,1,1,"H"
"20802",2001-08-25,2001,"Montpellier HSC","FC Sochaux","0-0",0,0,"1",1,0,0,"D"
"20803",2001-08-25,2001,"CS Sedan","FC Metz","2-0",2,0,"1",1,2,2,"H"
"20804",2001-08-25,2001,"ESTAC Troyes","Olympique Lyon","0-2",0,2,"1",1,2,-2,"D"
"20805",2001-08-25,2001,"FC Lorient","AS Monaco","2-0",2,0,"1",1,2,2,"H"
"20806",2001-08-25,2001,"EA Guingamp","FC Nantes","1-0",1,0,"1",1,1,1,"H"
"20807",2001-08-26,2001,"RC Lens","Lille OSC","1-1",1,1,"1",1,2,0,"D"
"20808",2001-09-08,2001,"Olympique Marseille","Olympique Lyon","0-0",0,0,"1",1,0,0,"D"
"20809",2001-09-08,2001,"Paris Saint-Germain","RC Lens","2-2",2,2,"1",1,4,0,"D"
"20810",2001-09-08,2001,"AS Monaco","ESTAC Troyes","2-0",2,0,"1",1,2,2,"H"
"20811",2001-09-08,2001,"AJ Auxerre","Montpellier HSC","1-0",1,0,"1",1,1,1,"H"
"20812",2001-09-08,2001,"FC Metz","SC Bastia","0-1",0,1,"1",1,1,-1,"D"
"20813",2001-09-08,2001,"FC Nantes","CS Sedan","1-1",1,1,"1",1,2,0,"D"
"20814",2001-09-08,2001,"Stade Rennes","FC Lorient","1-1",1,1,"1",1,2,0,"D"
"20815",2001-09-08,2001,"Lille OSC","EA Guingamp","1-0",1,0,"1",1,1,1,"H"
"20816",2001-09-09,2001,"FC Sochaux","Girondins Bordeaux","2-0",2,0,"1",1,2,2,"H"
"20817",2001-09-15,2001,"Olympique Lyon","FC Nantes","4-1",4,1,"1",1,5,3,"H"
"20818",2001-09-15,2001,"SC Bastia","AJ Auxerre","0-1",0,1,"1",1,1,-1,"D"
"20819",2001-09-15,2001,"RC Lens","FC Sochaux","3-0",3,0,"1",1,3,3,"H"
"20820",2001-09-15,2001,"Montpellier HSC","Stade Rennes","0-0",0,0,"1",1,0,0,"D"
"20821",2001-09-15,2001,"ESTAC Troyes","Lille OSC","0-1",0,1,"1",1,1,-1,"D"
"20822",2001-09-15,2001,"FC Lorient","Paris Saint-Germain","1-1",1,1,"1",1,2,0,"D"
"20823",2001-09-15,2001,"EA Guingamp","FC Metz","0-2",0,2,"1",1,2,-2,"D"
"20824",2001-09-16,2001,"Girondins Bordeaux","AS Monaco","0-0",0,0,"1",1,0,0,"D"
"20825",2001-09-16,2001,"CS Sedan","Olympique Marseille","1-1",1,1,"1",1,2,0,"D"
"20826",2001-09-21,2001,"Paris Saint-Germain","Montpellier HSC","0-0",0,0,"1",1,0,0,"D"
"20827",2001-09-22,2001,"AS Monaco","RC Lens","3-0",3,0,"1",1,3,3,"H"
"20828",2001-09-22,2001,"AJ Auxerre","EA Guingamp","2-2",2,2,"1",1,4,0,"D"
"20829",2001-09-22,2001,"FC Metz","Olympique Lyon","2-0",2,0,"1",1,2,2,"H"
"20830",2001-09-22,2001,"Olympique Marseille","FC Nantes","2-0",2,0,"1",1,2,2,"H"
"20831",2001-09-22,2001,"Stade Rennes","ESTAC Troyes","0-1",0,1,"1",1,1,-1,"D"
"20832",2001-09-22,2001,"Lille OSC","SC Bastia","2-1",2,1,"1",1,3,1,"H"
"20833",2001-09-23,2001,"FC Lorient","Girondins Bordeaux","0-2",0,2,"1",1,2,-2,"D"
"20834",2001-09-23,2001,"FC Sochaux","CS Sedan","3-0",3,0,"1",1,3,3,"H"
"20835",2001-09-29,2001,"EA Guingamp","Olympique Marseille","1-0",1,0,"1",1,1,1,"H"
"20836",2001-09-29,2001,"Olympique Lyon","Stade Rennes","4-0",4,0,"1",1,4,4,"H"
"20837",2001-09-29,2001,"SC Bastia","AS Monaco","1-0",1,0,"1",1,1,1,"H"
"20838",2001-09-29,2001,"FC Nantes","FC Metz","0-0",0,0,"1",1,0,0,"D"
"20839",2001-09-29,2001,"RC Lens","AJ Auxerre","1-1",1,1,"1",1,2,0,"D"
"20840",2001-09-29,2001,"Montpellier HSC","FC Lorient","1-3",1,3,"1",1,4,-2,"D"
"20841",2001-09-30,2001,"CS Sedan","Lille OSC","1-1",1,1,"1",1,2,0,"D"
"20842",2001-09-30,2001,"ESTAC Troyes","FC Sochaux","2-2",2,2,"1",1,4,0,"D"
"20843",2001-09-30,2001,"Girondins Bordeaux","Paris Saint-Germain","1-0",1,0,"1",1,1,1,"H"
"20844",2001-10-13,2001,"FC Metz","Olympique Marseille","0-2",0,2,"1",1,2,-2,"D"
"20845",2001-10-13,2001,"AS Monaco","CS Sedan","2-0",2,0,"1",1,2,2,"H"
"20846",2001-10-13,2001,"AJ Auxerre","ESTAC Troyes","1-3",1,3,"1",1,4,-2,"D"
"20847",2001-10-13,2001,"Stade Rennes","EA Guingamp","2-1",2,1,"1",1,3,1,"H"
"20848",2001-10-13,2001,"Montpellier HSC","Girondins Bordeaux","0-0",0,0,"1",1,0,0,"D"
"20849",2001-10-13,2001,"FC Lorient","RC Lens","2-3",2,3,"1",1,5,-1,"D"
"20850",2001-10-13,2001,"FC Sochaux","SC Bastia","4-1",4,1,"1",1,5,3,"H"
"20851",2001-10-13,2001,"Lille OSC","FC Nantes","1-0",1,0,"1",1,1,1,"H"
"20852",2001-10-14,2001,"Paris Saint-Germain","Olympique Lyon","2-2",2,2,"1",1,4,0,"D"
"20853",2001-10-20,2001,"Olympique Lyon","FC Sochaux","1-1",1,1,"1",1,2,0,"D"
"20854",2001-10-20,2001,"SC Bastia","Stade Rennes","1-2",1,2,"1",1,3,-1,"D"
"20855",2001-10-20,2001,"FC Nantes","AJ Auxerre","2-2",2,2,"1",1,4,0,"D"
"20856",2001-10-20,2001,"Olympique Marseille","Lille OSC","0-0",0,0,"1",1,0,0,"D"
"20857",2001-10-20,2001,"RC Lens","Montpellier HSC","2-0",2,0,"1",1,2,2,"H"
"20858",2001-10-20,2001,"EA Guingamp","AS Monaco","2-1",2,1,"1",1,3,1,"H"
"20859",2001-10-21,2001,"Girondins Bordeaux","FC Metz","1-0",1,0,"1",1,1,1,"H"
"20860",2001-10-21,2001,"ESTAC Troyes","FC Lorient","4-2",4,2,"1",1,6,2,"H"
"20861",2001-10-21,2001,"CS Sedan","Paris Saint-Germain","1-2",1,2,"1",1,3,-1,"D"
"20862",2001-10-26,2001,"AJ Auxerre","Olympique Marseille","2-0",2,0,"1",1,2,2,"H"
"20863",2001-10-27,2001,"Stade Rennes","RC Lens","1-2",1,2,"1",1,3,-1,"D"
"20864",2001-10-27,2001,"Paris Saint-Germain","SC Bastia","1-0",1,0,"1",1,1,1,"H"
"20865",2001-10-27,2001,"AS Monaco","Olympique Lyon","2-1",2,1,"1",1,3,1,"H"
"20866",2001-10-27,2001,"Girondins Bordeaux","CS Sedan","2-1",2,1,"1",1,3,1,"H"
"20867",2001-10-27,2001,"Montpellier HSC","ESTAC Troyes","2-0",2,0,"1",1,2,2,"H"
"20868",2001-10-27,2001,"FC Lorient","EA Guingamp","6-2",6,2,"1",1,8,4,"H"
"20869",2001-10-27,2001,"FC Sochaux","FC Nantes","0-1",0,1,"1",1,1,-1,"D"
"20870",2001-10-27,2001,"Lille OSC","FC Metz","2-0",2,0,"1",1,2,2,"H"
"20871",2001-11-03,2001,"FC Nantes","AS Monaco","2-1",2,1,"1",1,3,1,"H"
"20872",2001-11-03,2001,"SC Bastia","FC Lorient","3-1",3,1,"1",1,4,2,"H"
"20873",2001-11-03,2001,"Olympique Marseille","Stade Rennes","2-1",2,1,"1",1,3,1,"H"
"20874",2001-11-03,2001,"CS Sedan","Montpellier HSC","2-0",2,0,"1",1,2,2,"H"
"20875",2001-11-03,2001,"EA Guingamp","FC Sochaux","0-0",0,0,"1",1,0,0,"D"
"20876",2001-11-04,2001,"FC Metz","AJ Auxerre","2-0",2,0,"1",1,2,2,"H"
"20877",2001-11-04,2001,"ESTAC Troyes","Paris Saint-Germain","1-0",1,0,"1",1,1,1,"H"
"20878",2001-11-04,2001,"RC Lens","Girondins Bordeaux","0-0",0,0,"1",1,0,0,"D"
"20879",2001-11-04,2001,"Olympique Lyon","Lille OSC","4-2",4,2,"1",1,6,2,"H"
"20880",2001-11-16,2001,"AS Monaco","Olympique Marseille","1-1",1,1,"1",1,2,0,"D"
"20881",2001-11-17,2001,"Stade Rennes","FC Nantes","2-0",2,0,"1",1,2,2,"H"
"20882",2001-11-17,2001,"Paris Saint-Germain","EA Guingamp","1-1",1,1,"1",1,2,0,"D"
"20883",2001-11-17,2001,"AJ Auxerre","Lille OSC","2-1",2,1,"1",1,3,1,"H"
"20884",2001-11-17,2001,"Girondins Bordeaux","ESTAC Troyes","2-3",2,3,"1",1,5,-1,"D"
"20885",2001-11-17,2001,"RC Lens","CS Sedan","1-0",1,0,"1",1,1,1,"H"
"20886",2001-11-17,2001,"Montpellier HSC","SC Bastia","2-1",2,1,"1",1,3,1,"H"
"20887",2001-11-17,2001,"FC Lorient","Olympique Lyon","0-3",0,3,"1",1,3,-3,"D"
"20888",2001-11-17,2001,"FC Sochaux","FC Metz","2-0",2,0,"1",1,2,2,"H"
"20889",2001-11-24,2001,"Olympique Marseille","FC Sochaux","4-2",4,2,"1",1,6,2,"H"
"20890",2001-11-24,2001,"FC Metz","AS Monaco","1-0",1,0,"1",1,1,1,"H"
"20891",2001-11-24,2001,"SC Bastia","Girondins Bordeaux","1-2",1,2,"1",1,3,-1,"D"
"20892",2001-11-24,2001,"CS Sedan","FC Lorient","5-0",5,0,"1",1,5,5,"H"
"20893",2001-11-24,2001,"ESTAC Troyes","RC Lens","1-1",1,1,"1",1,2,0,"D"
"20894",2001-11-24,2001,"EA Guingamp","Montpellier HSC","2-2",2,2,"1",1,4,0,"D"
"20895",2001-11-25,2001,"Olympique Lyon","AJ Auxerre","3-0",3,0,"1",1,3,3,"H"
"20896",2001-11-25,2001,"Lille OSC","Stade Rennes","1-0",1,0,"1",1,1,1,"H"
"20897",2001-11-25,2001,"FC Nantes","Paris Saint-Germain","1-2",1,2,"1",1,3,-1,"D"
"20898",2001-11-28,2001,"Montpellier HSC","Olympique Lyon","3-0",3,0,"1",1,3,3,"H"
"20899",2001-11-28,2001,"AS Monaco","Lille OSC","2-2",2,2,"1",1,4,0,"D"
"20900",2001-11-28,2001,"Girondins Bordeaux","EA Guingamp","2-0",2,0,"1",1,2,2,"H"
"20901",2001-11-28,2001,"RC Lens","SC Bastia","7-0",7,0,"1",1,7,7,"H"
"20902",2001-11-28,2001,"Stade Rennes","FC Metz","0-0",0,0,"1",1,0,0,"D"
"20903",2001-11-28,2001,"ESTAC Troyes","CS Sedan","1-1",1,1,"1",1,2,0,"D"
"20904",2001-11-28,2001,"FC Lorient","FC Nantes","1-2",1,2,"1",1,3,-1,"D"
"20905",2001-11-28,2001,"FC Sochaux","AJ Auxerre","1-2",1,2,"1",1,3,-1,"D"
"20906",2001-11-29,2001,"Paris Saint-Germain","Olympique Marseille","0-0",0,0,"1",1,0,0,"D"
"20907",2001-12-08,2001,"AJ Auxerre","AS Monaco","2-0",2,0,"1",1,2,2,"H"
"20908",2001-12-08,2001,"SC Bastia","ESTAC Troyes","2-0",2,0,"1",1,2,2,"H"
"20909",2001-12-08,2001,"FC Nantes","Montpellier HSC","1-2",1,2,"1",1,3,-1,"D"
"20910",2001-12-08,2001,"Olympique Marseille","FC Lorient","3-2",3,2,"1",1,5,1,"H"
"20911",2001-12-08,2001,"CS Sedan","Stade Rennes","0-0",0,0,"1",1,0,0,"D"
"20912",2001-12-08,2001,"EA Guingamp","RC Lens","1-0",1,0,"1",1,1,1,"H"
"20913",2001-12-09,2001,"FC Metz","Paris Saint-Germain","0-2",0,2,"1",1,2,-2,"D"
"20914",2001-12-09,2001,"Lille OSC","FC Sochaux","1-2",1,2,"1",1,3,-1,"D"
"20915",2001-12-09,2001,"Olympique Lyon","Girondins Bordeaux","1-0",1,0,"1",1,1,1,"H"
"20916",2001-12-18,2001,"RC Lens","FC Nantes","3-0",3,0,"1",1,3,3,"H"
"20917",2001-12-18,2001,"Girondins Bordeaux","Olympique Marseille","0-0",0,0,"1",1,0,0,"D"
"20918",2001-12-19,2001,"Paris Saint-Germain","AJ Auxerre","0-0",0,0,"1",1,0,0,"D"
"20919",2001-12-19,2001,"SC Bastia","EA Guingamp","3-0",3,0,"1",1,3,3,"H"
"20920",2001-12-19,2001,"Stade Rennes","FC Sochaux","1-1",1,1,"1",1,2,0,"D"
"20921",2001-12-19,2001,"CS Sedan","Olympique Lyon","2-1",2,1,"1",1,3,1,"H"
"20922",2001-12-19,2001,"FC Lorient","Lille OSC","2-4",2,4,"1",1,6,-2,"D"
"20923",2001-12-21,2001,"Olympique Marseille","RC Lens","1-2",1,2,"1",1,3,-1,"D"
"20924",2001-12-22,2001,"FC Sochaux","Paris Saint-Germain","0-2",0,2,"1",1,2,-2,"D"
"20925",2001-12-22,2001,"AS Monaco","Stade Rennes","3-1",3,1,"1",1,4,2,"H"
"20926",2001-12-22,2001,"FC Nantes","ESTAC Troyes","1-0",1,0,"1",1,1,1,"H"
"20927",2001-12-22,2001,"EA Guingamp","CS Sedan","1-2",1,2,"1",1,3,-1,"D"
"20928",2002-01-05,2001,"Paris Saint-Germain","AS Monaco","1-2",1,2,"1",1,3,-1,"D"
"20929",2002-01-05,2001,"Girondins Bordeaux","Stade Rennes","2-1",2,1,"1",1,3,1,"H"
"20930",2002-01-05,2001,"SC Bastia","FC Nantes","0-2",0,2,"1",1,2,-2,"D"
"20931",2002-01-05,2001,"Montpellier HSC","Lille OSC","2-0",2,0,"1",1,2,2,"H"
"20932",2002-01-05,2001,"FC Lorient","FC Sochaux","1-1",1,1,"1",1,2,0,"D"
"20933",2002-01-05,2001,"EA Guingamp","Olympique Lyon","2-4",2,4,"1",1,6,-2,"D"
"20934",2002-01-11,2001,"Lille OSC","RC Lens","0-1",0,1,"1",1,1,-1,"D"
"20935",2002-01-12,2001,"Stade Rennes","Paris Saint-Germain","1-2",1,2,"1",1,3,-1,"D"
"20936",2002-01-12,2001,"AS Monaco","FC Lorient","1-0",1,0,"1",1,1,1,"H"
"20937",2002-01-12,2001,"FC Nantes","EA Guingamp","2-0",2,0,"1",1,2,2,"H"
"20938",2002-01-12,2001,"Olympique Marseille","SC Bastia","2-2",2,2,"1",1,4,0,"D"
"20939",2002-01-12,2001,"FC Sochaux","Montpellier HSC","0-1",0,1,"1",1,1,-1,"D"
"20940",2002-01-16,2001,"Montpellier HSC","AS Monaco","1-1",1,1,"1",1,2,0,"D"
"20941",2002-01-16,2001,"ESTAC Troyes","FC Metz","2-0",2,0,"1",1,2,2,"H"
"20942",2002-01-16,2001,"AJ Auxerre","FC Lorient","2-2",2,2,"1",1,4,0,"D"
"20943",2002-01-16,2001,"Olympique Lyon","SC Bastia","0-0",0,0,"1",1,0,0,"D"
"20944",2002-01-16,2001,"Lille OSC","Girondins Bordeaux","2-2",2,2,"1",1,4,0,"D"
"20945",2002-01-23,2001,"Girondins Bordeaux","FC Sochaux","0-1",0,1,"1",1,1,-1,"D"
"20946",2002-01-23,2001,"Olympique Lyon","Olympique Marseille","4-0",4,0,"1",1,4,4,"H"
"20947",2002-01-23,2001,"SC Bastia","FC Metz","1-2",1,2,"1",1,3,-1,"D"
"20948",2002-01-23,2001,"Montpellier HSC","AJ Auxerre","0-0",0,0,"1",1,0,0,"D"
"20949",2002-01-23,2001,"CS Sedan","FC Nantes","0-0",0,0,"1",1,0,0,"D"
"20950",2002-01-23,2001,"ESTAC Troyes","AS Monaco","3-0",3,0,"1",1,3,3,"H"
"20951",2002-01-23,2001,"FC Lorient","Stade Rennes","2-0",2,0,"1",1,2,2,"H"
"20952",2002-01-23,2001,"EA Guingamp","Lille OSC","0-0",0,0,"1",1,0,0,"D"
"20953",2002-01-24,2001,"RC Lens","Paris Saint-Germain","1-1",1,1,"1",1,2,0,"D"
"20954",2002-01-26,2001,"ESTAC Troyes","Olympique Marseille","1-0",1,0,"1",1,1,1,"H"
"20955",2002-01-29,2001,"FC Nantes","Olympique Lyon","3-0",3,0,"1",1,3,3,"H"
"20956",2002-01-30,2001,"AS Monaco","Girondins Bordeaux","3-1",3,1,"1",1,4,2,"H"
"20957",2002-01-30,2001,"Paris Saint-Germain","FC Lorient","5-0",5,0,"1",1,5,5,"H"
"20958",2002-01-30,2001,"AJ Auxerre","SC Bastia","1-0",1,0,"1",1,1,1,"H"
"20959",2002-01-30,2001,"FC Metz","EA Guingamp","2-4",2,4,"1",1,6,-2,"D"
"20960",2002-01-30,2001,"Olympique Marseille","CS Sedan","2-1",2,1,"1",1,3,1,"H"
"20961",2002-01-30,2001,"Stade Rennes","Montpellier HSC","2-0",2,0,"1",1,2,2,"H"
"20962",2002-01-30,2001,"FC Sochaux","RC Lens","0-2",0,2,"1",1,2,-2,"D"
"20963",2002-02-02,2001,"Montpellier HSC","Paris Saint-Germain","0-0",0,0,"1",1,0,0,"D"
"20964",2002-02-02,2001,"Girondins Bordeaux","FC Lorient","2-1",2,1,"1",1,3,1,"H"
"20965",2002-02-02,2001,"Olympique Lyon","FC Metz","4-1",4,1,"1",1,5,3,"H"
"20966",2002-02-02,2001,"SC Bastia","Lille OSC","1-0",1,0,"1",1,1,1,"H"
"20967",2002-02-02,2001,"RC Lens","AS Monaco","1-0",1,0,"1",1,1,1,"H"
"20968",2002-02-02,2001,"CS Sedan","FC Sochaux","2-1",2,1,"1",1,3,1,"H"
"20969",2002-02-02,2001,"ESTAC Troyes","Stade Rennes","1-1",1,1,"1",1,2,0,"D"
"20970",2002-02-02,2001,"EA Guingamp","AJ Auxerre","0-0",0,0,"1",1,0,0,"D"
"20971",2002-02-03,2001,"FC Nantes","Olympique Marseille","3-1",3,1,"1",1,4,2,"H"
"20972",2002-02-06,2001,"Stade Rennes","Olympique Lyon","2-2",2,2,"1",1,4,0,"D"
"20973",2002-02-06,2001,"AS Monaco","SC Bastia","1-1",1,1,"1",1,2,0,"D"
"20974",2002-02-06,2001,"AJ Auxerre","RC Lens","1-0",1,0,"1",1,1,1,"H"
"20975",2002-02-06,2001,"FC Metz","FC Nantes","2-0",2,0,"1",1,2,2,"H"
"20976",2002-02-06,2001,"Olympique Marseille","EA Guingamp","2-1",2,1,"1",1,3,1,"H"
"20977",2002-02-06,2001,"FC Lorient","Montpellier HSC","1-0",1,0,"1",1,1,1,"H"
"20978",2002-02-06,2001,"FC Sochaux","ESTAC Troyes","2-2",2,2,"1",1,4,0,"D"
"20979",2002-02-06,2001,"Lille OSC","CS Sedan","1-1",1,1,"1",1,2,0,"D"
"20980",2002-02-07,2001,"Paris Saint-Germain","Girondins Bordeaux","1-0",1,0,"1",1,1,1,"H"
"20981",2002-02-09,2001,"FC Metz","Montpellier HSC","0-0",0,0,"1",1,0,0,"D"
"20982",2002-02-09,2001,"Olympique Lyon","ESTAC Troyes","3-1",3,1,"1",1,4,2,"H"
"20983",2002-02-16,2001,"FC Nantes","Lille OSC","0-1",0,1,"1",1,1,-1,"D"
"20984",2002-02-16,2001,"Girondins Bordeaux","Montpellier HSC","3-1",3,1,"1",1,4,2,"H"
"20985",2002-02-16,2001,"SC Bastia","FC Sochaux","3-0",3,0,"1",1,3,3,"H"
"20986",2002-02-16,2001,"RC Lens","FC Lorient","1-1",1,1,"1",1,2,0,"D"
"20987",2002-02-16,2001,"CS Sedan","AS Monaco","0-0",0,0,"1",1,0,0,"D"
"20988",2002-02-16,2001,"ESTAC Troyes","AJ Auxerre","1-2",1,2,"1",1,3,-1,"D"
"20989",2002-02-16,2001,"EA Guingamp","Stade Rennes","1-1",1,1,"1",1,2,0,"D"
"20990",2002-02-17,2001,"Olympique Marseille","FC Metz","1-0",1,0,"1",1,1,1,"H"
"20991",2002-02-17,2001,"Olympique Lyon","Paris Saint-Germain","3-0",3,0,"1",1,3,3,"H"
"20992",2002-02-23,2001,"Montpellier HSC","RC Lens","1-2",1,2,"1",1,3,-1,"D"
"20993",2002-02-23,2001,"Paris Saint-Germain","CS Sedan","3-0",3,0,"1",1,3,3,"H"
"20994",2002-02-23,2001,"AS Monaco","EA Guingamp","3-1",3,1,"1",1,4,2,"H"
"20995",2002-02-23,2001,"AJ Auxerre","FC Nantes","2-1",2,1,"1",1,3,1,"H"
"20996",2002-02-23,2001,"FC Metz","Girondins Bordeaux","1-2",1,2,"1",1,3,-1,"D"
"20997",2002-02-23,2001,"Stade Rennes","SC Bastia","2-1",2,1,"1",1,3,1,"H"
"20998",2002-02-23,2001,"FC Lorient","ESTAC Troyes","1-0",1,0,"1",1,1,1,"H"
"20999",2002-02-24,2001,"FC Sochaux","Olympique Lyon","2-1",2,1,"1",1,3,1,"H"
"21000",2002-02-24,2001,"Lille OSC","Olympique Marseille","2-0",2,0,"1",1,2,2,"H"
"21001",2002-03-02,2001,"RC Lens","FC Metz","2-2",2,2,"1",1,4,0,"D"
"21002",2002-03-03,2001,"Lille OSC","ESTAC Troyes","1-0",1,0,"1",1,1,1,"H"
"21003",2002-03-06,2001,"SC Bastia","Paris Saint-Germain","0-1",0,1,"1",1,1,-1,"D"
"21004",2002-03-06,2001,"FC Metz","Lille OSC","0-1",0,1,"1",1,1,-1,"D"
"21005",2002-03-06,2001,"Olympique Lyon","AS Monaco","1-0",1,0,"1",1,1,1,"H"
"21006",2002-03-06,2001,"FC Nantes","FC Sochaux","0-0",0,0,"1",1,0,0,"D"
"21007",2002-03-06,2001,"RC Lens","Stade Rennes","2-0",2,0,"1",1,2,2,"H"
"21008",2002-03-06,2001,"CS Sedan","Girondins Bordeaux","1-0",1,0,"1",1,1,1,"H"
"21009",2002-03-06,2001,"ESTAC Troyes","Montpellier HSC","2-0",2,0,"1",1,2,2,"H"
"21010",2002-03-06,2001,"EA Guingamp","FC Lorient","4-3",4,3,"1",1,7,1,"H"
"21011",2002-03-10,2001,"AJ Auxerre","Girondins Bordeaux","0-1",0,1,"1",1,1,-1,"D"
"21012",2002-03-16,2001,"Stade Rennes","Olympique Marseille","2-1",2,1,"1",1,3,1,"H"
"21013",2002-03-16,2001,"Paris Saint-Germain","ESTAC Troyes","3-1",3,1,"1",1,4,2,"H"
"21014",2002-03-16,2001,"AS Monaco","FC Nantes","1-2",1,2,"1",1,3,-1,"D"
"21015",2002-03-16,2001,"AJ Auxerre","FC Metz","3-2",3,2,"1",1,5,1,"H"
"21016",2002-03-16,2001,"Montpellier HSC","CS Sedan","0-0",0,0,"1",1,0,0,"D"
"21017",2002-03-16,2001,"FC Lorient","SC Bastia","0-0",0,0,"1",1,0,0,"D"
"21018",2002-03-16,2001,"FC Sochaux","EA Guingamp","1-0",1,0,"1",1,1,1,"H"
"21019",2002-03-16,2001,"Lille OSC","Olympique Lyon","2-0",2,0,"1",1,2,2,"H"
"21020",2002-03-17,2001,"Girondins Bordeaux","RC Lens","2-1",2,1,"1",1,3,1,"H"
"21021",2002-03-23,2001,"EA Guingamp","Paris Saint-Germain","0-1",0,1,"1",1,1,-1,"D"
"21022",2002-03-23,2001,"FC Metz","FC Sochaux","2-0",2,0,"1",1,2,2,"H"
"21023",2002-03-23,2001,"Olympique Lyon","FC Lorient","2-0",2,0,"1",1,2,2,"H"
"21024",2002-03-23,2001,"SC Bastia","Montpellier HSC","3-0",3,0,"1",1,3,3,"H"
"21025",2002-03-23,2001,"FC Nantes","Stade Rennes","3-1",3,1,"1",1,4,2,"H"
"21026",2002-03-23,2001,"CS Sedan","RC Lens","1-1",1,1,"1",1,2,0,"D"
"21027",2002-03-23,2001,"ESTAC Troyes","Girondins Bordeaux","2-0",2,0,"1",1,2,2,"H"
"21028",2002-03-23,2001,"Lille OSC","AJ Auxerre","2-3",2,3,"1",1,5,-1,"D"
"21029",2002-03-24,2001,"Olympique Marseille","AS Monaco","1-1",1,1,"1",1,2,0,"D"
"21030",2002-04-01,2001,"Olympique Marseille","AJ Auxerre","3-0",3,0,"1",1,3,3,"H"
"21031",2002-04-06,2001,"RC Lens","ESTAC Troyes","0-0",0,0,"1",1,0,0,"D"
"21032",2002-04-06,2001,"Paris Saint-Germain","FC Nantes","1-1",1,1,"1",1,2,0,"D"
"21033",2002-04-06,2001,"AS Monaco","FC Metz","2-2",2,2,"1",1,4,0,"D"
"21034",2002-04-06,2001,"Girondins Bordeaux","SC Bastia","2-1",2,1,"1",1,3,1,"H"
"21035",2002-04-06,2001,"Stade Rennes","Lille OSC","4-0",4,0,"1",1,4,4,"H"
"21036",2002-04-06,2001,"Montpellier HSC","EA Guingamp","2-1",2,1,"1",1,3,1,"H"
"21037",2002-04-06,2001,"FC Lorient","CS Sedan","1-1",1,1,"1",1,2,0,"D"
"21038",2002-04-06,2001,"FC Sochaux","Olympique Marseille","3-0",3,0,"1",1,3,3,"H"
"21039",2002-04-07,2001,"AJ Auxerre","Olympique Lyon","0-1",0,1,"1",1,1,-1,"D"
"21040",2002-04-09,2001,"FC Metz","CS Sedan","2-3",2,3,"1",1,5,-1,"D"
"21041",2002-04-12,2001,"Olympique Marseille","Paris Saint-Germain","1-0",1,0,"1",1,1,1,"H"
"21042",2002-04-13,2001,"AJ Auxerre","FC Sochaux","2-0",2,0,"1",1,2,2,"H"
"21043",2002-04-13,2001,"FC Metz","Stade Rennes","3-1",3,1,"1",1,4,2,"H"
"21044",2002-04-13,2001,"Olympique Lyon","Montpellier HSC","0-0",0,0,"1",1,0,0,"D"
"21045",2002-04-13,2001,"SC Bastia","RC Lens","3-1",3,1,"1",1,4,2,"H"
"21046",2002-04-13,2001,"FC Nantes","FC Lorient","2-0",2,0,"1",1,2,2,"H"
"21047",2002-04-13,2001,"CS Sedan","ESTAC Troyes","0-0",0,0,"1",1,0,0,"D"
"21048",2002-04-13,2001,"EA Guingamp","Girondins Bordeaux","2-1",2,1,"1",1,3,1,"H"
"21049",2002-04-13,2001,"Lille OSC","AS Monaco","1-1",1,1,"1",1,2,0,"D"
"21050",2002-04-21,2001,"CS Sedan","AJ Auxerre","3-3",3,3,"1",1,6,0,"D"
"21051",2002-04-27,2001,"Paris Saint-Germain","FC Metz","2-0",2,0,"1",1,2,2,"H"
"21052",2002-04-27,2001,"AS Monaco","AJ Auxerre","1-1",1,1,"1",1,2,0,"D"
"21053",2002-04-27,2001,"Girondins Bordeaux","Olympique Lyon","0-1",0,1,"1",1,1,-1,"D"
"21054",2002-04-27,2001,"RC Lens","EA Guingamp","4-1",4,1,"1",1,5,3,"H"
"21055",2002-04-27,2001,"Stade Rennes","CS Sedan","1-0",1,0,"1",1,1,1,"H"
"21056",2002-04-27,2001,"Montpellier HSC","FC Nantes","3-0",3,0,"1",1,3,3,"H"
"21057",2002-04-27,2001,"ESTAC Troyes","SC Bastia","3-0",3,0,"1",1,3,3,"H"
"21058",2002-04-27,2001,"FC Lorient","Olympique Marseille","2-2",2,2,"1",1,4,0,"D"
"21059",2002-04-27,2001,"FC Sochaux","Lille OSC","0-0",0,0,"1",1,0,0,"D"
"21060",2002-05-04,2001,"AJ Auxerre","Stade Rennes","2-3",2,3,"1",1,5,-1,"D"
"21061",2002-05-04,2001,"FC Metz","FC Lorient","1-1",1,1,"1",1,2,0,"D"
"21062",2002-05-04,2001,"Olympique Lyon","RC Lens","3-1",3,1,"1",1,4,2,"H"
"21063",2002-05-04,2001,"FC Nantes","Girondins Bordeaux","2-1",2,1,"1",1,3,1,"H"
"21064",2002-05-04,2001,"Olympique Marseille","Montpellier HSC","1-0",1,0,"1",1,1,1,"H"
"21065",2002-05-04,2001,"CS Sedan","SC Bastia","0-2",0,2,"1",1,2,-2,"D"
"21066",2002-05-04,2001,"FC Sochaux","AS Monaco","3-0",3,0,"1",1,3,3,"H"
"21067",2002-05-04,2001,"EA Guingamp","ESTAC Troyes","1-0",1,0,"1",1,1,1,"H"
"21068",2002-05-04,2001,"Lille OSC","Paris Saint-Germain","1-0",1,0,"1",1,1,1,"H"
"21069",2002-08-02,2002,"EA Guingamp","Olympique Lyon","3-3",3,3,"1",1,6,0,"D"
"21070",2002-08-03,2002,"Olympique Marseille","FC Nantes","0-2",0,2,"1",1,2,-2,"D"
"21071",2002-08-03,2002,"ESTAC Troyes","AS Monaco","0-4",0,4,"1",1,4,-4,"D"
"21072",2002-08-03,2002,"Paris Saint-Germain","AJ Auxerre","1-0",1,0,"1",1,1,1,"H"
"21073",2002-08-03,2002,"CS Sedan","FC Sochaux","0-0",0,0,"1",1,0,0,"D"
"21074",2002-08-03,2002,"RC Strasbourg","AC Ajaccio","1-1",1,1,"1",1,2,0,"D"
"21075",2002-08-03,2002,"Montpellier HSC","Stade Rennes","1-0",1,0,"1",1,1,1,"H"
"21076",2002-08-03,2002,"OGC Nice","Le Havre AC","1-2",1,2,"1",1,3,-1,"D"
"21077",2002-08-03,2002,"SC Bastia","RC Lens","1-1",1,1,"1",1,2,0,"D"
"21078",2002-08-03,2002,"Lille OSC","Girondins Bordeaux","0-3",0,3,"1",1,3,-3,"D"
"21079",2002-08-08,2002,"AJ Auxerre","Montpellier HSC","2-0",2,0,"1",1,2,2,"H"
"21080",2002-08-09,2002,"Girondins Bordeaux","Paris Saint-Germain","0-0",0,0,"1",1,0,0,"D"
"21081",2002-08-10,2002,"RC Lens","FC Sochaux","1-1",1,1,"1",1,2,0,"D"
"21082",2002-08-10,2002,"AS Monaco","Olympique Marseille","0-1",0,1,"1",1,1,-1,"D"
"21083",2002-08-10,2002,"OGC Nice","RC Strasbourg","4-0",4,0,"1",1,4,4,"H"
"21084",2002-08-10,2002,"Olympique Lyon","CS Sedan","6-1",6,1,"1",1,7,5,"H"
"21085",2002-08-10,2002,"FC Nantes","SC Bastia","1-0",1,0,"1",1,1,1,"H"
"21086",2002-08-10,2002,"AC Ajaccio","EA Guingamp","0-2",0,2,"1",1,2,-2,"D"
"21087",2002-08-10,2002,"Stade Rennes","ESTAC Troyes","0-0",0,0,"1",1,0,0,"D"
"21088",2002-08-10,2002,"Le Havre AC","Lille OSC","0-0",0,0,"1",1,0,0,"D"
"21089",2002-08-16,2002,"Olympique Marseille","Olympique Lyon","1-1",1,1,"1",1,2,0,"D"
"21090",2002-08-17,2002,"Montpellier HSC","Girondins Bordeaux","0-1",0,1,"1",1,1,-1,"D"
"21091",2002-08-17,2002,"SC Bastia","AS Monaco","1-0",1,0,"1",1,1,1,"H"
"21092",2002-08-17,2002,"CS Sedan","RC Lens","0-1",0,1,"1",1,1,-1,"D"
"21093",2002-08-17,2002,"Paris Saint-Germain","AC Ajaccio","2-2",2,2,"1",1,4,0,"D"
"21094",2002-08-17,2002,"RC Strasbourg","Le Havre AC","1-1",1,1,"1",1,2,0,"D"
"21095",2002-08-17,2002,"EA Guingamp","Stade Rennes","3-0",3,0,"1",1,3,3,"H"
"21096",2002-08-17,2002,"Lille OSC","OGC Nice","0-3",0,3,"1",1,3,-3,"D"
"21097",2002-08-17,2002,"ESTAC Troyes","AJ Auxerre","1-2",1,2,"1",1,3,-1,"D"
"21098",2002-08-17,2002,"FC Sochaux","FC Nantes","4-2",4,2,"1",1,6,2,"H"
"21099",2002-08-23,2002,"Lille OSC","ESTAC Troyes","0-0",0,0,"1",1,0,0,"D"
"21100",2002-08-24,2002,"FC Nantes","RC Lens","2-2",2,2,"1",1,4,0,"D"
"21101",2002-08-24,2002,"Girondins Bordeaux","RC Strasbourg","1-2",1,2,"1",1,3,-1,"D"
"21102",2002-08-24,2002,"Stade Rennes","Olympique Marseille","1-3",1,3,"1",1,4,-2,"D"
"21103",2002-08-24,2002,"AS Monaco","FC Sochaux","1-0",1,0,"1",1,1,1,"H"
"21104",2002-08-24,2002,"AJ Auxerre","EA Guingamp","2-1",2,1,"1",1,3,1,"H"
"21105",2002-08-24,2002,"Olympique Lyon","SC Bastia","4-1",4,1,"1",1,5,3,"H"
"21106",2002-08-24,2002,"AC Ajaccio","CS Sedan","1-0",1,0,"1",1,1,1,"H"
"21107",2002-08-24,2002,"OGC Nice","Montpellier HSC","2-1",2,1,"1",1,3,1,"H"
"21108",2002-08-25,2002,"Le Havre AC","Paris Saint-Germain","0-1",0,1,"1",1,1,-1,"D"
"21109",2002-08-31,2002,"RC Lens","AS Monaco","1-0",1,0,"1",1,1,1,"H"
"21110",2002-08-31,2002,"SC Bastia","Stade Rennes","3-1",3,1,"1",1,4,2,"H"
"21111",2002-08-31,2002,"Montpellier HSC","Le Havre AC","0-0",0,0,"1",1,0,0,"D"
"21112",2002-08-31,2002,"Paris Saint-Germain","OGC Nice","1-1",1,1,"1",1,2,0,"D"
"21113",2002-08-31,2002,"RC Strasbourg","Lille OSC","2-2",2,2,"1",1,4,0,"D"
"21114",2002-08-31,2002,"FC Sochaux","Olympique Lyon","2-1",2,1,"1",1,3,1,"H"
"21115",2002-08-31,2002,"EA Guingamp","Girondins Bordeaux","0-0",0,0,"1",1,0,0,"D"
"21116",2002-08-31,2002,"CS Sedan","FC Nantes","1-0",1,0,"1",1,1,1,"H"
"21117",2002-08-31,2002,"ESTAC Troyes","AC Ajaccio","1-0",1,0,"1",1,1,1,"H"
"21118",2002-09-01,2002,"Olympique Marseille","AJ Auxerre","0-0",0,0,"1",1,0,0,"D"
"21119",2002-09-10,2002,"Olympique Lyon","RC Lens","1-0",1,0,"1",1,1,1,"H"
"21120",2002-09-11,2002,"OGC Nice","Olympique Marseille","2-0",2,0,"1",1,2,2,"H"
"21121",2002-09-11,2002,"Girondins Bordeaux","ESTAC Troyes","1-0",1,0,"1",1,1,1,"H"
"21122",2002-09-11,2002,"Stade Rennes","FC Sochaux","2-2",2,2,"1",1,4,0,"D"
"21123",2002-09-11,2002,"AS Monaco","FC Nantes","2-1",2,1,"1",1,3,1,"H"
"21124",2002-09-11,2002,"AJ Auxerre","SC Bastia","1-0",1,0,"1",1,1,1,"H"
"21125",2002-09-11,2002,"Lille OSC","Paris Saint-Germain","2-1",2,1,"1",1,3,1,"H"
"21126",2002-09-11,2002,"RC Strasbourg","CS Sedan","1-1",1,1,"1",1,2,0,"D"
"21127",2002-09-11,2002,"AC Ajaccio","Montpellier HSC","0-0",0,0,"1",1,0,0,"D"
"21128",2002-09-11,2002,"Le Havre AC","EA Guingamp","1-2",1,2,"1",1,3,-1,"D"
"21129",2002-09-14,2002,"Olympique Marseille","Girondins Bordeaux","2-1",2,1,"1",1,3,1,"H"
"21130",2002-09-14,2002,"FC Nantes","Olympique Lyon","1-0",1,0,"1",1,1,1,"H"
"21131",2002-09-14,2002,"Montpellier HSC","Lille OSC","1-0",1,0,"1",1,1,1,"H"
"21132",2002-09-14,2002,"Paris Saint-Germain","RC Strasbourg","3-0",3,0,"1",1,3,3,"H"
"21133",2002-09-14,2002,"FC Sochaux","AJ Auxerre","1-1",1,1,"1",1,2,0,"D"
"21134",2002-09-14,2002,"RC Lens","Stade Rennes","1-0",1,0,"1",1,1,1,"H"
"21135",2002-09-14,2002,"EA Guingamp","OGC Nice","0-0",0,0,"1",1,0,0,"D"
"21136",2002-09-14,2002,"CS Sedan","AS Monaco","2-2",2,2,"1",1,4,0,"D"
"21137",2002-09-14,2002,"ESTAC Troyes","Le Havre AC","1-1",1,1,"1",1,2,0,"D"
"21138",2002-09-15,2002,"SC Bastia","AC Ajaccio","1-2",1,2,"1",1,3,-1,"D"
"21139",2002-09-21,2002,"Olympique Lyon","AS Monaco","1-3",1,3,"1",1,4,-2,"D"
"21140",2002-09-21,2002,"Girondins Bordeaux","RC Lens","1-0",1,0,"1",1,1,1,"H"
"21141",2002-09-21,2002,"Stade Rennes","FC Nantes","1-0",1,0,"1",1,1,1,"H"
"21142",2002-09-21,2002,"Lille OSC","EA Guingamp","2-1",2,1,"1",1,3,1,"H"
"21143",2002-09-21,2002,"RC Strasbourg","Montpellier HSC","3-2",3,2,"1",1,5,1,"H"
"21144",2002-09-21,2002,"AC Ajaccio","FC Sochaux","0-1",0,1,"1",1,1,-1,"D"
"21145",2002-09-21,2002,"Le Havre AC","Olympique Marseille","1-3",1,3,"1",1,4,-2,"D"
"21146",2002-09-21,2002,"OGC Nice","ESTAC Troyes","1-0",1,0,"1",1,1,1,"H"
"21147",2002-09-22,2002,"Paris Saint-Germain","SC Bastia","1-1",1,1,"1",1,2,0,"D"
"21148",2002-09-27,2002,"Olympique Marseille","AC Ajaccio","3-1",3,1,"1",1,4,2,"H"
"21149",2002-09-28,2002,"FC Nantes","AJ Auxerre","1-4",1,4,"1",1,5,-3,"D"
"21150",2002-09-28,2002,"Montpellier HSC","Paris Saint-Germain","1-1",1,1,"1",1,2,0,"D"
"21151",2002-09-28,2002,"AS Monaco","Stade Rennes","2-1",2,1,"1",1,3,1,"H"
"21152",2002-09-28,2002,"SC Bastia","Girondins Bordeaux","2-1",2,1,"1",1,3,1,"H"
"21153",2002-09-28,2002,"FC Sochaux","OGC Nice","1-0",1,0,"1",1,1,1,"H"
"21154",2002-09-28,2002,"RC Lens","Lille OSC","0-0",0,0,"1",1,0,0,"D"
"21155",2002-09-28,2002,"EA Guingamp","RC Strasbourg","2-3",2,3,"1",1,5,-1,"D"
"21156",2002-09-28,2002,"CS Sedan","Le Havre AC","4-0",4,0,"1",1,4,4,"H"
"21157",2002-09-28,2002,"ESTAC Troyes","Olympique Lyon","1-1",1,1,"1",1,2,0,"D"
"21158",2002-10-05,2002,"Le Havre AC","FC Sochaux","1-0",1,0,"1",1,1,1,"H"
"21159",2002-10-05,2002,"Lille OSC","Olympique Marseille","3-0",3,0,"1",1,3,3,"H"
"21160",2002-10-05,2002,"RC Strasbourg","ESTAC Troyes","2-1",2,1,"1",1,3,1,"H"
"21161",2002-10-05,2002,"Stade Rennes","Olympique Lyon","0-1",0,1,"1",1,1,-1,"D"
"21162",2002-10-05,2002,"AC Ajaccio","FC Nantes","1-0",1,0,"1",1,1,1,"H"
"21163",2002-10-05,2002,"Montpellier HSC","RC Lens","0-2",0,2,"1",1,2,-2,"D"
"21164",2002-10-05,2002,"OGC Nice","SC Bastia","2-0",2,0,"1",1,2,2,"H"
"21165",2002-10-06,2002,"Girondins Bordeaux","CS Sedan","2-2",2,2,"1",1,4,0,"D"
"21166",2002-10-06,2002,"AJ Auxerre","AS Monaco","1-1",1,1,"1",1,2,0,"D"
"21167",2002-10-06,2002,"Paris Saint-Germain","EA Guingamp","5-0",5,0,"1",1,5,5,"H"
"21168",2002-10-19,2002,"Olympique Lyon","AJ Auxerre","3-0",3,0,"1",1,3,3,"H"
"21169",2002-10-19,2002,"SC Bastia","Le Havre AC","3-1",3,1,"1",1,4,2,"H"
"21170",2002-10-19,2002,"RC Lens","AC Ajaccio","1-1",1,1,"1",1,2,0,"D"
"21171",2002-10-19,2002,"AS Monaco","Lille OSC","1-1",1,1,"1",1,2,0,"D"
"21172",2002-10-19,2002,"FC Sochaux","Girondins Bordeaux","2-0",2,0,"1",1,2,2,"H"
"21173",2002-10-19,2002,"FC Nantes","OGC Nice","0-0",0,0,"1",1,0,0,"D"
"21174",2002-10-19,2002,"EA Guingamp","Montpellier HSC","3-1",3,1,"1",1,4,2,"H"
"21175",2002-10-19,2002,"CS Sedan","Stade Rennes","1-3",1,3,"1",1,4,-2,"D"
"21176",2002-10-19,2002,"ESTAC Troyes","Paris Saint-Germain","1-2",1,2,"1",1,3,-1,"D"
"21177",2002-10-20,2002,"Olympique Marseille","RC Strasbourg","1-0",1,0,"1",1,1,1,"H"
"21178",2002-10-25,2002,"Girondins Bordeaux","AS Monaco","2-2",2,2,"1",1,4,0,"D"
"21179",2002-10-26,2002,"Paris Saint-Germain","Olympique Marseille","3-0",3,0,"1",1,3,3,"H"
"21180",2002-10-26,2002,"Montpellier HSC","ESTAC Troyes","2-2",2,2,"1",1,4,0,"D"
"21181",2002-10-26,2002,"AJ Auxerre","Stade Rennes","1-0",1,0,"1",1,1,1,"H"
"21182",2002-10-26,2002,"Lille OSC","FC Sochaux","1-0",1,0,"1",1,1,1,"H"
"21183",2002-10-26,2002,"RC Strasbourg","SC Bastia","2-0",2,0,"1",1,2,2,"H"
"21184",2002-10-26,2002,"Le Havre AC","FC Nantes","1-1",1,1,"1",1,2,0,"D"
"21185",2002-10-26,2002,"AC Ajaccio","Olympique Lyon","0-1",0,1,"1",1,1,-1,"D"
"21186",2002-10-26,2002,"EA Guingamp","CS Sedan","0-1",0,1,"1",1,1,-1,"D"
"21187",2002-10-26,2002,"OGC Nice","RC Lens","0-0",0,0,"1",1,0,0,"D"
"21188",2002-11-02,2002,"Olympique Lyon","OGC Nice","2-2",2,2,"1",1,4,0,"D"
"21189",2002-11-02,2002,"SC Bastia","Lille OSC","1-0",1,0,"1",1,1,1,"H"
"21190",2002-11-02,2002,"RC Lens","AJ Auxerre","3-1",3,1,"1",1,4,2,"H"
"21191",2002-11-02,2002,"AS Monaco","Le Havre AC","1-1",1,1,"1",1,2,0,"D"
"21192",2002-11-02,2002,"ESTAC Troyes","EA Guingamp","0-2",0,2,"1",1,2,-2,"D"
"21193",2002-11-02,2002,"Olympique Marseille","Montpellier HSC","2-0",2,0,"1",1,2,2,"H"
"21194",2002-11-02,2002,"FC Sochaux","RC Strasbourg","2-0",2,0,"1",1,2,2,"H"
"21195",2002-11-02,2002,"Stade Rennes","AC Ajaccio","0-0",0,0,"1",1,0,0,"D"
"21196",2002-11-03,2002,"CS Sedan","Paris Saint-Germain","3-1",3,1,"1",1,4,2,"H"
"21197",2002-11-03,2002,"FC Nantes","Girondins Bordeaux","0-0",0,0,"1",1,0,0,"D"
"21198",2002-11-07,2002,"Le Havre AC","Olympique Lyon","1-2",1,2,"1",1,3,-1,"D"
"21199",2002-11-07,2002,"AC Ajaccio","AJ Auxerre","1-0",1,0,"1",1,1,1,"H"
"21200",2002-11-08,2002,"OGC Nice","AS Monaco","1-0",1,0,"1",1,1,1,"H"
"21201",2002-11-09,2002,"Girondins Bordeaux","Stade Rennes","2-0",2,0,"1",1,2,2,"H"
"21202",2002-11-09,2002,"RC Strasbourg","RC Lens","2-0",2,0,"1",1,2,2,"H"
"21203",2002-11-09,2002,"ESTAC Troyes","SC Bastia","3-0",3,0,"1",1,3,3,"H"
"21204",2002-11-09,2002,"Paris Saint-Germain","FC Sochaux","1-1",1,1,"1",1,2,0,"D"
"21205",2002-11-09,2002,"Lille OSC","FC Nantes","0-1",0,1,"1",1,1,-1,"D"
"21206",2002-11-09,2002,"Montpellier HSC","CS Sedan","2-0",2,0,"1",1,2,2,"H"
"21207",2002-11-09,2002,"EA Guingamp","Olympique Marseille","0-0",0,0,"1",1,0,0,"D"
"21208",2002-11-14,2002,"AS Monaco","AC Ajaccio","3-2",3,2,"1",1,5,1,"H"
"21209",2002-11-16,2002,"AJ Auxerre","OGC Nice","0-2",0,2,"1",1,2,-2,"D"
"21210",2002-11-16,2002,"Olympique Lyon","Girondins Bordeaux","4-2",4,2,"1",1,6,2,"H"
"21211",2002-11-16,2002,"Olympique Marseille","ESTAC Troyes","0-0",0,0,"1",1,0,0,"D"
"21212",2002-11-16,2002,"CS Sedan","Lille OSC","0-1",0,1,"1",1,1,-1,"D"
"21213",2002-11-16,2002,"SC Bastia","EA Guingamp","0-2",0,2,"1",1,2,-2,"D"
"21214",2002-11-16,2002,"FC Nantes","RC Strasbourg","4-1",4,1,"1",1,5,3,"H"
"21215",2002-11-16,2002,"FC Sochaux","Montpellier HSC","0-0",0,0,"1",1,0,0,"D"
"21216",2002-11-16,2002,"Stade Rennes","Le Havre AC","0-0",0,0,"1",1,0,0,"D"
"21217",2002-11-17,2002,"RC Lens","Paris Saint-Germain","3-2",3,2,"1",1,5,1,"H"
"21218",2002-11-22,2002,"Paris Saint-Germain","FC Nantes","0-1",0,1,"1",1,1,-1,"D"
"21219",2002-11-23,2002,"Olympique Marseille","RC Lens","1-0",1,0,"1",1,1,1,"H"
"21220",2002-11-23,2002,"Montpellier HSC","SC Bastia","2-2",2,2,"1",1,4,0,"D"
"21221",2002-11-23,2002,"Girondins Bordeaux","AC Ajaccio","1-0",1,0,"1",1,1,1,"H"
"21222",2002-11-23,2002,"OGC Nice","Stade Rennes","0-0",0,0,"1",1,0,0,"D"
"21223",2002-11-23,2002,"Le Havre AC","AJ Auxerre","0-1",0,1,"1",1,1,-1,"D"
"21224",2002-11-23,2002,"Lille OSC","Olympique Lyon","2-1",2,1,"1",1,3,1,"H"
"21225",2002-11-23,2002,"ESTAC Troyes","CS Sedan","2-0",2,0,"1",1,2,2,"H"
"21226",2002-11-23,2002,"EA Guingamp","FC Sochaux","2-0",2,0,"1",1,2,2,"H"
"21227",2002-11-24,2002,"RC Strasbourg","AS Monaco","1-0",1,0,"1",1,1,1,"H"
"21228",2002-11-30,2002,"AS Monaco","Paris Saint-Germain","3-1",3,1,"1",1,4,2,"H"
"21229",2002-11-30,2002,"FC Sochaux","ESTAC Troyes","1-0",1,0,"1",1,1,1,"H"
"21230",2002-11-30,2002,"SC Bastia","Olympique Marseille","2-0",2,0,"1",1,2,2,"H"
"21231",2002-11-30,2002,"FC Nantes","Montpellier HSC","3-1",3,1,"1",1,4,2,"H"
"21232",2002-11-30,2002,"AC Ajaccio","Le Havre AC","1-2",1,2,"1",1,3,-1,"D"
"21233",2002-11-30,2002,"Stade Rennes","Lille OSC","5-1",5,1,"1",1,6,4,"H"
"21234",2002-11-30,2002,"CS Sedan","OGC Nice","3-0",3,0,"1",1,3,3,"H"
"21235",2002-12-01,2002,"Olympique Lyon","RC Strasbourg","2-1",2,1,"1",1,3,1,"H"
"21236",2002-12-01,2002,"RC Lens","EA Guingamp","1-3",1,3,"1",1,4,-2,"D"
"21237",2002-12-01,2002,"AJ Auxerre","Girondins Bordeaux","1-0",1,0,"1",1,1,1,"H"
"21238",2002-12-03,2002,"OGC Nice","AC Ajaccio","3-0",3,0,"1",1,3,3,"H"
"21239",2002-12-04,2002,"Paris Saint-Germain","Olympique Lyon","2-0",2,0,"1",1,2,2,"H"
"21240",2002-12-04,2002,"SC Bastia","CS Sedan","0-1",0,1,"1",1,1,-1,"D"
"21241",2002-12-04,2002,"Montpellier HSC","AS Monaco","1-2",1,2,"1",1,3,-1,"D"
"21242",2002-12-04,2002,"RC Strasbourg","Stade Rennes","1-3",1,3,"1",1,4,-2,"D"
"21243",2002-12-04,2002,"Olympique Marseille","FC Sochaux","1-0",1,0,"1",1,1,1,"H"
"21244",2002-12-04,2002,"Le Havre AC","Girondins Bordeaux","1-0",1,0,"1",1,1,1,"H"
"21245",2002-12-04,2002,"Lille OSC","AJ Auxerre","2-2",2,2,"1",1,4,0,"D"
"21246",2002-12-04,2002,"ESTAC Troyes","RC Lens","0-0",0,0,"1",1,0,0,"D"
"21247",2002-12-04,2002,"EA Guingamp","FC Nantes","2-0",2,0,"1",1,2,2,"H"
"21248",2002-12-14,2002,"FC Sochaux","SC Bastia","2-0",2,0,"1",1,2,2,"H"
"21249",2002-12-14,2002,"CS Sedan","Olympique Marseille","1-2",1,2,"1",1,3,-1,"D"
"21250",2002-12-15,2002,"Girondins Bordeaux","OGC Nice","4-0",4,0,"1",1,4,4,"H"
"21251",2002-12-15,2002,"RC Lens","Le Havre AC","1-0",1,0,"1",1,1,1,"H"
"21252",2002-12-15,2002,"AS Monaco","EA Guingamp","4-0",4,0,"1",1,4,4,"H"
"21253",2002-12-15,2002,"AJ Auxerre","RC Strasbourg","0-0",0,0,"1",1,0,0,"D"
"21254",2002-12-15,2002,"Olympique Lyon","Montpellier HSC","1-1",1,1,"1",1,2,0,"D"
"21255",2002-12-15,2002,"FC Nantes","ESTAC Troyes","2-1",2,1,"1",1,3,1,"H"
"21256",2002-12-15,2002,"AC Ajaccio","Lille OSC","2-2",2,2,"1",1,4,0,"D"
"21257",2002-12-15,2002,"Stade Rennes","Paris Saint-Germain","1-0",1,0,"1",1,1,1,"H"
"21258",2002-12-19,2002,"Paris Saint-Germain","Girondins Bordeaux","1-1",1,1,"1",1,2,0,"D"
"21259",2002-12-20,2002,"FC Sochaux","RC Lens","3-0",3,0,"1",1,3,3,"H"
"21260",2002-12-20,2002,"SC Bastia","FC Nantes","3-1",3,1,"1",1,4,2,"H"
"21261",2002-12-20,2002,"CS Sedan","Olympique Lyon","1-1",1,1,"1",1,2,0,"D"
"21262",2002-12-20,2002,"RC Strasbourg","OGC Nice","0-0",0,0,"1",1,0,0,"D"
"21263",2002-12-20,2002,"EA Guingamp","AC Ajaccio","3-1",3,1,"1",1,4,2,"H"
"21264",2002-12-20,2002,"Olympique Marseille","AS Monaco","1-1",1,1,"1",1,2,0,"D"
"21265",2002-12-20,2002,"Lille OSC","Le Havre AC","1-0",1,0,"1",1,1,1,"H"
"21266",2002-12-20,2002,"ESTAC Troyes","Stade Rennes","0-1",0,1,"1",1,1,-1,"D"
"21267",2003-01-10,2002,"Olympique Lyon","Olympique Marseille","1-0",1,0,"1",1,1,1,"H"
"21268",2003-01-11,2002,"Stade Rennes","EA Guingamp","2-1",2,1,"1",1,3,1,"H"
"21269",2003-01-11,2002,"AJ Auxerre","ESTAC Troyes","1-0",1,0,"1",1,1,1,"H"
"21270",2003-01-11,2002,"Girondins Bordeaux","Montpellier HSC","3-1",3,1,"1",1,4,2,"H"
"21271",2003-01-11,2002,"AS Monaco","SC Bastia","0-0",0,0,"1",1,0,0,"D"
"21272",2003-01-11,2002,"OGC Nice","Lille OSC","2-0",2,0,"1",1,2,2,"H"
"21273",2003-01-11,2002,"AC Ajaccio","Paris Saint-Germain","0-0",0,0,"1",1,0,0,"D"
"21274",2003-01-14,2002,"Olympique Marseille","Stade Rennes","2-0",2,0,"1",1,2,2,"H"
"21275",2003-01-15,2002,"FC Sochaux","AS Monaco","0-0",0,0,"1",1,0,0,"D"
"21276",2003-01-15,2002,"SC Bastia","Olympique Lyon","2-0",2,0,"1",1,2,2,"H"
"21277",2003-01-15,2002,"EA Guingamp","AJ Auxerre","0-2",0,2,"1",1,2,-2,"D"
"21278",2003-01-15,2002,"Montpellier HSC","OGC Nice","2-2",2,2,"1",1,4,0,"D"
"21279",2003-01-15,2002,"Paris Saint-Germain","Le Havre AC","1-0",1,0,"1",1,1,1,"H"
"21280",2003-01-15,2002,"CS Sedan","AC Ajaccio","1-1",1,1,"1",1,2,0,"D"
"21281",2003-01-18,2002,"Montpellier HSC","AJ Auxerre","0-0",0,0,"1",1,0,0,"D"
"21282",2003-01-18,2002,"Le Havre AC","RC Strasbourg","1-1",1,1,"1",1,2,0,"D"
"21283",2003-01-18,2002,"RC Lens","CS Sedan","4-0",4,0,"1",1,4,4,"H"
"21284",2003-01-21,2002,"AJ Auxerre","Olympique Marseille","0-0",0,0,"1",1,0,0,"D"
"21285",2003-01-22,2002,"Olympique Lyon","FC Sochaux","4-1",4,1,"1",1,5,3,"H"
"21286",2003-01-22,2002,"AC Ajaccio","ESTAC Troyes","1-0",1,0,"1",1,1,1,"H"
"21287",2003-01-22,2002,"Girondins Bordeaux","EA Guingamp","4-2",4,2,"1",1,6,2,"H"
"21288",2003-01-22,2002,"Le Havre AC","Montpellier HSC","1-0",1,0,"1",1,1,1,"H"
"21289",2003-01-22,2002,"Lille OSC","RC Strasbourg","0-1",0,1,"1",1,1,-1,"D"
"21290",2003-01-22,2002,"AS Monaco","RC Lens","1-1",1,1,"1",1,2,0,"D"
"21291",2003-01-22,2002,"FC Nantes","CS Sedan","4-1",4,1,"1",1,5,3,"H"
"21292",2003-01-22,2002,"OGC Nice","Paris Saint-Germain","0-0",0,0,"1",1,0,0,"D"
"21293",2003-01-22,2002,"Stade Rennes","SC Bastia","0-1",0,1,"1",1,1,-1,"D"
"21294",2003-01-28,2002,"Olympique Marseille","OGC Nice","2-0",2,0,"1",1,2,2,"H"
"21295",2003-01-29,2002,"FC Nantes","AS Monaco","0-2",0,2,"1",1,2,-2,"D"
"21296",2003-01-29,2002,"SC Bastia","AJ Auxerre","2-0",2,0,"1",1,2,2,"H"
"21297",2003-01-29,2002,"EA Guingamp","Le Havre AC","1-2",1,2,"1",1,3,-1,"D"
"21298",2003-01-29,2002,"RC Lens","Olympique Lyon","2-2",2,2,"1",1,4,0,"D"
"21299",2003-01-29,2002,"Montpellier HSC","AC Ajaccio","0-1",0,1,"1",1,1,-1,"D"
"21300",2003-01-29,2002,"Paris Saint-Germain","Lille OSC","1-0",1,0,"1",1,1,1,"H"
"21301",2003-01-29,2002,"CS Sedan","RC Strasbourg","2-1",2,1,"1",1,3,1,"H"
"21302",2003-01-29,2002,"FC Sochaux","Stade Rennes","1-0",1,0,"1",1,1,1,"H"
"21303",2003-01-29,2002,"ESTAC Troyes","Girondins Bordeaux","0-1",0,1,"1",1,1,-1,"D"
"21304",2003-02-01,2002,"AJ Auxerre","FC Sochaux","2-0",2,0,"1",1,2,2,"H"
"21305",2003-02-01,2002,"AC Ajaccio","SC Bastia","1-1",1,1,"1",1,2,0,"D"
"21306",2003-02-01,2002,"Le Havre AC","ESTAC Troyes","1-0",1,0,"1",1,1,1,"H"
"21307",2003-02-01,2002,"Olympique Lyon","FC Nantes","0-0",0,0,"1",1,0,0,"D"
"21308",2003-02-01,2002,"AS Monaco","CS Sedan","3-0",3,0,"1",1,3,3,"H"
"21309",2003-02-01,2002,"OGC Nice","EA Guingamp","1-0",1,0,"1",1,1,1,"H"
"21310",2003-02-01,2002,"Stade Rennes","RC Lens","1-1",1,1,"1",1,2,0,"D"
"21311",2003-02-01,2002,"RC Strasbourg","Paris Saint-Germain","0-1",0,1,"1",1,1,-1,"D"
"21312",2003-02-02,2002,"Girondins Bordeaux","Olympique Marseille","3-1",3,1,"1",1,4,2,"H"
"21313",2003-02-04,2002,"AS Monaco","Olympique Lyon","2-0",2,0,"1",1,2,2,"H"
"21314",2003-02-05,2002,"CS Sedan","AJ Auxerre","1-2",1,2,"1",1,3,-1,"D"
"21315",2003-02-05,2002,"SC Bastia","Paris Saint-Germain","1-0",1,0,"1",1,1,1,"H"
"21316",2003-02-05,2002,"RC Lens","Girondins Bordeaux","3-3",3,3,"1",1,6,0,"D"
"21317",2003-02-05,2002,"Olympique Marseille","Le Havre AC","2-0",2,0,"1",1,2,2,"H"
"21318",2003-02-05,2002,"Montpellier HSC","RC Strasbourg","2-1",2,1,"1",1,3,1,"H"
"21319",2003-02-05,2002,"FC Nantes","Stade Rennes","1-0",1,0,"1",1,1,1,"H"
"21320",2003-02-05,2002,"ESTAC Troyes","OGC Nice","1-0",1,0,"1",1,1,1,"H"
"21321",2003-02-08,2002,"AC Ajaccio","Olympique Marseille","0-2",0,2,"1",1,2,-2,"D"
"21322",2003-02-08,2002,"Girondins Bordeaux","SC Bastia","0-2",0,2,"1",1,2,-2,"D"
"21323",2003-02-08,2002,"Le Havre AC","CS Sedan","2-1",2,1,"1",1,3,1,"H"
"21324",2003-02-08,2002,"Lille OSC","RC Lens","0-2",0,2,"1",1,2,-2,"D"
"21325",2003-02-08,2002,"Olympique Lyon","ESTAC Troyes","0-0",0,0,"1",1,0,0,"D"
"21326",2003-02-08,2002,"OGC Nice","FC Sochaux","2-2",2,2,"1",1,4,0,"D"
"21327",2003-02-08,2002,"Paris Saint-Germain","Montpellier HSC","1-3",1,3,"1",1,4,-2,"D"
"21328",2003-02-08,2002,"Stade Rennes","AS Monaco","0-0",0,0,"1",1,0,0,"D"
"21329",2003-02-08,2002,"RC Strasbourg","EA Guingamp","3-1",3,1,"1",1,4,2,"H"
"21330",2003-02-09,2002,"AJ Auxerre","FC Nantes","0-1",0,1,"1",1,1,-1,"D"
"21331",2003-02-15,2002,"FC Nantes","FC Sochaux","0-1",0,1,"1",1,1,-1,"D"
"21332",2003-02-19,2002,"ESTAC Troyes","Lille OSC","2-0",2,0,"1",1,2,2,"H"
"21333",2003-02-22,2002,"EA Guingamp","Paris Saint-Germain","3-2",3,2,"1",1,5,1,"H"
"21334",2003-02-22,2002,"SC Bastia","OGC Nice","1-1",1,1,"1",1,2,0,"D"
"21335",2003-02-22,2002,"RC Lens","Montpellier HSC","4-0",4,0,"1",1,4,4,"H"
"21336",2003-02-22,2002,"Olympique Lyon","Stade Rennes","4-1",4,1,"1",1,5,3,"H"
"21337",2003-02-22,2002,"Olympique Marseille","Lille OSC","2-0",2,0,"1",1,2,2,"H"
"21338",2003-02-22,2002,"FC Nantes","AC Ajaccio","1-0",1,0,"1",1,1,1,"H"
"21339",2003-02-22,2002,"CS Sedan","Girondins Bordeaux","0-1",0,1,"1",1,1,-1,"D"
"21340",2003-02-22,2002,"FC Sochaux","Le Havre AC","1-0",1,0,"1",1,1,1,"H"
"21341",2003-02-22,2002,"ESTAC Troyes","RC Strasbourg","1-0",1,0,"1",1,1,1,"H"
"21342",2003-02-23,2002,"AS Monaco","AJ Auxerre","3-1",3,1,"1",1,4,2,"H"
"21343",2003-02-28,2002,"OGC Nice","FC Nantes","1-1",1,1,"1",1,2,0,"D"
"21344",2003-03-01,2002,"Girondins Bordeaux","FC Sochaux","2-0",2,0,"1",1,2,2,"H"
"21345",2003-03-01,2002,"AC Ajaccio","RC Lens","0-0",0,0,"1",1,0,0,"D"
"21346",2003-03-01,2002,"Le Havre AC","SC Bastia","2-0",2,0,"1",1,2,2,"H"
"21347",2003-03-01,2002,"Lille OSC","AS Monaco","1-3",1,3,"1",1,4,-2,"D"
"21348",2003-03-01,2002,"Montpellier HSC","EA Guingamp","2-0",2,0,"1",1,2,2,"H"
"21349",2003-03-01,2002,"Paris Saint-Germain","ESTAC Troyes","4-2",4,2,"1",1,6,2,"H"
"21350",2003-03-01,2002,"Stade Rennes","CS Sedan","1-0",1,0,"1",1,1,1,"H"
"21351",2003-03-01,2002,"RC Strasbourg","Olympique Marseille","0-0",0,0,"1",1,0,0,"D"
"21352",2003-03-02,2002,"AJ Auxerre","Olympique Lyon","1-2",1,2,"1",1,3,-1,"D"
"21353",2003-03-08,2002,"Stade Rennes","AJ Auxerre","0-0",0,0,"1",1,0,0,"D"
"21354",2003-03-08,2002,"SC Bastia","RC Strasbourg","1-1",1,1,"1",1,2,0,"D"
"21355",2003-03-08,2002,"RC Lens","OGC Nice","0-0",0,0,"1",1,0,0,"D"
"21356",2003-03-08,2002,"Olympique Lyon","AC Ajaccio","3-1",3,1,"1",1,4,2,"H"
"21357",2003-03-08,2002,"AS Monaco","Girondins Bordeaux","0-1",0,1,"1",1,1,-1,"D"
"21358",2003-03-08,2002,"FC Nantes","Le Havre AC","2-0",2,0,"1",1,2,2,"H"
"21359",2003-03-08,2002,"CS Sedan","EA Guingamp","2-0",2,0,"1",1,2,2,"H"
"21360",2003-03-08,2002,"FC Sochaux","Lille OSC","2-2",2,2,"1",1,4,0,"D"
"21361",2003-03-08,2002,"ESTAC Troyes","Montpellier HSC","0-2",0,2,"1",1,2,-2,"D"
"21362",2003-03-09,2002,"Olympique Marseille","Paris Saint-Germain","0-3",0,3,"1",1,3,-3,"D"
"21363",2003-03-14,2002,"RC Lens","FC Nantes","0-1",0,1,"1",1,1,-1,"D"
"21364",2003-03-14,2002,"Lille OSC","Montpellier HSC","2-0",2,0,"1",1,2,2,"H"
"21365",2003-03-14,2002,"FC Sochaux","AC Ajaccio","1-1",1,1,"1",1,2,0,"D"
"21366",2003-03-18,2002,"EA Guingamp","Lille OSC","1-0",1,0,"1",1,1,1,"H"
"21367",2003-03-19,2002,"RC Strasbourg","Girondins Bordeaux","1-1",1,1,"1",1,2,0,"D"
"21368",2003-03-22,2002,"Montpellier HSC","Olympique Marseille","1-2",1,2,"1",1,3,-1,"D"
"21369",2003-03-22,2002,"AC Ajaccio","Stade Rennes","1-0",1,0,"1",1,1,1,"H"
"21370",2003-03-22,2002,"AJ Auxerre","RC Lens","0-0",0,0,"1",1,0,0,"D"
"21371",2003-03-22,2002,"Girondins Bordeaux","FC Nantes","0-0",0,0,"1",1,0,0,"D"
"21372",2003-03-22,2002,"EA Guingamp","ESTAC Troyes","2-0",2,0,"1",1,2,2,"H"
"21373",2003-03-22,2002,"Le Havre AC","AS Monaco","0-3",0,3,"1",1,3,-3,"D"
"21374",2003-03-22,2002,"Lille OSC","SC Bastia","1-1",1,1,"1",1,2,0,"D"
"21375",2003-03-22,2002,"Paris Saint-Germain","CS Sedan","2-0",2,0,"1",1,2,2,"H"
"21376",2003-03-22,2002,"RC Strasbourg","FC Sochaux","1-3",1,3,"1",1,4,-2,"D"
"21377",2003-03-23,2002,"OGC Nice","Olympique Lyon","0-1",0,1,"1",1,1,-1,"D"
"21378",2003-04-05,2002,"Olympique Lyon","Le Havre AC","2-1",2,1,"1",1,3,1,"H"
"21379",2003-04-05,2002,"AJ Auxerre","AC Ajaccio","1-0",1,0,"1",1,1,1,"H"
"21380",2003-04-05,2002,"SC Bastia","ESTAC Troyes","1-1",1,1,"1",1,2,0,"D"
"21381",2003-04-05,2002,"RC Lens","RC Strasbourg","1-1",1,1,"1",1,2,0,"D"
"21382",2003-04-05,2002,"Olympique Marseille","EA Guingamp","0-2",0,2,"1",1,2,-2,"D"
"21383",2003-04-05,2002,"FC Nantes","Lille OSC","1-0",1,0,"1",1,1,1,"H"
"21384",2003-04-05,2002,"Stade Rennes","Girondins Bordeaux","3-4",3,4,"1",1,7,-1,"D"
"21385",2003-04-05,2002,"CS Sedan","Montpellier HSC","1-2",1,2,"1",1,3,-1,"D"
"21386",2003-04-05,2002,"FC Sochaux","Paris Saint-Germain","0-0",0,0,"1",1,0,0,"D"
"21387",2003-04-06,2002,"AS Monaco","OGC Nice","0-1",0,1,"1",1,1,-1,"D"
"21388",2003-04-08,2002,"AJ Auxerre","CS Sedan","3-1",3,1,"1",1,4,2,"H"
"21389",2003-04-11,2002,"Girondins Bordeaux","Olympique Lyon","0-1",0,1,"1",1,1,-1,"D"
"21390",2003-04-12,2002,"ESTAC Troyes","Olympique Marseille","0-0",0,0,"1",1,0,0,"D"
"21391",2003-04-12,2002,"AC Ajaccio","AS Monaco","2-4",2,4,"1",1,6,-2,"D"
"21392",2003-04-12,2002,"EA Guingamp","SC Bastia","3-0",3,0,"1",1,3,3,"H"
"21393",2003-04-12,2002,"Le Havre AC","Stade Rennes","0-1",0,1,"1",1,1,-1,"D"
"21394",2003-04-12,2002,"Lille OSC","CS Sedan","0-0",0,0,"1",1,0,0,"D"
"21395",2003-04-12,2002,"Montpellier HSC","FC Sochaux","0-2",0,2,"1",1,2,-2,"D"
"21396",2003-04-12,2002,"OGC Nice","AJ Auxerre","1-0",1,0,"1",1,1,1,"H"
"21397",2003-04-12,2002,"Paris Saint-Germain","RC Lens","0-1",0,1,"1",1,1,-1,"D"
"21398",2003-04-12,2002,"RC Strasbourg","FC Nantes","2-0",2,0,"1",1,2,2,"H"
"21399",2003-04-19,2002,"AC Ajaccio","Girondins Bordeaux","1-6",1,6,"1",1,7,-5,"D"
"21400",2003-04-19,2002,"AJ Auxerre","Le Havre AC","1-0",1,0,"1",1,1,1,"H"
"21401",2003-04-19,2002,"SC Bastia","Montpellier HSC","1-2",1,2,"1",1,3,-1,"D"
"21402",2003-04-19,2002,"Olympique Lyon","Lille OSC","0-0",0,0,"1",1,0,0,"D"
"21403",2003-04-19,2002,"FC Nantes","Paris Saint-Germain","1-1",1,1,"1",1,2,0,"D"
"21404",2003-04-19,2002,"Stade Rennes","OGC Nice","2-2",2,2,"1",1,4,0,"D"
"21405",2003-04-19,2002,"CS Sedan","ESTAC Troyes","4-0",4,0,"1",1,4,4,"H"
"21406",2003-04-19,2002,"FC Sochaux","EA Guingamp","0-0",0,0,"1",1,0,0,"D"
"21407",2003-04-20,2002,"AS Monaco","RC Strasbourg","2-0",2,0,"1",1,2,2,"H"
"21408",2003-04-20,2002,"RC Lens","Olympique Marseille","0-1",0,1,"1",1,1,-1,"D"
"21409",2003-05-03,2002,"Olympique Marseille","SC Bastia","2-1",2,1,"1",1,3,1,"H"
"21410",2003-05-03,2002,"Girondins Bordeaux","AJ Auxerre","0-1",0,1,"1",1,1,-1,"D"
"21411",2003-05-03,2002,"EA Guingamp","RC Lens","1-0",1,0,"1",1,1,1,"H"
"21412",2003-05-03,2002,"Le Havre AC","AC Ajaccio","0-1",0,1,"1",1,1,-1,"D"
"21413",2003-05-03,2002,"Lille OSC","Stade Rennes","1-0",1,0,"1",1,1,1,"H"
"21414",2003-05-03,2002,"Montpellier HSC","FC Nantes","1-0",1,0,"1",1,1,1,"H"
"21415",2003-05-03,2002,"OGC Nice","CS Sedan","0-0",0,0,"1",1,0,0,"D"
"21416",2003-05-03,2002,"RC Strasbourg","Olympique Lyon","0-4",0,4,"1",1,4,-4,"D"
"21417",2003-05-03,2002,"ESTAC Troyes","FC Sochaux","0-2",0,2,"1",1,2,-2,"D"
"21418",2003-05-04,2002,"Paris Saint-Germain","AS Monaco","2-1",2,1,"1",1,3,1,"H"
"21419",2003-05-10,2002,"AC Ajaccio","OGC Nice","2-0",2,0,"1",1,2,2,"H"
"21420",2003-05-10,2002,"AJ Auxerre","Lille OSC","0-0",0,0,"1",1,0,0,"D"
"21421",2003-05-10,2002,"Girondins Bordeaux","Le Havre AC","2-0",2,0,"1",1,2,2,"H"
"21422",2003-05-10,2002,"RC Lens","ESTAC Troyes","1-0",1,0,"1",1,1,1,"H"
"21423",2003-05-10,2002,"AS Monaco","Montpellier HSC","3-1",3,1,"1",1,4,2,"H"
"21424",2003-05-10,2002,"FC Nantes","EA Guingamp","0-4",0,4,"1",1,4,-4,"D"
"21425",2003-05-10,2002,"Stade Rennes","RC Strasbourg","2-3",2,3,"1",1,5,-1,"D"
"21426",2003-05-10,2002,"CS Sedan","SC Bastia","2-2",2,2,"1",1,4,0,"D"
"21427",2003-05-10,2002,"FC Sochaux","Olympique Marseille","3-0",3,0,"1",1,3,3,"H"
"21428",2003-05-11,2002,"Olympique Lyon","Paris Saint-Germain","1-0",1,0,"1",1,1,1,"H"
"21429",2003-05-20,2002,"SC Bastia","FC Sochaux","2-2",2,2,"1",1,4,0,"D"
"21430",2003-05-20,2002,"EA Guingamp","AS Monaco","3-1",3,1,"1",1,4,2,"H"
"21431",2003-05-20,2002,"Le Havre AC","RC Lens","1-3",1,3,"1",1,4,-2,"D"
"21432",2003-05-20,2002,"Lille OSC","AC Ajaccio","2-0",2,0,"1",1,2,2,"H"
"21433",2003-05-20,2002,"Olympique Marseille","CS Sedan","4-2",4,2,"1",1,6,2,"H"
"21434",2003-05-20,2002,"Montpellier HSC","Olympique Lyon","1-1",1,1,"1",1,2,0,"D"
"21435",2003-05-20,2002,"OGC Nice","Girondins Bordeaux","1-1",1,1,"1",1,2,0,"D"
"21436",2003-05-20,2002,"Paris Saint-Germain","Stade Rennes","0-0",0,0,"1",1,0,0,"D"
"21437",2003-05-20,2002,"RC Strasbourg","AJ Auxerre","1-2",1,2,"1",1,3,-1,"D"
"21438",2003-05-20,2002,"ESTAC Troyes","FC Nantes","2-0",2,0,"1",1,2,2,"H"
"21439",2003-05-24,2002,"AC Ajaccio","RC Strasbourg","0-0",0,0,"1",1,0,0,"D"
"21440",2003-05-24,2002,"AJ Auxerre","Paris Saint-Germain","2-0",2,0,"1",1,2,2,"H"
"21441",2003-05-24,2002,"Girondins Bordeaux","Lille OSC","2-0",2,0,"1",1,2,2,"H"
"21442",2003-05-24,2002,"Le Havre AC","OGC Nice","2-1",2,1,"1",1,3,1,"H"
"21443",2003-05-24,2002,"RC Lens","SC Bastia","2-0",2,0,"1",1,2,2,"H"
"21444",2003-05-24,2002,"Olympique Lyon","EA Guingamp","1-4",1,4,"1",1,5,-3,"D"
"21445",2003-05-24,2002,"AS Monaco","ESTAC Troyes","6-0",6,0,"1",1,6,6,"H"
"21446",2003-05-24,2002,"FC Nantes","Olympique Marseille","1-0",1,0,"1",1,1,1,"H"
"21447",2003-05-24,2002,"Stade Rennes","Montpellier HSC","3-1",3,1,"1",1,4,2,"H"
"21448",2003-05-24,2002,"FC Sochaux","CS Sedan","2-1",2,1,"1",1,3,1,"H"
"21449",2003-08-01,2003,"Lille OSC","Olympique Lyon","1-0",1,0,"1",1,1,1,"H"
"21450",2003-08-02,2003,"AS Monaco","Girondins Bordeaux","2-0",2,0,"1",1,2,2,"H"
"21451",2003-08-02,2003,"FC Sochaux","FC Nantes","2-1",2,1,"1",1,3,1,"H"
"21452",2003-08-02,2003,"EA Guingamp","Olympique Marseille","0-1",0,1,"1",1,1,-1,"D"
"21453",2003-08-02,2003,"Toulouse FC","RC Strasbourg","1-1",1,1,"1",1,2,0,"D"
"21454",2003-08-02,2003,"FC Metz","AC Ajaccio","0-1",0,1,"1",1,1,-1,"D"
"21455",2003-08-02,2003,"RC Lens","Le Mans UC 72","0-0",0,0,"1",1,0,0,"D"
"21456",2003-08-02,2003,"Montpellier HSC","Stade Rennes","1-1",1,1,"1",1,2,0,"D"
"21457",2003-08-02,2003,"Paris Saint-Germain","SC Bastia","0-0",0,0,"1",1,0,0,"D"
"21458",2003-08-02,2003,"AJ Auxerre","OGC Nice","1-2",1,2,"1",1,3,-1,"D"
"21459",2003-08-08,2003,"Olympique Marseille","AJ Auxerre","1-0",1,0,"1",1,1,1,"H"
"21460",2003-08-09,2003,"Lille OSC","Paris Saint-Germain","1-0",1,0,"1",1,1,1,"H"
"21461",2003-08-09,2003,"Stade Rennes","Toulouse FC","1-0",1,0,"1",1,1,1,"H"
"21462",2003-08-09,2003,"OGC Nice","FC Sochaux","1-0",1,0,"1",1,1,1,"H"
"21463",2003-08-09,2003,"Le Mans UC 72","AC Ajaccio","0-1",0,1,"1",1,1,-1,"D"
"21464",2003-08-09,2003,"SC Bastia","FC Metz","0-2",0,2,"1",1,2,-2,"D"
"21465",2003-08-09,2003,"FC Nantes","RC Lens","2-0",2,0,"1",1,2,2,"H"
"21466",2003-08-09,2003,"Girondins Bordeaux","Montpellier HSC","0-1",0,1,"1",1,1,-1,"D"
"21467",2003-08-09,2003,"Olympique Lyon","AS Monaco","3-1",3,1,"1",1,4,2,"H"
"21468",2003-08-09,2003,"RC Strasbourg","EA Guingamp","2-0",2,0,"1",1,2,2,"H"
"21469",2003-08-16,2003,"AJ Auxerre","RC Strasbourg","3-2",3,2,"1",1,5,1,"H"
"21470",2003-08-16,2003,"AC Ajaccio","FC Nantes","1-3",1,3,"1",1,4,-2,"D"
"21471",2003-08-16,2003,"EA Guingamp","Girondins Bordeaux","1-3",1,3,"1",1,4,-2,"D"
"21472",2003-08-16,2003,"Toulouse FC","Lille OSC","0-3",0,3,"1",1,3,-3,"D"
"21473",2003-08-16,2003,"Le Mans UC 72","OGC Nice","1-1",1,1,"1",1,2,0,"D"
"21474",2003-08-16,2003,"Montpellier HSC","Olympique Lyon","0-2",0,2,"1",1,2,-2,"D"
"21475",2003-08-16,2003,"FC Sochaux","Stade Rennes","1-1",1,1,"1",1,2,0,"D"
"21476",2003-08-16,2003,"AS Monaco","SC Bastia","2-0",2,0,"1",1,2,2,"H"
"21477",2003-08-16,2003,"FC Metz","Paris Saint-Germain","0-1",0,1,"1",1,1,-1,"D"
"21478",2003-08-17,2003,"RC Lens","Olympique Marseille","2-1",2,1,"1",1,3,1,"H"
"21479",2003-08-23,2003,"Girondins Bordeaux","AJ Auxerre","2-0",2,0,"1",1,2,2,"H"
"21480",2003-08-23,2003,"Lille OSC","FC Metz","1-1",1,1,"1",1,2,0,"D"
"21481",2003-08-23,2003,"Olympique Marseille","FC Sochaux","2-0",2,0,"1",1,2,2,"H"
"21482",2003-08-23,2003,"Stade Rennes","EA Guingamp","0-0",0,0,"1",1,0,0,"D"
"21483",2003-08-23,2003,"OGC Nice","AC Ajaccio","2-2",2,2,"1",1,4,0,"D"
"21484",2003-08-23,2003,"RC Strasbourg","RC Lens","0-1",0,1,"1",1,1,-1,"D"
"21485",2003-08-23,2003,"SC Bastia","Montpellier HSC","1-0",1,0,"1",1,1,1,"H"
"21486",2003-08-23,2003,"FC Nantes","Le Mans UC 72","1-0",1,0,"1",1,1,1,"H"
"21487",2003-08-23,2003,"Olympique Lyon","Toulouse FC","0-0",0,0,"1",1,0,0,"D"
"21488",2003-08-24,2003,"Paris Saint-Germain","AS Monaco","2-4",2,4,"1",1,6,-2,"D"
"21489",2003-08-30,2003,"EA Guingamp","Olympique Lyon","2-0",2,0,"1",1,2,2,"H"
"21490",2003-08-30,2003,"Toulouse FC","SC Bastia","0-2",0,2,"1",1,2,-2,"D"
"21491",2003-08-30,2003,"Le Mans UC 72","RC Strasbourg","0-3",0,3,"1",1,3,-3,"D"
"21492",2003-08-30,2003,"Montpellier HSC","Paris Saint-Germain","3-2",3,2,"1",1,5,1,"H"
"21493",2003-08-30,2003,"FC Sochaux","Lille OSC","2-1",2,1,"1",1,3,1,"H"
"21494",2003-08-30,2003,"AJ Auxerre","Stade Rennes","2-1",2,1,"1",1,3,1,"H"
"21495",2003-08-30,2003,"FC Nantes","Girondins Bordeaux","0-0",0,0,"1",1,0,0,"D"
"21496",2003-08-31,2003,"RC Lens","OGC Nice","1-0",1,0,"1",1,1,1,"H"
"21497",2003-08-31,2003,"AS Monaco","FC Metz","1-0",1,0,"1",1,1,1,"H"
"21498",2003-08-31,2003,"AC Ajaccio","Olympique Marseille","0-1",0,1,"1",1,1,-1,"D"
"21499",2003-09-13,2003,"Olympique Lyon","AJ Auxerre","1-1",1,1,"1",1,2,0,"D"
"21500",2003-09-13,2003,"Lille OSC","AS Monaco","1-1",1,1,"1",1,2,0,"D"
"21501",2003-09-13,2003,"Olympique Marseille","Le Mans UC 72","5-0",5,0,"1",1,5,5,"H"
"21502",2003-09-13,2003,"Stade Rennes","RC Lens","2-0",2,0,"1",1,2,2,"H"
"21503",2003-09-13,2003,"OGC Nice","FC Nantes","1-0",1,0,"1",1,1,1,"H"
"21504",2003-09-13,2003,"RC Strasbourg","AC Ajaccio","3-2",3,2,"1",1,5,1,"H"
"21505",2003-09-13,2003,"SC Bastia","EA Guingamp","4-2",4,2,"1",1,6,2,"H"
"21506",2003-09-13,2003,"FC Metz","Montpellier HSC","2-1",2,1,"1",1,3,1,"H"
"21507",2003-09-13,2003,"Girondins Bordeaux","FC Sochaux","1-3",1,3,"1",1,4,-2,"D"
"21508",2003-09-14,2003,"Paris Saint-Germain","Toulouse FC","2-1",2,1,"1",1,3,1,"H"
"21509",2003-09-20,2003,"FC Sochaux","RC Strasbourg","3-0",3,0,"1",1,3,3,"H"
"21510",2003-09-20,2003,"AC Ajaccio","Stade Rennes","1-0",1,0,"1",1,1,1,"H"
"21511",2003-09-20,2003,"Toulouse FC","FC Metz","1-0",1,0,"1",1,1,1,"H"
"21512",2003-09-20,2003,"OGC Nice","Lille OSC","2-0",2,0,"1",1,2,2,"H"
"21513",2003-09-20,2003,"EA Guingamp","Paris Saint-Germain","0-2",0,2,"1",1,2,-2,"D"
"21514",2003-09-20,2003,"AJ Auxerre","SC Bastia","4-1",4,1,"1",1,5,3,"H"
"21515",2003-09-20,2003,"RC Lens","Girondins Bordeaux","1-0",1,0,"1",1,1,1,"H"
"21516",2003-09-21,2003,"Le Mans UC 72","Olympique Lyon","0-2",0,2,"1",1,2,-2,"D"
"21517",2003-09-21,2003,"Montpellier HSC","AS Monaco","1-2",1,2,"1",1,3,-1,"D"
"21518",2003-09-21,2003,"FC Nantes","Olympique Marseille","1-0",1,0,"1",1,1,1,"H"
"21519",2003-09-27,2003,"Olympique Lyon","RC Lens","4-0",4,0,"1",1,4,4,"H"
"21520",2003-09-27,2003,"Lille OSC","Montpellier HSC","1-1",1,1,"1",1,2,0,"D"
"21521",2003-09-27,2003,"SC Bastia","FC Sochaux","2-0",2,0,"1",1,2,2,"H"
"21522",2003-09-27,2003,"Olympique Marseille","OGC Nice","2-1",2,1,"1",1,3,1,"H"
"21523",2003-09-27,2003,"Stade Rennes","Le Mans UC 72","2-0",2,0,"1",1,2,2,"H"
"21524",2003-09-27,2003,"Paris Saint-Germain","AJ Auxerre","1-0",1,0,"1",1,1,1,"H"
"21525",2003-09-27,2003,"AS Monaco","Toulouse FC","3-0",3,0,"1",1,3,3,"H"
"21526",2003-09-27,2003,"FC Metz","EA Guingamp","1-1",1,1,"1",1,2,0,"D"
"21527",2003-09-28,2003,"Girondins Bordeaux","AC Ajaccio","1-0",1,0,"1",1,1,1,"H"
"21528",2003-09-28,2003,"RC Strasbourg","FC Nantes","1-0",1,0,"1",1,1,1,"H"
"21529",2003-10-04,2003,"FC Nantes","Stade Rennes","1-0",1,0,"1",1,1,1,"H"
"21530",2003-10-04,2003,"AC Ajaccio","Olympique Lyon","2-4",2,4,"1",1,6,-2,"D"
"21531",2003-10-04,2003,"Toulouse FC","Montpellier HSC","2-2",2,2,"1",1,4,0,"D"
"21532",2003-10-04,2003,"OGC Nice","RC Strasbourg","0-0",0,0,"1",1,0,0,"D"
"21533",2003-10-04,2003,"Le Mans UC 72","Girondins Bordeaux","0-0",0,0,"1",1,0,0,"D"
"21534",2003-10-04,2003,"RC Lens","FC Metz","0-2",0,2,"1",1,2,-2,"D"
"21535",2003-10-04,2003,"FC Sochaux","Paris Saint-Germain","0-1",0,1,"1",1,1,-1,"D"
"21536",2003-10-04,2003,"EA Guingamp","AS Monaco","1-2",1,2,"1",1,3,-1,"D"
"21537",2003-10-04,2003,"AJ Auxerre","Lille OSC","3-0",3,0,"1",1,3,3,"H"
"21538",2003-10-05,2003,"Olympique Marseille","SC Bastia","3-1",3,1,"1",1,4,2,"H"
"21539",2003-10-17,2003,"RC Strasbourg","Olympique Marseille","4-1",4,1,"1",1,5,3,"H"
"21540",2003-10-18,2003,"AS Monaco","AJ Auxerre","1-1",1,1,"1",1,2,0,"D"
"21541",2003-10-18,2003,"Lille OSC","AC Ajaccio","0-0",0,0,"1",1,0,0,"D"
"21542",2003-10-18,2003,"SC Bastia","RC Lens","3-1",3,1,"1",1,4,2,"H"
"21543",2003-10-18,2003,"Stade Rennes","OGC Nice","0-0",0,0,"1",1,0,0,"D"
"21544",2003-10-18,2003,"Montpellier HSC","EA Guingamp","2-0",2,0,"1",1,2,2,"H"
"21545",2003-10-18,2003,"Girondins Bordeaux","Toulouse FC","1-2",1,2,"1",1,3,-1,"D"
"21546",2003-10-18,2003,"Olympique Lyon","FC Sochaux","1-1",1,1,"1",1,2,0,"D"
"21547",2003-10-18,2003,"Paris Saint-Germain","Le Mans UC 72","5-1",5,1,"1",1,6,4,"H"
"21548",2003-10-18,2003,"FC Metz","FC Nantes","1-3",1,3,"1",1,4,-2,"D"
"21549",2003-10-25,2003,"FC Nantes","Olympique Lyon","0-1",0,1,"1",1,1,-1,"D"
"21550",2003-10-25,2003,"AC Ajaccio","Paris Saint-Germain","0-0",0,0,"1",1,0,0,"D"
"21551",2003-10-25,2003,"EA Guingamp","Toulouse FC","1-0",1,0,"1",1,1,1,"H"
"21552",2003-10-25,2003,"OGC Nice","Girondins Bordeaux","0-0",0,0,"1",1,0,0,"D"
"21553",2003-10-25,2003,"Le Mans UC 72","SC Bastia","1-1",1,1,"1",1,2,0,"D"
"21554",2003-10-25,2003,"Olympique Marseille","Stade Rennes","2-0",2,0,"1",1,2,2,"H"
"21555",2003-10-25,2003,"RC Lens","Lille OSC","2-1",2,1,"1",1,3,1,"H"
"21556",2003-10-25,2003,"AJ Auxerre","Montpellier HSC","0-1",0,1,"1",1,1,-1,"D"
"21557",2003-10-25,2003,"RC Strasbourg","FC Metz","0-2",0,2,"1",1,2,-2,"D"
"21558",2003-10-26,2003,"FC Sochaux","AS Monaco","1-1",1,1,"1",1,2,0,"D"
"21559",2003-11-01,2003,"Olympique Lyon","OGC Nice","5-0",5,0,"1",1,5,5,"H"
"21560",2003-11-01,2003,"Lille OSC","EA Guingamp","1-3",1,3,"1",1,4,-2,"D"
"21561",2003-11-01,2003,"Stade Rennes","RC Strasbourg","1-1",1,1,"1",1,2,0,"D"
"21562",2003-11-01,2003,"Montpellier HSC","FC Nantes","4-1",4,1,"1",1,5,3,"H"
"21563",2003-11-01,2003,"Toulouse FC","AJ Auxerre","0-3",0,3,"1",1,3,-3,"D"
"21564",2003-11-01,2003,"Girondins Bordeaux","Olympique Marseille","1-0",1,0,"1",1,1,1,"H"
"21565",2003-11-01,2003,"SC Bastia","AC Ajaccio","1-1",1,1,"1",1,2,0,"D"
"21566",2003-11-01,2003,"AS Monaco","Le Mans UC 72","4-2",4,2,"1",1,6,2,"H"
"21567",2003-11-01,2003,"FC Metz","FC Sochaux","0-1",0,1,"1",1,1,-1,"D"
"21568",2003-11-02,2003,"Paris Saint-Germain","RC Lens","0-1",0,1,"1",1,1,-1,"D"
"21569",2003-11-08,2003,"OGC Nice","SC Bastia","2-0",2,0,"1",1,2,2,"H"
"21570",2003-11-08,2003,"Le Mans UC 72","FC Metz","2-0",2,0,"1",1,2,2,"H"
"21571",2003-11-08,2003,"Stade Rennes","Lille OSC","2-2",2,2,"1",1,4,0,"D"
"21572",2003-11-08,2003,"FC Nantes","Paris Saint-Germain","0-1",0,1,"1",1,1,-1,"D"
"21573",2003-11-09,2003,"AC Ajaccio","AS Monaco","0-1",0,1,"1",1,1,-1,"D"
"21574",2003-11-09,2003,"FC Sochaux","Toulouse FC","3-1",3,1,"1",1,4,2,"H"
"21575",2003-11-09,2003,"RC Lens","Montpellier HSC","3-2",3,2,"1",1,5,1,"H"
"21576",2003-11-09,2003,"AJ Auxerre","EA Guingamp","3-0",3,0,"1",1,3,3,"H"
"21577",2003-11-09,2003,"RC Strasbourg","Girondins Bordeaux","1-1",1,1,"1",1,2,0,"D"
"21578",2003-11-09,2003,"Olympique Marseille","Olympique Lyon","1-4",1,4,"1",1,5,-3,"D"
"21579",2003-11-21,2003,"Olympique Lyon","RC Strasbourg","1-0",1,0,"1",1,1,1,"H"
"21580",2003-11-22,2003,"AS Monaco","RC Lens","2-0",2,0,"1",1,2,2,"H"
"21581",2003-11-22,2003,"Lille OSC","Olympique Marseille","0-2",0,2,"1",1,2,-2,"D"
"21582",2003-11-22,2003,"Montpellier HSC","AC Ajaccio","3-1",3,1,"1",1,4,2,"H"
"21583",2003-11-22,2003,"EA Guingamp","FC Sochaux","1-2",1,2,"1",1,3,-1,"D"
"21584",2003-11-22,2003,"Toulouse FC","Le Mans UC 72","1-1",1,1,"1",1,2,0,"D"
"21585",2003-11-22,2003,"Girondins Bordeaux","Stade Rennes","2-1",2,1,"1",1,3,1,"H"
"21586",2003-11-22,2003,"SC Bastia","FC Nantes","1-3",1,3,"1",1,4,-2,"D"
"21587",2003-11-22,2003,"FC Metz","AJ Auxerre","0-2",0,2,"1",1,2,-2,"D"
"21588",2003-11-23,2003,"Paris Saint-Germain","OGC Nice","0-0",0,0,"1",1,0,0,"D"
"21589",2003-11-29,2003,"Stade Rennes","Olympique Lyon","3-1",3,1,"1",1,4,2,"H"
"21590",2003-11-29,2003,"AC Ajaccio","Toulouse FC","2-1",2,1,"1",1,3,1,"H"
"21591",2003-11-29,2003,"OGC Nice","FC Metz","1-1",1,1,"1",1,2,0,"D"
"21592",2003-11-29,2003,"Le Mans UC 72","Montpellier HSC","4-0",4,0,"1",1,4,4,"H"
"21593",2003-11-29,2003,"RC Strasbourg","Lille OSC","2-2",2,2,"1",1,4,0,"D"
"21594",2003-11-29,2003,"FC Nantes","AS Monaco","0-1",0,1,"1",1,1,-1,"D"
"21595",2003-11-30,2003,"FC Sochaux","AJ Auxerre","3-2",3,2,"1",1,5,1,"H"
"21596",2003-11-30,2003,"RC Lens","EA Guingamp","2-1",2,1,"1",1,3,1,"H"
"21597",2003-11-30,2003,"Girondins Bordeaux","SC Bastia","1-1",1,1,"1",1,2,0,"D"
"21598",2003-11-30,2003,"Olympique Marseille","Paris Saint-Germain","0-1",0,1,"1",1,1,-1,"D"
"21599",2003-12-03,2003,"Lille OSC","FC Nantes","2-0",2,0,"1",1,2,2,"H"
"21600",2003-12-03,2003,"EA Guingamp","AC Ajaccio","2-0",2,0,"1",1,2,2,"H"
"21601",2003-12-03,2003,"Toulouse FC","RC Lens","1-2",1,2,"1",1,3,-1,"D"
"21602",2003-12-03,2003,"SC Bastia","Stade Rennes","3-2",3,2,"1",1,5,1,"H"
"21603",2003-12-03,2003,"AJ Auxerre","Le Mans UC 72","1-0",1,0,"1",1,1,1,"H"
"21604",2003-12-03,2003,"Paris Saint-Germain","RC Strasbourg","3-2",3,2,"1",1,5,1,"H"
"21605",2003-12-05,2003,"Olympique Lyon","FC Metz","2-1",2,1,"1",1,3,1,"H"
"21606",2003-12-05,2003,"Olympique Marseille","AS Monaco","1-2",1,2,"1",1,3,-1,"D"
"21607",2003-12-06,2003,"RC Lens","FC Sochaux","0-3",0,3,"1",1,3,-3,"D"
"21608",2003-12-06,2003,"AC Ajaccio","AJ Auxerre","1-2",1,2,"1",1,3,-1,"D"
"21609",2003-12-06,2003,"Stade Rennes","Paris Saint-Germain","1-1",1,1,"1",1,2,0,"D"
"21610",2003-12-06,2003,"FC Nantes","Toulouse FC","1-1",1,1,"1",1,2,0,"D"
"21611",2003-12-06,2003,"Girondins Bordeaux","Lille OSC","2-1",2,1,"1",1,3,1,"H"
"21612",2003-12-06,2003,"RC Strasbourg","SC Bastia","4-2",4,2,"1",1,6,2,"H"
"21613",2003-12-07,2003,"OGC Nice","Montpellier HSC","2-1",2,1,"1",1,3,1,"H"
"21614",2003-12-07,2003,"Le Mans UC 72","EA Guingamp","2-0",2,0,"1",1,2,2,"H"
"21615",2003-12-13,2003,"Paris Saint-Germain","Girondins Bordeaux","2-1",2,1,"1",1,3,1,"H"
"21616",2003-12-13,2003,"Lille OSC","Le Mans UC 72","1-1",1,1,"1",1,2,0,"D"
"21617",2003-12-13,2003,"FC Sochaux","AC Ajaccio","2-0",2,0,"1",1,2,2,"H"
"21618",2003-12-13,2003,"EA Guingamp","FC Nantes","1-1",1,1,"1",1,2,0,"D"
"21619",2003-12-13,2003,"Toulouse FC","OGC Nice","1-1",1,1,"1",1,2,0,"D"
"21620",2003-12-13,2003,"FC Metz","Stade Rennes","1-1",1,1,"1",1,2,0,"D"
"21621",2003-12-13,2003,"SC Bastia","Olympique Lyon","0-0",0,0,"1",1,0,0,"D"
"21622",2003-12-13,2003,"AJ Auxerre","RC Lens","2-0",2,0,"1",1,2,2,"H"
"21623",2003-12-14,2003,"AS Monaco","RC Strasbourg","2-0",2,0,"1",1,2,2,"H"
"21624",2003-12-19,2003,"Olympique Lyon","Paris Saint-Germain","1-1",1,1,"1",1,2,0,"D"
"21625",2003-12-20,2003,"Olympique Marseille","Toulouse FC","1-0",1,0,"1",1,1,1,"H"
"21626",2003-12-20,2003,"AC Ajaccio","RC Lens","2-0",2,0,"1",1,2,2,"H"
"21627",2003-12-20,2003,"Stade Rennes","AS Monaco","1-0",1,0,"1",1,1,1,"H"
"21628",2003-12-20,2003,"OGC Nice","EA Guingamp","2-0",2,0,"1",1,2,2,"H"
"21629",2003-12-20,2003,"Le Mans UC 72","FC Sochaux","2-2",2,2,"1",1,4,0,"D"
"21630",2003-12-20,2003,"SC Bastia","Lille OSC","0-2",0,2,"1",1,2,-2,"D"
"21631",2003-12-20,2003,"FC Nantes","AJ Auxerre","1-0",1,0,"1",1,1,1,"H"
"21632",2003-12-20,2003,"Girondins Bordeaux","FC Metz","2-0",2,0,"1",1,2,2,"H"
"21633",2003-12-20,2003,"RC Strasbourg","Montpellier HSC","4-2",4,2,"1",1,6,2,"H"
"21634",2004-01-09,2003,"AS Monaco","Olympique Lyon","3-0",3,0,"1",1,3,3,"H"
"21635",2004-01-10,2003,"Paris Saint-Germain","Lille OSC","1-0",1,0,"1",1,1,1,"H"
"21636",2004-01-10,2003,"Toulouse FC","Stade Rennes","2-0",2,0,"1",1,2,2,"H"
"21637",2004-01-10,2003,"FC Sochaux","OGC Nice","0-0",0,0,"1",1,0,0,"D"
"21638",2004-01-10,2003,"AC Ajaccio","Le Mans UC 72","2-0",2,0,"1",1,2,2,"H"
"21639",2004-01-10,2003,"FC Metz","SC Bastia","1-0",1,0,"1",1,1,1,"H"
"21640",2004-01-10,2003,"RC Lens","FC Nantes","0-0",0,0,"1",1,0,0,"D"
"21641",2004-01-10,2003,"AJ Auxerre","Olympique Marseille","2-0",2,0,"1",1,2,2,"H"
"21642",2004-01-10,2003,"Montpellier HSC","Girondins Bordeaux","1-2",1,2,"1",1,3,-1,"D"
"21643",2004-01-10,2003,"EA Guingamp","RC Strasbourg","3-2",3,2,"1",1,5,1,"H"
"21644",2004-01-17,2003,"SC Bastia","AS Monaco","0-0",0,0,"1",1,0,0,"D"
"21645",2004-01-17,2003,"FC Nantes","AC Ajaccio","4-0",4,0,"1",1,4,4,"H"
"21646",2004-01-17,2003,"Girondins Bordeaux","EA Guingamp","2-0",2,0,"1",1,2,2,"H"
"21647",2004-01-17,2003,"Lille OSC","Toulouse FC","0-1",0,1,"1",1,1,-1,"D"
"21648",2004-01-17,2003,"OGC Nice","Le Mans UC 72","0-1",0,1,"1",1,1,-1,"D"
"21649",2004-01-17,2003,"Olympique Lyon","Montpellier HSC","3-0",3,0,"1",1,3,3,"H"
"21650",2004-01-17,2003,"Stade Rennes","FC Sochaux","4-0",4,0,"1",1,4,4,"H"
"21651",2004-01-17,2003,"RC Strasbourg","AJ Auxerre","0-2",0,2,"1",1,2,-2,"D"
"21652",2004-01-17,2003,"Paris Saint-Germain","FC Metz","0-0",0,0,"1",1,0,0,"D"
"21653",2004-01-18,2003,"Olympique Marseille","RC Lens","3-2",3,2,"1",1,5,1,"H"
"21654",2004-01-21,2003,"AS Monaco","OGC Nice","1-1",1,1,"1",1,2,0,"D"
"21655",2004-01-21,2003,"Montpellier HSC","FC Sochaux","1-3",1,3,"1",1,4,-2,"D"
"21656",2004-01-27,2003,"FC Metz","Olympique Marseille","1-1",1,1,"1",1,2,0,"D"
"21657",2004-01-28,2003,"Olympique Lyon","Girondins Bordeaux","3-0",3,0,"1",1,3,3,"H"
"21658",2004-01-30,2003,"AS Monaco","Paris Saint-Germain","1-1",1,1,"1",1,2,0,"D"
"21659",2004-01-31,2003,"AJ Auxerre","Girondins Bordeaux","5-0",5,0,"1",1,5,5,"H"
"21660",2004-01-31,2003,"FC Metz","Lille OSC","0-1",0,1,"1",1,1,-1,"D"
"21661",2004-01-31,2003,"FC Sochaux","Olympique Marseille","2-1",2,1,"1",1,3,1,"H"
"21662",2004-01-31,2003,"EA Guingamp","Stade Rennes","0-2",0,2,"1",1,2,-2,"D"
"21663",2004-01-31,2003,"AC Ajaccio","OGC Nice","1-1",1,1,"1",1,2,0,"D"
"21664",2004-01-31,2003,"RC Lens","RC Strasbourg","2-1",2,1,"1",1,3,1,"H"
"21665",2004-01-31,2003,"Montpellier HSC","SC Bastia","1-1",1,1,"1",1,2,0,"D"
"21666",2004-01-31,2003,"Le Mans UC 72","FC Nantes","0-1",0,1,"1",1,1,-1,"D"
"21667",2004-01-31,2003,"Toulouse FC","Olympique Lyon","0-1",0,1,"1",1,1,-1,"D"
"21668",2004-02-04,2003,"Montpellier HSC","Olympique Marseille","0-1",0,1,"1",1,1,-1,"D"
"21669",2004-02-06,2003,"Girondins Bordeaux","FC Nantes","2-0",2,0,"1",1,2,2,"H"
"21670",2004-02-07,2003,"Olympique Marseille","AC Ajaccio","2-1",2,1,"1",1,3,1,"H"
"21671",2004-02-07,2003,"Olympique Lyon","EA Guingamp","0-1",0,1,"1",1,1,-1,"D"
"21672",2004-02-07,2003,"SC Bastia","Toulouse FC","1-0",1,0,"1",1,1,1,"H"
"21673",2004-02-07,2003,"RC Strasbourg","Le Mans UC 72","3-0",3,0,"1",1,3,3,"H"
"21674",2004-02-07,2003,"OGC Nice","RC Lens","4-0",4,0,"1",1,4,4,"H"
"21675",2004-02-07,2003,"Paris Saint-Germain","Montpellier HSC","6-1",6,1,"1",1,7,5,"H"
"21676",2004-02-07,2003,"Lille OSC","FC Sochaux","2-0",2,0,"1",1,2,2,"H"
"21677",2004-02-07,2003,"FC Metz","AS Monaco","0-2",0,2,"1",1,2,-2,"D"
"21678",2004-02-07,2003,"Stade Rennes","AJ Auxerre","0-2",0,2,"1",1,2,-2,"D"
"21679",2004-02-14,2003,"FC Sochaux","Girondins Bordeaux","1-1",1,1,"1",1,2,0,"D"
"21680",2004-02-14,2003,"AS Monaco","Lille OSC","0-1",0,1,"1",1,1,-1,"D"
"21681",2004-02-14,2003,"Le Mans UC 72","Olympique Marseille","0-0",0,0,"1",1,0,0,"D"
"21682",2004-02-14,2003,"RC Lens","Stade Rennes","2-1",2,1,"1",1,3,1,"H"
"21683",2004-02-14,2003,"FC Nantes","OGC Nice","3-1",3,1,"1",1,4,2,"H"
"21684",2004-02-14,2003,"AC Ajaccio","RC Strasbourg","0-0",0,0,"1",1,0,0,"D"
"21685",2004-02-14,2003,"EA Guingamp","SC Bastia","1-0",1,0,"1",1,1,1,"H"
"21686",2004-02-14,2003,"Toulouse FC","Paris Saint-Germain","0-1",0,1,"1",1,1,-1,"D"
"21687",2004-02-14,2003,"Montpellier HSC","FC Metz","0-1",0,1,"1",1,1,-1,"D"
"21688",2004-02-15,2003,"AJ Auxerre","Olympique Lyon","1-2",1,2,"1",1,3,-1,"D"
"21689",2004-02-20,2003,"AS Monaco","Montpellier HSC","4-0",4,0,"1",1,4,4,"H"
"21690",2004-02-21,2003,"Olympique Lyon","Le Mans UC 72","2-0",2,0,"1",1,2,2,"H"
"21691",2004-02-21,2003,"Stade Rennes","AC Ajaccio","4-1",4,1,"1",1,5,3,"H"
"21692",2004-02-21,2003,"FC Metz","Toulouse FC","0-2",0,2,"1",1,2,-2,"D"
"21693",2004-02-21,2003,"Lille OSC","OGC Nice","1-2",1,2,"1",1,3,-1,"D"
"21694",2004-02-21,2003,"RC Strasbourg","FC Sochaux","0-2",0,2,"1",1,2,-2,"D"
"21695",2004-02-21,2003,"Paris Saint-Germain","EA Guingamp","2-0",2,0,"1",1,2,2,"H"
"21696",2004-02-21,2003,"SC Bastia","AJ Auxerre","0-0",0,0,"1",1,0,0,"D"
"21697",2004-02-21,2003,"Girondins Bordeaux","RC Lens","0-0",0,0,"1",1,0,0,"D"
"21698",2004-02-22,2003,"Olympique Marseille","FC Nantes","1-1",1,1,"1",1,2,0,"D"
"21699",2004-02-28,2003,"FC Nantes","RC Strasbourg","1-1",1,1,"1",1,2,0,"D"
"21700",2004-02-28,2003,"Montpellier HSC","Lille OSC","0-2",0,2,"1",1,2,-2,"D"
"21701",2004-02-28,2003,"Le Mans UC 72","Stade Rennes","2-2",2,2,"1",1,4,0,"D"
"21702",2004-02-28,2003,"RC Lens","Olympique Lyon","1-1",1,1,"1",1,2,0,"D"
"21703",2004-02-28,2003,"Toulouse FC","AS Monaco","1-1",1,1,"1",1,2,0,"D"
"21704",2004-02-29,2003,"FC Sochaux","SC Bastia","2-1",2,1,"1",1,3,1,"H"
"21705",2004-02-29,2003,"OGC Nice","Olympique Marseille","0-0",0,0,"1",1,0,0,"D"
"21706",2004-02-29,2003,"AC Ajaccio","Girondins Bordeaux","1-0",1,0,"1",1,1,1,"H"
"21707",2004-02-29,2003,"AJ Auxerre","Paris Saint-Germain","1-1",1,1,"1",1,2,0,"D"
"21708",2004-03-05,2003,"Olympique Lyon","AC Ajaccio","4-0",4,0,"1",1,4,4,"H"
"21709",2004-03-05,2003,"AS Monaco","EA Guingamp","3-1",3,1,"1",1,4,2,"H"
"21710",2004-03-06,2003,"Lille OSC","AJ Auxerre","1-0",1,0,"1",1,1,1,"H"
"21711",2004-03-06,2003,"Montpellier HSC","Toulouse FC","0-1",0,1,"1",1,1,-1,"D"
"21712",2004-03-06,2003,"RC Strasbourg","OGC Nice","2-2",2,2,"1",1,4,0,"D"
"21713",2004-03-06,2003,"Girondins Bordeaux","Le Mans UC 72","2-0",2,0,"1",1,2,2,"H"
"21714",2004-03-06,2003,"FC Metz","RC Lens","0-2",0,2,"1",1,2,-2,"D"
"21715",2004-03-06,2003,"Paris Saint-Germain","FC Sochaux","1-1",1,1,"1",1,2,0,"D"
"21716",2004-03-06,2003,"Stade Rennes","FC Nantes","0-3",0,3,"1",1,3,-3,"D"
"21717",2004-03-07,2003,"SC Bastia","Olympique Marseille","4-1",4,1,"1",1,5,3,"H"
"21718",2004-03-13,2003,"Le Mans UC 72","Paris Saint-Germain","0-1",0,1,"1",1,1,-1,"D"
"21719",2004-03-13,2003,"AC Ajaccio","Lille OSC","0-3",0,3,"1",1,3,-3,"D"
"21720",2004-03-13,2003,"RC Lens","SC Bastia","0-0",0,0,"1",1,0,0,"D"
"21721",2004-03-13,2003,"OGC Nice","Stade Rennes","3-1",3,1,"1",1,4,2,"H"
"21722",2004-03-13,2003,"EA Guingamp","Montpellier HSC","4-3",4,3,"1",1,7,1,"H"
"21723",2004-03-13,2003,"FC Sochaux","Olympique Lyon","1-2",1,2,"1",1,3,-1,"D"
"21724",2004-03-13,2003,"FC Nantes","FC Metz","2-2",2,2,"1",1,4,0,"D"
"21725",2004-03-14,2003,"Toulouse FC","Girondins Bordeaux","1-0",1,0,"1",1,1,1,"H"
"21726",2004-03-14,2003,"Olympique Marseille","RC Strasbourg","4-0",4,0,"1",1,4,4,"H"
"21727",2004-03-14,2003,"AJ Auxerre","AS Monaco","0-0",0,0,"1",1,0,0,"D"
"21728",2004-03-19,2003,"Toulouse FC","EA Guingamp","0-0",0,0,"1",1,0,0,"D"
"21729",2004-03-20,2003,"Olympique Lyon","FC Nantes","1-0",1,0,"1",1,1,1,"H"
"21730",2004-03-20,2003,"Paris Saint-Germain","AC Ajaccio","1-0",1,0,"1",1,1,1,"H"
"21731",2004-03-20,2003,"Girondins Bordeaux","OGC Nice","1-1",1,1,"1",1,2,0,"D"
"21732",2004-03-20,2003,"SC Bastia","Le Mans UC 72","0-0",0,0,"1",1,0,0,"D"
"21733",2004-03-20,2003,"Lille OSC","RC Lens","1-1",1,1,"1",1,2,0,"D"
"21734",2004-03-20,2003,"AS Monaco","FC Sochaux","1-1",1,1,"1",1,2,0,"D"
"21735",2004-03-20,2003,"Montpellier HSC","AJ Auxerre","1-0",1,0,"1",1,1,1,"H"
"21736",2004-03-20,2003,"FC Metz","RC Strasbourg","1-0",1,0,"1",1,1,1,"H"
"21737",2004-03-21,2003,"Stade Rennes","Olympique Marseille","4-3",4,3,"1",1,7,1,"H"
"21738",2004-03-27,2003,"FC Sochaux","FC Metz","2-0",2,0,"1",1,2,2,"H"
"21739",2004-03-27,2003,"EA Guingamp","Lille OSC","2-1",2,1,"1",1,3,1,"H"
"21740",2004-03-27,2003,"RC Strasbourg","Stade Rennes","0-3",0,3,"1",1,3,-3,"D"
"21741",2004-03-27,2003,"FC Nantes","Montpellier HSC","3-2",3,2,"1",1,5,1,"H"
"21742",2004-03-27,2003,"OGC Nice","Olympique Lyon","0-1",0,1,"1",1,1,-1,"D"
"21743",2004-03-27,2003,"AC Ajaccio","SC Bastia","1-0",1,0,"1",1,1,1,"H"
"21744",2004-03-27,2003,"Le Mans UC 72","AS Monaco","0-1",0,1,"1",1,1,-1,"D"
"21745",2004-03-28,2003,"AJ Auxerre","Toulouse FC","3-2",3,2,"1",1,5,1,"H"
"21746",2004-03-28,2003,"Olympique Marseille","Girondins Bordeaux","1-1",1,1,"1",1,2,0,"D"
"21747",2004-03-28,2003,"RC Lens","Paris Saint-Germain","1-0",1,0,"1",1,1,1,"H"
"21748",2004-04-02,2003,"AS Monaco","AC Ajaccio","3-3",3,3,"1",1,6,0,"D"
"21749",2004-04-03,2003,"Olympique Lyon","Olympique Marseille","1-2",1,2,"1",1,3,-1,"D"
"21750",2004-04-03,2003,"Toulouse FC","FC Sochaux","0-0",0,0,"1",1,0,0,"D"
"21751",2004-04-03,2003,"SC Bastia","OGC Nice","2-1",2,1,"1",1,3,1,"H"
"21752",2004-04-03,2003,"FC Metz","Le Mans UC 72","5-0",5,0,"1",1,5,5,"H"
"21753",2004-04-03,2003,"Montpellier HSC","RC Lens","1-0",1,0,"1",1,1,1,"H"
"21754",2004-04-03,2003,"Lille OSC","Stade Rennes","1-0",1,0,"1",1,1,1,"H"
"21755",2004-04-03,2003,"Girondins Bordeaux","RC Strasbourg","1-1",1,1,"1",1,2,0,"D"
"21756",2004-04-03,2003,"Paris Saint-Germain","FC Nantes","3-2",3,2,"1",1,5,1,"H"
"21757",2004-04-04,2003,"EA Guingamp","AJ Auxerre","2-2",2,2,"1",1,4,0,"D"
"21758",2004-04-10,2003,"RC Lens","AS Monaco","0-0",0,0,"1",1,0,0,"D"
"21759",2004-04-10,2003,"AC Ajaccio","Montpellier HSC","0-0",0,0,"1",1,0,0,"D"
"21760",2004-04-10,2003,"FC Sochaux","EA Guingamp","2-0",2,0,"1",1,2,2,"H"
"21761",2004-04-10,2003,"Le Mans UC 72","Toulouse FC","2-1",2,1,"1",1,3,1,"H"
"21762",2004-04-10,2003,"FC Nantes","SC Bastia","1-1",1,1,"1",1,2,0,"D"
"21763",2004-04-10,2003,"OGC Nice","Paris Saint-Germain","1-2",1,2,"1",1,3,-1,"D"
"21764",2004-04-10,2003,"AJ Auxerre","FC Metz","2-1",2,1,"1",1,3,1,"H"
"21765",2004-04-11,2003,"RC Strasbourg","Olympique Lyon","0-1",0,1,"1",1,1,-1,"D"
"21766",2004-04-16,2003,"EA Guingamp","FC Metz","1-1",1,1,"1",1,2,0,"D"
"21767",2004-04-18,2003,"Olympique Marseille","Lille OSC","2-1",2,1,"1",1,3,1,"H"
"21768",2004-04-18,2003,"Stade Rennes","Girondins Bordeaux","3-1",3,1,"1",1,4,2,"H"
"21769",2004-04-24,2003,"AS Monaco","FC Nantes","0-1",0,1,"1",1,1,-1,"D"
"21770",2004-04-24,2003,"Toulouse FC","AC Ajaccio","3-1",3,1,"1",1,4,2,"H"
"21771",2004-04-24,2003,"AJ Auxerre","FC Sochaux","2-1",2,1,"1",1,3,1,"H"
"21772",2004-04-24,2003,"FC Metz","OGC Nice","1-0",1,0,"1",1,1,1,"H"
"21773",2004-04-24,2003,"Montpellier HSC","Le Mans UC 72","0-3",0,3,"1",1,3,-3,"D"
"21774",2004-04-24,2003,"EA Guingamp","RC Lens","1-0",1,0,"1",1,1,1,"H"
"21775",2004-04-24,2003,"Olympique Lyon","Stade Rennes","3-0",3,0,"1",1,3,3,"H"
"21776",2004-04-24,2003,"SC Bastia","Girondins Bordeaux","0-2",0,2,"1",1,2,-2,"D"
"21777",2004-04-24,2003,"Lille OSC","RC Strasbourg","0-1",0,1,"1",1,1,-1,"D"
"21778",2004-04-25,2003,"Paris Saint-Germain","Olympique Marseille","2-1",2,1,"1",1,3,1,"H"
"21779",2004-04-30,2003,"OGC Nice","AS Monaco","1-2",1,2,"1",1,3,-1,"D"
"21780",2004-05-01,2003,"Olympique Marseille","FC Metz","0-1",0,1,"1",1,1,-1,"D"
"21781",2004-05-01,2003,"FC Nantes","Lille OSC","2-0",2,0,"1",1,2,2,"H"
"21782",2004-05-01,2003,"FC Sochaux","Montpellier HSC","3-1",3,1,"1",1,4,2,"H"
"21783",2004-05-01,2003,"AC Ajaccio","EA Guingamp","0-0",0,0,"1",1,0,0,"D"
"21784",2004-05-01,2003,"RC Lens","Toulouse FC","1-1",1,1,"1",1,2,0,"D"
"21785",2004-05-01,2003,"Stade Rennes","SC Bastia","4-0",4,0,"1",1,4,4,"H"
"21786",2004-05-01,2003,"RC Strasbourg","Paris Saint-Germain","0-0",0,0,"1",1,0,0,"D"
"21787",2004-05-01,2003,"Le Mans UC 72","AJ Auxerre","2-1",2,1,"1",1,3,1,"H"
"21788",2004-05-02,2003,"Girondins Bordeaux","Olympique Lyon","1-1",1,1,"1",1,2,0,"D"
"21789",2004-05-08,2003,"Paris Saint-Germain","Stade Rennes","1-0",1,0,"1",1,1,1,"H"
"21790",2004-05-08,2003,"AJ Auxerre","AC Ajaccio","1-1",1,1,"1",1,2,0,"D"
"21791",2004-05-08,2003,"Montpellier HSC","OGC Nice","2-2",2,2,"1",1,4,0,"D"
"21792",2004-05-08,2003,"EA Guingamp","Le Mans UC 72","2-4",2,4,"1",1,6,-2,"D"
"21793",2004-05-08,2003,"Toulouse FC","FC Nantes","0-1",0,1,"1",1,1,-1,"D"
"21794",2004-05-08,2003,"FC Sochaux","RC Lens","0-3",0,3,"1",1,3,-3,"D"
"21795",2004-05-08,2003,"Lille OSC","Girondins Bordeaux","2-1",2,1,"1",1,3,1,"H"
"21796",2004-05-08,2003,"FC Metz","Olympique Lyon","1-2",1,2,"1",1,3,-1,"D"
"21797",2004-05-08,2003,"SC Bastia","RC Strasbourg","0-0",0,0,"1",1,0,0,"D"
"21798",2004-05-09,2003,"AS Monaco","Olympique Marseille","1-0",1,0,"1",1,1,1,"H"
"21799",2004-05-11,2003,"RC Lens","AJ Auxerre","1-3",1,3,"1",1,4,-2,"D"
"21800",2004-05-11,2003,"Girondins Bordeaux","Paris Saint-Germain","3-0",3,0,"1",1,3,3,"H"
"21801",2004-05-12,2003,"Le Mans UC 72","Lille OSC","1-1",1,1,"1",1,2,0,"D"
"21802",2004-05-12,2003,"AC Ajaccio","FC Sochaux","1-0",1,0,"1",1,1,1,"H"
"21803",2004-05-12,2003,"FC Nantes","EA Guingamp","0-0",0,0,"1",1,0,0,"D"
"21804",2004-05-12,2003,"OGC Nice","Toulouse FC","1-1",1,1,"1",1,2,0,"D"
"21805",2004-05-12,2003,"Stade Rennes","FC Metz","0-0",0,0,"1",1,0,0,"D"
"21806",2004-05-12,2003,"Olympique Lyon","SC Bastia","1-0",1,0,"1",1,1,1,"H"
"21807",2004-05-12,2003,"Olympique Marseille","Montpellier HSC","1-1",1,1,"1",1,2,0,"D"
"21808",2004-05-12,2003,"RC Strasbourg","AS Monaco","0-0",0,0,"1",1,0,0,"D"
"21809",2004-05-15,2003,"RC Lens","AC Ajaccio","2-0",2,0,"1",1,2,2,"H"
"21810",2004-05-15,2003,"AS Monaco","Stade Rennes","1-4",1,4,"1",1,5,-3,"D"
"21811",2004-05-15,2003,"EA Guingamp","OGC Nice","1-2",1,2,"1",1,3,-1,"D"
"21812",2004-05-15,2003,"FC Sochaux","Le Mans UC 72","3-0",3,0,"1",1,3,3,"H"
"21813",2004-05-15,2003,"Lille OSC","SC Bastia","2-0",2,0,"1",1,2,2,"H"
"21814",2004-05-15,2003,"AJ Auxerre","FC Nantes","2-0",2,0,"1",1,2,2,"H"
"21815",2004-05-15,2003,"Toulouse FC","Olympique Marseille","2-1",2,1,"1",1,3,1,"H"
"21816",2004-05-15,2003,"FC Metz","Girondins Bordeaux","3-1",3,1,"1",1,4,2,"H"
"21817",2004-05-15,2003,"Paris Saint-Germain","Olympique Lyon","1-0",1,0,"1",1,1,1,"H"
"21818",2004-05-15,2003,"Montpellier HSC","RC Strasbourg","1-2",1,2,"1",1,3,-1,"D"
"21819",2004-05-21,2003,"Girondins Bordeaux","AS Monaco","1-3",1,3,"1",1,4,-2,"D"
"21820",2004-05-23,2003,"Olympique Lyon","Lille OSC","3-0",3,0,"1",1,3,3,"H"
"21821",2004-05-23,2003,"FC Nantes","FC Sochaux","3-1",3,1,"1",1,4,2,"H"
"21822",2004-05-23,2003,"Olympique Marseille","EA Guingamp","2-1",2,1,"1",1,3,1,"H"
"21823",2004-05-23,2003,"RC Strasbourg","Toulouse FC","0-0",0,0,"1",1,0,0,"D"
"21824",2004-05-23,2003,"AC Ajaccio","FC Metz","3-1",3,1,"1",1,4,2,"H"
"21825",2004-05-23,2003,"Le Mans UC 72","RC Lens","3-0",3,0,"1",1,3,3,"H"
"21826",2004-05-23,2003,"Stade Rennes","Montpellier HSC","4-0",4,0,"1",1,4,4,"H"
"21827",2004-05-23,2003,"SC Bastia","Paris Saint-Germain","0-1",0,1,"1",1,1,-1,"D"
"21828",2004-05-23,2003,"OGC Nice","AJ Auxerre","1-1",1,1,"1",1,2,0,"D"
"21829",2004-08-06,2004,"OGC Nice","Olympique Lyon","0-1",0,1,"1",1,1,-1,"D"
"21830",2004-08-07,2004,"AS Saint-Etienne","AS Monaco","0-1",0,1,"1",1,1,-1,"D"
"21831",2004-08-07,2004,"SC Bastia","RC Strasbourg","2-1",2,1,"1",1,3,1,"H"
"21832",2004-08-07,2004,"SM Caen","FC Istres","1-1",1,1,"1",1,2,0,"D"
"21833",2004-08-07,2004,"Lille OSC","AJ Auxerre","2-0",2,0,"1",1,2,2,"H"
"21834",2004-08-07,2004,"Olympique Marseille","Girondins Bordeaux","1-0",1,0,"1",1,1,1,"H"
"21835",2004-08-07,2004,"FC Metz","FC Nantes","1-0",1,0,"1",1,1,1,"H"
"21836",2004-08-07,2004,"Stade Rennes","Paris Saint-Germain","2-1",2,1,"1",1,3,1,"H"
"21837",2004-08-07,2004,"FC Sochaux","AC Ajaccio","1-0",1,0,"1",1,1,1,"H"
"21838",2004-08-07,2004,"Toulouse FC","RC Lens","0-0",0,0,"1",1,0,0,"D"
"21839",2004-08-14,2004,"Paris Saint-Germain","SM Caen","2-2",2,2,"1",1,4,0,"D"
"21840",2004-08-14,2004,"AC Ajaccio","FC Metz","1-2",1,2,"1",1,3,-1,"D"
"21841",2004-08-14,2004,"AJ Auxerre","Stade Rennes","3-1",3,1,"1",1,4,2,"H"
"21842",2004-08-14,2004,"Girondins Bordeaux","OGC Nice","5-1",5,1,"1",1,6,4,"H"
"21843",2004-08-14,2004,"RC Lens","AS Saint-Etienne","3-0",3,0,"1",1,3,3,"H"
"21844",2004-08-14,2004,"Olympique Lyon","FC Sochaux","1-1",1,1,"1",1,2,0,"D"
"21845",2004-08-14,2004,"AS Monaco","FC Istres","2-1",2,1,"1",1,3,1,"H"
"21846",2004-08-14,2004,"FC Nantes","SC Bastia","1-1",1,1,"1",1,2,0,"D"
"21847",2004-08-14,2004,"RC Strasbourg","Toulouse FC","1-4",1,4,"1",1,5,-3,"D"
"21848",2004-08-15,2004,"Olympique Marseille","Lille OSC","3-0",3,0,"1",1,3,3,"H"
"21849",2004-08-21,2004,"OGC Nice","Olympique Marseille","1-1",1,1,"1",1,2,0,"D"
"21850",2004-08-21,2004,"SC Bastia","AC Ajaccio","1-0",1,0,"1",1,1,1,"H"
"21851",2004-08-21,2004,"SM Caen","AS Monaco","1-0",1,0,"1",1,1,1,"H"
"21852",2004-08-21,2004,"FC Istres","RC Lens","0-2",0,2,"1",1,2,-2,"D"
"21853",2004-08-21,2004,"Lille OSC","Girondins Bordeaux","0-0",0,0,"1",1,0,0,"D"
"21854",2004-08-21,2004,"Stade Rennes","FC Nantes","1-0",1,0,"1",1,1,1,"H"
"21855",2004-08-21,2004,"AS Saint-Etienne","RC Strasbourg","1-1",1,1,"1",1,2,0,"D"
"21856",2004-08-21,2004,"FC Sochaux","AJ Auxerre","1-2",1,2,"1",1,3,-1,"D"
"21857",2004-08-21,2004,"Toulouse FC","Paris Saint-Germain","2-1",2,1,"1",1,3,1,"H"
"21858",2004-08-22,2004,"FC Metz","Olympique Lyon","1-1",1,1,"1",1,2,0,"D"
"21859",2004-08-27,2004,"OGC Nice","SC Bastia","1-1",1,1,"1",1,2,0,"D"
"21860",2004-08-28,2004,"Girondins Bordeaux","FC Sochaux","2-0",2,0,"1",1,2,2,"H"
"21861",2004-08-28,2004,"AC Ajaccio","Stade Rennes","1-1",1,1,"1",1,2,0,"D"
"21862",2004-08-28,2004,"AJ Auxerre","SM Caen","1-0",1,0,"1",1,1,1,"H"
"21863",2004-08-28,2004,"RC Lens","AS Monaco","1-1",1,1,"1",1,2,0,"D"
"21864",2004-08-28,2004,"Olympique Lyon","Lille OSC","1-0",1,0,"1",1,1,1,"H"
"21865",2004-08-28,2004,"Olympique Marseille","FC Metz","1-3",1,3,"1",1,4,-2,"D"
"21866",2004-08-28,2004,"FC Nantes","Toulouse FC","2-2",2,2,"1",1,4,0,"D"
"21867",2004-08-28,2004,"RC Strasbourg","FC Istres","1-1",1,1,"1",1,2,0,"D"
"21868",2004-08-29,2004,"Paris Saint-Germain","AS Saint-Etienne","2-2",2,2,"1",1,4,0,"D"
"21869",2004-09-11,2004,"SC Bastia","AJ Auxerre","1-0",1,0,"1",1,1,1,"H"
"21870",2004-09-11,2004,"SM Caen","RC Lens","1-0",1,0,"1",1,1,1,"H"
"21871",2004-09-11,2004,"FC Istres","Paris Saint-Germain","1-1",1,1,"1",1,2,0,"D"
"21872",2004-09-11,2004,"Lille OSC","OGC Nice","1-0",1,0,"1",1,1,1,"H"
"21873",2004-09-11,2004,"FC Metz","Girondins Bordeaux","0-0",0,0,"1",1,0,0,"D"
"21874",2004-09-11,2004,"AS Monaco","RC Strasbourg","3-1",3,1,"1",1,4,2,"H"
"21875",2004-09-11,2004,"AS Saint-Etienne","FC Nantes","0-0",0,0,"1",1,0,0,"D"
"21876",2004-09-11,2004,"Toulouse FC","AC Ajaccio","3-1",3,1,"1",1,4,2,"H"
"21877",2004-09-11,2004,"Stade Rennes","Olympique Lyon","1-2",1,2,"1",1,3,-1,"D"
"21878",2004-09-12,2004,"FC Sochaux","Olympique Marseille","2-0",2,0,"1",1,2,2,"H"
"21879",2004-09-18,2004,"Girondins Bordeaux","Stade Rennes","0-0",0,0,"1",1,0,0,"D"
"21880",2004-09-18,2004,"AC Ajaccio","AS Saint-Etienne","1-1",1,1,"1",1,2,0,"D"
"21881",2004-09-18,2004,"Olympique Lyon","SC Bastia","0-0",0,0,"1",1,0,0,"D"
"21882",2004-09-18,2004,"Olympique Marseille","Toulouse FC","1-0",1,0,"1",1,1,1,"H"
"21883",2004-09-18,2004,"FC Nantes","FC Istres","1-0",1,0,"1",1,1,1,"H"
"21884",2004-09-18,2004,"RC Strasbourg","RC Lens","2-2",2,2,"1",1,4,0,"D"
"21885",2004-09-19,2004,"AJ Auxerre","FC Metz","4-0",4,0,"1",1,4,4,"H"
"21886",2004-09-19,2004,"Lille OSC","SM Caen","2-0",2,0,"1",1,2,2,"H"
"21887",2004-09-19,2004,"OGC Nice","FC Sochaux","2-1",2,1,"1",1,3,1,"H"
"21888",2004-09-19,2004,"Paris Saint-Germain","AS Monaco","0-1",0,1,"1",1,1,-1,"D"
"21889",2004-09-21,2004,"Toulouse FC","Olympique Lyon","0-2",0,2,"1",1,2,-2,"D"
"21890",2004-09-22,2004,"Stade Rennes","Olympique Marseille","1-0",1,0,"1",1,1,1,"H"
"21891",2004-09-22,2004,"SC Bastia","Girondins Bordeaux","1-4",1,4,"1",1,5,-3,"D"
"21892",2004-09-22,2004,"SM Caen","RC Strasbourg","0-0",0,0,"1",1,0,0,"D"
"21893",2004-09-22,2004,"FC Istres","AC Ajaccio","0-1",0,1,"1",1,1,-1,"D"
"21894",2004-09-22,2004,"RC Lens","Paris Saint-Germain","2-2",2,2,"1",1,4,0,"D"
"21895",2004-09-22,2004,"FC Metz","OGC Nice","1-1",1,1,"1",1,2,0,"D"
"21896",2004-09-22,2004,"AS Monaco","FC Nantes","2-1",2,1,"1",1,3,1,"H"
"21897",2004-09-22,2004,"AS Saint-Etienne","AJ Auxerre","3-1",3,1,"1",1,4,2,"H"
"21898",2004-09-22,2004,"FC Sochaux","Lille OSC","0-2",0,2,"1",1,2,-2,"D"
"21899",2004-09-25,2004,"Olympique Lyon","AS Monaco","0-0",0,0,"1",1,0,0,"D"
"21900",2004-09-25,2004,"AC Ajaccio","SM Caen","2-2",2,2,"1",1,4,0,"D"
"21901",2004-09-25,2004,"AJ Auxerre","FC Istres","0-0",0,0,"1",1,0,0,"D"
"21902",2004-09-25,2004,"Girondins Bordeaux","Toulouse FC","1-1",1,1,"1",1,2,0,"D"
"21903",2004-09-25,2004,"Lille OSC","FC Metz","4-0",4,0,"1",1,4,4,"H"
"21904",2004-09-25,2004,"Olympique Marseille","SC Bastia","1-0",1,0,"1",1,1,1,"H"
"21905",2004-09-25,2004,"OGC Nice","Stade Rennes","2-0",2,0,"1",1,2,2,"H"
"21906",2004-09-25,2004,"Paris Saint-Germain","RC Strasbourg","1-0",1,0,"1",1,1,1,"H"
"21907",2004-09-25,2004,"FC Sochaux","AS Saint-Etienne","2-1",2,1,"1",1,3,1,"H"
"21908",2004-09-26,2004,"FC Nantes","RC Lens","1-0",1,0,"1",1,1,1,"H"
"21909",2004-10-02,2004,"FC Istres","Olympique Marseille","0-2",0,2,"1",1,2,-2,"D"
"21910",2004-10-02,2004,"SC Bastia","Paris Saint-Germain","1-2",1,2,"1",1,3,-1,"D"
"21911",2004-10-02,2004,"SM Caen","Girondins Bordeaux","1-1",1,1,"1",1,2,0,"D"
"21912",2004-10-02,2004,"RC Lens","AC Ajaccio","1-1",1,1,"1",1,2,0,"D"
"21913",2004-10-02,2004,"AS Monaco","OGC Nice","3-4",3,4,"1",1,7,-1,"D"
"21914",2004-10-02,2004,"RC Strasbourg","FC Nantes","0-2",0,2,"1",1,2,-2,"D"
"21915",2004-10-03,2004,"FC Metz","FC Sochaux","0-0",0,0,"1",1,0,0,"D"
"21916",2004-10-03,2004,"Stade Rennes","Lille OSC","0-1",0,1,"1",1,1,-1,"D"
"21917",2004-10-03,2004,"Toulouse FC","AJ Auxerre","1-2",1,2,"1",1,3,-1,"D"
"21918",2004-10-03,2004,"AS Saint-Etienne","Olympique Lyon","2-3",2,3,"1",1,5,-1,"D"
"21919",2004-10-15,2004,"Olympique Lyon","SM Caen","4-0",4,0,"1",1,4,4,"H"
"21920",2004-10-16,2004,"AJ Auxerre","RC Lens","3-0",3,0,"1",1,3,3,"H"
"21921",2004-10-16,2004,"AC Ajaccio","RC Strasbourg","2-2",2,2,"1",1,4,0,"D"
"21922",2004-10-16,2004,"Girondins Bordeaux","FC Istres","2-2",2,2,"1",1,4,0,"D"
"21923",2004-10-16,2004,"Lille OSC","SC Bastia","2-1",2,1,"1",1,3,1,"H"
"21924",2004-10-16,2004,"FC Metz","AS Monaco","1-1",1,1,"1",1,2,0,"D"
"21925",2004-10-16,2004,"FC Nantes","Paris Saint-Germain","1-0",1,0,"1",1,1,1,"H"
"21926",2004-10-16,2004,"OGC Nice","Toulouse FC","1-0",1,0,"1",1,1,1,"H"
"21927",2004-10-16,2004,"FC Sochaux","Stade Rennes","3-0",3,0,"1",1,3,3,"H"
"21928",2004-10-17,2004,"Olympique Marseille","AS Saint-Etienne","1-1",1,1,"1",1,2,0,"D"
"21929",2004-10-23,2004,"FC Istres","Olympique Lyon","0-0",0,0,"1",1,0,0,"D"
"21930",2004-10-23,2004,"SM Caen","FC Nantes","2-1",2,1,"1",1,3,1,"H"
"21931",2004-10-23,2004,"Paris Saint-Germain","AC Ajaccio","1-0",1,0,"1",1,1,1,"H"
"21932",2004-10-23,2004,"Stade Rennes","FC Metz","3-1",3,1,"1",1,4,2,"H"
"21933",2004-10-23,2004,"AS Saint-Etienne","Girondins Bordeaux","0-0",0,0,"1",1,0,0,"D"
"21934",2004-10-23,2004,"RC Strasbourg","OGC Nice","3-1",3,1,"1",1,4,2,"H"
"21935",2004-10-24,2004,"SC Bastia","FC Sochaux","1-1",1,1,"1",1,2,0,"D"
"21936",2004-10-24,2004,"AS Monaco","AJ Auxerre","0-0",0,0,"1",1,0,0,"D"
"21937",2004-10-24,2004,"Toulouse FC","Lille OSC","1-0",1,0,"1",1,1,1,"H"
"21938",2004-10-24,2004,"RC Lens","Olympique Marseille","0-0",0,0,"1",1,0,0,"D"
"21939",2004-10-29,2004,"Olympique Marseille","AS Monaco","1-1",1,1,"1",1,2,0,"D"
"21940",2004-10-30,2004,"FC Sochaux","Toulouse FC","2-0",2,0,"1",1,2,2,"H"
"21941",2004-10-30,2004,"AC Ajaccio","FC Nantes","1-1",1,1,"1",1,2,0,"D"
"21942",2004-10-30,2004,"AJ Auxerre","Paris Saint-Germain","1-1",1,1,"1",1,2,0,"D"
"21943",2004-10-30,2004,"Girondins Bordeaux","RC Lens","1-1",1,1,"1",1,2,0,"D"
"21944",2004-10-30,2004,"Lille OSC","AS Saint-Etienne","1-0",1,0,"1",1,1,1,"H"
"21945",2004-10-30,2004,"Olympique Lyon","RC Strasbourg","1-0",1,0,"1",1,1,1,"H"
"21946",2004-10-30,2004,"FC Metz","SC Bastia","2-0",2,0,"1",1,2,2,"H"
"21947",2004-10-30,2004,"OGC Nice","FC Istres","0-0",0,0,"1",1,0,0,"D"
"21948",2004-10-30,2004,"Stade Rennes","SM Caen","1-1",1,1,"1",1,2,0,"D"
"21949",2004-11-06,2004,"AS Saint-Etienne","OGC Nice","2-1",2,1,"1",1,3,1,"H"
"21950",2004-11-06,2004,"SC Bastia","Stade Rennes","1-1",1,1,"1",1,2,0,"D"
"21951",2004-11-06,2004,"SM Caen","FC Sochaux","0-2",0,2,"1",1,2,-2,"D"
"21952",2004-11-06,2004,"RC Lens","Olympique Lyon","0-1",0,1,"1",1,1,-1,"D"
"21953",2004-11-06,2004,"AS Monaco","AC Ajaccio","2-2",2,2,"1",1,4,0,"D"
"21954",2004-11-06,2004,"RC Strasbourg","Girondins Bordeaux","1-0",1,0,"1",1,1,1,"H"
"21955",2004-11-06,2004,"Toulouse FC","FC Metz","1-1",1,1,"1",1,2,0,"D"
"21956",2004-11-07,2004,"FC Istres","Lille OSC","0-2",0,2,"1",1,2,-2,"D"
"21957",2004-11-07,2004,"FC Nantes","AJ Auxerre","1-1",1,1,"1",1,2,0,"D"
"21958",2004-11-07,2004,"Paris Saint-Germain","Olympique Marseille","2-1",2,1,"1",1,3,1,"H"
"21959",2004-11-13,2004,"Olympique Lyon","FC Nantes","2-0",2,0,"1",1,2,2,"H"
"21960",2004-11-13,2004,"AJ Auxerre","AC Ajaccio","1-0",1,0,"1",1,1,1,"H"
"21961",2004-11-13,2004,"SC Bastia","AS Saint-Etienne","0-3",0,3,"1",1,3,-3,"D"
"21962",2004-11-13,2004,"Girondins Bordeaux","Paris Saint-Germain","3-0",3,0,"1",1,3,3,"H"
"21963",2004-11-13,2004,"Olympique Marseille","RC Strasbourg","2-0",2,0,"1",1,2,2,"H"
"21964",2004-11-13,2004,"FC Metz","SM Caen","1-2",1,2,"1",1,3,-1,"D"
"21965",2004-11-13,2004,"OGC Nice","RC Lens","1-1",1,1,"1",1,2,0,"D"
"21966",2004-11-13,2004,"Stade Rennes","Toulouse FC","1-1",1,1,"1",1,2,0,"D"
"21967",2004-11-13,2004,"FC Sochaux","FC Istres","1-1",1,1,"1",1,2,0,"D"
"21968",2004-11-14,2004,"Lille OSC","AS Monaco","1-1",1,1,"1",1,2,0,"D"
"21969",2004-11-19,2004,"AS Monaco","FC Sochaux","1-3",1,3,"1",1,4,-2,"D"
"21970",2004-11-19,2004,"Paris Saint-Germain","Olympique Lyon","0-0",0,0,"1",1,0,0,"D"
"21971",2004-11-20,2004,"RC Lens","Lille OSC","1-1",1,1,"1",1,2,0,"D"
"21972",2004-11-20,2004,"AC Ajaccio","Olympique Marseille","2-0",2,0,"1",1,2,2,"H"
"21973",2004-11-20,2004,"SM Caen","OGC Nice","0-0",0,0,"1",1,0,0,"D"
"21974",2004-11-20,2004,"FC Istres","FC Metz","0-0",0,0,"1",1,0,0,"D"
"21975",2004-11-20,2004,"FC Nantes","Girondins Bordeaux","0-1",0,1,"1",1,1,-1,"D"
"21976",2004-11-20,2004,"AS Saint-Etienne","Stade Rennes","1-0",1,0,"1",1,1,1,"H"
"21977",2004-11-20,2004,"RC Strasbourg","AJ Auxerre","3-1",3,1,"1",1,4,2,"H"
"21978",2004-11-20,2004,"Toulouse FC","SC Bastia","1-0",1,0,"1",1,1,1,"H"
"21979",2004-11-27,2004,"Olympique Lyon","AJ Auxerre","2-1",2,1,"1",1,3,1,"H"
"21980",2004-11-27,2004,"SC Bastia","SM Caen","2-0",2,0,"1",1,2,2,"H"
"21981",2004-11-27,2004,"Girondins Bordeaux","AC Ajaccio","0-0",0,0,"1",1,0,0,"D"
"21982",2004-11-27,2004,"Olympique Marseille","FC Nantes","3-1",3,1,"1",1,4,2,"H"
"21983",2004-11-27,2004,"FC Metz","AS Saint-Etienne","2-2",2,2,"1",1,4,0,"D"
"21984",2004-11-27,2004,"Stade Rennes","FC Istres","3-1",3,1,"1",1,4,2,"H"
"21985",2004-11-27,2004,"Toulouse FC","AS Monaco","0-0",0,0,"1",1,0,0,"D"
"21986",2004-11-28,2004,"Lille OSC","RC Strasbourg","1-1",1,1,"1",1,2,0,"D"
"21987",2004-11-28,2004,"FC Sochaux","RC Lens","1-2",1,2,"1",1,3,-1,"D"
"21988",2004-11-28,2004,"OGC Nice","Paris Saint-Germain","1-1",1,1,"1",1,2,0,"D"
"21989",2004-12-03,2004,"AS Monaco","Stade Rennes","2-0",2,0,"1",1,2,2,"H"
"21990",2004-12-04,2004,"Paris Saint-Germain","Lille OSC","1-1",1,1,"1",1,2,0,"D"
"21991",2004-12-04,2004,"AC Ajaccio","Olympique Lyon","1-1",1,1,"1",1,2,0,"D"
"21992",2004-12-04,2004,"SM Caen","Olympique Marseille","2-3",2,3,"1",1,5,-1,"D"
"21993",2004-12-04,2004,"FC Istres","SC Bastia","1-0",1,0,"1",1,1,1,"H"
"21994",2004-12-04,2004,"RC Lens","FC Metz","2-0",2,0,"1",1,2,2,"H"
"21995",2004-12-04,2004,"FC Nantes","OGC Nice","0-1",0,1,"1",1,1,-1,"D"
"21996",2004-12-04,2004,"AS Saint-Etienne","Toulouse FC","0-0",0,0,"1",1,0,0,"D"
"21997",2004-12-04,2004,"RC Strasbourg","FC Sochaux","0-0",0,0,"1",1,0,0,"D"
"21998",2004-12-05,2004,"AJ Auxerre","Girondins Bordeaux","0-0",0,0,"1",1,0,0,"D"
"21999",2004-12-11,2004,"Olympique Marseille","AJ Auxerre","0-1",0,1,"1",1,1,-1,"D"
"22000",2004-12-11,2004,"SC Bastia","AS Monaco","0-2",0,2,"1",1,2,-2,"D"
"22001",2004-12-11,2004,"Girondins Bordeaux","Olympique Lyon","0-0",0,0,"1",1,0,0,"D"
"22002",2004-12-11,2004,"Lille OSC","FC Nantes","2-1",2,1,"1",1,3,1,"H"
"22003",2004-12-11,2004,"FC Metz","RC Strasbourg","1-0",1,0,"1",1,1,1,"H"
"22004",2004-12-11,2004,"OGC Nice","AC Ajaccio","3-0",3,0,"1",1,3,3,"H"
"22005",2004-12-11,2004,"Stade Rennes","RC Lens","3-1",3,1,"1",1,4,2,"H"
"22006",2004-12-11,2004,"AS Saint-Etienne","SM Caen","5-0",5,0,"1",1,5,5,"H"
"22007",2004-12-11,2004,"Toulouse FC","FC Istres","2-1",2,1,"1",1,3,1,"H"
"22008",2004-12-12,2004,"FC Sochaux","Paris Saint-Germain","1-2",1,2,"1",1,3,-1,"D"
"22009",2004-12-17,2004,"Olympique Lyon","Olympique Marseille","1-1",1,1,"1",1,2,0,"D"
"22010",2004-12-18,2004,"AS Monaco","Girondins Bordeaux","1-1",1,1,"1",1,2,0,"D"
"22011",2004-12-18,2004,"AC Ajaccio","Lille OSC","0-0",0,0,"1",1,0,0,"D"
"22012",2004-12-18,2004,"AJ Auxerre","OGC Nice","4-3",4,3,"1",1,7,1,"H"
"22013",2004-12-18,2004,"SM Caen","Toulouse FC","0-2",0,2,"1",1,2,-2,"D"
"22014",2004-12-18,2004,"FC Istres","AS Saint-Etienne","0-2",0,2,"1",1,2,-2,"D"
"22015",2004-12-18,2004,"RC Lens","SC Bastia","2-1",2,1,"1",1,3,1,"H"
"22016",2004-12-18,2004,"Paris Saint-Germain","FC Metz","3-0",3,0,"1",1,3,3,"H"
"22017",2004-12-18,2004,"RC Strasbourg","Stade Rennes","1-0",1,0,"1",1,1,1,"H"
"22018",2004-12-19,2004,"FC Nantes","FC Sochaux","2-2",2,2,"1",1,4,0,"D"
"22019",2005-01-11,2004,"Lille OSC","Olympique Marseille","1-2",1,2,"1",1,3,-1,"D"
"22020",2005-01-12,2004,"SM Caen","Paris Saint-Germain","0-0",0,0,"1",1,0,0,"D"
"22021",2005-01-12,2004,"FC Metz","AC Ajaccio","1-0",1,0,"1",1,1,1,"H"
"22022",2005-01-12,2004,"Stade Rennes","AJ Auxerre","1-0",1,0,"1",1,1,1,"H"
"22023",2005-01-12,2004,"OGC Nice","Girondins Bordeaux","3-3",3,3,"1",1,6,0,"D"
"22024",2005-01-12,2004,"AS Saint-Etienne","RC Lens","0-0",0,0,"1",1,0,0,"D"
"22025",2005-01-12,2004,"FC Sochaux","Olympique Lyon","0-2",0,2,"1",1,2,-2,"D"
"22026",2005-01-12,2004,"FC Istres","AS Monaco","0-1",0,1,"1",1,1,-1,"D"
"22027",2005-01-12,2004,"SC Bastia","FC Nantes","0-0",0,0,"1",1,0,0,"D"
"22028",2005-01-12,2004,"Toulouse FC","RC Strasbourg","2-0",2,0,"1",1,2,2,"H"
"22029",2005-01-15,2004,"AJ Auxerre","FC Sochaux","2-0",2,0,"1",1,2,2,"H"
"22030",2005-01-15,2004,"AC Ajaccio","SC Bastia","1-0",1,0,"1",1,1,1,"H"
"22031",2005-01-15,2004,"AS Monaco","SM Caen","5-2",5,2,"1",1,7,3,"H"
"22032",2005-01-15,2004,"RC Lens","FC Istres","0-1",0,1,"1",1,1,-1,"D"
"22033",2005-01-15,2004,"Girondins Bordeaux","Lille OSC","1-3",1,3,"1",1,4,-2,"D"
"22034",2005-01-15,2004,"Olympique Lyon","FC Metz","2-0",2,0,"1",1,2,2,"H"
"22035",2005-01-15,2004,"FC Nantes","Stade Rennes","2-0",2,0,"1",1,2,2,"H"
"22036",2005-01-15,2004,"RC Strasbourg","AS Saint-Etienne","1-1",1,1,"1",1,2,0,"D"
"22037",2005-01-15,2004,"Paris Saint-Germain","Toulouse FC","0-0",0,0,"1",1,0,0,"D"
"22038",2005-01-16,2004,"Olympique Marseille","OGC Nice","2-0",2,0,"1",1,2,2,"H"
"22039",2005-01-22,2004,"FC Metz","Olympique Marseille","0-1",0,1,"1",1,1,-1,"D"
"22040",2005-01-22,2004,"Stade Rennes","AC Ajaccio","2-0",2,0,"1",1,2,2,"H"
"22041",2005-01-22,2004,"SM Caen","AJ Auxerre","0-2",0,2,"1",1,2,-2,"D"
"22042",2005-01-22,2004,"FC Sochaux","Girondins Bordeaux","4-0",4,0,"1",1,4,4,"H"
"22043",2005-01-22,2004,"AS Monaco","RC Lens","2-0",2,0,"1",1,2,2,"H"
"22044",2005-01-22,2004,"Toulouse FC","FC Nantes","2-1",2,1,"1",1,3,1,"H"
"22045",2005-01-22,2004,"SC Bastia","OGC Nice","2-0",2,0,"1",1,2,2,"H"
"22046",2005-01-22,2004,"AS Saint-Etienne","Paris Saint-Germain","0-0",0,0,"1",1,0,0,"D"
"22047",2005-01-22,2004,"FC Istres","RC Strasbourg","1-1",1,1,"1",1,2,0,"D"
"22048",2005-01-23,2004,"Lille OSC","Olympique Lyon","2-1",2,1,"1",1,3,1,"H"
"22049",2005-01-25,2004,"Olympique Marseille","FC Sochaux","0-2",0,2,"1",1,2,-2,"D"
"22050",2005-01-26,2004,"Olympique Lyon","Stade Rennes","2-1",2,1,"1",1,3,1,"H"
"22051",2005-01-26,2004,"AJ Auxerre","SC Bastia","4-1",4,1,"1",1,5,3,"H"
"22052",2005-01-26,2004,"RC Lens","SM Caen","0-1",0,1,"1",1,1,-1,"D"
"22053",2005-01-26,2004,"Paris Saint-Germain","FC Istres","2-2",2,2,"1",1,4,0,"D"
"22054",2005-01-26,2004,"OGC Nice","Lille OSC","1-1",1,1,"1",1,2,0,"D"
"22055",2005-01-26,2004,"Girondins Bordeaux","FC Metz","1-0",1,0,"1",1,1,1,"H"
"22056",2005-01-26,2004,"FC Nantes","AS Saint-Etienne","0-0",0,0,"1",1,0,0,"D"
"22057",2005-01-26,2004,"AC Ajaccio","Toulouse FC","1-0",1,0,"1",1,1,1,"H"
"22058",2005-01-29,2004,"FC Metz","AJ Auxerre","3-0",3,0,"1",1,3,3,"H"
"22059",2005-01-29,2004,"Stade Rennes","Girondins Bordeaux","2-0",2,0,"1",1,2,2,"H"
"22060",2005-01-29,2004,"SM Caen","Lille OSC","0-0",0,0,"1",1,0,0,"D"
"22061",2005-01-29,2004,"Toulouse FC","Olympique Marseille","1-3",1,3,"1",1,4,-2,"D"
"22062",2005-01-29,2004,"FC Sochaux","OGC Nice","0-0",0,0,"1",1,0,0,"D"
"22063",2005-01-29,2004,"RC Lens","RC Strasbourg","2-1",2,1,"1",1,3,1,"H"
"22064",2005-01-30,2004,"FC Istres","FC Nantes","0-1",0,1,"1",1,1,-1,"D"
"22065",2005-01-30,2004,"AS Monaco","Paris Saint-Germain","2-0",2,0,"1",1,2,2,"H"
"22066",2005-02-01,2004,"SC Bastia","Olympique Lyon","1-1",1,1,"1",1,2,0,"D"
"22067",2005-02-05,2004,"Lille OSC","FC Sochaux","0-0",0,0,"1",1,0,0,"D"
"22068",2005-02-05,2004,"Girondins Bordeaux","SC Bastia","0-0",0,0,"1",1,0,0,"D"
"22069",2005-02-05,2004,"RC Strasbourg","SM Caen","5-0",5,0,"1",1,5,5,"H"
"22070",2005-02-05,2004,"AC Ajaccio","FC Istres","0-0",0,0,"1",1,0,0,"D"
"22071",2005-02-05,2004,"OGC Nice","FC Metz","1-1",1,1,"1",1,2,0,"D"
"22072",2005-02-05,2004,"FC Nantes","AS Monaco","0-0",0,0,"1",1,0,0,"D"
"22073",2005-02-05,2004,"Olympique Marseille","Stade Rennes","3-1",3,1,"1",1,4,2,"H"
"22074",2005-02-05,2004,"AJ Auxerre","AS Saint-Etienne","2-2",2,2,"1",1,4,0,"D"
"22075",2005-02-05,2004,"Olympique Lyon","Toulouse FC","4-0",4,0,"1",1,4,4,"H"
"22076",2005-02-06,2004,"Paris Saint-Germain","RC Lens","0-2",0,2,"1",1,2,-2,"D"
"22077",2005-02-18,2004,"AS Monaco","Olympique Lyon","1-1",1,1,"1",1,2,0,"D"
"22078",2005-02-19,2004,"RC Strasbourg","Paris Saint-Germain","3-1",3,1,"1",1,4,2,"H"
"22079",2005-02-19,2004,"SM Caen","AC Ajaccio","2-2",2,2,"1",1,4,0,"D"
"22080",2005-02-19,2004,"Toulouse FC","Girondins Bordeaux","1-0",1,0,"1",1,1,1,"H"
"22081",2005-02-19,2004,"SC Bastia","Olympique Marseille","0-1",0,1,"1",1,1,-1,"D"
"22082",2005-02-19,2004,"RC Lens","FC Nantes","2-0",2,0,"1",1,2,2,"H"
"22083",2005-02-19,2004,"Stade Rennes","OGC Nice","4-1",4,1,"1",1,5,3,"H"
"22084",2005-02-20,2004,"FC Istres","AJ Auxerre","1-0",1,0,"1",1,1,1,"H"
"22085",2005-02-20,2004,"FC Metz","Lille OSC","1-1",1,1,"1",1,2,0,"D"
"22086",2005-02-20,2004,"AS Saint-Etienne","FC Sochaux","1-0",1,0,"1",1,1,1,"H"
"22087",2005-02-26,2004,"Olympique Lyon","AS Saint-Etienne","3-2",3,2,"1",1,5,1,"H"
"22088",2005-02-26,2004,"Paris Saint-Germain","SC Bastia","1-0",1,0,"1",1,1,1,"H"
"22089",2005-02-26,2004,"Girondins Bordeaux","SM Caen","2-2",2,2,"1",1,4,0,"D"
"22090",2005-02-26,2004,"AC Ajaccio","RC Lens","0-0",0,0,"1",1,0,0,"D"
"22091",2005-02-26,2004,"OGC Nice","AS Monaco","2-1",2,1,"1",1,3,1,"H"
"22092",2005-02-26,2004,"FC Nantes","RC Strasbourg","2-1",2,1,"1",1,3,1,"H"
"22093",2005-02-27,2004,"Lille OSC","Stade Rennes","0-0",0,0,"1",1,0,0,"D"
"22094",2005-02-27,2004,"Olympique Marseille","FC Istres","1-1",1,1,"1",1,2,0,"D"
"22095",2005-03-04,2004,"SM Caen","Olympique Lyon","1-0",1,0,"1",1,1,1,"H"
"22096",2005-03-05,2004,"RC Lens","AJ Auxerre","3-1",3,1,"1",1,4,2,"H"
"22097",2005-03-05,2004,"RC Strasbourg","AC Ajaccio","1-0",1,0,"1",1,1,1,"H"
"22098",2005-03-05,2004,"FC Istres","Girondins Bordeaux","0-1",0,1,"1",1,1,-1,"D"
"22099",2005-03-05,2004,"SC Bastia","Lille OSC","3-1",3,1,"1",1,4,2,"H"
"22100",2005-03-05,2004,"AS Monaco","FC Metz","0-0",0,0,"1",1,0,0,"D"
"22101",2005-03-05,2004,"Paris Saint-Germain","FC Nantes","1-0",1,0,"1",1,1,1,"H"
"22102",2005-03-05,2004,"Toulouse FC","OGC Nice","1-0",1,0,"1",1,1,1,"H"
"22103",2005-03-05,2004,"Stade Rennes","FC Sochaux","3-0",3,0,"1",1,3,3,"H"
"22104",2005-03-06,2004,"AS Saint-Etienne","Olympique Marseille","2-0",2,0,"1",1,2,2,"H"
"22105",2005-03-12,2004,"Olympique Lyon","FC Istres","2-1",2,1,"1",1,3,1,"H"
"22106",2005-03-12,2004,"FC Sochaux","SC Bastia","1-0",1,0,"1",1,1,1,"H"
"22107",2005-03-12,2004,"FC Nantes","SM Caen","2-0",2,0,"1",1,2,2,"H"
"22108",2005-03-12,2004,"Olympique Marseille","RC Lens","2-1",2,1,"1",1,3,1,"H"
"22109",2005-03-12,2004,"AC Ajaccio","Paris Saint-Germain","1-0",1,0,"1",1,1,1,"H"
"22110",2005-03-12,2004,"FC Metz","Stade Rennes","1-1",1,1,"1",1,2,0,"D"
"22111",2005-03-12,2004,"Girondins Bordeaux","AS Saint-Etienne","2-0",2,0,"1",1,2,2,"H"
"22112",2005-03-12,2004,"OGC Nice","RC Strasbourg","0-0",0,0,"1",1,0,0,"D"
"22113",2005-03-13,2004,"Lille OSC","Toulouse FC","1-1",1,1,"1",1,2,0,"D"
"22114",2005-03-13,2004,"AJ Auxerre","AS Monaco","2-2",2,2,"1",1,4,0,"D"
"22115",2005-03-16,2004,"RC Strasbourg","AS Monaco","0-0",0,0,"1",1,0,0,"D"
"22116",2005-03-16,2004,"AS Saint-Etienne","AC Ajaccio","3-0",3,0,"1",1,3,3,"H"
"22117",2005-03-16,2004,"FC Sochaux","FC Metz","2-1",2,1,"1",1,3,1,"H"
"22118",2005-03-19,2004,"Toulouse FC","FC Sochaux","0-0",0,0,"1",1,0,0,"D"
"22119",2005-03-19,2004,"FC Nantes","AC Ajaccio","0-0",0,0,"1",1,0,0,"D"
"22120",2005-03-19,2004,"RC Lens","Girondins Bordeaux","2-0",2,0,"1",1,2,2,"H"
"22121",2005-03-19,2004,"RC Strasbourg","Olympique Lyon","0-1",0,1,"1",1,1,-1,"D"
"22122",2005-03-19,2004,"SC Bastia","FC Metz","1-0",1,0,"1",1,1,1,"H"
"22123",2005-03-19,2004,"FC Istres","OGC Nice","1-1",1,1,"1",1,2,0,"D"
"22124",2005-03-19,2004,"SM Caen","Stade Rennes","2-2",2,2,"1",1,4,0,"D"
"22125",2005-03-20,2004,"Paris Saint-Germain","AJ Auxerre","1-0",1,0,"1",1,1,1,"H"
"22126",2005-03-20,2004,"AS Saint-Etienne","Lille OSC","0-0",0,0,"1",1,0,0,"D"
"22127",2005-03-20,2004,"AS Monaco","Olympique Marseille","2-1",2,1,"1",1,3,1,"H"
"22128",2005-04-02,2004,"AJ Auxerre","FC Nantes","2-1",2,1,"1",1,3,1,"H"
"22129",2005-04-02,2004,"Stade Rennes","SC Bastia","1-0",1,0,"1",1,1,1,"H"
"22130",2005-04-02,2004,"FC Sochaux","SM Caen","1-0",1,0,"1",1,1,1,"H"
"22131",2005-04-02,2004,"Lille OSC","FC Istres","8-0",8,0,"1",1,8,8,"H"
"22132",2005-04-02,2004,"Olympique Lyon","RC Lens","1-0",1,0,"1",1,1,1,"H"
"22133",2005-04-02,2004,"AC Ajaccio","AS Monaco","3-0",3,0,"1",1,3,3,"H"
"22134",2005-04-02,2004,"OGC Nice","AS Saint-Etienne","2-0",2,0,"1",1,2,2,"H"
"22135",2005-04-02,2004,"Girondins Bordeaux","RC Strasbourg","0-2",0,2,"1",1,2,-2,"D"
"22136",2005-04-02,2004,"FC Metz","Toulouse FC","0-1",0,1,"1",1,1,-1,"D"
"22137",2005-04-03,2004,"Olympique Marseille","Paris Saint-Germain","1-1",1,1,"1",1,2,0,"D"
"22138",2005-04-09,2004,"FC Nantes","Olympique Lyon","2-2",2,2,"1",1,4,0,"D"
"22139",2005-04-09,2004,"AS Saint-Etienne","SC Bastia","3-0",3,0,"1",1,3,3,"H"
"22140",2005-04-09,2004,"Paris Saint-Germain","Girondins Bordeaux","1-1",1,1,"1",1,2,0,"D"
"22141",2005-04-09,2004,"RC Strasbourg","Olympique Marseille","1-0",1,0,"1",1,1,1,"H"
"22142",2005-04-09,2004,"SM Caen","FC Metz","0-1",0,1,"1",1,1,-1,"D"
"22143",2005-04-09,2004,"RC Lens","OGC Nice","0-0",0,0,"1",1,0,0,"D"
"22144",2005-04-09,2004,"Toulouse FC","Stade Rennes","0-2",0,2,"1",1,2,-2,"D"
"22145",2005-04-09,2004,"FC Istres","FC Sochaux","2-0",2,0,"1",1,2,2,"H"
"22146",2005-04-10,2004,"AC Ajaccio","AJ Auxerre","4-3",4,3,"1",1,7,1,"H"
"22147",2005-04-16,2004,"Lille OSC","RC Lens","2-1",2,1,"1",1,3,1,"H"
"22148",2005-04-16,2004,"Olympique Marseille","AC Ajaccio","1-2",1,2,"1",1,3,-1,"D"
"22149",2005-04-16,2004,"OGC Nice","SM Caen","0-1",0,1,"1",1,1,-1,"D"
"22150",2005-04-16,2004,"FC Metz","FC Istres","2-1",2,1,"1",1,3,1,"H"
"22151",2005-04-16,2004,"FC Sochaux","AS Monaco","1-1",1,1,"1",1,2,0,"D"
"22152",2005-04-16,2004,"Girondins Bordeaux","FC Nantes","0-2",0,2,"1",1,2,-2,"D"
"22153",2005-04-16,2004,"Stade Rennes","AS Saint-Etienne","2-2",2,2,"1",1,4,0,"D"
"22154",2005-04-16,2004,"SC Bastia","Toulouse FC","2-1",2,1,"1",1,3,1,"H"
"22155",2005-04-17,2004,"AJ Auxerre","RC Strasbourg","0-0",0,0,"1",1,0,0,"D"
"22156",2005-04-17,2004,"Olympique Lyon","Paris Saint-Germain","0-1",0,1,"1",1,1,-1,"D"
"22157",2005-04-22,2004,"Paris Saint-Germain","OGC Nice","3-1",3,1,"1",1,4,2,"H"
"22158",2005-04-23,2004,"AS Monaco","Toulouse FC","2-1",2,1,"1",1,3,1,"H"
"22159",2005-04-23,2004,"SM Caen","SC Bastia","0-1",0,1,"1",1,1,-1,"D"
"22160",2005-04-23,2004,"AC Ajaccio","Girondins Bordeaux","0-0",0,0,"1",1,0,0,"D"
"22161",2005-04-23,2004,"RC Strasbourg","Lille OSC","1-2",1,2,"1",1,3,-1,"D"
"22162",2005-04-23,2004,"FC Nantes","Olympique Marseille","2-2",2,2,"1",1,4,0,"D"
"22163",2005-04-23,2004,"AS Saint-Etienne","FC Metz","0-0",0,0,"1",1,0,0,"D"
"22164",2005-04-23,2004,"FC Istres","Stade Rennes","0-2",0,2,"1",1,2,-2,"D"
"22165",2005-04-23,2004,"RC Lens","FC Sochaux","3-2",3,2,"1",1,5,1,"H"
"22166",2005-04-24,2004,"AJ Auxerre","Olympique Lyon","0-3",0,3,"1",1,3,-3,"D"
"22167",2005-04-29,2004,"AJ Auxerre","Toulouse FC","3-2",3,2,"1",1,5,1,"H"
"22168",2005-05-01,2004,"AS Monaco","Lille OSC","2-0",2,0,"1",1,2,2,"H"
"22169",2005-05-06,2004,"Girondins Bordeaux","AJ Auxerre","0-0",0,0,"1",1,0,0,"D"
"22170",2005-05-07,2004,"Olympique Marseille","SM Caen","2-3",2,3,"1",1,5,-1,"D"
"22171",2005-05-07,2004,"SC Bastia","FC Istres","2-0",2,0,"1",1,2,2,"H"
"22172",2005-05-07,2004,"FC Metz","RC Lens","1-1",1,1,"1",1,2,0,"D"
"22173",2005-05-07,2004,"Stade Rennes","AS Monaco","0-0",0,0,"1",1,0,0,"D"
"22174",2005-05-07,2004,"OGC Nice","FC Nantes","0-0",0,0,"1",1,0,0,"D"
"22175",2005-05-07,2004,"Lille OSC","Paris Saint-Germain","1-0",1,0,"1",1,1,1,"H"
"22176",2005-05-07,2004,"Toulouse FC","AS Saint-Etienne","0-2",0,2,"1",1,2,-2,"D"
"22177",2005-05-07,2004,"FC Sochaux","RC Strasbourg","1-2",1,2,"1",1,3,-1,"D"
"22178",2005-05-08,2004,"Olympique Lyon","AC Ajaccio","2-1",2,1,"1",1,3,1,"H"
"22179",2005-05-14,2004,"FC Nantes","Lille OSC","1-3",1,3,"1",1,4,-2,"D"
"22180",2005-05-14,2004,"AS Monaco","SC Bastia","5-2",5,2,"1",1,7,3,"H"
"22181",2005-05-14,2004,"AJ Auxerre","Olympique Marseille","0-0",0,0,"1",1,0,0,"D"
"22182",2005-05-14,2004,"RC Strasbourg","FC Metz","3-1",3,1,"1",1,4,2,"H"
"22183",2005-05-14,2004,"AC Ajaccio","OGC Nice","0-1",0,1,"1",1,1,-1,"D"
"22184",2005-05-14,2004,"RC Lens","Stade Rennes","5-2",5,2,"1",1,7,3,"H"
"22185",2005-05-14,2004,"SM Caen","AS Saint-Etienne","2-0",2,0,"1",1,2,2,"H"
"22186",2005-05-14,2004,"Paris Saint-Germain","FC Sochaux","2-2",2,2,"1",1,4,0,"D"
"22187",2005-05-14,2004,"FC Istres","Toulouse FC","1-0",1,0,"1",1,1,1,"H"
"22188",2005-05-15,2004,"Olympique Lyon","Girondins Bordeaux","5-1",5,1,"1",1,6,4,"H"
"22189",2005-05-21,2004,"Lille OSC","AC Ajaccio","0-2",0,2,"1",1,2,-2,"D"
"22190",2005-05-21,2004,"OGC Nice","AJ Auxerre","1-0",1,0,"1",1,1,1,"H"
"22191",2005-05-21,2004,"Toulouse FC","SM Caen","2-3",2,3,"1",1,5,-1,"D"
"22192",2005-05-21,2004,"AS Saint-Etienne","FC Istres","2-0",2,0,"1",1,2,2,"H"
"22193",2005-05-21,2004,"SC Bastia","RC Lens","3-1",3,1,"1",1,4,2,"H"
"22194",2005-05-21,2004,"Olympique Marseille","Olympique Lyon","0-1",0,1,"1",1,1,-1,"D"
"22195",2005-05-21,2004,"Girondins Bordeaux","AS Monaco","1-1",1,1,"1",1,2,0,"D"
"22196",2005-05-21,2004,"FC Sochaux","FC Nantes","1-0",1,0,"1",1,1,1,"H"
"22197",2005-05-21,2004,"FC Metz","Paris Saint-Germain","3-2",3,2,"1",1,5,1,"H"
"22198",2005-05-21,2004,"Stade Rennes","RC Strasbourg","4-0",4,0,"1",1,4,4,"H"
"22199",2005-05-28,2004,"RC Strasbourg","SC Bastia","2-0",2,0,"1",1,2,2,"H"
"22200",2005-05-28,2004,"FC Istres","SM Caen","3-2",3,2,"1",1,5,1,"H"
"22201",2005-05-28,2004,"AJ Auxerre","Lille OSC","1-3",1,3,"1",1,4,-2,"D"
"22202",2005-05-28,2004,"Girondins Bordeaux","Olympique Marseille","3-3",3,3,"1",1,6,0,"D"
"22203",2005-05-28,2004,"FC Nantes","FC Metz","1-0",1,0,"1",1,1,1,"H"
"22204",2005-05-28,2004,"Olympique Lyon","OGC Nice","0-0",0,0,"1",1,0,0,"D"
"22205",2005-05-28,2004,"Paris Saint-Germain","Stade Rennes","1-0",1,0,"1",1,1,1,"H"
"22206",2005-05-28,2004,"AS Monaco","AS Saint-Etienne","1-1",1,1,"1",1,2,0,"D"
"22207",2005-05-28,2004,"AC Ajaccio","FC Sochaux","3-1",3,1,"1",1,4,2,"H"
"22208",2005-05-28,2004,"RC Lens","Toulouse FC","1-0",1,0,"1",1,1,1,"H"
"22209",2005-07-29,2005,"Paris Saint-Germain","FC Metz","4-1",4,1,"1",1,5,3,"H"
"22210",2005-07-30,2005,"Olympique Marseille","Girondins Bordeaux","0-2",0,2,"1",1,2,-2,"D"
"22211",2005-07-30,2005,"Lille OSC","Stade Rennes","1-0",1,0,"1",1,1,1,"H"
"22212",2005-07-30,2005,"AS Nancy","AS Monaco","0-1",0,1,"1",1,1,-1,"D"
"22213",2005-07-30,2005,"OGC Nice","ESTAC Troyes","1-1",1,1,"1",1,2,0,"D"
"22214",2005-07-30,2005,"AS Saint-Etienne","AC Ajaccio","0-0",0,0,"1",1,0,0,"D"
"22215",2005-07-30,2005,"FC Sochaux","Toulouse FC","0-1",0,1,"1",1,1,-1,"D"
"22216",2005-07-30,2005,"RC Strasbourg","AJ Auxerre","0-0",0,0,"1",1,0,0,"D"
"22217",2005-07-30,2005,"FC Nantes","RC Lens","2-0",2,0,"1",1,2,2,"H"
"22218",2005-07-31,2005,"Le Mans UC 72","Olympique Lyon","1-2",1,2,"1",1,3,-1,"D"
"22219",2005-08-06,2005,"RC Lens","Olympique Marseille","2-0",2,0,"1",1,2,2,"H"
"22220",2005-08-06,2005,"AC Ajaccio","Lille OSC","3-3",3,3,"1",1,6,0,"D"
"22221",2005-08-06,2005,"Girondins Bordeaux","AS Nancy","1-0",1,0,"1",1,1,1,"H"
"22222",2005-08-06,2005,"FC Metz","Le Mans UC 72","0-0",0,0,"1",1,0,0,"D"
"22223",2005-08-06,2005,"AS Monaco","AJ Auxerre","0-2",0,2,"1",1,2,-2,"D"
"22224",2005-08-06,2005,"FC Sochaux","Paris Saint-Germain","0-1",0,1,"1",1,1,-1,"D"
"22225",2005-08-06,2005,"Toulouse FC","OGC Nice","0-2",0,2,"1",1,2,-2,"D"
"22226",2005-08-06,2005,"ESTAC Troyes","AS Saint-Etienne","0-0",0,0,"1",1,0,0,"D"
"22227",2005-08-07,2005,"Stade Rennes","FC Nantes","0-3",0,3,"1",1,3,-3,"D"
"22228",2005-08-07,2005,"Olympique Lyon","RC Strasbourg","1-0",1,0,"1",1,1,1,"H"
"22229",2005-08-13,2005,"Paris Saint-Germain","Toulouse FC","2-0",2,0,"1",1,2,2,"H"
"22230",2005-08-13,2005,"AJ Auxerre","Girondins Bordeaux","1-0",1,0,"1",1,1,1,"H"
"22231",2005-08-13,2005,"Le Mans UC 72","Stade Rennes","4-0",4,0,"1",1,4,4,"H"
"22232",2005-08-13,2005,"Lille OSC","ESTAC Troyes","1-2",1,2,"1",1,3,-1,"D"
"22233",2005-08-13,2005,"AS Nancy","RC Lens","1-2",1,2,"1",1,3,-1,"D"
"22234",2005-08-13,2005,"FC Nantes","AC Ajaccio","0-2",0,2,"1",1,2,-2,"D"
"22235",2005-08-13,2005,"OGC Nice","FC Sochaux","1-2",1,2,"1",1,3,-1,"D"
"22236",2005-08-13,2005,"AS Saint-Etienne","FC Metz","2-0",2,0,"1",1,2,2,"H"
"22237",2005-08-14,2005,"RC Strasbourg","AS Monaco","1-2",1,2,"1",1,3,-1,"D"
"22238",2005-08-14,2005,"Olympique Marseille","Olympique Lyon","1-1",1,1,"1",1,2,0,"D"
"22239",2005-08-20,2005,"Girondins Bordeaux","AS Monaco","1-0",1,0,"1",1,1,1,"H"
"22240",2005-08-20,2005,"AC Ajaccio","Le Mans UC 72","0-0",0,0,"1",1,0,0,"D"
"22241",2005-08-20,2005,"RC Lens","AJ Auxerre","7-0",7,0,"1",1,7,7,"H"
"22242",2005-08-20,2005,"Olympique Lyon","AS Nancy","1-0",1,0,"1",1,1,1,"H"
"22243",2005-08-20,2005,"FC Metz","RC Strasbourg","0-0",0,0,"1",1,0,0,"D"
"22244",2005-08-20,2005,"OGC Nice","FC Nantes","1-1",1,1,"1",1,2,0,"D"
"22245",2005-08-20,2005,"Stade Rennes","Olympique Marseille","3-2",3,2,"1",1,5,1,"H"
"22246",2005-08-20,2005,"FC Sochaux","Lille OSC","0-0",0,0,"1",1,0,0,"D"
"22247",2005-08-21,2005,"Toulouse FC","AS Saint-Etienne","1-1",1,1,"1",1,2,0,"D"
"22248",2005-08-21,2005,"ESTAC Troyes","Paris Saint-Germain","1-1",1,1,"1",1,2,0,"D"
"22249",2005-08-24,2005,"Lille OSC","Toulouse FC","0-0",0,0,"1",1,0,0,"D"
"22250",2005-08-27,2005,"Olympique Marseille","AC Ajaccio","1-1",1,1,"1",1,2,0,"D"
"22251",2005-08-27,2005,"Le Mans UC 72","ESTAC Troyes","1-0",1,0,"1",1,1,1,"H"
"22252",2005-08-27,2005,"AS Nancy","Stade Rennes","6-0",6,0,"1",1,6,6,"H"
"22253",2005-08-27,2005,"FC Nantes","FC Metz","0-0",0,0,"1",1,0,0,"D"
"22254",2005-08-27,2005,"Paris Saint-Germain","OGC Nice","1-2",1,2,"1",1,3,-1,"D"
"22255",2005-08-27,2005,"AS Saint-Etienne","FC Sochaux","0-0",0,0,"1",1,0,0,"D"
"22256",2005-08-27,2005,"RC Strasbourg","Girondins Bordeaux","0-0",0,0,"1",1,0,0,"D"
"22257",2005-08-28,2005,"AS Monaco","RC Lens","0-0",0,0,"1",1,0,0,"D"
"22258",2005-08-28,2005,"AJ Auxerre","Olympique Lyon","0-2",0,2,"1",1,2,-2,"D"
"22259",2005-09-10,2005,"Olympique Lyon","AS Monaco","2-1",2,1,"1",1,3,1,"H"
"22260",2005-09-10,2005,"AC Ajaccio","AS Nancy","1-0",1,0,"1",1,1,1,"H"
"22261",2005-09-10,2005,"FC Metz","Lille OSC","0-2",0,2,"1",1,2,-2,"D"
"22262",2005-09-10,2005,"OGC Nice","AS Saint-Etienne","0-1",0,1,"1",1,1,-1,"D"
"22263",2005-09-10,2005,"Paris Saint-Germain","RC Strasbourg","1-0",1,0,"1",1,1,1,"H"
"22264",2005-09-10,2005,"Stade Rennes","AJ Auxerre","3-1",3,1,"1",1,4,2,"H"
"22265",2005-09-10,2005,"Toulouse FC","Le Mans UC 72","0-2",0,2,"1",1,2,-2,"D"
"22266",2005-09-10,2005,"ESTAC Troyes","FC Nantes","1-0",1,0,"1",1,1,1,"H"
"22267",2005-09-11,2005,"RC Lens","Girondins Bordeaux","1-1",1,1,"1",1,2,0,"D"
"22268",2005-09-11,2005,"FC Sochaux","Olympique Marseille","0-1",0,1,"1",1,1,-1,"D"
"22269",2005-09-17,2005,"Girondins Bordeaux","Olympique Lyon","1-1",1,1,"1",1,2,0,"D"
"22270",2005-09-17,2005,"Le Mans UC 72","FC Sochaux","2-1",2,1,"1",1,3,1,"H"
"22271",2005-09-17,2005,"Lille OSC","OGC Nice","4-0",4,0,"1",1,4,4,"H"
"22272",2005-09-17,2005,"AS Nancy","FC Metz","1-1",1,1,"1",1,2,0,"D"
"22273",2005-09-17,2005,"FC Nantes","Toulouse FC","2-0",2,0,"1",1,2,2,"H"
"22274",2005-09-18,2005,"AJ Auxerre","AC Ajaccio","2-0",2,0,"1",1,2,2,"H"
"22275",2005-09-18,2005,"Olympique Marseille","ESTAC Troyes","2-1",2,1,"1",1,3,1,"H"
"22276",2005-09-18,2005,"AS Monaco","Stade Rennes","0-2",0,2,"1",1,2,-2,"D"
"22277",2005-09-18,2005,"RC Strasbourg","RC Lens","1-1",1,1,"1",1,2,0,"D"
"22278",2005-09-18,2005,"AS Saint-Etienne","Paris Saint-Germain","3-0",3,0,"1",1,3,3,"H"
"22279",2005-09-21,2005,"Toulouse FC","Olympique Marseille","1-0",1,0,"1",1,1,1,"H"
"22280",2005-09-21,2005,"AC Ajaccio","RC Strasbourg","0-0",0,0,"1",1,0,0,"D"
"22281",2005-09-21,2005,"FC Metz","AJ Auxerre","1-2",1,2,"1",1,3,-1,"D"
"22282",2005-09-21,2005,"OGC Nice","Le Mans UC 72","1-0",1,0,"1",1,1,1,"H"
"22283",2005-09-21,2005,"Stade Rennes","Girondins Bordeaux","2-2",2,2,"1",1,4,0,"D"
"22284",2005-09-21,2005,"AS Saint-Etienne","AS Nancy","0-2",0,2,"1",1,2,-2,"D"
"22285",2005-09-21,2005,"FC Sochaux","FC Nantes","1-0",1,0,"1",1,1,1,"H"
"22286",2005-09-21,2005,"ESTAC Troyes","AS Monaco","1-2",1,2,"1",1,3,-1,"D"
"22287",2005-09-21,2005,"Paris Saint-Germain","Lille OSC","2-1",2,1,"1",1,3,1,"H"
"22288",2005-09-22,2005,"Olympique Lyon","RC Lens","1-1",1,1,"1",1,2,0,"D"
"22289",2005-09-24,2005,"AS Monaco","OGC Nice","0-0",0,0,"1",1,0,0,"D"
"22290",2005-09-24,2005,"AJ Auxerre","FC Sochaux","3-0",3,0,"1",1,3,3,"H"
"22291",2005-09-24,2005,"Girondins Bordeaux","AC Ajaccio","1-0",1,0,"1",1,1,1,"H"
"22292",2005-09-24,2005,"Le Mans UC 72","Paris Saint-Germain","0-0",0,0,"1",1,0,0,"D"
"22293",2005-09-24,2005,"Lille OSC","AS Saint-Etienne","2-0",2,0,"1",1,2,2,"H"
"22294",2005-09-24,2005,"Olympique Marseille","FC Metz","3-1",3,1,"1",1,4,2,"H"
"22295",2005-09-24,2005,"AS Nancy","ESTAC Troyes","2-1",2,1,"1",1,3,1,"H"
"22296",2005-09-24,2005,"RC Strasbourg","Toulouse FC","2-4",2,4,"1",1,6,-2,"D"
"22297",2005-09-25,2005,"FC Nantes","Olympique Lyon","0-1",0,1,"1",1,1,-1,"D"
"22298",2005-09-25,2005,"RC Lens","Stade Rennes","0-0",0,0,"1",1,0,0,"D"
"22299",2005-10-01,2005,"Paris Saint-Germain","FC Nantes","2-0",2,0,"1",1,2,2,"H"
"22300",2005-10-01,2005,"FC Metz","Girondins Bordeaux","0-1",0,1,"1",1,1,-1,"D"
"22301",2005-10-01,2005,"AS Saint-Etienne","Le Mans UC 72","3-0",3,0,"1",1,3,3,"H"
"22302",2005-10-01,2005,"FC Sochaux","AS Nancy","0-2",0,2,"1",1,2,-2,"D"
"22303",2005-10-02,2005,"Lille OSC","AS Monaco","0-1",0,1,"1",1,1,-1,"D"
"22304",2005-10-02,2005,"Stade Rennes","Olympique Lyon","1-3",1,3,"1",1,4,-2,"D"
"22305",2005-10-02,2005,"Toulouse FC","AJ Auxerre","2-0",2,0,"1",1,2,2,"H"
"22306",2005-10-02,2005,"ESTAC Troyes","RC Strasbourg","1-1",1,1,"1",1,2,0,"D"
"22307",2005-10-02,2005,"OGC Nice","Olympique Marseille","0-1",0,1,"1",1,1,-1,"D"
"22308",2005-10-15,2005,"FC Nantes","AS Saint-Etienne","1-1",1,1,"1",1,2,0,"D"
"22309",2005-10-15,2005,"AJ Auxerre","ESTAC Troyes","3-0",3,0,"1",1,3,3,"H"
"22310",2005-10-15,2005,"Girondins Bordeaux","FC Sochaux","1-1",1,1,"1",1,2,0,"D"
"22311",2005-10-15,2005,"Le Mans UC 72","Lille OSC","1-1",1,1,"1",1,2,0,"D"
"22312",2005-10-15,2005,"RC Lens","OGC Nice","2-2",2,2,"1",1,4,0,"D"
"22313",2005-10-15,2005,"AS Monaco","FC Metz","3-0",3,0,"1",1,3,3,"H"
"22314",2005-10-15,2005,"AS Nancy","Toulouse FC","2-0",2,0,"1",1,2,2,"H"
"22315",2005-10-15,2005,"RC Strasbourg","Stade Rennes","0-1",0,1,"1",1,1,-1,"D"
"22316",2005-10-16,2005,"Olympique Lyon","AC Ajaccio","3-2",3,2,"1",1,5,1,"H"
"22317",2005-10-16,2005,"Olympique Marseille","Paris Saint-Germain","1-0",1,0,"1",1,1,1,"H"
"22318",2005-10-22,2005,"FC Metz","Olympique Lyon","0-4",0,4,"1",1,4,-4,"D"
"22319",2005-10-22,2005,"Lille OSC","FC Nantes","2-0",2,0,"1",1,2,2,"H"
"22320",2005-10-22,2005,"OGC Nice","AJ Auxerre","1-0",1,0,"1",1,1,1,"H"
"22321",2005-10-22,2005,"Paris Saint-Germain","AS Nancy","1-0",1,0,"1",1,1,1,"H"
"22322",2005-10-22,2005,"Toulouse FC","Girondins Bordeaux","1-1",1,1,"1",1,2,0,"D"
"22323",2005-10-23,2005,"AC Ajaccio","Stade Rennes","0-1",0,1,"1",1,1,-1,"D"
"22324",2005-10-23,2005,"Le Mans UC 72","RC Strasbourg","2-0",2,0,"1",1,2,2,"H"
"22325",2005-10-23,2005,"FC Sochaux","AS Monaco","2-1",2,1,"1",1,3,1,"H"
"22326",2005-10-23,2005,"ESTAC Troyes","RC Lens","1-1",1,1,"1",1,2,0,"D"
"22327",2005-10-23,2005,"AS Saint-Etienne","Olympique Marseille","2-1",2,1,"1",1,3,1,"H"
"22328",2005-10-29,2005,"Olympique Marseille","Lille OSC","1-1",1,1,"1",1,2,0,"D"
"22329",2005-10-29,2005,"Girondins Bordeaux","ESTAC Troyes","2-0",2,0,"1",1,2,2,"H"
"22330",2005-10-29,2005,"RC Lens","Toulouse FC","1-0",1,0,"1",1,1,1,"H"
"22331",2005-10-29,2005,"Olympique Lyon","FC Sochaux","1-0",1,0,"1",1,1,1,"H"
"22332",2005-10-29,2005,"AS Monaco","AC Ajaccio","3-0",3,0,"1",1,3,3,"H"
"22333",2005-10-29,2005,"FC Nantes","Le Mans UC 72","1-0",1,0,"1",1,1,1,"H"
"22334",2005-10-29,2005,"Stade Rennes","FC Metz","2-1",2,1,"1",1,3,1,"H"
"22335",2005-10-29,2005,"RC Strasbourg","AS Saint-Etienne","0-1",0,1,"1",1,1,-1,"D"
"22336",2005-10-30,2005,"AS Nancy","OGC Nice","0-0",0,0,"1",1,0,0,"D"
"22337",2005-10-30,2005,"AJ Auxerre","Paris Saint-Germain","2-0",2,0,"1",1,2,2,"H"
"22338",2005-11-05,2005,"Toulouse FC","Olympique Lyon","0-1",0,1,"1",1,1,-1,"D"
"22339",2005-11-05,2005,"Le Mans UC 72","Olympique Marseille","3-0",3,0,"1",1,3,3,"H"
"22340",2005-11-05,2005,"FC Metz","AC Ajaccio","2-0",2,0,"1",1,2,2,"H"
"22341",2005-11-05,2005,"FC Nantes","AS Nancy","3-0",3,0,"1",1,3,3,"H"
"22342",2005-11-05,2005,"OGC Nice","Girondins Bordeaux","0-1",0,1,"1",1,1,-1,"D"
"22343",2005-11-05,2005,"AS Saint-Etienne","AJ Auxerre","1-1",1,1,"1",1,2,0,"D"
"22344",2005-11-06,2005,"Lille OSC","RC Strasbourg","2-0",2,0,"1",1,2,2,"H"
"22345",2005-11-06,2005,"FC Sochaux","RC Lens","1-1",1,1,"1",1,2,0,"D"
"22346",2005-11-06,2005,"ESTAC Troyes","Stade Rennes","2-1",2,1,"1",1,3,1,"H"
"22347",2005-11-06,2005,"Paris Saint-Germain","AS Monaco","0-0",0,0,"1",1,0,0,"D"
"22348",2005-11-11,2005,"AC Ajaccio","RC Lens","0-0",0,0,"1",1,0,0,"D"
"22349",2005-11-19,2005,"Olympique Marseille","FC Nantes","2-1",2,1,"1",1,3,1,"H"
"22350",2005-11-19,2005,"AS Monaco","AS Saint-Etienne","1-0",1,0,"1",1,1,1,"H"
"22351",2005-11-19,2005,"AC Ajaccio","FC Sochaux","0-1",0,1,"1",1,1,-1,"D"
"22352",2005-11-19,2005,"AJ Auxerre","Lille OSC","3-2",3,2,"1",1,5,1,"H"
"22353",2005-11-19,2005,"RC Lens","FC Metz","0-0",0,0,"1",1,0,0,"D"
"22354",2005-11-19,2005,"Olympique Lyon","ESTAC Troyes","2-1",2,1,"1",1,3,1,"H"
"22355",2005-11-19,2005,"AS Nancy","Le Mans UC 72","1-0",1,0,"1",1,1,1,"H"
"22356",2005-11-19,2005,"RC Strasbourg","OGC Nice","0-0",0,0,"1",1,0,0,"D"
"22357",2005-11-20,2005,"Stade Rennes","Toulouse FC","4-1",4,1,"1",1,5,3,"H"
"22358",2005-11-20,2005,"Girondins Bordeaux","Paris Saint-Germain","0-2",0,2,"1",1,2,-2,"D"
"22359",2005-11-25,2005,"Le Mans UC 72","AJ Auxerre","0-2",0,2,"1",1,2,-2,"D"
"22360",2005-11-26,2005,"AS Saint-Etienne","Girondins Bordeaux","1-1",1,1,"1",1,2,0,"D"
"22361",2005-11-26,2005,"Lille OSC","AS Nancy","1-0",1,0,"1",1,1,1,"H"
"22362",2005-11-26,2005,"OGC Nice","Olympique Lyon","1-1",1,1,"1",1,2,0,"D"
"22363",2005-11-26,2005,"FC Sochaux","Stade Rennes","1-0",1,0,"1",1,1,1,"H"
"22364",2005-11-26,2005,"Toulouse FC","AC Ajaccio","3-0",3,0,"1",1,3,3,"H"
"22365",2005-11-26,2005,"ESTAC Troyes","FC Metz","0-0",0,0,"1",1,0,0,"D"
"22366",2005-11-27,2005,"FC Nantes","RC Strasbourg","4-3",4,3,"1",1,7,1,"H"
"22367",2005-11-27,2005,"Paris Saint-Germain","RC Lens","3-4",3,4,"1",1,7,-1,"D"
"22368",2005-11-27,2005,"Olympique Marseille","AS Monaco","2-1",2,1,"1",1,3,1,"H"
"22369",2005-12-03,2005,"Olympique Lyon","Paris Saint-Germain","2-0",2,0,"1",1,2,2,"H"
"22370",2005-12-03,2005,"AC Ajaccio","ESTAC Troyes","0-1",0,1,"1",1,1,-1,"D"
"22371",2005-12-03,2005,"AJ Auxerre","FC Nantes","4-0",4,0,"1",1,4,4,"H"
"22372",2005-12-03,2005,"Girondins Bordeaux","Lille OSC","1-0",1,0,"1",1,1,1,"H"
"22373",2005-12-03,2005,"FC Metz","Toulouse FC","2-2",2,2,"1",1,4,0,"D"
"22374",2005-12-03,2005,"AS Monaco","Le Mans UC 72","2-0",2,0,"1",1,2,2,"H"
"22375",2005-12-03,2005,"RC Strasbourg","FC Sochaux","0-0",0,0,"1",1,0,0,"D"
"22376",2005-12-04,2005,"AS Nancy","Olympique Marseille","1-1",1,1,"1",1,2,0,"D"
"22377",2005-12-04,2005,"Stade Rennes","OGC Nice","1-0",1,0,"1",1,1,1,"H"
"22378",2005-12-04,2005,"RC Lens","AS Saint-Etienne","2-1",2,1,"1",1,3,1,"H"
"22379",2005-12-10,2005,"Lille OSC","RC Lens","0-0",0,0,"1",1,0,0,"D"
"22380",2005-12-10,2005,"Le Mans UC 72","Girondins Bordeaux","1-0",1,0,"1",1,1,1,"H"
"22381",2005-12-10,2005,"Olympique Marseille","AJ Auxerre","1-0",1,0,"1",1,1,1,"H"
"22382",2005-12-10,2005,"AS Nancy","RC Strasbourg","1-2",1,2,"1",1,3,-1,"D"
"22383",2005-12-10,2005,"OGC Nice","AC Ajaccio","1-0",1,0,"1",1,1,1,"H"
"22384",2005-12-10,2005,"Paris Saint-Germain","Stade Rennes","2-0",2,0,"1",1,2,2,"H"
"22385",2005-12-10,2005,"FC Sochaux","FC Metz","1-1",1,1,"1",1,2,0,"D"
"22386",2005-12-10,2005,"Toulouse FC","ESTAC Troyes","2-1",2,1,"1",1,3,1,"H"
"22387",2005-12-11,2005,"FC Nantes","AS Monaco","0-0",0,0,"1",1,0,0,"D"
"22388",2005-12-11,2005,"AS Saint-Etienne","Olympique Lyon","0-0",0,0,"1",1,0,0,"D"
"22389",2005-12-16,2005,"Olympique Lyon","Lille OSC","1-3",1,3,"1",1,4,-2,"D"
"22390",2005-12-17,2005,"AC Ajaccio","Paris Saint-Germain","1-1",1,1,"1",1,2,0,"D"
"22391",2005-12-17,2005,"AJ Auxerre","AS Nancy","0-1",0,1,"1",1,1,-1,"D"
"22392",2005-12-17,2005,"Girondins Bordeaux","FC Nantes","0-0",0,0,"1",1,0,0,"D"
"22393",2005-12-17,2005,"FC Metz","OGC Nice","1-0",1,0,"1",1,1,1,"H"
"22394",2005-12-17,2005,"Stade Rennes","AS Saint-Etienne","0-1",0,1,"1",1,1,-1,"D"
"22395",2005-12-17,2005,"RC Strasbourg","Olympique Marseille","0-1",0,1,"1",1,1,-1,"D"
"22396",2005-12-17,2005,"ESTAC Troyes","FC Sochaux","2-1",2,1,"1",1,3,1,"H"
"22397",2005-12-18,2005,"RC Lens","Le Mans UC 72","2-0",2,0,"1",1,2,2,"H"
"22398",2005-12-18,2005,"AS Monaco","Toulouse FC","1-0",1,0,"1",1,1,1,"H"
"22399",2006-01-04,2005,"RC Strasbourg","Olympique Lyon","0-4",0,4,"1",1,4,-4,"D"
"22400",2006-01-04,2005,"Le Mans UC 72","FC Metz","2-0",2,0,"1",1,2,2,"H"
"22401",2006-01-04,2005,"Lille OSC","AC Ajaccio","2-0",2,0,"1",1,2,2,"H"
"22402",2006-01-04,2005,"AS Nancy","Girondins Bordeaux","0-0",0,0,"1",1,0,0,"D"
"22403",2006-01-04,2005,"FC Nantes","Stade Rennes","0-2",0,2,"1",1,2,-2,"D"
"22404",2006-01-04,2005,"OGC Nice","Toulouse FC","2-1",2,1,"1",1,3,1,"H"
"22405",2006-01-04,2005,"Paris Saint-Germain","FC Sochaux","3-1",3,1,"1",1,4,2,"H"
"22406",2006-01-04,2005,"AS Saint-Etienne","ESTAC Troyes","1-1",1,1,"1",1,2,0,"D"
"22407",2006-01-04,2005,"Olympique Marseille","RC Lens","1-1",1,1,"1",1,2,0,"D"
"22408",2006-01-05,2005,"AJ Auxerre","AS Monaco","2-1",2,1,"1",1,3,1,"H"
"22409",2006-01-11,2005,"Girondins Bordeaux","AJ Auxerre","1-0",1,0,"1",1,1,1,"H"
"22410",2006-01-11,2005,"AC Ajaccio","FC Nantes","0-2",0,2,"1",1,2,-2,"D"
"22411",2006-01-11,2005,"RC Lens","AS Nancy","1-2",1,2,"1",1,3,-1,"D"
"22412",2006-01-11,2005,"FC Metz","AS Saint-Etienne","0-1",0,1,"1",1,1,-1,"D"
"22413",2006-01-11,2005,"AS Monaco","RC Strasbourg","1-1",1,1,"1",1,2,0,"D"
"22414",2006-01-11,2005,"Stade Rennes","Le Mans UC 72","1-0",1,0,"1",1,1,1,"H"
"22415",2006-01-11,2005,"FC Sochaux","OGC Nice","1-1",1,1,"1",1,2,0,"D"
"22416",2006-01-11,2005,"ESTAC Troyes","Lille OSC","1-0",1,0,"1",1,1,1,"H"
"22417",2006-01-11,2005,"Olympique Lyon","Olympique Marseille","2-1",2,1,"1",1,3,1,"H"
"22418",2006-01-12,2005,"Toulouse FC","Paris Saint-Germain","1-0",1,0,"1",1,1,1,"H"
"22419",2006-01-14,2005,"AS Nancy","Olympique Lyon","0-2",0,2,"1",1,2,-2,"D"
"22420",2006-01-14,2005,"AJ Auxerre","RC Lens","1-0",1,0,"1",1,1,1,"H"
"22421",2006-01-14,2005,"Le Mans UC 72","AC Ajaccio","1-0",1,0,"1",1,1,1,"H"
"22422",2006-01-14,2005,"Lille OSC","FC Sochaux","3-0",3,0,"1",1,3,3,"H"
"22423",2006-01-14,2005,"AS Monaco","Girondins Bordeaux","0-1",0,1,"1",1,1,-1,"D"
"22424",2006-01-14,2005,"FC Nantes","OGC Nice","0-0",0,0,"1",1,0,0,"D"
"22425",2006-01-14,2005,"RC Strasbourg","FC Metz","2-1",2,1,"1",1,3,1,"H"
"22426",2006-01-15,2005,"Paris Saint-Germain","ESTAC Troyes","2-1",2,1,"1",1,3,1,"H"
"22427",2006-01-15,2005,"Olympique Marseille","Stade Rennes","1-0",1,0,"1",1,1,1,"H"
"22428",2006-01-21,2005,"AC Ajaccio","Olympique Marseille","3-1",3,1,"1",1,4,2,"H"
"22429",2006-01-21,2005,"Girondins Bordeaux","RC Strasbourg","2-1",2,1,"1",1,3,1,"H"
"22430",2006-01-21,2005,"FC Metz","FC Nantes","1-4",1,4,"1",1,5,-3,"D"
"22431",2006-01-21,2005,"OGC Nice","Paris Saint-Germain","1-0",1,0,"1",1,1,1,"H"
"22432",2006-01-21,2005,"Stade Rennes","AS Nancy","0-2",0,2,"1",1,2,-2,"D"
"22433",2006-01-21,2005,"FC Sochaux","AS Saint-Etienne","4-0",4,0,"1",1,4,4,"H"
"22434",2006-01-21,2005,"Toulouse FC","Lille OSC","0-0",0,0,"1",1,0,0,"D"
"22435",2006-01-21,2005,"ESTAC Troyes","Le Mans UC 72","1-3",1,3,"1",1,4,-2,"D"
"22436",2006-01-22,2005,"RC Lens","AS Monaco","1-1",1,1,"1",1,2,0,"D"
"22437",2006-01-22,2005,"Olympique Lyon","AJ Auxerre","1-1",1,1,"1",1,2,0,"D"
"22438",2006-01-28,2005,"Girondins Bordeaux","RC Lens","1-0",1,0,"1",1,1,1,"H"
"22439",2006-01-28,2005,"AJ Auxerre","Stade Rennes","2-0",2,0,"1",1,2,2,"H"
"22440",2006-01-28,2005,"Le Mans UC 72","Toulouse FC","1-1",1,1,"1",1,2,0,"D"
"22441",2006-01-28,2005,"Olympique Marseille","FC Sochaux","0-0",0,0,"1",1,0,0,"D"
"22442",2006-01-28,2005,"AS Nancy","AC Ajaccio","0-0",0,0,"1",1,0,0,"D"
"22443",2006-01-29,2005,"Lille OSC","FC Metz","3-1",3,1,"1",1,4,2,"H"
"22444",2006-02-01,2005,"AS Saint-Etienne","Toulouse FC","1-3",1,3,"1",1,4,-2,"D"
"22445",2006-02-04,2005,"Paris Saint-Germain","AS Saint-Etienne","2-2",2,2,"1",1,4,0,"D"
"22446",2006-02-04,2005,"AC Ajaccio","AJ Auxerre","1-0",1,0,"1",1,1,1,"H"
"22447",2006-02-04,2005,"RC Lens","RC Strasbourg","2-1",2,1,"1",1,3,1,"H"
"22448",2006-02-04,2005,"OGC Nice","Lille OSC","2-0",2,0,"1",1,2,2,"H"
"22449",2006-02-04,2005,"Stade Rennes","AS Monaco","1-3",1,3,"1",1,4,-2,"D"
"22450",2006-02-04,2005,"FC Sochaux","Le Mans UC 72","0-0",0,0,"1",1,0,0,"D"
"22451",2006-02-04,2005,"Toulouse FC","FC Nantes","1-0",1,0,"1",1,1,1,"H"
"22452",2006-02-05,2005,"ESTAC Troyes","Olympique Marseille","0-1",0,1,"1",1,1,-1,"D"
"22453",2006-02-05,2005,"Olympique Lyon","Girondins Bordeaux","0-0",0,0,"1",1,0,0,"D"
"22454",2006-02-08,2005,"RC Strasbourg","Paris Saint-Germain","1-1",1,1,"1",1,2,0,"D"
"22455",2006-02-11,2005,"RC Lens","Olympique Lyon","1-1",1,1,"1",1,2,0,"D"
"22456",2006-02-11,2005,"AJ Auxerre","FC Metz","1-1",1,1,"1",1,2,0,"D"
"22457",2006-02-11,2005,"Girondins Bordeaux","Stade Rennes","2-0",2,0,"1",1,2,2,"H"
"22458",2006-02-11,2005,"Le Mans UC 72","OGC Nice","2-0",2,0,"1",1,2,2,"H"
"22459",2006-02-11,2005,"AS Monaco","ESTAC Troyes","1-1",1,1,"1",1,2,0,"D"
"22460",2006-02-11,2005,"AS Nancy","AS Saint-Etienne","2-0",2,0,"1",1,2,2,"H"
"22461",2006-02-11,2005,"FC Nantes","FC Sochaux","3-1",3,1,"1",1,4,2,"H"
"22462",2006-02-11,2005,"RC Strasbourg","AC Ajaccio","2-2",2,2,"1",1,4,0,"D"
"22463",2006-02-12,2005,"Olympique Marseille","Toulouse FC","0-0",0,0,"1",1,0,0,"D"
"22464",2006-02-12,2005,"Lille OSC","Paris Saint-Germain","0-0",0,0,"1",1,0,0,"D"
"22465",2006-02-14,2005,"FC Nantes","ESTAC Troyes","1-1",1,1,"1",1,2,0,"D"
"22466",2006-02-14,2005,"AS Saint-Etienne","OGC Nice","0-1",0,1,"1",1,1,-1,"D"
"22467",2006-02-17,2005,"Olympique Lyon","FC Nantes","3-1",3,1,"1",1,4,2,"H"
"22468",2006-02-18,2005,"OGC Nice","AS Monaco","2-0",2,0,"1",1,2,2,"H"
"22469",2006-02-18,2005,"AC Ajaccio","Girondins Bordeaux","0-2",0,2,"1",1,2,-2,"D"
"22470",2006-02-18,2005,"Paris Saint-Germain","Le Mans UC 72","0-1",0,1,"1",1,1,-1,"D"
"22471",2006-02-18,2005,"Stade Rennes","RC Lens","4-1",4,1,"1",1,5,3,"H"
"22472",2006-02-18,2005,"AS Saint-Etienne","Lille OSC","0-2",0,2,"1",1,2,-2,"D"
"22473",2006-02-18,2005,"FC Sochaux","AJ Auxerre","1-0",1,0,"1",1,1,1,"H"
"22474",2006-02-18,2005,"Toulouse FC","RC Strasbourg","1-2",1,2,"1",1,3,-1,"D"
"22475",2006-02-18,2005,"ESTAC Troyes","AS Nancy","0-1",0,1,"1",1,1,-1,"D"
"22476",2006-02-19,2005,"FC Metz","Olympique Marseille","1-0",1,0,"1",1,1,1,"H"
"22477",2006-02-25,2005,"FC Nantes","Paris Saint-Germain","0-0",0,0,"1",1,0,0,"D"
"22478",2006-02-25,2005,"AJ Auxerre","Toulouse FC","2-0",2,0,"1",1,2,2,"H"
"22479",2006-02-25,2005,"Girondins Bordeaux","FC Metz","3-3",3,3,"1",1,6,0,"D"
"22480",2006-02-25,2005,"Le Mans UC 72","AS Saint-Etienne","0-1",0,1,"1",1,1,-1,"D"
"22481",2006-02-25,2005,"Olympique Lyon","Stade Rennes","1-4",1,4,"1",1,5,-3,"D"
"22482",2006-02-25,2005,"AS Nancy","FC Sochaux","0-3",0,3,"1",1,3,-3,"D"
"22483",2006-02-26,2005,"RC Lens","AC Ajaccio","1-0",1,0,"1",1,1,1,"H"
"22484",2006-02-26,2005,"AS Monaco","Lille OSC","0-1",0,1,"1",1,1,-1,"D"
"22485",2006-02-26,2005,"RC Strasbourg","ESTAC Troyes","2-0",2,0,"1",1,2,2,"H"
"22486",2006-02-26,2005,"Olympique Marseille","OGC Nice","1-0",1,0,"1",1,1,1,"H"
"22487",2006-03-04,2005,"AC Ajaccio","Olympique Lyon","1-3",1,3,"1",1,4,-2,"D"
"22488",2006-03-04,2005,"Lille OSC","Le Mans UC 72","4-0",4,0,"1",1,4,4,"H"
"22489",2006-03-04,2005,"FC Metz","AS Monaco","2-1",2,1,"1",1,3,1,"H"
"22490",2006-03-04,2005,"OGC Nice","RC Lens","0-0",0,0,"1",1,0,0,"D"
"22491",2006-03-04,2005,"Stade Rennes","RC Strasbourg","2-1",2,1,"1",1,3,1,"H"
"22492",2006-03-04,2005,"Toulouse FC","AS Nancy","1-1",1,1,"1",1,2,0,"D"
"22493",2006-03-05,2005,"Paris Saint-Germain","Olympique Marseille","0-0",0,0,"1",1,0,0,"D"
"22494",2006-03-05,2005,"ESTAC Troyes","AJ Auxerre","1-1",1,1,"1",1,2,0,"D"
"22495",2006-03-05,2005,"AS Saint-Etienne","FC Nantes","1-0",1,0,"1",1,1,1,"H"
"22496",2006-03-07,2005,"FC Metz","AS Nancy","0-0",0,0,"1",1,0,0,"D"
"22497",2006-03-11,2005,"AS Nancy","Paris Saint-Germain","1-1",1,1,"1",1,2,0,"D"
"22498",2006-03-11,2005,"AJ Auxerre","OGC Nice","2-0",2,0,"1",1,2,2,"H"
"22499",2006-03-11,2005,"Girondins Bordeaux","Toulouse FC","2-0",2,0,"1",1,2,2,"H"
"22500",2006-03-11,2005,"RC Lens","ESTAC Troyes","1-0",1,0,"1",1,1,1,"H"
"22501",2006-03-11,2005,"Olympique Lyon","FC Metz","4-0",4,0,"1",1,4,4,"H"
"22502",2006-03-11,2005,"AS Monaco","FC Sochaux","4-1",4,1,"1",1,5,3,"H"
"22503",2006-03-11,2005,"Stade Rennes","AC Ajaccio","3-0",3,0,"1",1,3,3,"H"
"22504",2006-03-12,2005,"FC Nantes","Lille OSC","1-1",1,1,"1",1,2,0,"D"
"22505",2006-03-12,2005,"RC Strasbourg","Le Mans UC 72","1-2",1,2,"1",1,3,-1,"D"
"22506",2006-03-12,2005,"Olympique Marseille","AS Saint-Etienne","2-0",2,0,"1",1,2,2,"H"
"22507",2006-03-18,2005,"Le Mans UC 72","FC Nantes","0-0",0,0,"1",1,0,0,"D"
"22508",2006-03-18,2005,"AC Ajaccio","AS Monaco","1-0",1,0,"1",1,1,1,"H"
"22509",2006-03-18,2005,"FC Metz","Stade Rennes","0-1",0,1,"1",1,1,-1,"D"
"22510",2006-03-18,2005,"OGC Nice","AS Nancy","1-0",1,0,"1",1,1,1,"H"
"22511",2006-03-18,2005,"FC Sochaux","Olympique Lyon","0-4",0,4,"1",1,4,-4,"D"
"22512",2006-03-18,2005,"Toulouse FC","RC Lens","1-1",1,1,"1",1,2,0,"D"
"22513",2006-03-18,2005,"ESTAC Troyes","Girondins Bordeaux","1-1",1,1,"1",1,2,0,"D"
"22514",2006-03-19,2005,"Lille OSC","Olympique Marseille","0-0",0,0,"1",1,0,0,"D"
"22515",2006-03-19,2005,"AS Saint-Etienne","RC Strasbourg","0-2",0,2,"1",1,2,-2,"D"
"22516",2006-03-19,2005,"Paris Saint-Germain","AJ Auxerre","4-1",4,1,"1",1,5,3,"H"
"22517",2006-03-25,2005,"Olympique Lyon","Toulouse FC","1-1",1,1,"1",1,2,0,"D"
"22518",2006-03-25,2005,"AC Ajaccio","FC Metz","0-1",0,1,"1",1,1,-1,"D"
"22519",2006-03-25,2005,"AJ Auxerre","AS Saint-Etienne","0-0",0,0,"1",1,0,0,"D"
"22520",2006-03-25,2005,"RC Lens","FC Sochaux","2-1",2,1,"1",1,3,1,"H"
"22521",2006-03-25,2005,"Olympique Marseille","Le Mans UC 72","1-1",1,1,"1",1,2,0,"D"
"22522",2006-03-25,2005,"AS Nancy","FC Nantes","0-0",0,0,"1",1,0,0,"D"
"22523",2006-03-25,2005,"Stade Rennes","ESTAC Troyes","2-0",2,0,"1",1,2,2,"H"
"22524",2006-03-25,2005,"RC Strasbourg","Lille OSC","2-2",2,2,"1",1,4,0,"D"
"22525",2006-03-26,2005,"Girondins Bordeaux","OGC Nice","1-0",1,0,"1",1,1,1,"H"
"22526",2006-03-26,2005,"AS Monaco","Paris Saint-Germain","1-1",1,1,"1",1,2,0,"D"
"22527",2006-04-01,2005,"Lille OSC","AJ Auxerre","1-1",1,1,"1",1,2,0,"D"
"22528",2006-04-01,2005,"ESTAC Troyes","Olympique Lyon","0-1",0,1,"1",1,1,-1,"D"
"22529",2006-04-01,2005,"FC Metz","RC Lens","0-1",0,1,"1",1,1,-1,"D"
"22530",2006-04-01,2005,"FC Nantes","Olympique Marseille","1-3",1,3,"1",1,4,-2,"D"
"22531",2006-04-01,2005,"OGC Nice","RC Strasbourg","3-1",3,1,"1",1,4,2,"H"
"22532",2006-04-01,2005,"AS Saint-Etienne","AS Monaco","1-1",1,1,"1",1,2,0,"D"
"22533",2006-04-01,2005,"FC Sochaux","AC Ajaccio","3-1",3,1,"1",1,4,2,"H"
"22534",2006-04-02,2005,"Le Mans UC 72","AS Nancy","0-0",0,0,"1",1,0,0,"D"
"22535",2006-04-02,2005,"Toulouse FC","Stade Rennes","0-1",0,1,"1",1,1,-1,"D"
"22536",2006-04-02,2005,"Paris Saint-Germain","Girondins Bordeaux","3-1",3,1,"1",1,4,2,"H"
"22537",2006-04-08,2005,"RC Lens","Paris Saint-Germain","1-1",1,1,"1",1,2,0,"D"
"22538",2006-04-08,2005,"AC Ajaccio","Toulouse FC","1-0",1,0,"1",1,1,1,"H"
"22539",2006-04-08,2005,"Girondins Bordeaux","AS Saint-Etienne","0-0",0,0,"1",1,0,0,"D"
"22540",2006-04-08,2005,"Olympique Lyon","OGC Nice","2-1",2,1,"1",1,3,1,"H"
"22541",2006-04-08,2005,"FC Metz","ESTAC Troyes","2-4",2,4,"1",1,6,-2,"D"
"22542",2006-04-08,2005,"AS Monaco","Olympique Marseille","1-0",1,0,"1",1,1,1,"H"
"22543",2006-04-08,2005,"AS Nancy","Lille OSC","0-0",0,0,"1",1,0,0,"D"
"22544",2006-04-08,2005,"RC Strasbourg","FC Nantes","0-1",0,1,"1",1,1,-1,"D"
"22545",2006-04-09,2005,"AJ Auxerre","Le Mans UC 72","0-0",0,0,"1",1,0,0,"D"
"22546",2006-04-09,2005,"Stade Rennes","FC Sochaux","2-1",2,1,"1",1,3,1,"H"
"22547",2006-04-14,2005,"Toulouse FC","FC Metz","2-0",2,0,"1",1,2,2,"H"
"22548",2006-04-15,2005,"Lille OSC","Girondins Bordeaux","3-2",3,2,"1",1,5,1,"H"
"22549",2006-04-15,2005,"Le Mans UC 72","AS Monaco","0-0",0,0,"1",1,0,0,"D"
"22550",2006-04-15,2005,"Olympique Marseille","AS Nancy","6-0",6,0,"1",1,6,6,"H"
"22551",2006-04-15,2005,"FC Nantes","AJ Auxerre","3-2",3,2,"1",1,5,1,"H"
"22552",2006-04-15,2005,"AS Saint-Etienne","RC Lens","2-0",2,0,"1",1,2,2,"H"
"22553",2006-04-15,2005,"FC Sochaux","RC Strasbourg","1-1",1,1,"1",1,2,0,"D"
"22554",2006-04-15,2005,"ESTAC Troyes","AC Ajaccio","3-0",3,0,"1",1,3,3,"H"
"22555",2006-04-16,2005,"OGC Nice","Stade Rennes","2-1",2,1,"1",1,3,1,"H"
"22556",2006-04-16,2005,"Paris Saint-Germain","Olympique Lyon","0-1",0,1,"1",1,1,-1,"D"
"22557",2006-04-23,2005,"AS Monaco","Olympique Lyon","2-1",2,1,"1",1,3,1,"H"
"22558",2006-04-23,2005,"FC Sochaux","Girondins Bordeaux","0-3",0,3,"1",1,3,-3,"D"
"22559",2006-04-29,2005,"RC Lens","Lille OSC","4-2",4,2,"1",1,6,2,"H"
"22560",2006-04-30,2005,"AC Ajaccio","OGC Nice","0-3",0,3,"1",1,3,-3,"D"
"22561",2006-04-30,2005,"Girondins Bordeaux","Le Mans UC 72","2-2",2,2,"1",1,4,0,"D"
"22562",2006-04-30,2005,"FC Metz","FC Sochaux","0-1",0,1,"1",1,1,-1,"D"
"22563",2006-04-30,2005,"AS Monaco","FC Nantes","1-1",1,1,"1",1,2,0,"D"
"22564",2006-04-30,2005,"RC Strasbourg","AS Nancy","1-3",1,3,"1",1,4,-2,"D"
"22565",2006-04-30,2005,"ESTAC Troyes","Toulouse FC","3-1",3,1,"1",1,4,2,"H"
"22566",2006-04-30,2005,"Olympique Lyon","AS Saint-Etienne","4-0",4,0,"1",1,4,4,"H"
"22567",2006-05-03,2005,"AJ Auxerre","Olympique Marseille","1-2",1,2,"1",1,3,-1,"D"
"22568",2006-05-03,2005,"Stade Rennes","Paris Saint-Germain","1-1",1,1,"1",1,2,0,"D"
"22569",2006-05-06,2005,"Le Mans UC 72","RC Lens","0-0",0,0,"1",1,0,0,"D"
"22570",2006-05-06,2005,"Lille OSC","Olympique Lyon","4-0",4,0,"1",1,4,4,"H"
"22571",2006-05-06,2005,"Olympique Marseille","RC Strasbourg","2-2",2,2,"1",1,4,0,"D"
"22572",2006-05-06,2005,"AS Nancy","AJ Auxerre","1-3",1,3,"1",1,4,-2,"D"
"22573",2006-05-06,2005,"FC Nantes","Girondins Bordeaux","0-1",0,1,"1",1,1,-1,"D"
"22574",2006-05-06,2005,"OGC Nice","FC Metz","2-1",2,1,"1",1,3,1,"H"
"22575",2006-05-06,2005,"Paris Saint-Germain","AC Ajaccio","2-4",2,4,"1",1,6,-2,"D"
"22576",2006-05-06,2005,"AS Saint-Etienne","Stade Rennes","0-0",0,0,"1",1,0,0,"D"
"22577",2006-05-06,2005,"FC Sochaux","ESTAC Troyes","1-1",1,1,"1",1,2,0,"D"
"22578",2006-05-06,2005,"Toulouse FC","AS Monaco","3-3",3,3,"1",1,6,0,"D"
"22579",2006-05-13,2005,"AC Ajaccio","AS Saint-Etienne","3-1",3,1,"1",1,4,2,"H"
"22580",2006-05-13,2005,"AJ Auxerre","RC Strasbourg","4-0",4,0,"1",1,4,4,"H"
"22581",2006-05-13,2005,"Girondins Bordeaux","Olympique Marseille","1-1",1,1,"1",1,2,0,"D"
"22582",2006-05-13,2005,"RC Lens","FC Nantes","3-1",3,1,"1",1,4,2,"H"
"22583",2006-05-13,2005,"Olympique Lyon","Le Mans UC 72","8-1",8,1,"1",1,9,7,"H"
"22584",2006-05-13,2005,"FC Metz","Paris Saint-Germain","1-0",1,0,"1",1,1,1,"H"
"22585",2006-05-13,2005,"AS Monaco","AS Nancy","2-2",2,2,"1",1,4,0,"D"
"22586",2006-05-13,2005,"Stade Rennes","Lille OSC","2-2",2,2,"1",1,4,0,"D"
"22587",2006-05-13,2005,"Toulouse FC","FC Sochaux","1-2",1,2,"1",1,3,-1,"D"
"22588",2006-05-13,2005,"ESTAC Troyes","OGC Nice","1-2",1,2,"1",1,3,-1,"D"
"22589",2006-08-04,2006,"FC Nantes","Olympique Lyon","1-3",1,3,"1",1,4,-2,"D"
"22590",2006-08-05,2006,"Stade Rennes","Lille OSC","1-2",1,2,"1",1,3,-1,"D"
"22591",2006-08-05,2006,"AJ Auxerre","Valenciennes FC","1-1",1,1,"1",1,2,0,"D"
"22592",2006-08-05,2006,"Girondins Bordeaux","Toulouse FC","2-0",2,0,"1",1,2,2,"H"
"22593",2006-08-05,2006,"Le Mans UC 72","OGC Nice","1-0",1,0,"1",1,1,1,"H"
"22594",2006-08-05,2006,"RC Lens","ESTAC Troyes","1-0",1,0,"1",1,1,1,"H"
"22595",2006-08-05,2006,"AS Nancy","AS Monaco","1-0",1,0,"1",1,1,1,"H"
"22596",2006-08-05,2006,"Paris Saint-Germain","FC Lorient","2-3",2,3,"1",1,5,-1,"D"
"22597",2006-08-05,2006,"AS Saint-Etienne","FC Sochaux","1-2",1,2,"1",1,3,-1,"D"
"22598",2006-08-06,2006,"CS Sedan","Olympique Marseille","0-0",0,0,"1",1,0,0,"D"
"22599",2006-08-12,2006,"FC Lorient","Girondins Bordeaux","0-1",0,1,"1",1,1,-1,"D"
"22600",2006-08-12,2006,"Olympique Lyon","Toulouse FC","1-1",1,1,"1",1,2,0,"D"
"22601",2006-08-12,2006,"Valenciennes FC","Paris Saint-Germain","0-0",0,0,"1",1,0,0,"D"
"22602",2006-08-12,2006,"AS Monaco","AS Saint-Etienne","1-2",1,2,"1",1,3,-1,"D"
"22603",2006-08-12,2006,"FC Sochaux","AJ Auxerre","1-1",1,1,"1",1,2,0,"D"
"22604",2006-08-12,2006,"OGC Nice","FC Nantes","1-1",1,1,"1",1,2,0,"D"
"22605",2006-08-12,2006,"AS Nancy","CS Sedan","3-1",3,1,"1",1,4,2,"H"
"22606",2006-08-12,2006,"ESTAC Troyes","Le Mans UC 72","2-2",2,2,"1",1,4,0,"D"
"22607",2006-08-13,2006,"Lille OSC","RC Lens","4-0",4,0,"1",1,4,4,"H"
"22608",2006-08-13,2006,"Olympique Marseille","Stade Rennes","2-0",2,0,"1",1,2,2,"H"
"22609",2006-08-19,2006,"AJ Auxerre","Olympique Marseille","0-3",0,3,"1",1,3,-3,"D"
"22610",2006-08-19,2006,"Le Mans UC 72","Valenciennes FC","3-2",3,2,"1",1,5,1,"H"
"22611",2006-08-19,2006,"FC Nantes","ESTAC Troyes","1-1",1,1,"1",1,2,0,"D"
"22612",2006-08-19,2006,"Paris Saint-Germain","Lille OSC","1-0",1,0,"1",1,1,1,"H"
"22613",2006-08-19,2006,"Stade Rennes","AS Monaco","1-1",1,1,"1",1,2,0,"D"
"22614",2006-08-19,2006,"AS Saint-Etienne","AS Nancy","1-0",1,0,"1",1,1,1,"H"
"22615",2006-08-19,2006,"CS Sedan","FC Sochaux","1-1",1,1,"1",1,2,0,"D"
"22616",2006-08-19,2006,"RC Lens","FC Lorient","1-1",1,1,"1",1,2,0,"D"
"22617",2006-08-20,2006,"Toulouse FC","OGC Nice","1-0",1,0,"1",1,1,1,"H"
"22618",2006-08-20,2006,"Girondins Bordeaux","Olympique Lyon","1-2",1,2,"1",1,3,-1,"D"
"22619",2006-08-26,2006,"OGC Nice","Olympique Lyon","1-4",1,4,"1",1,5,-3,"D"
"22620",2006-08-26,2006,"Lille OSC","Girondins Bordeaux","3-0",3,0,"1",1,3,3,"H"
"22621",2006-08-26,2006,"FC Lorient","FC Nantes","3-1",3,1,"1",1,4,2,"H"
"22622",2006-08-26,2006,"FC Sochaux","Paris Saint-Germain","3-2",3,2,"1",1,5,1,"H"
"22623",2006-08-26,2006,"ESTAC Troyes","Toulouse FC","1-2",1,2,"1",1,3,-1,"D"
"22624",2006-08-27,2006,"Olympique Marseille","Le Mans UC 72","2-0",2,0,"1",1,2,2,"H"
"22625",2006-08-27,2006,"AS Monaco","CS Sedan","2-1",2,1,"1",1,3,1,"H"
"22626",2006-08-27,2006,"AS Nancy","AJ Auxerre","1-0",1,0,"1",1,1,1,"H"
"22627",2006-08-27,2006,"Valenciennes FC","Stade Rennes","3-1",3,1,"1",1,4,2,"H"
"22628",2006-08-27,2006,"AS Saint-Etienne","RC Lens","3-2",3,2,"1",1,5,1,"H"
"22629",2006-09-09,2006,"Girondins Bordeaux","OGC Nice","3-2",3,2,"1",1,5,1,"H"
"22630",2006-09-09,2006,"Olympique Lyon","ESTAC Troyes","2-0",2,0,"1",1,2,2,"H"
"22631",2006-09-09,2006,"AJ Auxerre","AS Monaco","2-1",2,1,"1",1,3,1,"H"
"22632",2006-09-09,2006,"CS Sedan","AS Saint-Etienne","2-2",2,2,"1",1,4,0,"D"
"22633",2006-09-09,2006,"Le Mans UC 72","FC Lorient","1-1",1,1,"1",1,2,0,"D"
"22634",2006-09-09,2006,"FC Nantes","Lille OSC","1-1",1,1,"1",1,2,0,"D"
"22635",2006-09-09,2006,"RC Lens","Valenciennes FC","3-0",3,0,"1",1,3,3,"H"
"22636",2006-09-09,2006,"Stade Rennes","FC Sochaux","2-1",2,1,"1",1,3,1,"H"
"22637",2006-09-10,2006,"Toulouse FC","AS Nancy","2-2",2,2,"1",1,4,0,"D"
"22638",2006-09-10,2006,"Paris Saint-Germain","Olympique Marseille","1-3",1,3,"1",1,4,-2,"D"
"22639",2006-09-16,2006,"CS Sedan","Le Mans UC 72","1-2",1,2,"1",1,3,-1,"D"
"22640",2006-09-16,2006,"Lille OSC","Toulouse FC","1-3",1,3,"1",1,4,-2,"D"
"22641",2006-09-16,2006,"Valenciennes FC","FC Nantes","1-0",1,0,"1",1,1,1,"H"
"22642",2006-09-16,2006,"ESTAC Troyes","OGC Nice","2-0",2,0,"1",1,2,2,"H"
"22643",2006-09-16,2006,"FC Lorient","Olympique Lyon","1-3",1,3,"1",1,4,-2,"D"
"22644",2006-09-17,2006,"AS Monaco","Paris Saint-Germain","1-2",1,2,"1",1,3,-1,"D"
"22645",2006-09-17,2006,"FC Sochaux","RC Lens","0-3",0,3,"1",1,3,-3,"D"
"22646",2006-09-17,2006,"AS Saint-Etienne","AJ Auxerre","2-3",2,3,"1",1,5,-1,"D"
"22647",2006-09-17,2006,"AS Nancy","Stade Rennes","0-0",0,0,"1",1,0,0,"D"
"22648",2006-09-17,2006,"Olympique Marseille","Girondins Bordeaux","2-1",2,1,"1",1,3,1,"H"
"22649",2006-09-23,2006,"Olympique Lyon","Lille OSC","4-1",4,1,"1",1,5,3,"H"
"22650",2006-09-23,2006,"AJ Auxerre","CS Sedan","2-2",2,2,"1",1,4,0,"D"
"22651",2006-09-23,2006,"Girondins Bordeaux","ESTAC Troyes","2-1",2,1,"1",1,3,1,"H"
"22652",2006-09-23,2006,"Le Mans UC 72","FC Sochaux","2-2",2,2,"1",1,4,0,"D"
"22653",2006-09-23,2006,"OGC Nice","Valenciennes FC","2-0",2,0,"1",1,2,2,"H"
"22654",2006-09-23,2006,"Paris Saint-Germain","AS Nancy","0-0",0,0,"1",1,0,0,"D"
"22655",2006-09-23,2006,"Stade Rennes","AS Saint-Etienne","0-0",0,0,"1",1,0,0,"D"
"22656",2006-09-23,2006,"Toulouse FC","FC Lorient","0-0",0,0,"1",1,0,0,"D"
"22657",2006-09-24,2006,"RC Lens","AS Monaco","1-0",1,0,"1",1,1,1,"H"
"22658",2006-09-24,2006,"FC Nantes","Olympique Marseille","2-1",2,1,"1",1,3,1,"H"
"22659",2006-09-30,2006,"FC Sochaux","Olympique Lyon","0-1",0,1,"1",1,1,-1,"D"
"22660",2006-09-30,2006,"Lille OSC","OGC Nice","1-0",1,0,"1",1,1,1,"H"
"22661",2006-09-30,2006,"Valenciennes FC","Girondins Bordeaux","2-0",2,0,"1",1,2,2,"H"
"22662",2006-09-30,2006,"AS Monaco","Le Mans UC 72","2-1",2,1,"1",1,3,1,"H"
"22663",2006-09-30,2006,"CS Sedan","Stade Rennes","1-0",1,0,"1",1,1,1,"H"
"22664",2006-09-30,2006,"FC Lorient","ESTAC Troyes","0-0",0,0,"1",1,0,0,"D"
"22665",2006-10-01,2006,"AJ Auxerre","FC Nantes","1-0",1,0,"1",1,1,1,"H"
"22666",2006-10-01,2006,"Olympique Marseille","Toulouse FC","3-0",3,0,"1",1,3,3,"H"
"22667",2006-10-01,2006,"AS Nancy","RC Lens","2-1",2,1,"1",1,3,1,"H"
"22668",2006-10-01,2006,"AS Saint-Etienne","Paris Saint-Germain","1-0",1,0,"1",1,1,1,"H"
"22669",2006-10-14,2006,"Olympique Lyon","AS Saint-Etienne","2-1",2,1,"1",1,3,1,"H"
"22670",2006-10-14,2006,"Girondins Bordeaux","AS Monaco","1-0",1,0,"1",1,1,1,"H"
"22671",2006-10-14,2006,"FC Nantes","FC Sochaux","0-2",0,2,"1",1,2,-2,"D"
"22672",2006-10-14,2006,"OGC Nice","FC Lorient","3-0",3,0,"1",1,3,3,"H"
"22673",2006-10-14,2006,"Paris Saint-Germain","CS Sedan","4-2",4,2,"1",1,6,2,"H"
"22674",2006-10-14,2006,"Stade Rennes","AJ Auxerre","3-1",3,1,"1",1,4,2,"H"
"22675",2006-10-14,2006,"Toulouse FC","Valenciennes FC","3-0",3,0,"1",1,3,3,"H"
"22676",2006-10-14,2006,"ESTAC Troyes","Lille OSC","1-1",1,1,"1",1,2,0,"D"
"22677",2006-10-15,2006,"Le Mans UC 72","AS Nancy","0-0",0,0,"1",1,0,0,"D"
"22678",2006-10-15,2006,"RC Lens","Olympique Marseille","1-1",1,1,"1",1,2,0,"D"
"22679",2006-10-21,2006,"Lille OSC","FC Lorient","1-0",1,0,"1",1,1,1,"H"
"22680",2006-10-21,2006,"Valenciennes FC","ESTAC Troyes","3-1",3,1,"1",1,4,2,"H"
"22681",2006-10-21,2006,"AS Monaco","Toulouse FC","1-3",1,3,"1",1,4,-2,"D"
"22682",2006-10-21,2006,"AS Nancy","FC Nantes","1-0",1,0,"1",1,1,1,"H"
"22683",2006-10-21,2006,"CS Sedan","RC Lens","2-2",2,2,"1",1,4,0,"D"
"22684",2006-10-21,2006,"FC Sochaux","Girondins Bordeaux","2-1",2,1,"1",1,3,1,"H"
"22685",2006-10-21,2006,"AS Saint-Etienne","Le Mans UC 72","2-0",2,0,"1",1,2,2,"H"
"22686",2006-10-21,2006,"Stade Rennes","OGC Nice","1-0",1,0,"1",1,1,1,"H"
"22687",2006-10-22,2006,"AJ Auxerre","Paris Saint-Germain","0-0",0,0,"1",1,0,0,"D"
"22688",2006-10-22,2006,"Olympique Marseille","Olympique Lyon","1-4",1,4,"1",1,5,-3,"D"
"22689",2006-10-28,2006,"RC Lens","AJ Auxerre","1-0",1,0,"1",1,1,1,"H"
"22690",2006-10-28,2006,"FC Nantes","AS Monaco","1-0",1,0,"1",1,1,1,"H"
"22691",2006-10-28,2006,"Paris Saint-Germain","Stade Rennes","1-0",1,0,"1",1,1,1,"H"
"22692",2006-10-28,2006,"Girondins Bordeaux","CS Sedan","3-1",3,1,"1",1,4,2,"H"
"22693",2006-10-28,2006,"Toulouse FC","FC Sochaux","1-2",1,2,"1",1,3,-1,"D"
"22694",2006-10-28,2006,"Le Mans UC 72","Lille OSC","1-1",1,1,"1",1,2,0,"D"
"22695",2006-10-28,2006,"ESTAC Troyes","AS Saint-Etienne","3-1",3,1,"1",1,4,2,"H"
"22696",2006-10-28,2006,"FC Lorient","Valenciennes FC","1-0",1,0,"1",1,1,1,"H"
"22697",2006-10-29,2006,"OGC Nice","Olympique Marseille","2-1",2,1,"1",1,3,1,"H"
"22698",2006-10-29,2006,"Olympique Lyon","AS Nancy","1-0",1,0,"1",1,1,1,"H"
"22699",2006-11-04,2006,"Stade Rennes","Olympique Lyon","1-0",1,0,"1",1,1,1,"H"
"22700",2006-11-04,2006,"AJ Auxerre","Le Mans UC 72","2-3",2,3,"1",1,5,-1,"D"
"22701",2006-11-04,2006,"Olympique Marseille","FC Lorient","0-1",0,1,"1",1,1,-1,"D"
"22702",2006-11-04,2006,"AS Monaco","OGC Nice","0-0",0,0,"1",1,0,0,"D"
"22703",2006-11-04,2006,"AS Saint-Etienne","Toulouse FC","3-0",3,0,"1",1,3,3,"H"
"22704",2006-11-04,2006,"CS Sedan","FC Nantes","1-1",1,1,"1",1,2,0,"D"
"22705",2006-11-04,2006,"FC Sochaux","ESTAC Troyes","1-0",1,0,"1",1,1,1,"H"
"22706",2006-11-04,2006,"Valenciennes FC","Lille OSC","0-3",0,3,"1",1,3,-3,"D"
"22707",2006-11-05,2006,"AS Nancy","Girondins Bordeaux","2-1",2,1,"1",1,3,1,"H"
"22708",2006-11-05,2006,"Paris Saint-Germain","RC Lens","1-3",1,3,"1",1,4,-2,"D"
"22709",2006-11-10,2006,"Olympique Lyon","Valenciennes FC","2-1",2,1,"1",1,3,1,"H"
"22710",2006-11-11,2006,"Girondins Bordeaux","AJ Auxerre","0-0",0,0,"1",1,0,0,"D"
"22711",2006-11-11,2006,"Le Mans UC 72","Paris Saint-Germain","1-1",1,1,"1",1,2,0,"D"
"22712",2006-11-11,2006,"RC Lens","Stade Rennes","0-0",0,0,"1",1,0,0,"D"
"22713",2006-11-11,2006,"FC Lorient","AS Nancy","2-0",2,0,"1",1,2,2,"H"
"22714",2006-11-11,2006,"FC Nantes","AS Saint-Etienne","2-2",2,2,"1",1,4,0,"D"
"22715",2006-11-11,2006,"OGC Nice","FC Sochaux","0-0",0,0,"1",1,0,0,"D"
"22716",2006-11-11,2006,"Toulouse FC","CS Sedan","3-1",3,1,"1",1,4,2,"H"
"22717",2006-11-12,2006,"ESTAC Troyes","AS Monaco","0-4",0,4,"1",1,4,-4,"D"
"22718",2006-11-12,2006,"Lille OSC","Olympique Marseille","1-0",1,0,"1",1,1,1,"H"
"22719",2006-11-18,2006,"FC Sochaux","Lille OSC","0-0",0,0,"1",1,0,0,"D"
"22720",2006-11-18,2006,"RC Lens","FC Nantes","2-0",2,0,"1",1,2,2,"H"
"22721",2006-11-18,2006,"AS Monaco","FC Lorient","2-2",2,2,"1",1,4,0,"D"
"22722",2006-11-18,2006,"AS Nancy","ESTAC Troyes","1-0",1,0,"1",1,1,1,"H"
"22723",2006-11-18,2006,"Paris Saint-Germain","Girondins Bordeaux","0-2",0,2,"1",1,2,-2,"D"
"22724",2006-11-18,2006,"Stade Rennes","Le Mans UC 72","1-1",1,1,"1",1,2,0,"D"
"22725",2006-11-18,2006,"AS Saint-Etienne","OGC Nice","2-1",2,1,"1",1,3,1,"H"
"22726",2006-11-18,2006,"CS Sedan","Olympique Lyon","0-1",0,1,"1",1,1,-1,"D"
"22727",2006-11-19,2006,"AJ Auxerre","Toulouse FC","1-0",1,0,"1",1,1,1,"H"
"22728",2006-11-19,2006,"Olympique Marseille","Valenciennes FC","1-0",1,0,"1",1,1,1,"H"
"22729",2006-11-25,2006,"ESTAC Troyes","Olympique Marseille","1-1",1,1,"1",1,2,0,"D"
"22730",2006-11-25,2006,"Girondins Bordeaux","AS Saint-Etienne","1-0",1,0,"1",1,1,1,"H"
"22731",2006-11-25,2006,"Lille OSC","AS Monaco","1-1",1,1,"1",1,2,0,"D"
"22732",2006-11-25,2006,"FC Lorient","FC Sochaux","1-3",1,3,"1",1,4,-2,"D"
"22733",2006-11-25,2006,"OGC Nice","CS Sedan","2-2",2,2,"1",1,4,0,"D"
"22734",2006-11-25,2006,"Toulouse FC","Stade Rennes","1-0",1,0,"1",1,1,1,"H"
"22735",2006-11-26,2006,"Le Mans UC 72","RC Lens","1-1",1,1,"1",1,2,0,"D"
"22736",2006-11-26,2006,"FC Nantes","Paris Saint-Germain","1-1",1,1,"1",1,2,0,"D"
"22737",2006-11-26,2006,"Valenciennes FC","AS Nancy","1-0",1,0,"1",1,1,1,"H"
"22738",2006-11-26,2006,"Olympique Lyon","AJ Auxerre","1-0",1,0,"1",1,1,1,"H"
"22739",2006-12-02,2006,"Le Mans UC 72","Olympique Lyon","0-1",0,1,"1",1,1,-1,"D"
"22740",2006-12-02,2006,"AJ Auxerre","OGC Nice","0-0",0,0,"1",1,0,0,"D"
"22741",2006-12-02,2006,"AS Monaco","Valenciennes FC","3-0",3,0,"1",1,3,3,"H"
"22742",2006-12-02,2006,"CS Sedan","ESTAC Troyes","1-2",1,2,"1",1,3,-1,"D"
"22743",2006-12-02,2006,"AS Saint-Etienne","FC Lorient","2-0",2,0,"1",1,2,2,"H"
"22744",2006-12-02,2006,"RC Lens","Girondins Bordeaux","3-0",3,0,"1",1,3,3,"H"
"22745",2006-12-02,2006,"Stade Rennes","FC Nantes","2-0",2,0,"1",1,2,2,"H"
"22746",2006-12-03,2006,"FC Sochaux","Olympique Marseille","1-0",1,0,"1",1,1,1,"H"
"22747",2006-12-03,2006,"AS Nancy","Lille OSC","1-3",1,3,"1",1,4,-2,"D"
"22748",2006-12-09,2006,"Toulouse FC","RC Lens","0-1",0,1,"1",1,1,-1,"D"
"22749",2006-12-09,2006,"Girondins Bordeaux","Stade Rennes","1-2",1,2,"1",1,3,-1,"D"
"22750",2006-12-09,2006,"FC Lorient","CS Sedan","2-0",2,0,"1",1,2,2,"H"
"22751",2006-12-09,2006,"Olympique Marseille","AS Monaco","2-1",2,1,"1",1,3,1,"H"
"22752",2006-12-09,2006,"FC Nantes","Le Mans UC 72","0-0",0,0,"1",1,0,0,"D"
"22753",2006-12-09,2006,"OGC Nice","AS Nancy","0-0",0,0,"1",1,0,0,"D"
"22754",2006-12-09,2006,"ESTAC Troyes","AJ Auxerre","3-3",3,3,"1",1,6,0,"D"
"22755",2006-12-09,2006,"Valenciennes FC","FC Sochaux","0-0",0,0,"1",1,0,0,"D"
"22756",2006-12-10,2006,"Lille OSC","AS Saint-Etienne","2-2",2,2,"1",1,4,0,"D"
"22757",2006-12-10,2006,"Olympique Lyon","Paris Saint-Germain","3-1",3,1,"1",1,4,2,"H"
"22758",2006-12-16,2006,"AS Nancy","Olympique Marseille","2-0",2,0,"1",1,2,2,"H"
"22759",2006-12-16,2006,"Le Mans UC 72","Toulouse FC","2-0",2,0,"1",1,2,2,"H"
"22760",2006-12-16,2006,"AS Monaco","FC Sochaux","3-0",3,0,"1",1,3,3,"H"
"22761",2006-12-16,2006,"FC Nantes","Girondins Bordeaux","0-0",0,0,"1",1,0,0,"D"
"22762",2006-12-16,2006,"Stade Rennes","ESTAC Troyes","1-1",1,1,"1",1,2,0,"D"
"22763",2006-12-16,2006,"AS Saint-Etienne","Valenciennes FC","3-0",3,0,"1",1,3,3,"H"
"22764",2006-12-16,2006,"CS Sedan","Lille OSC","2-0",2,0,"1",1,2,2,"H"
"22765",2006-12-17,2006,"Paris Saint-Germain","OGC Nice","0-0",0,0,"1",1,0,0,"D"
"22766",2006-12-17,2006,"AJ Auxerre","FC Lorient","2-1",2,1,"1",1,3,1,"H"
"22767",2006-12-17,2006,"RC Lens","Olympique Lyon","0-4",0,4,"1",1,4,-4,"D"
"22768",2006-12-22,2006,"Olympique Marseille","AS Saint-Etienne","2-1",2,1,"1",1,3,1,"H"
"22769",2006-12-23,2006,"FC Sochaux","AS Nancy","2-1",2,1,"1",1,3,1,"H"
"22770",2006-12-23,2006,"ESTAC Troyes","Paris Saint-Germain","1-1",1,1,"1",1,2,0,"D"
"22771",2006-12-23,2006,"Olympique Lyon","AS Monaco","0-0",0,0,"1",1,0,0,"D"
"22772",2006-12-23,2006,"Lille OSC","AJ Auxerre","1-1",1,1,"1",1,2,0,"D"
"22773",2006-12-23,2006,"Valenciennes FC","CS Sedan","2-1",2,1,"1",1,3,1,"H"
"22774",2006-12-23,2006,"Girondins Bordeaux","Le Mans UC 72","1-0",1,0,"1",1,1,1,"H"
"22775",2006-12-23,2006,"Toulouse FC","FC Nantes","0-4",0,4,"1",1,4,-4,"D"
"22776",2006-12-23,2006,"OGC Nice","RC Lens","1-2",1,2,"1",1,3,-1,"D"
"22777",2006-12-23,2006,"FC Lorient","Stade Rennes","0-0",0,0,"1",1,0,0,"D"
"22778",2007-01-13,2006,"Paris Saint-Germain","Valenciennes FC","1-2",1,2,"1",1,3,-1,"D"
"22779",2007-01-13,2006,"RC Lens","Lille OSC","1-1",1,1,"1",1,2,0,"D"
"22780",2007-01-13,2006,"AJ Auxerre","FC Sochaux","1-0",1,0,"1",1,1,1,"H"
"22781",2007-01-13,2006,"Girondins Bordeaux","FC Lorient","1-1",1,1,"1",1,2,0,"D"
"22782",2007-01-13,2006,"Le Mans UC 72","ESTAC Troyes","2-0",2,0,"1",1,2,2,"H"
"22783",2007-01-13,2006,"FC Nantes","OGC Nice","1-0",1,0,"1",1,1,1,"H"
"22784",2007-01-13,2006,"CS Sedan","AS Nancy","2-2",2,2,"1",1,4,0,"D"
"22785",2007-01-13,2006,"Toulouse FC","Olympique Lyon","2-0",2,0,"1",1,2,2,"H"
"22786",2007-01-14,2006,"AS Saint-Etienne","AS Monaco","0-1",0,1,"1",1,1,-1,"D"
"22787",2007-01-14,2006,"Stade Rennes","Olympique Marseille","0-2",0,2,"1",1,2,-2,"D"
"22788",2007-01-17,2006,"Paris Saint-Germain","Toulouse FC","0-0",0,0,"1",1,0,0,"D"
"22789",2007-01-24,2006,"Olympique Marseille","AJ Auxerre","3-1",3,1,"1",1,4,2,"H"
"22790",2007-01-24,2006,"Lille OSC","Paris Saint-Germain","1-0",1,0,"1",1,1,1,"H"
"22791",2007-01-24,2006,"FC Lorient","RC Lens","1-0",1,0,"1",1,1,1,"H"
"22792",2007-01-24,2006,"Olympique Lyon","Girondins Bordeaux","1-2",1,2,"1",1,3,-1,"D"
"22793",2007-01-24,2006,"AS Monaco","Stade Rennes","0-2",0,2,"1",1,2,-2,"D"
"22794",2007-01-24,2006,"OGC Nice","Toulouse FC","0-1",0,1,"1",1,1,-1,"D"
"22795",2007-01-24,2006,"FC Sochaux","CS Sedan","1-1",1,1,"1",1,2,0,"D"
"22796",2007-01-24,2006,"ESTAC Troyes","FC Nantes","1-0",1,0,"1",1,1,1,"H"
"22797",2007-01-24,2006,"Valenciennes FC","Le Mans UC 72","1-1",1,1,"1",1,2,0,"D"
"22798",2007-01-25,2006,"AS Nancy","AS Saint-Etienne","0-2",0,2,"1",1,2,-2,"D"
"22799",2007-01-27,2006,"Le Mans UC 72","Olympique Marseille","2-0",2,0,"1",1,2,2,"H"
"22800",2007-01-27,2006,"Olympique Lyon","OGC Nice","1-1",1,1,"1",1,2,0,"D"
"22801",2007-01-27,2006,"Paris Saint-Germain","FC Sochaux","0-0",0,0,"1",1,0,0,"D"
"22802",2007-01-27,2006,"Girondins Bordeaux","Lille OSC","0-1",0,1,"1",1,1,-1,"D"
"22803",2007-01-27,2006,"CS Sedan","AS Monaco","0-1",0,1,"1",1,1,-1,"D"
"22804",2007-01-27,2006,"Toulouse FC","ESTAC Troyes","1-1",1,1,"1",1,2,0,"D"
"22805",2007-01-27,2006,"FC Nantes","FC Lorient","0-2",0,2,"1",1,2,-2,"D"
"22806",2007-01-27,2006,"Stade Rennes","Valenciennes FC","1-0",1,0,"1",1,1,1,"H"
"22807",2007-01-28,2006,"AJ Auxerre","AS Nancy","2-0",2,0,"1",1,2,2,"H"
"22808",2007-01-28,2006,"RC Lens","AS Saint-Etienne","3-3",3,3,"1",1,6,0,"D"
"22809",2007-02-03,2006,"Lille OSC","FC Nantes","0-0",0,0,"1",1,0,0,"D"
"22810",2007-02-03,2006,"AS Monaco","AJ Auxerre","2-1",2,1,"1",1,3,1,"H"
"22811",2007-02-03,2006,"OGC Nice","Girondins Bordeaux","2-1",2,1,"1",1,3,1,"H"
"22812",2007-02-03,2006,"Valenciennes FC","RC Lens","1-3",1,3,"1",1,4,-2,"D"
"22813",2007-02-03,2006,"FC Lorient","Le Mans UC 72","2-1",2,1,"1",1,3,1,"H"
"22814",2007-02-03,2006,"FC Sochaux","Stade Rennes","0-0",0,0,"1",1,0,0,"D"
"22815",2007-02-03,2006,"AS Saint-Etienne","CS Sedan","1-2",1,2,"1",1,3,-1,"D"
"22816",2007-02-03,2006,"AS Nancy","Toulouse FC","2-1",2,1,"1",1,3,1,"H"
"22817",2007-02-04,2006,"ESTAC Troyes","Olympique Lyon","1-0",1,0,"1",1,1,1,"H"
"22818",2007-02-04,2006,"Olympique Marseille","Paris Saint-Germain","1-1",1,1,"1",1,2,0,"D"
"22819",2007-02-10,2006,"Paris Saint-Germain","AS Monaco","4-2",4,2,"1",1,6,2,"H"
"22820",2007-02-10,2006,"AJ Auxerre","AS Saint-Etienne","1-1",1,1,"1",1,2,0,"D"
"22821",2007-02-10,2006,"Le Mans UC 72","CS Sedan","3-2",3,2,"1",1,5,1,"H"
"22822",2007-02-10,2006,"Olympique Lyon","FC Lorient","1-0",1,0,"1",1,1,1,"H"
"22823",2007-02-10,2006,"FC Nantes","Valenciennes FC","2-5",2,5,"1",1,7,-3,"D"
"22824",2007-02-10,2006,"OGC Nice","ESTAC Troyes","3-0",3,0,"1",1,3,3,"H"
"22825",2007-02-10,2006,"Stade Rennes","AS Nancy","1-1",1,1,"1",1,2,0,"D"
"22826",2007-02-10,2006,"Toulouse FC","Lille OSC","1-0",1,0,"1",1,1,1,"H"
"22827",2007-02-11,2006,"RC Lens","FC Sochaux","3-1",3,1,"1",1,4,2,"H"
"22828",2007-02-11,2006,"Girondins Bordeaux","Olympique Marseille","1-0",1,0,"1",1,1,1,"H"
"22829",2007-02-16,2006,"Lille OSC","Olympique Lyon","1-2",1,2,"1",1,3,-1,"D"
"22830",2007-02-17,2006,"AS Saint-Etienne","Stade Rennes","1-3",1,3,"1",1,4,-2,"D"
"22831",2007-02-17,2006,"FC Lorient","Toulouse FC","0-1",0,1,"1",1,1,-1,"D"
"22832",2007-02-17,2006,"AS Nancy","Paris Saint-Germain","0-3",0,3,"1",1,3,-3,"D"
"22833",2007-02-17,2006,"CS Sedan","AJ Auxerre","2-2",2,2,"1",1,4,0,"D"
"22834",2007-02-17,2006,"FC Sochaux","Le Mans UC 72","2-0",2,0,"1",1,2,2,"H"
"22835",2007-02-17,2006,"ESTAC Troyes","Girondins Bordeaux","1-0",1,0,"1",1,1,1,"H"
"22836",2007-02-17,2006,"Valenciennes FC","OGC Nice","0-1",0,1,"1",1,1,-1,"D"
"22837",2007-02-18,2006,"AS Monaco","RC Lens","0-0",0,0,"1",1,0,0,"D"
"22838",2007-02-18,2006,"Olympique Marseille","FC Nantes","0-0",0,0,"1",1,0,0,"D"
"22839",2007-02-24,2006,"Toulouse FC","Olympique Marseille","3-0",3,0,"1",1,3,3,"H"
"22840",2007-02-24,2006,"FC Nantes","AJ Auxerre","1-1",1,1,"1",1,2,0,"D"
"22841",2007-02-24,2006,"Olympique Lyon","FC Sochaux","3-3",3,3,"1",1,6,0,"D"
"22842",2007-02-24,2006,"OGC Nice","Lille OSC","2-1",2,1,"1",1,3,1,"H"
"22843",2007-02-24,2006,"Le Mans UC 72","AS Monaco","0-2",0,2,"1",1,2,-2,"D"
"22844",2007-02-24,2006,"Stade Rennes","CS Sedan","0-2",0,2,"1",1,2,-2,"D"
"22845",2007-02-24,2006,"ESTAC Troyes","FC Lorient","3-0",3,0,"1",1,3,3,"H"
"22846",2007-02-25,2006,"RC Lens","AS Nancy","2-2",2,2,"1",1,4,0,"D"
"22847",2007-02-25,2006,"Girondins Bordeaux","Valenciennes FC","2-1",2,1,"1",1,3,1,"H"
"22848",2007-02-25,2006,"Paris Saint-Germain","AS Saint-Etienne","0-2",0,2,"1",1,2,-2,"D"
"22849",2007-03-03,2006,"AS Saint-Etienne","Olympique Lyon","1-3",1,3,"1",1,4,-2,"D"
"22850",2007-03-03,2006,"AJ Auxerre","Stade Rennes","1-0",1,0,"1",1,1,1,"H"
"22851",2007-03-03,2006,"Lille OSC","ESTAC Troyes","4-0",4,0,"1",1,4,4,"H"
"22852",2007-03-03,2006,"Valenciennes FC","Toulouse FC","0-0",0,0,"1",1,0,0,"D"
"22853",2007-03-03,2006,"AS Monaco","Girondins Bordeaux","0-0",0,0,"1",1,0,0,"D"
"22854",2007-03-03,2006,"CS Sedan","Paris Saint-Germain","2-0",2,0,"1",1,2,2,"H"
"22855",2007-03-03,2006,"FC Lorient","OGC Nice","0-0",0,0,"1",1,0,0,"D"
"22856",2007-03-03,2006,"AS Nancy","Le Mans UC 72","1-1",1,1,"1",1,2,0,"D"
"22857",2007-03-04,2006,"FC Sochaux","FC Nantes","1-2",1,2,"1",1,3,-1,"D"
"22858",2007-03-04,2006,"Olympique Marseille","RC Lens","0-1",0,1,"1",1,1,-1,"D"
"22859",2007-03-10,2006,"Toulouse FC","AS Monaco","1-1",1,1,"1",1,2,0,"D"
"22860",2007-03-10,2006,"OGC Nice","Stade Rennes","1-1",1,1,"1",1,2,0,"D"
"22861",2007-03-10,2006,"Le Mans UC 72","AS Saint-Etienne","2-1",2,1,"1",1,3,1,"H"
"22862",2007-03-10,2006,"Girondins Bordeaux","FC Sochaux","2-0",2,0,"1",1,2,2,"H"
"22863",2007-03-10,2006,"ESTAC Troyes","Valenciennes FC","1-3",1,3,"1",1,4,-2,"D"
"22864",2007-03-10,2006,"FC Lorient","Lille OSC","0-0",0,0,"1",1,0,0,"D"
"22865",2007-03-10,2006,"FC Nantes","AS Nancy","2-1",2,1,"1",1,3,1,"H"
"22866",2007-03-11,2006,"Paris Saint-Germain","AJ Auxerre","0-1",0,1,"1",1,1,-1,"D"
"22867",2007-03-11,2006,"RC Lens","CS Sedan","1-1",1,1,"1",1,2,0,"D"
"22868",2007-03-11,2006,"Olympique Lyon","Olympique Marseille","1-1",1,1,"1",1,2,0,"D"
"22869",2007-03-17,2006,"FC Sochaux","Toulouse FC","4-2",4,2,"1",1,6,2,"H"
"22870",2007-03-17,2006,"Lille OSC","Le Mans UC 72","0-2",0,2,"1",1,2,-2,"D"
"22871",2007-03-17,2006,"Olympique Marseille","OGC Nice","3-0",3,0,"1",1,3,3,"H"
"22872",2007-03-17,2006,"AS Monaco","FC Nantes","2-1",2,1,"1",1,3,1,"H"
"22873",2007-03-17,2006,"AS Nancy","Olympique Lyon","0-3",0,3,"1",1,3,-3,"D"
"22874",2007-03-17,2006,"AS Saint-Etienne","ESTAC Troyes","3-1",3,1,"1",1,4,2,"H"
"22875",2007-03-17,2006,"CS Sedan","Girondins Bordeaux","1-1",1,1,"1",1,2,0,"D"
"22876",2007-03-17,2006,"Valenciennes FC","FC Lorient","0-0",0,0,"1",1,0,0,"D"
"22877",2007-03-18,2006,"AJ Auxerre","RC Lens","1-0",1,0,"1",1,1,1,"H"
"22878",2007-03-18,2006,"Stade Rennes","Paris Saint-Germain","1-0",1,0,"1",1,1,1,"H"
"22879",2007-03-31,2006,"FC Lorient","Olympique Marseille","2-1",2,1,"1",1,3,1,"H"
"22880",2007-04-01,2006,"FC Nantes","CS Sedan","0-1",0,1,"1",1,1,-1,"D"
"22881",2007-04-01,2006,"Le Mans UC 72","AJ Auxerre","2-2",2,2,"1",1,4,0,"D"
"22882",2007-04-01,2006,"Lille OSC","Valenciennes FC","0-2",0,2,"1",1,2,-2,"D"
"22883",2007-04-01,2006,"Toulouse FC","AS Saint-Etienne","1-0",1,0,"1",1,1,1,"H"
"22884",2007-04-01,2006,"OGC Nice","AS Monaco","1-1",1,1,"1",1,2,0,"D"
"22885",2007-04-01,2006,"ESTAC Troyes","FC Sochaux","0-1",0,1,"1",1,1,-1,"D"
"22886",2007-04-01,2006,"RC Lens","Paris Saint-Germain","1-2",1,2,"1",1,3,-1,"D"
"22887",2007-04-07,2006,"Valenciennes FC","Olympique Lyon","0-0",0,0,"1",1,0,0,"D"
"22888",2007-04-07,2006,"AJ Auxerre","Girondins Bordeaux","0-0",0,0,"1",1,0,0,"D"
"22889",2007-04-07,2006,"AS Monaco","ESTAC Troyes","0-0",0,0,"1",1,0,0,"D"
"22890",2007-04-07,2006,"AS Nancy","FC Lorient","0-1",0,1,"1",1,1,-1,"D"
"22891",2007-04-07,2006,"Paris Saint-Germain","Le Mans UC 72","2-1",2,1,"1",1,3,1,"H"
"22892",2007-04-07,2006,"Stade Rennes","RC Lens","1-0",1,0,"1",1,1,1,"H"
"22893",2007-04-07,2006,"AS Saint-Etienne","FC Nantes","2-1",2,1,"1",1,3,1,"H"
"22894",2007-04-07,2006,"FC Sochaux","OGC Nice","1-1",1,1,"1",1,2,0,"D"
"22895",2007-04-08,2006,"CS Sedan","Toulouse FC","0-2",0,2,"1",1,2,-2,"D"
"22896",2007-04-08,2006,"Olympique Marseille","Lille OSC","4-1",4,1,"1",1,5,3,"H"
"22897",2007-04-14,2006,"Girondins Bordeaux","Paris Saint-Germain","0-0",0,0,"1",1,0,0,"D"
"22898",2007-04-14,2006,"Le Mans UC 72","Stade Rennes","0-0",0,0,"1",1,0,0,"D"
"22899",2007-04-14,2006,"Lille OSC","FC Sochaux","2-0",2,0,"1",1,2,2,"H"
"22900",2007-04-14,2006,"FC Lorient","AS Monaco","0-0",0,0,"1",1,0,0,"D"
"22901",2007-04-14,2006,"FC Nantes","RC Lens","0-0",0,0,"1",1,0,0,"D"
"22902",2007-04-14,2006,"Toulouse FC","AJ Auxerre","2-0",2,0,"1",1,2,2,"H"
"22903",2007-04-14,2006,"ESTAC Troyes","AS Nancy","0-0",0,0,"1",1,0,0,"D"
"22904",2007-04-14,2006,"Valenciennes FC","Olympique Marseille","0-0",0,0,"1",1,0,0,"D"
"22905",2007-04-15,2006,"OGC Nice","AS Saint-Etienne","2-1",2,1,"1",1,3,1,"H"
"22906",2007-04-15,2006,"Olympique Lyon","CS Sedan","1-0",1,0,"1",1,1,1,"H"
"22907",2007-04-18,2006,"Olympique Lyon","Stade Rennes","0-0",0,0,"1",1,0,0,"D"
"22908",2007-04-18,2006,"Girondins Bordeaux","AS Nancy","3-0",3,0,"1",1,3,3,"H"
"22909",2007-04-21,2006,"Paris Saint-Germain","FC Nantes","4-0",4,0,"1",1,4,4,"H"
"22910",2007-04-21,2006,"RC Lens","Le Mans UC 72","2-0",2,0,"1",1,2,2,"H"
"22911",2007-04-21,2006,"Olympique Marseille","ESTAC Troyes","2-1",2,1,"1",1,3,1,"H"
"22912",2007-04-21,2006,"AS Monaco","Lille OSC","3-1",3,1,"1",1,4,2,"H"
"22913",2007-04-21,2006,"AS Nancy","Valenciennes FC","1-0",1,0,"1",1,1,1,"H"
"22914",2007-04-21,2006,"Stade Rennes","Toulouse FC","3-2",3,2,"1",1,5,1,"H"
"22915",2007-04-21,2006,"CS Sedan","OGC Nice","1-1",1,1,"1",1,2,0,"D"
"22916",2007-04-21,2006,"FC Sochaux","FC Lorient","1-1",1,1,"1",1,2,0,"D"
"22917",2007-04-22,2006,"AJ Auxerre","Olympique Lyon","0-0",0,0,"1",1,0,0,"D"
"22918",2007-04-22,2006,"AS Saint-Etienne","Girondins Bordeaux","0-2",0,2,"1",1,2,-2,"D"
"22919",2007-04-28,2006,"Toulouse FC","Paris Saint-Germain","1-3",1,3,"1",1,4,-2,"D"
"22920",2007-04-28,2006,"Lille OSC","AS Nancy","0-1",0,1,"1",1,1,-1,"D"
"22921",2007-04-28,2006,"FC Lorient","AS Saint-Etienne","0-0",0,0,"1",1,0,0,"D"
"22922",2007-04-28,2006,"Olympique Lyon","Le Mans UC 72","2-1",2,1,"1",1,3,1,"H"
"22923",2007-04-28,2006,"FC Nantes","Stade Rennes","0-2",0,2,"1",1,2,-2,"D"
"22924",2007-04-28,2006,"OGC Nice","AJ Auxerre","0-0",0,0,"1",1,0,0,"D"
"22925",2007-04-28,2006,"ESTAC Troyes","CS Sedan","3-2",3,2,"1",1,5,1,"H"
"22926",2007-04-28,2006,"Valenciennes FC","AS Monaco","2-2",2,2,"1",1,4,0,"D"
"22927",2007-04-29,2006,"Girondins Bordeaux","RC Lens","1-0",1,0,"1",1,1,1,"H"
"22928",2007-04-29,2006,"Olympique Marseille","FC Sochaux","4-2",4,2,"1",1,6,2,"H"
"22929",2007-05-05,2006,"Paris Saint-Germain","Olympique Lyon","1-1",1,1,"1",1,2,0,"D"
"22930",2007-05-05,2006,"AJ Auxerre","ESTAC Troyes","1-0",1,0,"1",1,1,1,"H"
"22931",2007-05-05,2006,"Le Mans UC 72","FC Nantes","1-1",1,1,"1",1,2,0,"D"
"22932",2007-05-05,2006,"RC Lens","Toulouse FC","2-0",2,0,"1",1,2,2,"H"
"22933",2007-05-05,2006,"AS Nancy","OGC Nice","3-0",3,0,"1",1,3,3,"H"
"22934",2007-05-05,2006,"Stade Rennes","Girondins Bordeaux","0-0",0,0,"1",1,0,0,"D"
"22935",2007-05-05,2006,"CS Sedan","FC Lorient","3-1",3,1,"1",1,4,2,"H"
"22936",2007-05-05,2006,"FC Sochaux","Valenciennes FC","1-0",1,0,"1",1,1,1,"H"
"22937",2007-05-06,2006,"AS Saint-Etienne","Lille OSC","2-1",2,1,"1",1,3,1,"H"
"22938",2007-05-06,2006,"AS Monaco","Olympique Marseille","1-2",1,2,"1",1,3,-1,"D"
"22939",2007-05-09,2006,"FC Sochaux","AS Monaco","2-1",2,1,"1",1,3,1,"H"
"22940",2007-05-09,2006,"Lille OSC","CS Sedan","2-1",2,1,"1",1,3,1,"H"
"22941",2007-05-09,2006,"Valenciennes FC","AS Saint-Etienne","1-0",1,0,"1",1,1,1,"H"
"22942",2007-05-09,2006,"Girondins Bordeaux","FC Nantes","0-1",0,1,"1",1,1,-1,"D"
"22943",2007-05-09,2006,"OGC Nice","Paris Saint-Germain","1-0",1,0,"1",1,1,1,"H"
"22944",2007-05-09,2006,"Olympique Marseille","AS Nancy","2-1",2,1,"1",1,3,1,"H"
"22945",2007-05-09,2006,"ESTAC Troyes","Stade Rennes","2-2",2,2,"1",1,4,0,"D"
"22946",2007-05-09,2006,"FC Lorient","AJ Auxerre","2-1",2,1,"1",1,3,1,"H"
"22947",2007-05-09,2006,"Olympique Lyon","RC Lens","3-0",3,0,"1",1,3,3,"H"
"22948",2007-05-10,2006,"Toulouse FC","Le Mans UC 72","0-1",0,1,"1",1,1,-1,"D"
"22949",2007-05-19,2006,"AJ Auxerre","Lille OSC","2-1",2,1,"1",1,3,1,"H"
"22950",2007-05-19,2006,"Le Mans UC 72","Girondins Bordeaux","1-1",1,1,"1",1,2,0,"D"
"22951",2007-05-19,2006,"RC Lens","OGC Nice","0-0",0,0,"1",1,0,0,"D"
"22952",2007-05-19,2006,"AS Monaco","Olympique Lyon","1-0",1,0,"1",1,1,1,"H"
"22953",2007-05-19,2006,"AS Nancy","FC Sochaux","5-2",5,2,"1",1,7,3,"H"
"22954",2007-05-19,2006,"Paris Saint-Germain","ESTAC Troyes","2-1",2,1,"1",1,3,1,"H"
"22955",2007-05-19,2006,"Stade Rennes","FC Lorient","4-1",4,1,"1",1,5,3,"H"
"22956",2007-05-19,2006,"AS Saint-Etienne","Olympique Marseille","1-2",1,2,"1",1,3,-1,"D"
"22957",2007-05-19,2006,"CS Sedan","Valenciennes FC","1-1",1,1,"1",1,2,0,"D"
"22958",2007-05-26,2006,"Olympique Lyon","FC Nantes","3-1",3,1,"1",1,4,2,"H"
"22959",2007-05-26,2006,"Lille OSC","Stade Rennes","1-1",1,1,"1",1,2,0,"D"
"22960",2007-05-26,2006,"Valenciennes FC","AJ Auxerre","1-3",1,3,"1",1,4,-2,"D"
"22961",2007-05-26,2006,"AS Monaco","AS Nancy","2-0",2,0,"1",1,2,2,"H"
"22962",2007-05-26,2006,"FC Sochaux","AS Saint-Etienne","1-0",1,0,"1",1,1,1,"H"
"22963",2007-05-26,2006,"Toulouse FC","Girondins Bordeaux","3-1",3,1,"1",1,4,2,"H"
"22964",2007-05-26,2006,"OGC Nice","Le Mans UC 72","3-3",3,3,"1",1,6,0,"D"
"22965",2007-05-26,2006,"Olympique Marseille","CS Sedan","1-0",1,0,"1",1,1,1,"H"
"22966",2007-05-26,2006,"ESTAC Troyes","RC Lens","3-0",3,0,"1",1,3,3,"H"
"22967",2007-05-26,2006,"FC Lorient","Paris Saint-Germain","0-1",0,1,"1",1,1,-1,"D"
"22968",2007-08-04,2007,"RC Strasbourg","Olympique Marseille","0-0",0,0,"1",1,0,0,"D"
"22969",2007-08-04,2007,"Girondins Bordeaux","RC Lens","1-0",1,0,"1",1,1,1,"H"
"22970",2007-08-04,2007,"SM Caen","OGC Nice","1-0",1,0,"1",1,1,1,"H"
"22971",2007-08-04,2007,"Lille OSC","FC Lorient","0-0",0,0,"1",1,0,0,"D"
"22972",2007-08-04,2007,"AS Monaco","AS Saint-Etienne","1-1",1,1,"1",1,2,0,"D"
"22973",2007-08-04,2007,"Paris Saint-Germain","FC Sochaux","0-0",0,0,"1",1,0,0,"D"
"22974",2007-08-04,2007,"Stade Rennes","AS Nancy","0-2",0,2,"1",1,2,-2,"D"
"22975",2007-08-04,2007,"Valenciennes FC","Toulouse FC","3-1",3,1,"1",1,4,2,"H"
"22976",2007-08-05,2007,"Le Mans UC 72","FC Metz","1-0",1,0,"1",1,1,1,"H"
"22977",2007-08-05,2007,"Olympique Lyon","AJ Auxerre","2-0",2,0,"1",1,2,2,"H"
"22978",2007-08-11,2007,"Toulouse FC","Olympique Lyon","1-0",1,0,"1",1,1,1,"H"
"22979",2007-08-11,2007,"AJ Auxerre","Girondins Bordeaux","0-2",0,2,"1",1,2,-2,"D"
"22980",2007-08-11,2007,"FC Lorient","AS Monaco","2-1",2,1,"1",1,3,1,"H"
"22981",2007-08-11,2007,"Olympique Marseille","Stade Rennes","0-0",0,0,"1",1,0,0,"D"
"22982",2007-08-11,2007,"AS Nancy","SM Caen","1-0",1,0,"1",1,1,1,"H"
"22983",2007-08-11,2007,"OGC Nice","RC Strasbourg","1-0",1,0,"1",1,1,1,"H"
"22984",2007-08-11,2007,"AS Saint-Etienne","Valenciennes FC","3-1",3,1,"1",1,4,2,"H"
"22985",2007-08-11,2007,"FC Sochaux","Le Mans UC 72","1-3",1,3,"1",1,4,-2,"D"
"22986",2007-08-12,2007,"FC Metz","Lille OSC","1-2",1,2,"1",1,3,-1,"D"
"22987",2007-08-12,2007,"RC Lens","Paris Saint-Germain","0-0",0,0,"1",1,0,0,"D"
"22988",2007-08-15,2007,"Valenciennes FC","Olympique Marseille","2-1",2,1,"1",1,3,1,"H"
"22989",2007-08-15,2007,"Girondins Bordeaux","Le Mans UC 72","1-2",1,2,"1",1,3,-1,"D"
"22990",2007-08-15,2007,"Lille OSC","FC Sochaux","1-1",1,1,"1",1,2,0,"D"
"22991",2007-08-15,2007,"AS Monaco","FC Metz","2-0",2,0,"1",1,2,2,"H"
"22992",2007-08-15,2007,"Paris Saint-Germain","FC Lorient","1-3",1,3,"1",1,4,-2,"D"
"22993",2007-08-15,2007,"RC Strasbourg","AJ Auxerre","3-0",3,0,"1",1,3,3,"H"
"22994",2007-08-15,2007,"Stade Rennes","AS Saint-Etienne","1-0",1,0,"1",1,1,1,"H"
"22995",2007-08-16,2007,"AS Nancy","OGC Nice","2-1",2,1,"1",1,3,1,"H"
"22996",2007-08-18,2007,"FC Sochaux","AS Monaco","0-3",0,3,"1",1,3,-3,"D"
"22997",2007-08-18,2007,"AJ Auxerre","SM Caen","1-0",1,0,"1",1,1,1,"H"
"22998",2007-08-18,2007,"Le Mans UC 72","Lille OSC","1-1",1,1,"1",1,2,0,"D"
"22999",2007-08-18,2007,"FC Lorient","Olympique Lyon","2-1",2,1,"1",1,3,1,"H"
"23000",2007-08-18,2007,"FC Metz","Paris Saint-Germain","0-0",0,0,"1",1,0,0,"D"
"23001",2007-08-18,2007,"AS Saint-Etienne","Girondins Bordeaux","0-0",0,0,"1",1,0,0,"D"
"23002",2007-08-18,2007,"Toulouse FC","RC Strasbourg","1-3",1,3,"1",1,4,-2,"D"
"23003",2007-08-19,2007,"RC Lens","Valenciennes FC","0-0",0,0,"1",1,0,0,"D"
"23004",2007-08-19,2007,"OGC Nice","Stade Rennes","1-1",1,1,"1",1,2,0,"D"
"23005",2007-08-19,2007,"Olympique Marseille","AS Nancy","2-2",2,2,"1",1,4,0,"D"
"23006",2007-08-25,2007,"SM Caen","Olympique Marseille","1-2",1,2,"1",1,3,-1,"D"
"23007",2007-08-25,2007,"Girondins Bordeaux","FC Lorient","2-2",2,2,"1",1,4,0,"D"
"23008",2007-08-25,2007,"AS Monaco","Le Mans UC 72","3-1",3,1,"1",1,4,2,"H"
"23009",2007-08-25,2007,"AS Nancy","AJ Auxerre","4-1",4,1,"1",1,5,3,"H"
"23010",2007-08-25,2007,"OGC Nice","Toulouse FC","1-1",1,1,"1",1,2,0,"D"
"23011",2007-08-25,2007,"Stade Rennes","FC Metz","2-0",2,0,"1",1,2,2,"H"
"23012",2007-08-25,2007,"RC Strasbourg","RC Lens","2-1",2,1,"1",1,3,1,"H"
"23013",2007-08-25,2007,"Valenciennes FC","FC Sochaux","3-1",3,1,"1",1,4,2,"H"
"23014",2007-08-26,2007,"Paris Saint-Germain","Lille OSC","1-1",1,1,"1",1,2,0,"D"
"23015",2007-08-26,2007,"Olympique Lyon","AS Saint-Etienne","1-0",1,0,"1",1,1,1,"H"
"23016",2007-08-28,2007,"FC Lorient","Valenciennes FC","1-3",1,3,"1",1,4,-2,"D"
"23017",2007-08-29,2007,"Olympique Marseille","OGC Nice","0-2",0,2,"1",1,2,-2,"D"
"23018",2007-08-29,2007,"AJ Auxerre","Stade Rennes","0-2",0,2,"1",1,2,-2,"D"
"23019",2007-08-29,2007,"Le Mans UC 72","Paris Saint-Germain","0-2",0,2,"1",1,2,-2,"D"
"23020",2007-08-29,2007,"Lille OSC","AS Monaco","0-1",0,1,"1",1,1,-1,"D"
"23021",2007-08-29,2007,"FC Metz","Girondins Bordeaux","0-1",0,1,"1",1,1,-1,"D"
"23022",2007-08-29,2007,"AS Saint-Etienne","RC Strasbourg","2-0",2,0,"1",1,2,2,"H"
"23023",2007-08-29,2007,"FC Sochaux","Olympique Lyon","1-2",1,2,"1",1,3,-1,"D"
"23024",2007-09-01,2007,"Girondins Bordeaux","AS Monaco","2-1",2,1,"1",1,3,1,"H"
"23025",2007-09-01,2007,"SM Caen","FC Sochaux","2-2",2,2,"1",1,4,0,"D"
"23026",2007-09-01,2007,"Olympique Lyon","Le Mans UC 72","3-2",3,2,"1",1,5,1,"H"
"23027",2007-09-01,2007,"AS Nancy","AS Saint-Etienne","2-0",2,0,"1",1,2,2,"H"
"23028",2007-09-01,2007,"Stade Rennes","Lille OSC","2-2",2,2,"1",1,4,0,"D"
"23029",2007-09-01,2007,"RC Strasbourg","FC Lorient","0-0",0,0,"1",1,0,0,"D"
"23030",2007-09-01,2007,"Toulouse FC","AJ Auxerre","2-0",2,0,"1",1,2,2,"H"
"23031",2007-09-01,2007,"Valenciennes FC","FC Metz","0-0",0,0,"1",1,0,0,"D"
"23032",2007-09-02,2007,"Paris Saint-Germain","Olympique Marseille","1-1",1,1,"1",1,2,0,"D"
"23033",2007-09-02,2007,"OGC Nice","RC Lens","1-0",1,0,"1",1,1,1,"H"
"23034",2007-09-15,2007,"Olympique Marseille","Toulouse FC","1-2",1,2,"1",1,3,-1,"D"
"23035",2007-09-15,2007,"AJ Auxerre","OGC Nice","2-0",2,0,"1",1,2,2,"H"
"23036",2007-09-15,2007,"Le Mans UC 72","Valenciennes FC","2-0",2,0,"1",1,2,2,"H"
"23037",2007-09-15,2007,"RC Lens","AS Nancy","1-0",1,0,"1",1,1,1,"H"
"23038",2007-09-15,2007,"Lille OSC","Girondins Bordeaux","1-1",1,1,"1",1,2,0,"D"
"23039",2007-09-15,2007,"FC Metz","Olympique Lyon","1-5",1,5,"1",1,6,-4,"D"
"23040",2007-09-15,2007,"AS Saint-Etienne","SM Caen","3-0",3,0,"1",1,3,3,"H"
"23041",2007-09-15,2007,"FC Sochaux","RC Strasbourg","0-0",0,0,"1",1,0,0,"D"
"23042",2007-09-16,2007,"AS Monaco","Paris Saint-Germain","1-2",1,2,"1",1,3,-1,"D"
"23043",2007-09-16,2007,"FC Lorient","Stade Rennes","0-1",0,1,"1",1,1,-1,"D"
"23044",2007-09-22,2007,"AJ Auxerre","Olympique Marseille","2-0",2,0,"1",1,2,2,"H"
"23045",2007-09-22,2007,"SM Caen","FC Metz","1-2",1,2,"1",1,3,-1,"D"
"23046",2007-09-22,2007,"AS Nancy","FC Lorient","2-0",2,0,"1",1,2,2,"H"
"23047",2007-09-22,2007,"OGC Nice","AS Saint-Etienne","3-0",3,0,"1",1,3,3,"H"
"23048",2007-09-22,2007,"RC Strasbourg","Le Mans UC 72","0-1",0,1,"1",1,1,-1,"D"
"23049",2007-09-22,2007,"Toulouse FC","RC Lens","1-1",1,1,"1",1,2,0,"D"
"23050",2007-09-22,2007,"Valenciennes FC","AS Monaco","1-0",1,0,"1",1,1,1,"H"
"23051",2007-09-23,2007,"Paris Saint-Germain","Girondins Bordeaux","0-2",0,2,"1",1,2,-2,"D"
"23052",2007-09-23,2007,"Stade Rennes","FC Sochaux","0-2",0,2,"1",1,2,-2,"D"
"23053",2007-09-23,2007,"Olympique Lyon","Lille OSC","1-1",1,1,"1",1,2,0,"D"
"23054",2007-09-29,2007,"Olympique Lyon","RC Lens","3-0",3,0,"1",1,3,3,"H"
"23055",2007-09-30,2007,"SM Caen","Toulouse FC","2-1",2,1,"1",1,3,1,"H"
"23056",2007-10-05,2007,"AS Monaco","AS Nancy","1-3",1,3,"1",1,4,-2,"D"
"23057",2007-10-06,2007,"AS Saint-Etienne","Olympique Marseille","1-0",1,0,"1",1,1,1,"H"
"23058",2007-10-06,2007,"Le Mans UC 72","OGC Nice","2-0",2,0,"1",1,2,2,"H"
"23059",2007-10-06,2007,"RC Lens","AJ Auxerre","2-0",2,0,"1",1,2,2,"H"
"23060",2007-10-06,2007,"Lille OSC","Valenciennes FC","3-0",3,0,"1",1,3,3,"H"
"23061",2007-10-06,2007,"FC Lorient","SM Caen","0-0",0,0,"1",1,0,0,"D"
"23062",2007-10-06,2007,"FC Metz","RC Strasbourg","1-2",1,2,"1",1,3,-1,"D"
"23063",2007-10-06,2007,"Paris Saint-Germain","Stade Rennes","1-3",1,3,"1",1,4,-2,"D"
"23064",2007-10-07,2007,"Girondins Bordeaux","Olympique Lyon","1-3",1,3,"1",1,4,-2,"D"
"23065",2007-10-07,2007,"FC Sochaux","Toulouse FC","0-1",0,1,"1",1,1,-1,"D"
"23066",2007-10-20,2007,"AJ Auxerre","FC Lorient","5-3",5,3,"1",1,8,2,"H"
"23067",2007-10-20,2007,"SM Caen","Lille OSC","1-0",1,0,"1",1,1,1,"H"
"23068",2007-10-20,2007,"OGC Nice","FC Metz","3-1",3,1,"1",1,4,2,"H"
"23069",2007-10-20,2007,"Stade Rennes","Le Mans UC 72","3-0",3,0,"1",1,3,3,"H"
"23070",2007-10-20,2007,"RC Strasbourg","Girondins Bordeaux","1-1",1,1,"1",1,2,0,"D"
"23071",2007-10-20,2007,"Toulouse FC","AS Saint-Etienne","0-2",0,2,"1",1,2,-2,"D"
"23072",2007-10-20,2007,"Valenciennes FC","Paris Saint-Germain","0-0",0,0,"1",1,0,0,"D"
"23073",2007-10-20,2007,"Olympique Lyon","AS Monaco","3-1",3,1,"1",1,4,2,"H"
"23074",2007-10-21,2007,"AS Nancy","FC Sochaux","1-1",1,1,"1",1,2,0,"D"
"23075",2007-10-21,2007,"Olympique Marseille","RC Lens","1-0",1,0,"1",1,1,1,"H"
"23076",2007-10-27,2007,"FC Metz","AS Nancy","0-0",0,0,"1",1,0,0,"D"
"23077",2007-10-27,2007,"Girondins Bordeaux","Valenciennes FC","2-1",2,1,"1",1,3,1,"H"
"23078",2007-10-27,2007,"Lille OSC","RC Strasbourg","0-3",0,3,"1",1,3,-3,"D"
"23079",2007-10-27,2007,"FC Lorient","OGC Nice","0-0",0,0,"1",1,0,0,"D"
"23080",2007-10-27,2007,"AS Monaco","SM Caen","0-0",0,0,"1",1,0,0,"D"
"23081",2007-10-27,2007,"AS Saint-Etienne","AJ Auxerre","0-0",0,0,"1",1,0,0,"D"
"23082",2007-10-27,2007,"FC Sochaux","Olympique Marseille","2-1",2,1,"1",1,3,1,"H"
"23083",2007-10-28,2007,"Le Mans UC 72","Toulouse FC","1-1",1,1,"1",1,2,0,"D"
"23084",2007-10-28,2007,"RC Lens","Stade Rennes","1-2",1,2,"1",1,3,-1,"D"
"23085",2007-10-28,2007,"Paris Saint-Germain","Olympique Lyon","2-3",2,3,"1",1,5,-1,"D"
"23086",2007-11-03,2007,"AS Nancy","Girondins Bordeaux","1-0",1,0,"1",1,1,1,"H"
"23087",2007-11-03,2007,"AJ Auxerre","Lille OSC","0-1",0,1,"1",1,1,-1,"D"
"23088",2007-11-03,2007,"Olympique Lyon","Valenciennes FC","2-0",2,0,"1",1,2,2,"H"
"23089",2007-11-03,2007,"Olympique Marseille","FC Lorient","0-0",0,0,"1",1,0,0,"D"
"23090",2007-11-03,2007,"OGC Nice","FC Sochaux","0-0",0,0,"1",1,0,0,"D"
"23091",2007-11-03,2007,"Stade Rennes","AS Monaco","0-1",0,1,"1",1,1,-1,"D"
"23092",2007-11-03,2007,"RC Strasbourg","Paris Saint-Germain","1-2",1,2,"1",1,3,-1,"D"
"23093",2007-11-04,2007,"SM Caen","Le Mans UC 72","3-2",3,2,"1",1,5,1,"H"
"23094",2007-11-04,2007,"Toulouse FC","FC Metz","0-0",0,0,"1",1,0,0,"D"
"23095",2007-11-04,2007,"RC Lens","AS Saint-Etienne","3-2",3,2,"1",1,5,1,"H"
"23096",2007-11-10,2007,"Le Mans UC 72","AS Saint-Etienne","3-2",3,2,"1",1,5,1,"H"
"23097",2007-11-10,2007,"Lille OSC","OGC Nice","1-1",1,1,"1",1,2,0,"D"
"23098",2007-11-10,2007,"FC Metz","RC Lens","1-2",1,2,"1",1,3,-1,"D"
"23099",2007-11-10,2007,"AS Monaco","RC Strasbourg","3-0",3,0,"1",1,3,3,"H"
"23100",2007-11-10,2007,"Paris Saint-Germain","AS Nancy","0-0",0,0,"1",1,0,0,"D"
"23101",2007-11-10,2007,"FC Sochaux","AJ Auxerre","1-1",1,1,"1",1,2,0,"D"
"23102",2007-11-10,2007,"Valenciennes FC","SM Caen","3-0",3,0,"1",1,3,3,"H"
"23103",2007-11-11,2007,"Girondins Bordeaux","Stade Rennes","3-0",3,0,"1",1,3,3,"H"
"23104",2007-11-11,2007,"FC Lorient","Toulouse FC","1-0",1,0,"1",1,1,1,"H"
"23105",2007-11-11,2007,"Olympique Lyon","Olympique Marseille","1-2",1,2,"1",1,3,-1,"D"
"23106",2007-11-24,2007,"Stade Rennes","Olympique Lyon","0-2",0,2,"1",1,2,-2,"D"
"23107",2007-11-24,2007,"SM Caen","Girondins Bordeaux","5-0",5,0,"1",1,5,5,"H"
"23108",2007-11-24,2007,"RC Lens","FC Lorient","1-1",1,1,"1",1,2,0,"D"
"23109",2007-11-24,2007,"Olympique Marseille","FC Metz","3-1",3,1,"1",1,4,2,"H"
"23110",2007-11-24,2007,"AS Nancy","Lille OSC","2-0",2,0,"1",1,2,2,"H"
"23111",2007-11-24,2007,"AS Saint-Etienne","FC Sochaux","1-0",1,0,"1",1,1,1,"H"
"23112",2007-11-24,2007,"RC Strasbourg","Valenciennes FC","0-0",0,0,"1",1,0,0,"D"
"23113",2007-11-24,2007,"Toulouse FC","AS Monaco","0-0",0,0,"1",1,0,0,"D"
"23114",2007-11-25,2007,"AJ Auxerre","Le Mans UC 72","3-0",3,0,"1",1,3,3,"H"
"23115",2007-11-25,2007,"OGC Nice","Paris Saint-Germain","2-1",2,1,"1",1,3,1,"H"
"23116",2007-11-28,2007,"RC Lens","SM Caen","1-1",1,1,"1",1,2,0,"D"
"23117",2007-12-01,2007,"Le Mans UC 72","AS Nancy","2-1",2,1,"1",1,3,1,"H"
"23118",2007-12-01,2007,"Lille OSC","Olympique Marseille","1-1",1,1,"1",1,2,0,"D"
"23119",2007-12-01,2007,"FC Lorient","AS Saint-Etienne","1-1",1,1,"1",1,2,0,"D"
"23120",2007-12-01,2007,"FC Metz","AJ Auxerre","0-1",0,1,"1",1,1,-1,"D"
"23121",2007-12-01,2007,"AS Monaco","OGC Nice","1-1",1,1,"1",1,2,0,"D"
"23122",2007-12-01,2007,"Paris Saint-Germain","SM Caen","0-1",0,1,"1",1,1,-1,"D"
"23123",2007-12-01,2007,"FC Sochaux","RC Lens","0-2",0,2,"1",1,2,-2,"D"
"23124",2007-12-02,2007,"Girondins Bordeaux","Toulouse FC","4-3",4,3,"1",1,7,1,"H"
"23125",2007-12-02,2007,"Valenciennes FC","Stade Rennes","3-0",3,0,"1",1,3,3,"H"
"23126",2007-12-02,2007,"Olympique Lyon","RC Strasbourg","5-0",5,0,"1",1,5,5,"H"
"23127",2007-12-05,2007,"Toulouse FC","AS Nancy","1-1",1,1,"1",1,2,0,"D"
"23128",2007-12-08,2007,"Olympique Marseille","AS Monaco","2-0",2,0,"1",1,2,2,"H"
"23129",2007-12-08,2007,"SM Caen","Olympique Lyon","1-0",1,0,"1",1,1,1,"H"
"23130",2007-12-08,2007,"RC Lens","Le Mans UC 72","1-3",1,3,"1",1,4,-2,"D"
"23131",2007-12-08,2007,"FC Lorient","FC Sochaux","2-1",2,1,"1",1,3,1,"H"
"23132",2007-12-08,2007,"AS Nancy","Valenciennes FC","0-0",0,0,"1",1,0,0,"D"
"23133",2007-12-08,2007,"AS Saint-Etienne","FC Metz","2-0",2,0,"1",1,2,2,"H"
"23134",2007-12-08,2007,"RC Strasbourg","Stade Rennes","3-0",3,0,"1",1,3,3,"H"
"23135",2007-12-08,2007,"Toulouse FC","Lille OSC","1-0",1,0,"1",1,1,1,"H"
"23136",2007-12-09,2007,"OGC Nice","Girondins Bordeaux","1-1",1,1,"1",1,2,0,"D"
"23137",2007-12-09,2007,"AJ Auxerre","Paris Saint-Germain","0-1",0,1,"1",1,1,-1,"D"
"23138",2007-12-15,2007,"Paris Saint-Germain","Toulouse FC","1-2",1,2,"1",1,3,-1,"D"
"23139",2007-12-15,2007,"Olympique Lyon","OGC Nice","0-0",0,0,"1",1,0,0,"D"
"23140",2007-12-15,2007,"Le Mans UC 72","FC Lorient","0-0",0,0,"1",1,0,0,"D"
"23141",2007-12-15,2007,"Lille OSC","AS Saint-Etienne","3-0",3,0,"1",1,3,3,"H"
"23142",2007-12-15,2007,"FC Metz","FC Sochaux","1-2",1,2,"1",1,3,-1,"D"
"23143",2007-12-15,2007,"AS Monaco","RC Lens","2-0",2,0,"1",1,2,2,"H"
"23144",2007-12-15,2007,"Stade Rennes","SM Caen","1-2",1,2,"1",1,3,-1,"D"
"23145",2007-12-15,2007,"Valenciennes FC","AJ Auxerre","3-0",3,0,"1",1,3,3,"H"
"23146",2007-12-16,2007,"RC Strasbourg","AS Nancy","0-0",0,0,"1",1,0,0,"D"
"23147",2007-12-16,2007,"Girondins Bordeaux","Olympique Marseille","2-2",2,2,"1",1,4,0,"D"
"23148",2007-12-22,2007,"AS Nancy","Olympique Lyon","1-1",1,1,"1",1,2,0,"D"
"23149",2007-12-22,2007,"AJ Auxerre","AS Monaco","1-0",1,0,"1",1,1,1,"H"
"23150",2007-12-22,2007,"SM Caen","RC Strasbourg","2-0",2,0,"1",1,2,2,"H"
"23151",2007-12-22,2007,"FC Lorient","FC Metz","2-0",2,0,"1",1,2,2,"H"
"23152",2007-12-22,2007,"Olympique Marseille","Le Mans UC 72","1-0",1,0,"1",1,1,1,"H"
"23153",2007-12-22,2007,"OGC Nice","Valenciennes FC","1-0",1,0,"1",1,1,1,"H"
"23154",2007-12-22,2007,"FC Sochaux","Girondins Bordeaux","0-1",0,1,"1",1,1,-1,"D"
"23155",2007-12-23,2007,"Toulouse FC","Stade Rennes","0-0",0,0,"1",1,0,0,"D"
"23156",2007-12-23,2007,"AS Saint-Etienne","Paris Saint-Germain","0-1",0,1,"1",1,1,-1,"D"
"23157",2008-01-12,2007,"Valenciennes FC","AS Saint-Etienne","2-0",2,0,"1",1,2,2,"H"
"23158",2008-01-12,2007,"Girondins Bordeaux","AJ Auxerre","4-1",4,1,"1",1,5,3,"H"
"23159",2008-01-12,2007,"SM Caen","AS Nancy","0-0",0,0,"1",1,0,0,"D"
"23160",2008-01-12,2007,"Le Mans UC 72","FC Sochaux","0-2",0,2,"1",1,2,-2,"D"
"23161",2008-01-12,2007,"Lille OSC","FC Metz","1-1",1,1,"1",1,2,0,"D"
"23162",2008-01-12,2007,"Olympique Lyon","Toulouse FC","3-2",3,2,"1",1,5,1,"H"
"23163",2008-01-12,2007,"AS Monaco","FC Lorient","1-0",1,0,"1",1,1,1,"H"
"23164",2008-01-12,2007,"RC Strasbourg","OGC Nice","0-1",0,1,"1",1,1,-1,"D"
"23165",2008-01-13,2007,"Paris Saint-Germain","RC Lens","3-0",3,0,"1",1,3,3,"H"
"23166",2008-01-13,2007,"Stade Rennes","Olympique Marseille","3-1",3,1,"1",1,4,2,"H"
"23167",2008-01-19,2007,"FC Lorient","Paris Saint-Germain","1-0",1,0,"1",1,1,1,"H"
"23168",2008-01-19,2007,"AJ Auxerre","RC Strasbourg","1-1",1,1,"1",1,2,0,"D"
"23169",2008-01-19,2007,"Le Mans UC 72","Girondins Bordeaux","1-2",1,2,"1",1,3,-1,"D"
"23170",2008-01-19,2007,"Olympique Marseille","Valenciennes FC","3-1",3,1,"1",1,4,2,"H"
"23171",2008-01-19,2007,"FC Metz","AS Monaco","1-4",1,4,"1",1,5,-3,"D"
"23172",2008-01-19,2007,"AS Saint-Etienne","Stade Rennes","2-0",2,0,"1",1,2,2,"H"
"23173",2008-01-19,2007,"FC Sochaux","Lille OSC","1-1",1,1,"1",1,2,0,"D"
"23174",2008-01-19,2007,"Toulouse FC","SM Caen","1-1",1,1,"1",1,2,0,"D"
"23175",2008-01-20,2007,"OGC Nice","AS Nancy","1-0",1,0,"1",1,1,1,"H"
"23176",2008-01-20,2007,"RC Lens","Olympique Lyon","3-0",3,0,"1",1,3,3,"H"
"23177",2008-01-23,2007,"Valenciennes FC","RC Lens","1-2",1,2,"1",1,3,-1,"D"
"23178",2008-01-23,2007,"SM Caen","AJ Auxerre","0-0",0,0,"1",1,0,0,"D"
"23179",2008-01-23,2007,"Lille OSC","Le Mans UC 72","3-1",3,1,"1",1,4,2,"H"
"23180",2008-01-23,2007,"Olympique Lyon","FC Lorient","2-0",2,0,"1",1,2,2,"H"
"23181",2008-01-23,2007,"AS Monaco","FC Sochaux","1-0",1,0,"1",1,1,1,"H"
"23182",2008-01-23,2007,"Paris Saint-Germain","FC Metz","3-0",3,0,"1",1,3,3,"H"
"23183",2008-01-23,2007,"Stade Rennes","OGC Nice","1-1",1,1,"1",1,2,0,"D"
"23184",2008-01-23,2007,"RC Strasbourg","Toulouse FC","2-0",2,0,"1",1,2,2,"H"
"23185",2008-01-23,2007,"AS Nancy","Olympique Marseille","1-1",1,1,"1",1,2,0,"D"
"23186",2008-01-24,2007,"Girondins Bordeaux","AS Saint-Etienne","1-0",1,0,"1",1,1,1,"H"
"23187",2008-01-26,2007,"Lille OSC","Paris Saint-Germain","0-0",0,0,"1",1,0,0,"D"
"23188",2008-01-26,2007,"AJ Auxerre","AS Nancy","0-0",0,0,"1",1,0,0,"D"
"23189",2008-01-26,2007,"Le Mans UC 72","AS Monaco","1-0",1,0,"1",1,1,1,"H"
"23190",2008-01-26,2007,"RC Lens","RC Strasbourg","2-2",2,2,"1",1,4,0,"D"
"23191",2008-01-26,2007,"Olympique Marseille","SM Caen","6-1",6,1,"1",1,7,5,"H"
"23192",2008-01-26,2007,"FC Metz","Stade Rennes","1-1",1,1,"1",1,2,0,"D"
"23193",2008-01-26,2007,"FC Sochaux","Valenciennes FC","1-0",1,0,"1",1,1,1,"H"
"23194",2008-01-26,2007,"Toulouse FC","OGC Nice","1-1",1,1,"1",1,2,0,"D"
"23195",2008-01-27,2007,"FC Lorient","Girondins Bordeaux","1-0",1,0,"1",1,1,1,"H"
"23196",2008-01-27,2007,"AS Saint-Etienne","Olympique Lyon","1-1",1,1,"1",1,2,0,"D"
"23197",2008-02-09,2007,"Paris Saint-Germain","Le Mans UC 72","0-0",0,0,"1",1,0,0,"D"
"23198",2008-02-09,2007,"Girondins Bordeaux","FC Metz","3-0",3,0,"1",1,3,3,"H"
"23199",2008-02-09,2007,"Olympique Lyon","FC Sochaux","4-1",4,1,"1",1,5,3,"H"
"23200",2008-02-09,2007,"AS Monaco","Lille OSC","0-0",0,0,"1",1,0,0,"D"
"23201",2008-02-09,2007,"AS Nancy","Toulouse FC","1-0",1,0,"1",1,1,1,"H"
"23202",2008-02-09,2007,"Stade Rennes","AJ Auxerre","1-2",1,2,"1",1,3,-1,"D"
"23203",2008-02-09,2007,"RC Strasbourg","AS Saint-Etienne","3-0",3,0,"1",1,3,3,"H"
"23204",2008-02-09,2007,"Valenciennes FC","FC Lorient","3-0",3,0,"1",1,3,3,"H"
"23205",2008-02-10,2007,"SM Caen","RC Lens","1-4",1,4,"1",1,5,-3,"D"
"23206",2008-02-10,2007,"OGC Nice","Olympique Marseille","0-2",0,2,"1",1,2,-2,"D"
"23207",2008-02-16,2007,"Le Mans UC 72","Olympique Lyon","1-0",1,0,"1",1,1,1,"H"
"23208",2008-02-16,2007,"AJ Auxerre","Toulouse FC","1-0",1,0,"1",1,1,1,"H"
"23209",2008-02-16,2007,"RC Lens","OGC Nice","0-0",0,0,"1",1,0,0,"D"
"23210",2008-02-16,2007,"Lille OSC","Stade Rennes","3-1",3,1,"1",1,4,2,"H"
"23211",2008-02-16,2007,"FC Lorient","RC Strasbourg","1-0",1,0,"1",1,1,1,"H"
"23212",2008-02-16,2007,"FC Metz","Valenciennes FC","2-1",2,1,"1",1,3,1,"H"
"23213",2008-02-16,2007,"AS Saint-Etienne","AS Nancy","4-0",4,0,"1",1,4,4,"H"
"23214",2008-02-16,2007,"FC Sochaux","SM Caen","1-1",1,1,"1",1,2,0,"D"
"23215",2008-02-17,2007,"AS Monaco","Girondins Bordeaux","0-6",0,6,"1",1,6,-6,"D"
"23216",2008-02-17,2007,"Olympique Marseille","Paris Saint-Germain","2-1",2,1,"1",1,3,1,"H"
"23217",2008-02-23,2007,"SM Caen","AS Saint-Etienne","1-3",1,3,"1",1,4,-2,"D"
"23218",2008-02-23,2007,"Olympique Lyon","FC Metz","2-0",2,0,"1",1,2,2,"H"
"23219",2008-02-23,2007,"AS Nancy","RC Lens","2-1",2,1,"1",1,3,1,"H"
"23220",2008-02-23,2007,"OGC Nice","AJ Auxerre","1-2",1,2,"1",1,3,-1,"D"
"23221",2008-02-23,2007,"Paris Saint-Germain","AS Monaco","1-1",1,1,"1",1,2,0,"D"
"23222",2008-02-23,2007,"Stade Rennes","FC Lorient","2-0",2,0,"1",1,2,2,"H"
"23223",2008-02-23,2007,"RC Strasbourg","FC Sochaux","0-2",0,2,"1",1,2,-2,"D"
"23224",2008-02-23,2007,"Valenciennes FC","Le Mans UC 72","1-2",1,2,"1",1,3,-1,"D"
"23225",2008-02-24,2007,"Toulouse FC","Olympique Marseille","0-0",0,0,"1",1,0,0,"D"
"23226",2008-02-24,2007,"Girondins Bordeaux","Lille OSC","0-0",0,0,"1",1,0,0,"D"
"23227",2008-03-01,2007,"Lille OSC","Olympique Lyon","0-1",0,1,"1",1,1,-1,"D"
"23228",2008-03-01,2007,"Le Mans UC 72","RC Strasbourg","0-1",0,1,"1",1,1,-1,"D"
"23229",2008-03-01,2007,"RC Lens","Toulouse FC","1-1",1,1,"1",1,2,0,"D"
"23230",2008-03-01,2007,"FC Lorient","AS Nancy","0-0",0,0,"1",1,0,0,"D"
"23231",2008-03-01,2007,"Olympique Marseille","AJ Auxerre","2-1",2,1,"1",1,3,1,"H"
"23232",2008-03-01,2007,"FC Metz","SM Caen","2-1",2,1,"1",1,3,1,"H"
"23233",2008-03-01,2007,"AS Monaco","Valenciennes FC","0-0",0,0,"1",1,0,0,"D"
"23234",2008-03-01,2007,"FC Sochaux","Stade Rennes","0-0",0,0,"1",1,0,0,"D"
"23235",2008-03-02,2007,"AS Saint-Etienne","OGC Nice","0-0",0,0,"1",1,0,0,"D"
"23236",2008-03-02,2007,"Girondins Bordeaux","Paris Saint-Germain","3-0",3,0,"1",1,3,3,"H"
"23237",2008-03-08,2007,"Stade Rennes","Paris Saint-Germain","2-0",2,0,"1",1,2,2,"H"
"23238",2008-03-08,2007,"AJ Auxerre","RC Lens","0-0",0,0,"1",1,0,0,"D"
"23239",2008-03-08,2007,"SM Caen","FC Lorient","0-0",0,0,"1",1,0,0,"D"
"23240",2008-03-08,2007,"AS Nancy","AS Monaco","2-0",2,0,"1",1,2,2,"H"
"23241",2008-03-08,2007,"OGC Nice","Le Mans UC 72","0-0",0,0,"1",1,0,0,"D"
"23242",2008-03-08,2007,"RC Strasbourg","FC Metz","2-3",2,3,"1",1,5,-1,"D"
"23243",2008-03-08,2007,"Toulouse FC","FC Sochaux","1-2",1,2,"1",1,3,-1,"D"
"23244",2008-03-08,2007,"Valenciennes FC","Lille OSC","0-0",0,0,"1",1,0,0,"D"
"23245",2008-03-09,2007,"Olympique Marseille","AS Saint-Etienne","2-0",2,0,"1",1,2,2,"H"
"23246",2008-03-09,2007,"Olympique Lyon","Girondins Bordeaux","4-2",4,2,"1",1,6,2,"H"
"23247",2008-03-11,2007,"RC Lens","Lille OSC","1-2",1,2,"1",1,3,-1,"D"
"23248",2008-03-15,2007,"AS Monaco","Olympique Lyon","0-3",0,3,"1",1,3,-3,"D"
"23249",2008-03-15,2007,"Le Mans UC 72","Stade Rennes","1-1",1,1,"1",1,2,0,"D"
"23250",2008-03-15,2007,"Lille OSC","SM Caen","5-0",5,0,"1",1,5,5,"H"
"23251",2008-03-15,2007,"FC Lorient","AJ Auxerre","1-1",1,1,"1",1,2,0,"D"
"23252",2008-03-15,2007,"FC Metz","OGC Nice","1-2",1,2,"1",1,3,-1,"D"
"23253",2008-03-15,2007,"Paris Saint-Germain","Valenciennes FC","1-1",1,1,"1",1,2,0,"D"
"23254",2008-03-15,2007,"AS Saint-Etienne","Toulouse FC","0-0",0,0,"1",1,0,0,"D"
"23255",2008-03-15,2007,"FC Sochaux","AS Nancy","1-1",1,1,"1",1,2,0,"D"
"23256",2008-03-16,2007,"Girondins Bordeaux","RC Strasbourg","3-0",3,0,"1",1,3,3,"H"
"23257",2008-03-16,2007,"RC Lens","Olympique Marseille","3-3",3,3,"1",1,6,0,"D"
"23258",2008-03-22,2007,"AS Nancy","FC Metz","2-1",2,1,"1",1,3,1,"H"
"23259",2008-03-22,2007,"AJ Auxerre","AS Saint-Etienne","1-3",1,3,"1",1,4,-2,"D"
"23260",2008-03-22,2007,"SM Caen","AS Monaco","4-1",4,1,"1",1,5,3,"H"
"23261",2008-03-22,2007,"Olympique Marseille","FC Sochaux","0-1",0,1,"1",1,1,-1,"D"
"23262",2008-03-22,2007,"OGC Nice","FC Lorient","1-2",1,2,"1",1,3,-1,"D"
"23263",2008-03-22,2007,"RC Strasbourg","Lille OSC","0-1",0,1,"1",1,1,-1,"D"
"23264",2008-03-22,2007,"Toulouse FC","Le Mans UC 72","1-1",1,1,"1",1,2,0,"D"
"23265",2008-03-22,2007,"Valenciennes FC","Girondins Bordeaux","3-1",3,1,"1",1,4,2,"H"
"23266",2008-03-23,2007,"Stade Rennes","RC Lens","3-1",3,1,"1",1,4,2,"H"
"23267",2008-03-23,2007,"Olympique Lyon","Paris Saint-Germain","4-2",4,2,"1",1,6,2,"H"
"23268",2008-03-29,2007,"Girondins Bordeaux","AS Nancy","2-1",2,1,"1",1,3,1,"H"
"23269",2008-03-30,2007,"Le Mans UC 72","SM Caen","1-1",1,1,"1",1,2,0,"D"
"23270",2008-03-30,2007,"Lille OSC","AJ Auxerre","0-2",0,2,"1",1,2,-2,"D"
"23271",2008-03-30,2007,"FC Metz","Toulouse FC","0-2",0,2,"1",1,2,-2,"D"
"23272",2008-03-30,2007,"FC Sochaux","OGC Nice","1-0",1,0,"1",1,1,1,"H"
"23273",2008-03-30,2007,"Valenciennes FC","Olympique Lyon","1-2",1,2,"1",1,3,-1,"D"
"23274",2008-03-30,2007,"FC Lorient","Olympique Marseille","1-2",1,2,"1",1,3,-1,"D"
"23275",2008-03-31,2007,"AS Monaco","Stade Rennes","1-2",1,2,"1",1,3,-1,"D"
"23276",2008-04-02,2007,"Paris Saint-Germain","RC Strasbourg","1-0",1,0,"1",1,1,1,"H"
"23277",2008-04-05,2007,"Stade Rennes","Girondins Bordeaux","0-2",0,2,"1",1,2,-2,"D"
"23278",2008-04-05,2007,"AJ Auxerre","FC Sochaux","0-1",0,1,"1",1,1,-1,"D"
"23279",2008-04-05,2007,"SM Caen","Valenciennes FC","1-0",1,0,"1",1,1,1,"H"
"23280",2008-04-05,2007,"RC Lens","FC Metz","1-1",1,1,"1",1,2,0,"D"
"23281",2008-04-05,2007,"OGC Nice","Lille OSC","0-0",0,0,"1",1,0,0,"D"
"23282",2008-04-05,2007,"AS Saint-Etienne","Le Mans UC 72","4-1",4,1,"1",1,5,3,"H"
"23283",2008-04-05,2007,"RC Strasbourg","AS Monaco","0-2",0,2,"1",1,2,-2,"D"
"23284",2008-04-05,2007,"Toulouse FC","FC Lorient","0-0",0,0,"1",1,0,0,"D"
"23285",2008-04-06,2007,"AS Nancy","Paris Saint-Germain","1-0",1,0,"1",1,1,1,"H"
"23286",2008-04-06,2007,"Olympique Marseille","Olympique Lyon","3-1",3,1,"1",1,4,2,"H"
"23287",2008-04-09,2007,"AS Saint-Etienne","RC Lens","2-0",2,0,"1",1,2,2,"H"
"23288",2008-04-12,2007,"Olympique Lyon","Stade Rennes","1-1",1,1,"1",1,2,0,"D"
"23289",2008-04-12,2007,"Le Mans UC 72","AJ Auxerre","3-0",3,0,"1",1,3,3,"H"
"23290",2008-04-12,2007,"Lille OSC","AS Nancy","2-1",2,1,"1",1,3,1,"H"
"23291",2008-04-12,2007,"FC Lorient","RC Lens","1-0",1,0,"1",1,1,1,"H"
"23292",2008-04-12,2007,"FC Metz","Olympique Marseille","1-2",1,2,"1",1,3,-1,"D"
"23293",2008-04-12,2007,"AS Monaco","Toulouse FC","0-2",0,2,"1",1,2,-2,"D"
"23294",2008-04-12,2007,"FC Sochaux","AS Saint-Etienne","1-1",1,1,"1",1,2,0,"D"
"23295",2008-04-12,2007,"Valenciennes FC","RC Strasbourg","2-0",2,0,"1",1,2,2,"H"
"23296",2008-04-13,2007,"Girondins Bordeaux","SM Caen","2-1",2,1,"1",1,3,1,"H"
"23297",2008-04-13,2007,"Paris Saint-Germain","OGC Nice","2-3",2,3,"1",1,5,-1,"D"
"23298",2008-04-19,2007,"RC Lens","FC Sochaux","3-2",3,2,"1",1,5,1,"H"
"23299",2008-04-19,2007,"AJ Auxerre","FC Metz","0-0",0,0,"1",1,0,0,"D"
"23300",2008-04-19,2007,"SM Caen","Paris Saint-Germain","3-0",3,0,"1",1,3,3,"H"
"23301",2008-04-19,2007,"AS Nancy","Le Mans UC 72","1-1",1,1,"1",1,2,0,"D"
"23302",2008-04-19,2007,"OGC Nice","AS Monaco","0-2",0,2,"1",1,2,-2,"D"
"23303",2008-04-19,2007,"Stade Rennes","Valenciennes FC","1-0",1,0,"1",1,1,1,"H"
"23304",2008-04-19,2007,"AS Saint-Etienne","FC Lorient","1-0",1,0,"1",1,1,1,"H"
"23305",2008-04-19,2007,"RC Strasbourg","Olympique Lyon","1-2",1,2,"1",1,3,-1,"D"
"23306",2008-04-20,2007,"Toulouse FC","Girondins Bordeaux","0-1",0,1,"1",1,1,-1,"D"
"23307",2008-04-20,2007,"Olympique Marseille","Lille OSC","1-3",1,3,"1",1,4,-2,"D"
"23308",2008-04-26,2007,"Paris Saint-Germain","AJ Auxerre","3-1",3,1,"1",1,4,2,"H"
"23309",2008-04-26,2007,"Girondins Bordeaux","OGC Nice","0-0",0,0,"1",1,0,0,"D"
"23310",2008-04-26,2007,"Le Mans UC 72","RC Lens","3-2",3,2,"1",1,5,1,"H"
"23311",2008-04-26,2007,"Lille OSC","Toulouse FC","3-2",3,2,"1",1,5,1,"H"
"23312",2008-04-26,2007,"Olympique Lyon","SM Caen","2-2",2,2,"1",1,4,0,"D"
"23313",2008-04-26,2007,"FC Metz","AS Saint-Etienne","0-1",0,1,"1",1,1,-1,"D"
"23314",2008-04-26,2007,"Stade Rennes","RC Strasbourg","3-0",3,0,"1",1,3,3,"H"
"23315",2008-04-26,2007,"FC Sochaux","FC Lorient","1-1",1,1,"1",1,2,0,"D"
"23316",2008-04-27,2007,"Valenciennes FC","AS Nancy","1-1",1,1,"1",1,2,0,"D"
"23317",2008-04-27,2007,"AS Monaco","Olympique Marseille","2-3",2,3,"1",1,5,-1,"D"
"23318",2008-05-03,2007,"OGC Nice","Olympique Lyon","0-0",0,0,"1",1,0,0,"D"
"23319",2008-05-03,2007,"Toulouse FC","Paris Saint-Germain","1-1",1,1,"1",1,2,0,"D"
"23320",2008-05-03,2007,"AJ Auxerre","Valenciennes FC","2-0",2,0,"1",1,2,2,"H"
"23321",2008-05-03,2007,"SM Caen","Stade Rennes","2-2",2,2,"1",1,4,0,"D"
"23322",2008-05-03,2007,"RC Lens","AS Monaco","0-0",0,0,"1",1,0,0,"D"
"23323",2008-05-03,2007,"FC Lorient","Le Mans UC 72","0-0",0,0,"1",1,0,0,"D"
"23324",2008-05-03,2007,"AS Nancy","RC Strasbourg","3-0",3,0,"1",1,3,3,"H"
"23325",2008-05-03,2007,"FC Sochaux","FC Metz","0-0",0,0,"1",1,0,0,"D"
"23326",2008-05-04,2007,"AS Saint-Etienne","Lille OSC","0-0",0,0,"1",1,0,0,"D"
"23327",2008-05-04,2007,"Olympique Marseille","Girondins Bordeaux","1-2",1,2,"1",1,3,-1,"D"
"23328",2008-05-10,2007,"Girondins Bordeaux","FC Sochaux","2-0",2,0,"1",1,2,2,"H"
"23329",2008-05-10,2007,"Le Mans UC 72","Olympique Marseille","0-0",0,0,"1",1,0,0,"D"
"23330",2008-05-10,2007,"Lille OSC","RC Lens","2-1",2,1,"1",1,3,1,"H"
"23331",2008-05-10,2007,"Olympique Lyon","AS Nancy","1-0",1,0,"1",1,1,1,"H"
"23332",2008-05-10,2007,"FC Metz","FC Lorient","1-2",1,2,"1",1,3,-1,"D"
"23333",2008-05-10,2007,"AS Monaco","AJ Auxerre","3-0",3,0,"1",1,3,3,"H"
"23334",2008-05-10,2007,"Paris Saint-Germain","AS Saint-Etienne","1-1",1,1,"1",1,2,0,"D"
"23335",2008-05-10,2007,"Stade Rennes","Toulouse FC","2-1",2,1,"1",1,3,1,"H"
"23336",2008-05-10,2007,"RC Strasbourg","SM Caen","1-4",1,4,"1",1,5,-3,"D"
"23337",2008-05-10,2007,"Valenciennes FC","OGC Nice","1-2",1,2,"1",1,3,-1,"D"
"23338",2008-05-17,2007,"AJ Auxerre","Olympique Lyon","1-3",1,3,"1",1,4,-2,"D"
"23339",2008-05-17,2007,"RC Lens","Girondins Bordeaux","2-2",2,2,"1",1,4,0,"D"
"23340",2008-05-17,2007,"FC Lorient","Lille OSC","1-1",1,1,"1",1,2,0,"D"
"23341",2008-05-17,2007,"Olympique Marseille","RC Strasbourg","4-3",4,3,"1",1,7,1,"H"
"23342",2008-05-17,2007,"FC Metz","Le Mans UC 72","4-3",4,3,"1",1,7,1,"H"
"23343",2008-05-17,2007,"AS Nancy","Stade Rennes","2-3",2,3,"1",1,5,-1,"D"
"23344",2008-05-17,2007,"OGC Nice","SM Caen","3-1",3,1,"1",1,4,2,"H"
"23345",2008-05-17,2007,"AS Saint-Etienne","AS Monaco","4-0",4,0,"1",1,4,4,"H"
"23346",2008-05-17,2007,"FC Sochaux","Paris Saint-Germain","1-2",1,2,"1",1,3,-1,"D"
"23347",2008-05-17,2007,"Toulouse FC","Valenciennes FC","2-1",2,1,"1",1,3,1,"H"
"23348",2008-08-09,2008,"AJ Auxerre","FC Nantes","2-1",2,1,"1",1,3,1,"H"
"23349",2008-08-09,2008,"Girondins Bordeaux","SM Caen","2-1",2,1,"1",1,3,1,"H"
"23350",2008-08-09,2008,"Le Havre AC","OGC Nice","1-0",1,0,"1",1,1,1,"H"
"23351",2008-08-09,2008,"Le Mans UC 72","FC Lorient","0-1",0,1,"1",1,1,-1,"D"
"23352",2008-08-09,2008,"AS Monaco","Paris Saint-Germain","1-0",1,0,"1",1,1,1,"H"
"23353",2008-08-09,2008,"AS Nancy","Lille OSC","0-0",0,0,"1",1,0,0,"D"
"23354",2008-08-09,2008,"Stade Rennes","Olympique Marseille","4-4",4,4,"1",1,8,0,"D"
"23355",2008-08-09,2008,"FC Sochaux","Grenoble Foot 38","1-2",1,2,"1",1,3,-1,"D"
"23356",2008-08-09,2008,"Valenciennes FC","AS Saint-Etienne","1-0",1,0,"1",1,1,1,"H"
"23357",2008-08-10,2008,"Olympique Lyon","Toulouse FC","3-0",3,0,"1",1,3,3,"H"
"23358",2008-08-16,2008,"SM Caen","Valenciennes FC","3-1",3,1,"1",1,4,2,"H"
"23359",2008-08-16,2008,"Lille OSC","Le Mans UC 72","1-3",1,3,"1",1,4,-2,"D"
"23360",2008-08-16,2008,"FC Nantes","AS Monaco","1-1",1,1,"1",1,2,0,"D"
"23361",2008-08-16,2008,"OGC Nice","AS Nancy","2-1",2,1,"1",1,3,1,"H"
"23362",2008-08-16,2008,"AS Saint-Etienne","FC Sochaux","2-1",2,1,"1",1,3,1,"H"
"23363",2008-08-16,2008,"Toulouse FC","Le Havre AC","2-1",2,1,"1",1,3,1,"H"
"23364",2008-08-16,2008,"Paris Saint-Germain","Girondins Bordeaux","1-0",1,0,"1",1,1,1,"H"
"23365",2008-08-17,2008,"Grenoble Foot 38","Stade Rennes","1-0",1,0,"1",1,1,1,"H"
"23366",2008-08-17,2008,"FC Lorient","Olympique Lyon","0-0",0,0,"1",1,0,0,"D"
"23367",2008-08-17,2008,"Olympique Marseille","AJ Auxerre","4-0",4,0,"1",1,4,4,"H"
"23368",2008-08-23,2008,"Le Havre AC","Olympique Marseille","0-1",0,1,"1",1,1,-1,"D"
"23369",2008-08-23,2008,"Le Mans UC 72","AS Saint-Etienne","1-0",1,0,"1",1,1,1,"H"
"23370",2008-08-23,2008,"AS Monaco","SM Caen","1-1",1,1,"1",1,2,0,"D"
"23371",2008-08-23,2008,"AS Nancy","Toulouse FC","0-0",0,0,"1",1,0,0,"D"
"23372",2008-08-23,2008,"FC Sochaux","Paris Saint-Germain","1-1",1,1,"1",1,2,0,"D"
"23373",2008-08-23,2008,"Valenciennes FC","FC Lorient","3-1",3,1,"1",1,4,2,"H"
"23374",2008-08-23,2008,"Olympique Lyon","Grenoble Foot 38","2-0",2,0,"1",1,2,2,"H"
"23375",2008-08-24,2008,"AJ Auxerre","OGC Nice","0-1",0,1,"1",1,1,-1,"D"
"23376",2008-08-24,2008,"Stade Rennes","Lille OSC","2-1",2,1,"1",1,3,1,"H"
"23377",2008-08-24,2008,"Girondins Bordeaux","FC Nantes","2-0",2,0,"1",1,2,2,"H"
"23378",2008-08-30,2008,"SM Caen","Paris Saint-Germain","0-1",0,1,"1",1,1,-1,"D"
"23379",2008-08-30,2008,"Grenoble Foot 38","AS Monaco","1-0",1,0,"1",1,1,1,"H"
"23380",2008-08-30,2008,"FC Lorient","AJ Auxerre","0-2",0,2,"1",1,2,-2,"D"
"23381",2008-08-30,2008,"AS Nancy","Le Havre AC","2-1",2,1,"1",1,3,1,"H"
"23382",2008-08-30,2008,"FC Nantes","Le Mans UC 72","1-4",1,4,"1",1,5,-3,"D"
"23383",2008-08-30,2008,"OGC Nice","Valenciennes FC","2-0",2,0,"1",1,2,2,"H"
"23384",2008-08-30,2008,"Olympique Marseille","FC Sochaux","2-1",2,1,"1",1,3,1,"H"
"23385",2008-08-31,2008,"Lille OSC","Girondins Bordeaux","2-1",2,1,"1",1,3,1,"H"
"23386",2008-08-31,2008,"Toulouse FC","Stade Rennes","0-0",0,0,"1",1,0,0,"D"
"23387",2008-08-31,2008,"AS Saint-Etienne","Olympique Lyon","0-1",0,1,"1",1,1,-1,"D"
"23388",2008-09-13,2008,"AJ Auxerre","AS Nancy","1-1",1,1,"1",1,2,0,"D"
"23389",2008-09-13,2008,"Le Mans UC 72","Toulouse FC","1-2",1,2,"1",1,3,-1,"D"
"23390",2008-09-13,2008,"Olympique Lyon","OGC Nice","3-2",3,2,"1",1,5,1,"H"
"23391",2008-09-13,2008,"AS Monaco","FC Lorient","2-0",2,0,"1",1,2,2,"H"
"23392",2008-09-13,2008,"Stade Rennes","Le Havre AC","1-1",1,1,"1",1,2,0,"D"
"23393",2008-09-13,2008,"Valenciennes FC","Grenoble Foot 38","1-1",1,1,"1",1,2,0,"D"
"23394",2008-09-13,2008,"Girondins Bordeaux","Olympique Marseille","1-1",1,1,"1",1,2,0,"D"
"23395",2008-09-14,2008,"SM Caen","AS Saint-Etienne","2-0",2,0,"1",1,2,2,"H"
"23396",2008-09-14,2008,"FC Sochaux","Lille OSC","1-1",1,1,"1",1,2,0,"D"
"23397",2008-09-14,2008,"Paris Saint-Germain","FC Nantes","1-0",1,0,"1",1,1,1,"H"
"23398",2008-09-20,2008,"Grenoble Foot 38","Girondins Bordeaux","0-1",0,1,"1",1,1,-1,"D"
"23399",2008-09-20,2008,"Le Havre AC","Olympique Lyon","0-1",0,1,"1",1,1,-1,"D"
"23400",2008-09-20,2008,"Lille OSC","AJ Auxerre","3-2",3,2,"1",1,5,1,"H"
"23401",2008-09-20,2008,"FC Lorient","SM Caen","1-1",1,1,"1",1,2,0,"D"
"23402",2008-09-20,2008,"FC Nantes","Valenciennes FC","2-0",2,0,"1",1,2,2,"H"
"23403",2008-09-20,2008,"Toulouse FC","FC Sochaux","2-1",2,1,"1",1,3,1,"H"
"23404",2008-09-20,2008,"OGC Nice","Le Mans UC 72","2-2",2,2,"1",1,4,0,"D"
"23405",2008-09-21,2008,"AS Nancy","Stade Rennes","0-0",0,0,"1",1,0,0,"D"
"23406",2008-09-21,2008,"AS Saint-Etienne","Paris Saint-Germain","1-0",1,0,"1",1,1,1,"H"
"23407",2008-09-21,2008,"Olympique Marseille","AS Monaco","0-0",0,0,"1",1,0,0,"D"
"23408",2008-09-27,2008,"AJ Auxerre","Le Havre AC","3-0",3,0,"1",1,3,3,"H"
"23409",2008-09-27,2008,"SM Caen","FC Nantes","3-0",3,0,"1",1,3,3,"H"
"23410",2008-09-27,2008,"Le Mans UC 72","Olympique Marseille","1-1",1,1,"1",1,2,0,"D"
"23411",2008-09-27,2008,"Olympique Lyon","AS Nancy","2-1",2,1,"1",1,3,1,"H"
"23412",2008-09-27,2008,"Stade Rennes","OGC Nice","1-0",1,0,"1",1,1,1,"H"
"23413",2008-09-27,2008,"FC Sochaux","FC Lorient","1-1",1,1,"1",1,2,0,"D"
"23414",2008-09-27,2008,"Paris Saint-Germain","Grenoble Foot 38","0-1",0,1,"1",1,1,-1,"D"
"23415",2008-09-28,2008,"AS Monaco","Lille OSC","0-2",0,2,"1",1,2,-2,"D"
"23416",2008-09-28,2008,"Valenciennes FC","Toulouse FC","0-1",0,1,"1",1,1,-1,"D"
"23417",2008-09-28,2008,"Girondins Bordeaux","AS Saint-Etienne","1-1",1,1,"1",1,2,0,"D"
"23418",2008-10-04,2008,"Grenoble Foot 38","FC Nantes","0-1",0,1,"1",1,1,-1,"D"
"23419",2008-10-04,2008,"Le Havre AC","Le Mans UC 72","1-2",1,2,"1",1,3,-1,"D"
"23420",2008-10-04,2008,"FC Lorient","Girondins Bordeaux","1-2",1,2,"1",1,3,-1,"D"
"23421",2008-10-04,2008,"Olympique Marseille","SM Caen","2-1",2,1,"1",1,3,1,"H"
"23422",2008-10-04,2008,"OGC Nice","FC Sochaux","1-1",1,1,"1",1,2,0,"D"
"23423",2008-10-04,2008,"Toulouse FC","AJ Auxerre","1-0",1,0,"1",1,1,1,"H"
"23424",2008-10-04,2008,"Lille OSC","Valenciennes FC","1-0",1,0,"1",1,1,1,"H"
"23425",2008-10-05,2008,"Stade Rennes","Olympique Lyon","3-0",3,0,"1",1,3,3,"H"
"23426",2008-10-05,2008,"AS Saint-Etienne","AS Monaco","2-0",2,0,"1",1,2,2,"H"
"23427",2008-10-05,2008,"AS Nancy","Paris Saint-Germain","1-1",1,1,"1",1,2,0,"D"
"23428",2008-10-18,2008,"Girondins Bordeaux","Toulouse FC","2-1",2,1,"1",1,3,1,"H"
"23429",2008-10-18,2008,"SM Caen","Grenoble Foot 38","2-2",2,2,"1",1,4,0,"D"
"23430",2008-10-18,2008,"AS Monaco","OGC Nice","1-2",1,2,"1",1,3,-1,"D"
"23431",2008-10-18,2008,"FC Nantes","AS Saint-Etienne","1-0",1,0,"1",1,1,1,"H"
"23432",2008-10-18,2008,"Paris Saint-Germain","FC Lorient","3-2",3,2,"1",1,5,1,"H"
"23433",2008-10-18,2008,"FC Sochaux","Le Havre AC","1-1",1,1,"1",1,2,0,"D"
"23434",2008-10-18,2008,"Olympique Lyon","Lille OSC","2-2",2,2,"1",1,4,0,"D"
"23435",2008-10-19,2008,"AJ Auxerre","Stade Rennes","0-0",0,0,"1",1,0,0,"D"
"23436",2008-10-19,2008,"Le Mans UC 72","AS Nancy","2-0",2,0,"1",1,2,2,"H"
"23437",2008-10-19,2008,"Valenciennes FC","Olympique Marseille","1-3",1,3,"1",1,4,-2,"D"
"23438",2008-10-25,2008,"AJ Auxerre","Olympique Lyon","0-0",0,0,"1",1,0,0,"D"
"23439",2008-10-25,2008,"Le Havre AC","Valenciennes FC","2-1",2,1,"1",1,3,1,"H"
"23440",2008-10-25,2008,"Lille OSC","SM Caen","2-2",2,2,"1",1,4,0,"D"
"23441",2008-10-25,2008,"FC Lorient","FC Nantes","3-0",3,0,"1",1,3,3,"H"
"23442",2008-10-25,2008,"OGC Nice","Girondins Bordeaux","2-2",2,2,"1",1,4,0,"D"
"23443",2008-10-25,2008,"Stade Rennes","Le Mans UC 72","2-2",2,2,"1",1,4,0,"D"
"23444",2008-10-25,2008,"Toulouse FC","AS Monaco","0-0",0,0,"1",1,0,0,"D"
"23445",2008-10-26,2008,"AS Nancy","FC Sochaux","1-1",1,1,"1",1,2,0,"D"
"23446",2008-10-26,2008,"AS Saint-Etienne","Grenoble Foot 38","0-2",0,2,"1",1,2,-2,"D"
"23447",2008-10-26,2008,"Olympique Marseille","Paris Saint-Germain","2-4",2,4,"1",1,6,-2,"D"
"23448",2008-10-28,2008,"Girondins Bordeaux","Le Havre AC","4-0",4,0,"1",1,4,4,"H"
"23449",2008-10-29,2008,"SM Caen","OGC Nice","1-1",1,1,"1",1,2,0,"D"
"23450",2008-10-29,2008,"Grenoble Foot 38","Lille OSC","0-0",0,0,"1",1,0,0,"D"
"23451",2008-10-29,2008,"Le Mans UC 72","AJ Auxerre","0-2",0,2,"1",1,2,-2,"D"
"23452",2008-10-29,2008,"AS Monaco","AS Nancy","3-1",3,1,"1",1,4,2,"H"
"23453",2008-10-29,2008,"FC Nantes","Olympique Marseille","1-1",1,1,"1",1,2,0,"D"
"23454",2008-10-29,2008,"Paris Saint-Germain","Toulouse FC","0-1",0,1,"1",1,1,-1,"D"
"23455",2008-10-29,2008,"FC Sochaux","Olympique Lyon","0-2",0,2,"1",1,2,-2,"D"
"23456",2008-10-29,2008,"Valenciennes FC","Stade Rennes","0-0",0,0,"1",1,0,0,"D"
"23457",2008-10-29,2008,"AS Saint-Etienne","FC Lorient","1-4",1,4,"1",1,5,-3,"D"
"23458",2008-11-01,2008,"AJ Auxerre","Valenciennes FC","0-0",0,0,"1",1,0,0,"D"
"23459",2008-11-01,2008,"Lille OSC","FC Nantes","2-0",2,0,"1",1,2,2,"H"
"23460",2008-11-01,2008,"FC Lorient","Grenoble Foot 38","1-1",1,1,"1",1,2,0,"D"
"23461",2008-11-01,2008,"AS Nancy","Girondins Bordeaux","1-0",1,0,"1",1,1,1,"H"
"23462",2008-11-01,2008,"OGC Nice","Paris Saint-Germain","1-0",1,0,"1",1,1,1,"H"
"23463",2008-11-01,2008,"Toulouse FC","SM Caen","0-1",0,1,"1",1,1,-1,"D"
"23464",2008-11-01,2008,"Olympique Marseille","AS Saint-Etienne","3-1",3,1,"1",1,4,2,"H"
"23465",2008-11-02,2008,"Le Havre AC","AS Monaco","2-3",2,3,"1",1,5,-1,"D"
"23466",2008-11-02,2008,"Stade Rennes","FC Sochaux","1-0",1,0,"1",1,1,1,"H"
"23467",2008-11-02,2008,"Olympique Lyon","Le Mans UC 72","2-0",2,0,"1",1,2,2,"H"
"23468",2008-11-08,2008,"Girondins Bordeaux","AJ Auxerre","2-0",2,0,"1",1,2,2,"H"
"23469",2008-11-08,2008,"SM Caen","Le Havre AC","0-1",0,1,"1",1,1,-1,"D"
"23470",2008-11-08,2008,"Grenoble Foot 38","Olympique Marseille","0-3",0,3,"1",1,3,-3,"D"
"23471",2008-11-08,2008,"FC Lorient","OGC Nice","0-1",0,1,"1",1,1,-1,"D"
"23472",2008-11-08,2008,"AS Monaco","Olympique Lyon","0-1",0,1,"1",1,1,-1,"D"
"23473",2008-11-08,2008,"FC Sochaux","Le Mans UC 72","2-1",2,1,"1",1,3,1,"H"
"23474",2008-11-08,2008,"FC Nantes","Toulouse FC","1-1",1,1,"1",1,2,0,"D"
"23475",2008-11-09,2008,"AS Saint-Etienne","Stade Rennes","0-3",0,3,"1",1,3,-3,"D"
"23476",2008-11-09,2008,"Valenciennes FC","AS Nancy","0-1",0,1,"1",1,1,-1,"D"
"23477",2008-11-09,2008,"Paris Saint-Germain","Lille OSC","1-0",1,0,"1",1,1,1,"H"
"23478",2008-11-15,2008,"AJ Auxerre","FC Sochaux","1-0",1,0,"1",1,1,1,"H"
"23479",2008-11-15,2008,"Le Havre AC","Paris Saint-Germain","1-3",1,3,"1",1,4,-2,"D"
"23480",2008-11-15,2008,"Le Mans UC 72","Valenciennes FC","1-0",1,0,"1",1,1,1,"H"
"23481",2008-11-15,2008,"Olympique Marseille","FC Lorient","2-3",2,3,"1",1,5,-1,"D"
"23482",2008-11-15,2008,"AS Nancy","SM Caen","1-1",1,1,"1",1,2,0,"D"
"23483",2008-11-15,2008,"Toulouse FC","Grenoble Foot 38","2-0",2,0,"1",1,2,2,"H"
"23484",2008-11-15,2008,"Lille OSC","AS Saint-Etienne","3-0",3,0,"1",1,3,3,"H"
"23485",2008-11-16,2008,"OGC Nice","FC Nantes","2-1",2,1,"1",1,3,1,"H"
"23486",2008-11-16,2008,"Stade Rennes","AS Monaco","2-1",2,1,"1",1,3,1,"H"
"23487",2008-11-16,2008,"Olympique Lyon","Girondins Bordeaux","2-1",2,1,"1",1,3,1,"H"
"23488",2008-11-22,2008,"Girondins Bordeaux","Stade Rennes","1-1",1,1,"1",1,2,0,"D"
"23489",2008-11-22,2008,"SM Caen","AJ Auxerre","1-0",1,0,"1",1,1,1,"H"
"23490",2008-11-22,2008,"Grenoble Foot 38","Le Havre AC","0-0",0,0,"1",1,0,0,"D"
"23491",2008-11-22,2008,"FC Lorient","Toulouse FC","1-0",1,0,"1",1,1,1,"H"
"23492",2008-11-22,2008,"AS Saint-Etienne","OGC Nice","0-1",0,1,"1",1,1,-1,"D"
"23493",2008-11-22,2008,"Valenciennes FC","FC Sochaux","2-2",2,2,"1",1,4,0,"D"
"23494",2008-11-22,2008,"Paris Saint-Germain","Olympique Lyon","1-0",1,0,"1",1,1,1,"H"
"23495",2008-11-23,2008,"AS Monaco","Le Mans UC 72","3-0",3,0,"1",1,3,3,"H"
"23496",2008-11-23,2008,"FC Nantes","AS Nancy","0-1",0,1,"1",1,1,-1,"D"
"23497",2008-11-23,2008,"Olympique Marseille","Lille OSC","2-2",2,2,"1",1,4,0,"D"
"23498",2008-11-29,2008,"AJ Auxerre","AS Monaco","0-1",0,1,"1",1,1,-1,"D"
"23499",2008-11-29,2008,"Le Havre AC","FC Nantes","0-2",0,2,"1",1,2,-2,"D"
"23500",2008-11-29,2008,"Le Mans UC 72","SM Caen","2-0",2,0,"1",1,2,2,"H"
"23501",2008-11-29,2008,"Lille OSC","FC Lorient","1-1",1,1,"1",1,2,0,"D"
"23502",2008-11-29,2008,"Olympique Lyon","Valenciennes FC","0-0",0,0,"1",1,0,0,"D"
"23503",2008-11-29,2008,"FC Sochaux","Girondins Bordeaux","0-0",0,0,"1",1,0,0,"D"
"23504",2008-11-30,2008,"AS Nancy","AS Saint-Etienne","1-2",1,2,"1",1,3,-1,"D"
"23505",2008-11-30,2008,"Toulouse FC","Olympique Marseille","0-0",0,0,"1",1,0,0,"D"
"23506",2008-11-30,2008,"Stade Rennes","Paris Saint-Germain","1-0",1,0,"1",1,1,1,"H"
"23507",2008-12-05,2008,"Girondins Bordeaux","Valenciennes FC","2-1",2,1,"1",1,3,1,"H"
"23508",2008-12-06,2008,"SM Caen","Stade Rennes","1-1",1,1,"1",1,2,0,"D"
"23509",2008-12-06,2008,"Lille OSC","Toulouse FC","1-1",1,1,"1",1,2,0,"D"
"23510",2008-12-06,2008,"Olympique Marseille","OGC Nice","2-1",2,1,"1",1,3,1,"H"
"23511",2008-12-06,2008,"AS Saint-Etienne","Le Havre AC","2-0",2,0,"1",1,2,2,"H"
"23512",2008-12-06,2008,"FC Nantes","Olympique Lyon","2-1",2,1,"1",1,3,1,"H"
"23513",2008-12-07,2008,"Grenoble Foot 38","AJ Auxerre","0-0",0,0,"1",1,0,0,"D"
"23514",2008-12-07,2008,"FC Lorient","AS Nancy","1-0",1,0,"1",1,1,1,"H"
"23515",2008-12-07,2008,"AS Monaco","FC Sochaux","1-1",1,1,"1",1,2,0,"D"
"23516",2008-12-07,2008,"Paris Saint-Germain","Le Mans UC 72","3-1",3,1,"1",1,4,2,"H"
"23517",2008-12-10,2008,"OGC Nice","Grenoble Foot 38","0-0",0,0,"1",1,0,0,"D"
"23518",2008-12-13,2008,"AJ Auxerre","Paris Saint-Germain","1-2",1,2,"1",1,3,-1,"D"
"23519",2008-12-13,2008,"Le Mans UC 72","Girondins Bordeaux","1-3",1,3,"1",1,4,-2,"D"
"23520",2008-12-13,2008,"AS Nancy","Grenoble Foot 38","2-0",2,0,"1",1,2,2,"H"
"23521",2008-12-13,2008,"FC Sochaux","SM Caen","2-2",2,2,"1",1,4,0,"D"
"23522",2008-12-13,2008,"Toulouse FC","AS Saint-Etienne","3-1",3,1,"1",1,4,2,"H"
"23523",2008-12-13,2008,"Valenciennes FC","AS Monaco","3-1",3,1,"1",1,4,2,"H"
"23524",2008-12-13,2008,"Stade Rennes","FC Nantes","0-0",0,0,"1",1,0,0,"D"
"23525",2008-12-14,2008,"Le Havre AC","FC Lorient","1-3",1,3,"1",1,4,-2,"D"
"23526",2008-12-14,2008,"OGC Nice","Lille OSC","0-1",0,1,"1",1,1,-1,"D"
"23527",2008-12-14,2008,"Olympique Lyon","Olympique Marseille","0-0",0,0,"1",1,0,0,"D"
"23528",2008-12-20,2008,"Grenoble Foot 38","Le Mans UC 72","2-1",2,1,"1",1,3,1,"H"
"23529",2008-12-20,2008,"Lille OSC","Le Havre AC","3-1",3,1,"1",1,4,2,"H"
"23530",2008-12-20,2008,"FC Lorient","Stade Rennes","1-2",1,2,"1",1,3,-1,"D"
"23531",2008-12-20,2008,"FC Nantes","FC Sochaux","1-1",1,1,"1",1,2,0,"D"
"23532",2008-12-20,2008,"AS Saint-Etienne","AJ Auxerre","2-0",2,0,"1",1,2,2,"H"
"23533",2008-12-20,2008,"Toulouse FC","OGC Nice","2-2",2,2,"1",1,4,0,"D"
"23534",2008-12-20,2008,"SM Caen","Olympique Lyon","0-1",0,1,"1",1,1,-1,"D"
"23535",2008-12-21,2008,"Olympique Marseille","AS Nancy","0-3",0,3,"1",1,3,-3,"D"
"23536",2008-12-21,2008,"Paris Saint-Germain","Valenciennes FC","2-2",2,2,"1",1,4,0,"D"
"23537",2008-12-21,2008,"AS Monaco","Girondins Bordeaux","3-4",3,4,"1",1,7,-1,"D"
"23538",2009-01-10,2008,"AJ Auxerre","Olympique Marseille","0-2",0,2,"1",1,2,-2,"D"
"23539",2009-01-10,2008,"Le Havre AC","Toulouse FC","0-1",0,1,"1",1,1,-1,"D"
"23540",2009-01-10,2008,"Olympique Lyon","FC Lorient","1-1",1,1,"1",1,2,0,"D"
"23541",2009-01-10,2008,"AS Monaco","FC Nantes","1-2",1,2,"1",1,3,-1,"D"
"23542",2009-01-10,2008,"Stade Rennes","Grenoble Foot 38","1-0",1,0,"1",1,1,1,"H"
"23543",2009-01-10,2008,"FC Sochaux","AS Saint-Etienne","1-0",1,0,"1",1,1,1,"H"
"23544",2009-01-11,2008,"Girondins Bordeaux","Paris Saint-Germain","4-0",4,0,"1",1,4,4,"H"
"23545",2009-01-17,2008,"Grenoble Foot 38","Olympique Lyon","0-2",0,2,"1",1,2,-2,"D"
"23546",2009-01-17,2008,"FC Lorient","Valenciennes FC","1-1",1,1,"1",1,2,0,"D"
"23547",2009-01-17,2008,"Olympique Marseille","Le Havre AC","2-0",2,0,"1",1,2,2,"H"
"23548",2009-01-17,2008,"OGC Nice","AJ Auxerre","2-0",2,0,"1",1,2,2,"H"
"23549",2009-01-17,2008,"AS Saint-Etienne","Le Mans UC 72","1-1",1,1,"1",1,2,0,"D"
"23550",2009-01-17,2008,"Toulouse FC","AS Nancy","3-0",3,0,"1",1,3,3,"H"
"23551",2009-01-17,2008,"FC Nantes","Girondins Bordeaux","1-2",1,2,"1",1,3,-1,"D"
"23552",2009-01-18,2008,"SM Caen","AS Monaco","2-2",2,2,"1",1,4,0,"D"
"23553",2009-01-18,2008,"Paris Saint-Germain","FC Sochaux","2-1",2,1,"1",1,3,1,"H"
"23554",2009-01-18,2008,"Lille OSC","Stade Rennes","1-0",1,0,"1",1,1,1,"H"
"23555",2009-01-31,2008,"AJ Auxerre","FC Lorient","0-0",0,0,"1",1,0,0,"D"
"23556",2009-01-31,2008,"Le Havre AC","AS Nancy","2-3",2,3,"1",1,5,-1,"D"
"23557",2009-01-31,2008,"Le Mans UC 72","FC Nantes","0-2",0,2,"1",1,2,-2,"D"
"23558",2009-01-31,2008,"AS Monaco","Grenoble Foot 38","1-0",1,0,"1",1,1,1,"H"
"23559",2009-01-31,2008,"Paris Saint-Germain","SM Caen","2-0",2,0,"1",1,2,2,"H"
"23560",2009-01-31,2008,"Valenciennes FC","OGC Nice","1-0",1,0,"1",1,1,1,"H"
"23561",2009-01-31,2008,"Stade Rennes","Toulouse FC","0-0",0,0,"1",1,0,0,"D"
"23562",2009-02-01,2008,"Girondins Bordeaux","Lille OSC","2-2",2,2,"1",1,4,0,"D"
"23563",2009-02-01,2008,"FC Sochaux","Olympique Marseille","1-0",1,0,"1",1,1,1,"H"
"23564",2009-02-01,2008,"Olympique Lyon","AS Saint-Etienne","1-1",1,1,"1",1,2,0,"D"
"23565",2009-02-07,2008,"Le Havre AC","Stade Rennes","1-0",1,0,"1",1,1,1,"H"
"23566",2009-02-07,2008,"FC Lorient","AS Monaco","1-1",1,1,"1",1,2,0,"D"
"23567",2009-02-07,2008,"AS Nancy","AJ Auxerre","0-2",0,2,"1",1,2,-2,"D"
"23568",2009-02-07,2008,"FC Nantes","Paris Saint-Germain","1-4",1,4,"1",1,5,-3,"D"
"23569",2009-02-07,2008,"AS Saint-Etienne","SM Caen","3-2",3,2,"1",1,5,1,"H"
"23570",2009-02-07,2008,"Toulouse FC","Le Mans UC 72","2-0",2,0,"1",1,2,2,"H"
"23571",2009-02-07,2008,"Lille OSC","FC Sochaux","3-2",3,2,"1",1,5,1,"H"
"23572",2009-02-08,2008,"Grenoble Foot 38","Valenciennes FC","0-0",0,0,"1",1,0,0,"D"
"23573",2009-02-08,2008,"OGC Nice","Olympique Lyon","1-3",1,3,"1",1,4,-2,"D"
"23574",2009-02-08,2008,"Olympique Marseille","Girondins Bordeaux","1-0",1,0,"1",1,1,1,"H"
"23575",2009-02-14,2008,"AJ Auxerre","Lille OSC","2-0",2,0,"1",1,2,2,"H"
"23576",2009-02-14,2008,"Girondins Bordeaux","Grenoble Foot 38","1-1",1,1,"1",1,2,0,"D"
"23577",2009-02-14,2008,"SM Caen","FC Lorient","1-1",1,1,"1",1,2,0,"D"
"23578",2009-02-14,2008,"Le Mans UC 72","OGC Nice","1-2",1,2,"1",1,3,-1,"D"
"23579",2009-02-14,2008,"Stade Rennes","AS Nancy","1-1",1,1,"1",1,2,0,"D"
"23580",2009-02-14,2008,"Valenciennes FC","FC Nantes","1-1",1,1,"1",1,2,0,"D"
"23581",2009-02-14,2008,"Paris Saint-Germain","AS Saint-Etienne","2-1",2,1,"1",1,3,1,"H"
"23582",2009-02-15,2008,"Olympique Lyon","Le Havre AC","3-1",3,1,"1",1,4,2,"H"
"23583",2009-02-15,2008,"FC Sochaux","Toulouse FC","1-2",1,2,"1",1,3,-1,"D"
"23584",2009-02-15,2008,"AS Monaco","Olympique Marseille","0-1",0,1,"1",1,1,-1,"D"
"23585",2009-02-17,2008,"Le Mans UC 72","Lille OSC","0-0",0,0,"1",1,0,0,"D"
"23586",2009-02-17,2008,"AS Nancy","OGC Nice","1-2",1,2,"1",1,3,-1,"D"
"23587",2009-02-17,2008,"Valenciennes FC","SM Caen","2-0",2,0,"1",1,2,2,"H"
"23588",2009-02-21,2008,"Grenoble Foot 38","Paris Saint-Germain","0-0",0,0,"1",1,0,0,"D"
"23589",2009-02-21,2008,"Le Havre AC","AJ Auxerre","1-2",1,2,"1",1,3,-1,"D"
"23590",2009-02-21,2008,"FC Lorient","FC Sochaux","1-2",1,2,"1",1,3,-1,"D"
"23591",2009-02-21,2008,"AS Nancy","Olympique Lyon","0-2",0,2,"1",1,2,-2,"D"
"23592",2009-02-21,2008,"FC Nantes","SM Caen","1-1",1,1,"1",1,2,0,"D"
"23593",2009-02-21,2008,"Toulouse FC","Valenciennes FC","0-0",0,0,"1",1,0,0,"D"
"23594",2009-02-21,2008,"OGC Nice","Stade Rennes","0-1",0,1,"1",1,1,-1,"D"
"23595",2009-02-22,2008,"Olympique Marseille","Le Mans UC 72","0-0",0,0,"1",1,0,0,"D"
"23596",2009-02-22,2008,"AS Saint-Etienne","Girondins Bordeaux","1-1",1,1,"1",1,2,0,"D"
"23597",2009-02-22,2008,"Lille OSC","AS Monaco","2-1",2,1,"1",1,3,1,"H"
"23598",2009-02-28,2008,"Le Mans UC 72","Le Havre AC","2-0",2,0,"1",1,2,2,"H"
"23599",2009-02-28,2008,"FC Nantes","Grenoble Foot 38","1-1",1,1,"1",1,2,0,"D"
"23600",2009-02-28,2008,"FC Sochaux","OGC Nice","1-0",1,0,"1",1,1,1,"H"
"23601",2009-02-28,2008,"Valenciennes FC","Lille OSC","2-0",2,0,"1",1,2,2,"H"
"23602",2009-02-28,2008,"AJ Auxerre","Toulouse FC","1-1",1,1,"1",1,2,0,"D"
"23603",2009-03-01,2008,"Girondins Bordeaux","FC Lorient","1-0",1,0,"1",1,1,1,"H"
"23604",2009-03-01,2008,"SM Caen","Olympique Marseille","0-1",0,1,"1",1,1,-1,"D"
"23605",2009-03-01,2008,"AS Monaco","AS Saint-Etienne","2-2",2,2,"1",1,4,0,"D"
"23606",2009-03-01,2008,"Paris Saint-Germain","AS Nancy","4-1",4,1,"1",1,5,3,"H"
"23607",2009-03-01,2008,"Olympique Lyon","Stade Rennes","1-1",1,1,"1",1,2,0,"D"
"23608",2009-03-07,2008,"Grenoble Foot 38","SM Caen","2-1",2,1,"1",1,3,1,"H"
"23609",2009-03-07,2008,"FC Lorient","Paris Saint-Germain","0-1",0,1,"1",1,1,-1,"D"
"23610",2009-03-07,2008,"Olympique Marseille","Valenciennes FC","0-0",0,0,"1",1,0,0,"D"
"23611",2009-03-07,2008,"AS Nancy","Le Mans UC 72","2-2",2,2,"1",1,4,0,"D"
"23612",2009-03-07,2008,"OGC Nice","AS Monaco","0-0",0,0,"1",1,0,0,"D"
"23613",2009-03-07,2008,"Toulouse FC","Girondins Bordeaux","3-0",3,0,"1",1,3,3,"H"
"23614",2009-03-07,2008,"Lille OSC","Olympique Lyon","2-0",2,0,"1",1,2,2,"H"
"23615",2009-03-08,2008,"Le Havre AC","FC Sochaux","2-1",2,1,"1",1,3,1,"H"
"23616",2009-03-08,2008,"Stade Rennes","AJ Auxerre","2-0",2,0,"1",1,2,2,"H"
"23617",2009-03-08,2008,"AS Saint-Etienne","FC Nantes","2-1",2,1,"1",1,3,1,"H"
"23618",2009-03-14,2008,"SM Caen","Lille OSC","0-1",0,1,"1",1,1,-1,"D"
"23619",2009-03-14,2008,"Le Mans UC 72","Stade Rennes","2-2",2,2,"1",1,4,0,"D"
"23620",2009-03-14,2008,"AS Monaco","Toulouse FC","3-2",3,2,"1",1,5,1,"H"
"23621",2009-03-14,2008,"FC Nantes","FC Lorient","1-1",1,1,"1",1,2,0,"D"
"23622",2009-03-14,2008,"FC Sochaux","AS Nancy","2-1",2,1,"1",1,3,1,"H"
"23623",2009-03-14,2008,"Valenciennes FC","Le Havre AC","3-2",3,2,"1",1,5,1,"H"
"23624",2009-03-14,2008,"Girondins Bordeaux","OGC Nice","2-1",2,1,"1",1,3,1,"H"
"23625",2009-03-15,2008,"Grenoble Foot 38","AS Saint-Etienne","1-0",1,0,"1",1,1,1,"H"
"23626",2009-03-15,2008,"Olympique Lyon","AJ Auxerre","0-2",0,2,"1",1,2,-2,"D"
"23627",2009-03-15,2008,"Paris Saint-Germain","Olympique Marseille","1-3",1,3,"1",1,4,-2,"D"
"23628",2009-03-21,2008,"AJ Auxerre","Le Mans UC 72","2-0",2,0,"1",1,2,2,"H"
"23629",2009-03-21,2008,"Le Havre AC","Girondins Bordeaux","0-3",0,3,"1",1,3,-3,"D"
"23630",2009-03-21,2008,"Lille OSC","Grenoble Foot 38","2-1",2,1,"1",1,3,1,"H"
"23631",2009-03-21,2008,"AS Nancy","AS Monaco","0-1",0,1,"1",1,1,-1,"D"
"23632",2009-03-21,2008,"OGC Nice","SM Caen","2-2",2,2,"1",1,4,0,"D"
"23633",2009-03-21,2008,"Stade Rennes","Valenciennes FC","0-0",0,0,"1",1,0,0,"D"
"23634",2009-03-21,2008,"Olympique Marseille","FC Nantes","2-0",2,0,"1",1,2,2,"H"
"23635",2009-03-22,2008,"FC Lorient","AS Saint-Etienne","3-1",3,1,"1",1,4,2,"H"
"23636",2009-03-22,2008,"Olympique Lyon","FC Sochaux","2-0",2,0,"1",1,2,2,"H"
"23637",2009-03-22,2008,"Toulouse FC","Paris Saint-Germain","4-1",4,1,"1",1,5,3,"H"
"23638",2009-04-04,2008,"Girondins Bordeaux","AS Nancy","1-0",1,0,"1",1,1,1,"H"
"23639",2009-04-04,2008,"Grenoble Foot 38","FC Lorient","1-3",1,3,"1",1,4,-2,"D"
"23640",2009-04-04,2008,"Le Mans UC 72","Olympique Lyon","1-3",1,3,"1",1,4,-2,"D"
"23641",2009-04-04,2008,"AS Monaco","Le Havre AC","0-1",0,1,"1",1,1,-1,"D"
"23642",2009-04-04,2008,"FC Nantes","Lille OSC","0-2",0,2,"1",1,2,-2,"D"
"23643",2009-04-04,2008,"Valenciennes FC","AJ Auxerre","2-0",2,0,"1",1,2,2,"H"
"23644",2009-04-04,2008,"SM Caen","Toulouse FC","0-0",0,0,"1",1,0,0,"D"
"23645",2009-04-05,2008,"Paris Saint-Germain","OGC Nice","2-1",2,1,"1",1,3,1,"H"
"23646",2009-04-05,2008,"FC Sochaux","Stade Rennes","3-0",3,0,"1",1,3,3,"H"
"23647",2009-04-05,2008,"AS Saint-Etienne","Olympique Marseille","0-3",0,3,"1",1,3,-3,"D"
"23648",2009-04-11,2008,"AJ Auxerre","Girondins Bordeaux","0-2",0,2,"1",1,2,-2,"D"
"23649",2009-04-11,2008,"Le Havre AC","SM Caen","1-2",1,2,"1",1,3,-1,"D"
"23650",2009-04-11,2008,"Le Mans UC 72","FC Sochaux","2-0",2,0,"1",1,2,2,"H"
"23651",2009-04-11,2008,"AS Nancy","Valenciennes FC","2-0",2,0,"1",1,2,2,"H"
"23652",2009-04-11,2008,"OGC Nice","FC Lorient","2-0",2,0,"1",1,2,2,"H"
"23653",2009-04-11,2008,"Toulouse FC","FC Nantes","1-0",1,0,"1",1,1,1,"H"
"23654",2009-04-11,2008,"Stade Rennes","AS Saint-Etienne","1-0",1,0,"1",1,1,1,"H"
"23655",2009-04-12,2008,"Olympique Marseille","Grenoble Foot 38","4-1",4,1,"1",1,5,3,"H"
"23656",2009-04-12,2008,"Lille OSC","Paris Saint-Germain","0-0",0,0,"1",1,0,0,"D"
"23657",2009-04-12,2008,"Olympique Lyon","AS Monaco","2-2",2,2,"1",1,4,0,"D"
"23658",2009-04-18,2008,"SM Caen","AS Nancy","1-2",1,2,"1",1,3,-1,"D"
"23659",2009-04-18,2008,"Grenoble Foot 38","Toulouse FC","1-0",1,0,"1",1,1,1,"H"
"23660",2009-04-18,2008,"AS Monaco","Stade Rennes","3-1",3,1,"1",1,4,2,"H"
"23661",2009-04-18,2008,"FC Nantes","OGC Nice","2-0",2,0,"1",1,2,2,"H"
"23662",2009-04-18,2008,"FC Sochaux","AJ Auxerre","0-1",0,1,"1",1,1,-1,"D"
"23663",2009-04-18,2008,"Valenciennes FC","Le Mans UC 72","0-2",0,2,"1",1,2,-2,"D"
"23664",2009-04-18,2008,"AS Saint-Etienne","Lille OSC","2-1",2,1,"1",1,3,1,"H"
"23665",2009-04-19,2008,"FC Lorient","Olympique Marseille","1-2",1,2,"1",1,3,-1,"D"
"23666",2009-04-19,2008,"Paris Saint-Germain","Le Havre AC","3-0",3,0,"1",1,3,3,"H"
"23667",2009-04-19,2008,"Girondins Bordeaux","Olympique Lyon","1-0",1,0,"1",1,1,1,"H"
"23668",2009-04-24,2008,"Olympique Lyon","Paris Saint-Germain","0-0",0,0,"1",1,0,0,"D"
"23669",2009-04-26,2008,"AJ Auxerre","SM Caen","2-1",2,1,"1",1,3,1,"H"
"23670",2009-04-26,2008,"Le Havre AC","Grenoble Foot 38","0-1",0,1,"1",1,1,-1,"D"
"23671",2009-04-26,2008,"Le Mans UC 72","AS Monaco","0-1",0,1,"1",1,1,-1,"D"
"23672",2009-04-26,2008,"AS Nancy","FC Nantes","2-0",2,0,"1",1,2,2,"H"
"23673",2009-04-26,2008,"OGC Nice","AS Saint-Etienne","3-1",3,1,"1",1,4,2,"H"
"23674",2009-04-26,2008,"FC Sochaux","Valenciennes FC","1-1",1,1,"1",1,2,0,"D"
"23675",2009-04-26,2008,"Toulouse FC","FC Lorient","1-1",1,1,"1",1,2,0,"D"
"23676",2009-04-26,2008,"Lille OSC","Olympique Marseille","1-2",1,2,"1",1,3,-1,"D"
"23677",2009-04-29,2008,"Stade Rennes","Girondins Bordeaux","2-3",2,3,"1",1,5,-1,"D"
"23678",2009-05-02,2008,"SM Caen","Le Mans UC 72","3-1",3,1,"1",1,4,2,"H"
"23679",2009-05-02,2008,"Grenoble Foot 38","OGC Nice","0-0",0,0,"1",1,0,0,"D"
"23680",2009-05-02,2008,"FC Lorient","Lille OSC","3-1",3,1,"1",1,4,2,"H"
"23681",2009-05-02,2008,"AS Monaco","AJ Auxerre","0-1",0,1,"1",1,1,-1,"D"
"23682",2009-05-02,2008,"AS Saint-Etienne","AS Nancy","0-0",0,0,"1",1,0,0,"D"
"23683",2009-05-02,2008,"Valenciennes FC","Olympique Lyon","2-0",2,0,"1",1,2,2,"H"
"23684",2009-05-02,2008,"Olympique Marseille","Toulouse FC","2-2",2,2,"1",1,4,0,"D"
"23685",2009-05-03,2008,"FC Nantes","Le Havre AC","1-2",1,2,"1",1,3,-1,"D"
"23686",2009-05-03,2008,"Paris Saint-Germain","Stade Rennes","0-1",0,1,"1",1,1,-1,"D"
"23687",2009-05-03,2008,"Girondins Bordeaux","FC Sochaux","3-0",3,0,"1",1,3,3,"H"
"23688",2009-05-12,2008,"Olympique Lyon","FC Nantes","3-0",3,0,"1",1,3,3,"H"
"23689",2009-05-13,2008,"AJ Auxerre","Grenoble Foot 38","2-0",2,0,"1",1,2,2,"H"
"23690",2009-05-13,2008,"Le Havre AC","AS Saint-Etienne","2-4",2,4,"1",1,6,-2,"D"
"23691",2009-05-13,2008,"Le Mans UC 72","Paris Saint-Germain","0-1",0,1,"1",1,1,-1,"D"
"23692",2009-05-13,2008,"AS Nancy","FC Lorient","2-2",2,2,"1",1,4,0,"D"
"23693",2009-05-13,2008,"OGC Nice","Olympique Marseille","0-2",0,2,"1",1,2,-2,"D"
"23694",2009-05-13,2008,"Stade Rennes","SM Caen","1-0",1,0,"1",1,1,1,"H"
"23695",2009-05-13,2008,"FC Sochaux","AS Monaco","3-0",3,0,"1",1,3,3,"H"
"23696",2009-05-13,2008,"Toulouse FC","Lille OSC","0-0",0,0,"1",1,0,0,"D"
"23697",2009-05-13,2008,"Valenciennes FC","Girondins Bordeaux","1-2",1,2,"1",1,3,-1,"D"
"23698",2009-05-16,2008,"Girondins Bordeaux","Le Mans UC 72","3-2",3,2,"1",1,5,1,"H"
"23699",2009-05-16,2008,"SM Caen","FC Sochaux","2-0",2,0,"1",1,2,2,"H"
"23700",2009-05-16,2008,"Grenoble Foot 38","AS Nancy","0-0",0,0,"1",1,0,0,"D"
"23701",2009-05-16,2008,"FC Lorient","Le Havre AC","1-1",1,1,"1",1,2,0,"D"
"23702",2009-05-16,2008,"AS Monaco","Valenciennes FC","1-1",1,1,"1",1,2,0,"D"
"23703",2009-05-16,2008,"AS Saint-Etienne","Toulouse FC","2-2",2,2,"1",1,4,0,"D"
"23704",2009-05-16,2008,"Paris Saint-Germain","AJ Auxerre","1-2",1,2,"1",1,3,-1,"D"
"23705",2009-05-17,2008,"Lille OSC","OGC Nice","1-1",1,1,"1",1,2,0,"D"
"23706",2009-05-17,2008,"FC Nantes","Stade Rennes","1-1",1,1,"1",1,2,0,"D"
"23707",2009-05-17,2008,"Olympique Marseille","Olympique Lyon","1-3",1,3,"1",1,4,-2,"D"
"23708",2009-05-23,2008,"AJ Auxerre","AS Saint-Etienne","1-0",1,0,"1",1,1,1,"H"
"23709",2009-05-23,2008,"Girondins Bordeaux","AS Monaco","1-0",1,0,"1",1,1,1,"H"
"23710",2009-05-23,2008,"Le Havre AC","Lille OSC","0-1",0,1,"1",1,1,-1,"D"
"23711",2009-05-23,2008,"Le Mans UC 72","Grenoble Foot 38","1-1",1,1,"1",1,2,0,"D"
"23712",2009-05-23,2008,"Olympique Lyon","SM Caen","3-1",3,1,"1",1,4,2,"H"
"23713",2009-05-23,2008,"AS Nancy","Olympique Marseille","1-2",1,2,"1",1,3,-1,"D"
"23714",2009-05-23,2008,"OGC Nice","Toulouse FC","0-2",0,2,"1",1,2,-2,"D"
"23715",2009-05-23,2008,"Stade Rennes","FC Lorient","3-1",3,1,"1",1,4,2,"H"
"23716",2009-05-23,2008,"FC Sochaux","FC Nantes","2-1",2,1,"1",1,3,1,"H"
"23717",2009-05-23,2008,"Valenciennes FC","Paris Saint-Germain","2-1",2,1,"1",1,3,1,"H"
"23718",2009-05-30,2008,"SM Caen","Girondins Bordeaux","0-1",0,1,"1",1,1,-1,"D"
"23719",2009-05-30,2008,"Grenoble Foot 38","FC Sochaux","0-1",0,1,"1",1,1,-1,"D"
"23720",2009-05-30,2008,"Lille OSC","AS Nancy","3-2",3,2,"1",1,5,1,"H"
"23721",2009-05-30,2008,"FC Lorient","Le Mans UC 72","1-1",1,1,"1",1,2,0,"D"
"23722",2009-05-30,2008,"Olympique Marseille","Stade Rennes","4-0",4,0,"1",1,4,4,"H"
"23723",2009-05-30,2008,"FC Nantes","AJ Auxerre","2-1",2,1,"1",1,3,1,"H"
"23724",2009-05-30,2008,"OGC Nice","Le Havre AC","0-0",0,0,"1",1,0,0,"D"
"23725",2009-05-30,2008,"Paris Saint-Germain","AS Monaco","0-0",0,0,"1",1,0,0,"D"
"23726",2009-05-30,2008,"AS Saint-Etienne","Valenciennes FC","4-0",4,0,"1",1,4,4,"H"
"23727",2009-05-30,2008,"Toulouse FC","Olympique Lyon","0-0",0,0,"1",1,0,0,"D"
"23728",2009-08-08,2009,"AJ Auxerre","FC Sochaux","0-1",0,1,"1",1,1,-1,"D"
"23729",2009-08-08,2009,"Grenoble Foot 38","Olympique Marseille","0-2",0,2,"1",1,2,-2,"D"
"23730",2009-08-08,2009,"Le Mans UC 72","Olympique Lyon","2-2",2,2,"1",1,4,0,"D"
"23731",2009-08-08,2009,"AS Monaco","Toulouse FC","1-0",1,0,"1",1,1,1,"H"
"23732",2009-08-08,2009,"Montpellier HSC","Paris Saint-Germain","1-1",1,1,"1",1,2,0,"D"
"23733",2009-08-08,2009,"Stade Rennes","US Boulogne","3-0",3,0,"1",1,3,3,"H"
"23734",2009-08-08,2009,"AS Saint-Etienne","OGC Nice","0-2",0,2,"1",1,2,-2,"D"
"23735",2009-08-08,2009,"Valenciennes FC","AS Nancy","1-3",1,3,"1",1,4,-2,"D"
"23736",2009-08-09,2009,"Lille OSC","FC Lorient","1-2",1,2,"1",1,3,-1,"D"
"23737",2009-08-09,2009,"Girondins Bordeaux","RC Lens","4-1",4,1,"1",1,5,3,"H"
"23738",2009-08-15,2009,"RC Lens","AJ Auxerre","2-0",2,0,"1",1,2,2,"H"
"23739",2009-08-15,2009,"FC Lorient","Montpellier HSC","2-2",2,2,"1",1,4,0,"D"
"23740",2009-08-15,2009,"Olympique Lyon","Valenciennes FC","1-0",1,0,"1",1,1,1,"H"
"23741",2009-08-15,2009,"AS Nancy","AS Monaco","4-0",4,0,"1",1,4,4,"H"
"23742",2009-08-15,2009,"Paris Saint-Germain","Le Mans UC 72","3-1",3,1,"1",1,4,2,"H"
"23743",2009-08-15,2009,"FC Sochaux","Girondins Bordeaux","2-3",2,3,"1",1,5,-1,"D"
"23744",2009-08-15,2009,"Toulouse FC","AS Saint-Etienne","3-1",3,1,"1",1,4,2,"H"
"23745",2009-08-16,2009,"US Boulogne","Grenoble Foot 38","2-1",2,1,"1",1,3,1,"H"
"23746",2009-08-16,2009,"OGC Nice","Stade Rennes","1-1",1,1,"1",1,2,0,"D"
"23747",2009-08-16,2009,"Olympique Marseille","Lille OSC","1-0",1,0,"1",1,1,1,"H"
"23748",2009-08-22,2009,"AJ Auxerre","Olympique Lyon","0-3",0,3,"1",1,3,-3,"D"
"23749",2009-08-22,2009,"Le Mans UC 72","AS Nancy","2-1",2,1,"1",1,3,1,"H"
"23750",2009-08-22,2009,"AS Monaco","FC Lorient","2-0",2,0,"1",1,2,2,"H"
"23751",2009-08-22,2009,"Montpellier HSC","FC Sochaux","2-0",2,0,"1",1,2,2,"H"
"23752",2009-08-22,2009,"AS Saint-Etienne","US Boulogne","0-1",0,1,"1",1,1,-1,"D"
"23753",2009-08-22,2009,"Valenciennes FC","Paris Saint-Germain","2-3",2,3,"1",1,5,-1,"D"
"23754",2009-08-22,2009,"Stade Rennes","Olympique Marseille","1-1",1,1,"1",1,2,0,"D"
"23755",2009-08-23,2009,"Girondins Bordeaux","OGC Nice","4-0",4,0,"1",1,4,4,"H"
"23756",2009-08-23,2009,"Grenoble Foot 38","RC Lens","1-2",1,2,"1",1,3,-1,"D"
"23757",2009-08-23,2009,"Lille OSC","Toulouse FC","1-1",1,1,"1",1,2,0,"D"
"23758",2009-08-29,2009,"US Boulogne","AJ Auxerre","0-0",0,0,"1",1,0,0,"D"
"23759",2009-08-29,2009,"RC Lens","Stade Rennes","2-2",2,2,"1",1,4,0,"D"
"23760",2009-08-29,2009,"FC Lorient","Le Mans UC 72","1-0",1,0,"1",1,1,1,"H"
"23761",2009-08-29,2009,"OGC Nice","Montpellier HSC","0-3",0,3,"1",1,3,-3,"D"
"23762",2009-08-29,2009,"AS Saint-Etienne","Grenoble Foot 38","1-0",1,0,"1",1,1,1,"H"
"23763",2009-08-29,2009,"FC Sochaux","AS Monaco","1-0",1,0,"1",1,1,1,"H"
"23764",2009-08-29,2009,"Olympique Lyon","AS Nancy","3-1",3,1,"1",1,4,2,"H"
"23765",2009-08-30,2009,"Paris Saint-Germain","Lille OSC","3-0",3,0,"1",1,3,3,"H"
"23766",2009-08-30,2009,"Toulouse FC","Valenciennes FC","0-1",0,1,"1",1,1,-1,"D"
"23767",2009-08-30,2009,"Olympique Marseille","Girondins Bordeaux","0-0",0,0,"1",1,0,0,"D"
"23768",2009-09-12,2009,"Le Mans UC 72","Olympique Marseille","1-2",1,2,"1",1,3,-1,"D"
"23769",2009-09-12,2009,"Lille OSC","FC Sochaux","1-0",1,0,"1",1,1,1,"H"
"23770",2009-09-12,2009,"Olympique Lyon","FC Lorient","1-0",1,0,"1",1,1,1,"H"
"23771",2009-09-12,2009,"Montpellier HSC","RC Lens","1-0",1,0,"1",1,1,1,"H"
"23772",2009-09-12,2009,"AS Nancy","Toulouse FC","0-0",0,0,"1",1,0,0,"D"
"23773",2009-09-12,2009,"Valenciennes FC","US Boulogne","1-1",1,1,"1",1,2,0,"D"
"23774",2009-09-12,2009,"Girondins Bordeaux","Grenoble Foot 38","1-0",1,0,"1",1,1,1,"H"
"23775",2009-09-13,2009,"AJ Auxerre","OGC Nice","2-0",2,0,"1",1,2,2,"H"
"23776",2009-09-13,2009,"Stade Rennes","AS Saint-Etienne","1-0",1,0,"1",1,1,1,"H"
"23777",2009-09-13,2009,"AS Monaco","Paris Saint-Germain","2-0",2,0,"1",1,2,2,"H"
"23778",2009-09-19,2009,"US Boulogne","Girondins Bordeaux","0-2",0,2,"1",1,2,-2,"D"
"23779",2009-09-19,2009,"Grenoble Foot 38","Stade Rennes","0-4",0,4,"1",1,4,-4,"D"
"23780",2009-09-19,2009,"FC Lorient","AS Nancy","3-1",3,1,"1",1,4,2,"H"
"23781",2009-09-19,2009,"OGC Nice","AS Monaco","1-3",1,3,"1",1,4,-2,"D"
"23782",2009-09-19,2009,"AS Saint-Etienne","AJ Auxerre","1-1",1,1,"1",1,2,0,"D"
"23783",2009-09-19,2009,"FC Sochaux","Valenciennes FC","2-5",2,5,"1",1,7,-3,"D"
"23784",2009-09-19,2009,"Olympique Marseille","Montpellier HSC","4-2",4,2,"1",1,6,2,"H"
"23785",2009-09-20,2009,"RC Lens","Lille OSC","1-1",1,1,"1",1,2,0,"D"
"23786",2009-09-20,2009,"Toulouse FC","Le Mans UC 72","2-0",2,0,"1",1,2,2,"H"
"23787",2009-09-20,2009,"Paris Saint-Germain","Olympique Lyon","1-1",1,1,"1",1,2,0,"D"
"23788",2009-09-26,2009,"AJ Auxerre","Grenoble Foot 38","2-0",2,0,"1",1,2,2,"H"
"23789",2009-09-26,2009,"FC Lorient","Paris Saint-Germain","1-1",1,1,"1",1,2,0,"D"
"23790",2009-09-26,2009,"AS Monaco","AS Saint-Etienne","1-2",1,2,"1",1,3,-1,"D"
"23791",2009-09-26,2009,"Montpellier HSC","US Boulogne","1-0",1,0,"1",1,1,1,"H"
"23792",2009-09-26,2009,"AS Nancy","FC Sochaux","2-1",2,1,"1",1,3,1,"H"
"23793",2009-09-26,2009,"Valenciennes FC","Olympique Marseille","3-2",3,2,"1",1,5,1,"H"
"23794",2009-09-26,2009,"Olympique Lyon","Toulouse FC","2-1",2,1,"1",1,3,1,"H"
"23795",2009-09-27,2009,"Le Mans UC 72","RC Lens","3-0",3,0,"1",1,3,3,"H"
"23796",2009-09-27,2009,"Lille OSC","OGC Nice","1-1",1,1,"1",1,2,0,"D"
"23797",2009-09-27,2009,"Girondins Bordeaux","Stade Rennes","1-0",1,0,"1",1,1,1,"H"
"23798",2009-10-03,2009,"Grenoble Foot 38","Montpellier HSC","2-3",2,3,"1",1,5,-1,"D"
"23799",2009-10-03,2009,"OGC Nice","Valenciennes FC","3-2",3,2,"1",1,5,1,"H"
"23800",2009-10-03,2009,"Paris Saint-Germain","AS Nancy","1-1",1,1,"1",1,2,0,"D"
"23801",2009-10-03,2009,"Stade Rennes","AJ Auxerre","0-1",0,1,"1",1,1,-1,"D"
"23802",2009-10-03,2009,"AS Saint-Etienne","Girondins Bordeaux","3-1",3,1,"1",1,4,2,"H"
"23803",2009-10-03,2009,"FC Sochaux","Le Mans UC 72","1-0",1,0,"1",1,1,1,"H"
"23804",2009-10-03,2009,"RC Lens","Olympique Lyon","0-2",0,2,"1",1,2,-2,"D"
"23805",2009-10-04,2009,"US Boulogne","Lille OSC","2-3",2,3,"1",1,5,-1,"D"
"23806",2009-10-04,2009,"Toulouse FC","FC Lorient","0-1",0,1,"1",1,1,-1,"D"
"23807",2009-10-04,2009,"Olympique Marseille","AS Monaco","1-2",1,2,"1",1,3,-1,"D"
"23808",2009-10-17,2009,"AJ Auxerre","Girondins Bordeaux","1-0",1,0,"1",1,1,1,"H"
"23809",2009-10-17,2009,"Le Mans UC 72","US Boulogne","1-1",1,1,"1",1,2,0,"D"
"23810",2009-10-17,2009,"Olympique Lyon","FC Sochaux","0-2",0,2,"1",1,2,-2,"D"
"23811",2009-10-17,2009,"Montpellier HSC","AS Saint-Etienne","2-1",2,1,"1",1,3,1,"H"
"23812",2009-10-17,2009,"AS Nancy","Olympique Marseille","0-3",0,3,"1",1,3,-3,"D"
"23813",2009-10-17,2009,"Valenciennes FC","Grenoble Foot 38","2-0",2,0,"1",1,2,2,"H"
"23814",2009-10-17,2009,"Lille OSC","Stade Rennes","0-0",0,0,"1",1,0,0,"D"
"23815",2009-10-18,2009,"FC Lorient","OGC Nice","4-1",4,1,"1",1,5,3,"H"
"23816",2009-10-18,2009,"AS Monaco","RC Lens","2-0",2,0,"1",1,2,2,"H"
"23817",2009-10-18,2009,"Toulouse FC","Paris Saint-Germain","1-0",1,0,"1",1,1,1,"H"
"23818",2009-10-24,2009,"Girondins Bordeaux","Le Mans UC 72","3-0",3,0,"1",1,3,3,"H"
"23819",2009-10-24,2009,"US Boulogne","AS Monaco","1-3",1,3,"1",1,4,-2,"D"
"23820",2009-10-24,2009,"Grenoble Foot 38","AS Nancy","1-2",1,2,"1",1,3,-1,"D"
"23821",2009-10-24,2009,"OGC Nice","Olympique Lyon","4-1",4,1,"1",1,5,3,"H"
"23822",2009-10-24,2009,"AS Saint-Etienne","Valenciennes FC","0-2",0,2,"1",1,2,-2,"D"
"23823",2009-10-24,2009,"FC Sochaux","FC Lorient","1-0",1,0,"1",1,1,1,"H"
"23824",2009-10-24,2009,"Stade Rennes","Montpellier HSC","3-0",3,0,"1",1,3,3,"H"
"23825",2009-10-25,2009,"AJ Auxerre","Lille OSC","3-2",3,2,"1",1,5,1,"H"
"23826",2009-10-25,2009,"RC Lens","Toulouse FC","0-2",0,2,"1",1,2,-2,"D"
"23827",2009-10-31,2009,"AJ Auxerre","Montpellier HSC","2-1",2,1,"1",1,3,1,"H"
"23828",2009-10-31,2009,"Girondins Bordeaux","AS Monaco","1-0",1,0,"1",1,1,1,"H"
"23829",2009-10-31,2009,"US Boulogne","AS Nancy","1-2",1,2,"1",1,3,-1,"D"
"23830",2009-10-31,2009,"Grenoble Foot 38","Lille OSC","0-2",0,2,"1",1,2,-2,"D"
"23831",2009-10-31,2009,"RC Lens","FC Lorient","1-1",1,1,"1",1,2,0,"D"
"23832",2009-10-31,2009,"Olympique Marseille","Toulouse FC","1-1",1,1,"1",1,2,0,"D"
"23833",2009-10-31,2009,"AS Saint-Etienne","Olympique Lyon","0-1",0,1,"1",1,1,-1,"D"
"23834",2009-11-01,2009,"OGC Nice","Le Mans UC 72","1-0",1,0,"1",1,1,1,"H"
"23835",2009-11-01,2009,"Stade Rennes","Valenciennes FC","0-3",0,3,"1",1,3,-3,"D"
"23836",2009-11-01,2009,"FC Sochaux","Paris Saint-Germain","1-4",1,4,"1",1,5,-3,"D"
"23837",2009-11-07,2009,"Le Mans UC 72","AJ Auxerre","0-1",0,1,"1",1,1,-1,"D"
"23838",2009-11-07,2009,"FC Lorient","US Boulogne","5-0",5,0,"1",1,5,5,"H"
"23839",2009-11-07,2009,"AS Monaco","Grenoble Foot 38","0-0",0,0,"1",1,0,0,"D"
"23840",2009-11-07,2009,"AS Nancy","AS Saint-Etienne","0-1",0,1,"1",1,1,-1,"D"
"23841",2009-11-07,2009,"Paris Saint-Germain","OGC Nice","0-1",0,1,"1",1,1,-1,"D"
"23842",2009-11-07,2009,"Valenciennes FC","Montpellier HSC","1-1",1,1,"1",1,2,0,"D"
"23843",2009-11-07,2009,"FC Sochaux","RC Lens","1-2",1,2,"1",1,3,-1,"D"
"23844",2009-11-08,2009,"Lille OSC","Girondins Bordeaux","2-0",2,0,"1",1,2,2,"H"
"23845",2009-11-08,2009,"Toulouse FC","Stade Rennes","3-2",3,2,"1",1,5,1,"H"
"23846",2009-11-08,2009,"Olympique Lyon","Olympique Marseille","5-5",5,5,"1",1,10,0,"D"
"23847",2009-11-20,2009,"Olympique Marseille","Paris Saint-Germain","1-0",1,0,"1",1,1,1,"H"
"23848",2009-11-21,2009,"Girondins Bordeaux","Valenciennes FC","0-1",0,1,"1",1,1,-1,"D"
"23849",2009-11-21,2009,"Grenoble Foot 38","Olympique Lyon","1-1",1,1,"1",1,2,0,"D"
"23850",2009-11-21,2009,"RC Lens","AS Nancy","2-1",2,1,"1",1,3,1,"H"
"23851",2009-11-21,2009,"Stade Rennes","Le Mans UC 72","2-1",2,1,"1",1,3,1,"H"
"23852",2009-11-21,2009,"AJ Auxerre","AS Monaco","2-0",2,0,"1",1,2,2,"H"
"23853",2009-11-22,2009,"OGC Nice","Toulouse FC","1-0",1,0,"1",1,1,1,"H"
"23854",2009-11-22,2009,"AS Saint-Etienne","FC Lorient","0-2",0,2,"1",1,2,-2,"D"
"23855",2009-11-22,2009,"Montpellier HSC","Lille OSC","2-0",2,0,"1",1,2,2,"H"
"23856",2009-11-28,2009,"Lille OSC","Valenciennes FC","4-0",4,0,"1",1,4,4,"H"
"23857",2009-11-28,2009,"FC Lorient","Grenoble Foot 38","2-2",2,2,"1",1,4,0,"D"
"23858",2009-11-28,2009,"Paris Saint-Germain","AJ Auxerre","1-0",1,0,"1",1,1,1,"H"
"23859",2009-11-28,2009,"FC Sochaux","OGC Nice","1-0",1,0,"1",1,1,1,"H"
"23860",2009-11-28,2009,"Toulouse FC","US Boulogne","1-0",1,0,"1",1,1,1,"H"
"23861",2009-11-28,2009,"RC Lens","Olympique Marseille","1-0",1,0,"1",1,1,1,"H"
"23862",2009-11-29,2009,"Le Mans UC 72","AS Saint-Etienne","1-1",1,1,"1",1,2,0,"D"
"23863",2009-11-29,2009,"AS Nancy","Girondins Bordeaux","0-3",0,3,"1",1,3,-3,"D"
"23864",2009-11-29,2009,"Olympique Lyon","Stade Rennes","1-1",1,1,"1",1,2,0,"D"
"23865",2009-12-02,2009,"US Boulogne","Paris Saint-Germain","2-5",2,5,"1",1,7,-3,"D"
"23866",2009-12-05,2009,"Montpellier HSC","Le Mans UC 72","2-1",2,1,"1",1,3,1,"H"
"23867",2009-12-05,2009,"OGC Nice","Olympique Marseille","1-3",1,3,"1",1,4,-2,"D"
"23868",2009-12-05,2009,"Stade Rennes","FC Lorient","1-0",1,0,"1",1,1,1,"H"
"23869",2009-12-05,2009,"AS Saint-Etienne","FC Sochaux","0-0",0,0,"1",1,0,0,"D"
"23870",2009-12-05,2009,"Valenciennes FC","AS Monaco","3-1",3,1,"1",1,4,2,"H"
"23871",2009-12-05,2009,"Girondins Bordeaux","Paris Saint-Germain","1-0",1,0,"1",1,1,1,"H"
"23872",2009-12-06,2009,"AJ Auxerre","AS Nancy","1-3",1,3,"1",1,4,-2,"D"
"23873",2009-12-06,2009,"US Boulogne","RC Lens","2-1",2,1,"1",1,3,1,"H"
"23874",2009-12-06,2009,"Grenoble Foot 38","Toulouse FC","1-0",1,0,"1",1,1,1,"H"
"23875",2009-12-06,2009,"Lille OSC","Olympique Lyon","4-3",4,3,"1",1,7,1,"H"
"23876",2009-12-10,2009,"Lille OSC","AS Saint-Etienne","4-0",4,0,"1",1,4,4,"H"
"23877",2009-12-10,2009,"Toulouse FC","FC Sochaux","2-0",2,0,"1",1,2,2,"H"
"23878",2009-12-12,2009,"Le Mans UC 72","Valenciennes FC","2-1",2,1,"1",1,3,1,"H"
"23879",2009-12-12,2009,"RC Lens","OGC Nice","2-0",2,0,"1",1,2,2,"H"
"23880",2009-12-12,2009,"Olympique Marseille","US Boulogne","2-0",2,0,"1",1,2,2,"H"
"23881",2009-12-12,2009,"AS Nancy","Stade Rennes","1-2",1,2,"1",1,3,-1,"D"
"23882",2009-12-12,2009,"FC Lorient","AJ Auxerre","0-0",0,0,"1",1,0,0,"D"
"23883",2009-12-13,2009,"AS Monaco","Lille OSC","0-4",0,4,"1",1,4,-4,"D"
"23884",2009-12-13,2009,"Paris Saint-Germain","AS Saint-Etienne","3-0",3,0,"1",1,3,3,"H"
"23885",2009-12-13,2009,"FC Sochaux","Grenoble Foot 38","1-0",1,0,"1",1,1,1,"H"
"23886",2009-12-13,2009,"Toulouse FC","Montpellier HSC","0-1",0,1,"1",1,1,-1,"D"
"23887",2009-12-13,2009,"Olympique Lyon","Girondins Bordeaux","0-1",0,1,"1",1,1,-1,"D"
"23888",2009-12-15,2009,"Valenciennes FC","AJ Auxerre","0-0",0,0,"1",1,0,0,"D"
"23889",2009-12-16,2009,"Le Mans UC 72","Grenoble Foot 38","1-0",1,0,"1",1,1,1,"H"
"23890",2009-12-16,2009,"FC Lorient","Olympique Marseille","1-2",1,2,"1",1,3,-1,"D"
"23891",2009-12-16,2009,"Olympique Lyon","US Boulogne","2-0",2,0,"1",1,2,2,"H"
"23892",2009-12-16,2009,"AS Monaco","Stade Rennes","1-0",1,0,"1",1,1,1,"H"
"23893",2009-12-16,2009,"Montpellier HSC","Girondins Bordeaux","0-1",0,1,"1",1,1,-1,"D"
"23894",2009-12-16,2009,"AS Nancy","OGC Nice","2-0",2,0,"1",1,2,2,"H"
"23895",2009-12-16,2009,"Paris Saint-Germain","RC Lens","1-1",1,1,"1",1,2,0,"D"
"23896",2009-12-19,2009,"Girondins Bordeaux","FC Lorient","4-1",4,1,"1",1,5,3,"H"
"23897",2009-12-19,2009,"Grenoble Foot 38","OGC Nice","1-1",1,1,"1",1,2,0,"D"
"23898",2009-12-19,2009,"Montpellier HSC","AS Nancy","0-2",0,2,"1",1,2,-2,"D"
"23899",2009-12-19,2009,"Stade Rennes","Paris Saint-Germain","1-0",1,0,"1",1,1,1,"H"
"23900",2009-12-19,2009,"Valenciennes FC","RC Lens","0-0",0,0,"1",1,0,0,"D"
"23901",2009-12-19,2009,"AS Saint-Etienne","Olympique Marseille","0-0",0,0,"1",1,0,0,"D"
"23902",2009-12-20,2009,"AJ Auxerre","Toulouse FC","1-1",1,1,"1",1,2,0,"D"
"23903",2009-12-20,2009,"Lille OSC","Le Mans UC 72","3-0",3,0,"1",1,3,3,"H"
"23904",2009-12-20,2009,"AS Monaco","Olympique Lyon","1-1",1,1,"1",1,2,0,"D"
"23905",2009-12-22,2009,"RC Lens","AS Saint-Etienne","1-0",1,0,"1",1,1,1,"H"
"23906",2009-12-23,2009,"Le Mans UC 72","AS Monaco","1-1",1,1,"1",1,2,0,"D"
"23907",2009-12-23,2009,"FC Lorient","Valenciennes FC","3-2",3,2,"1",1,5,1,"H"
"23908",2009-12-23,2009,"Olympique Lyon","Montpellier HSC","1-2",1,2,"1",1,3,-1,"D"
"23909",2009-12-23,2009,"Olympique Marseille","AJ Auxerre","0-2",0,2,"1",1,2,-2,"D"
"23910",2009-12-23,2009,"AS Nancy","Lille OSC","0-4",0,4,"1",1,4,-4,"D"
"23911",2009-12-23,2009,"OGC Nice","US Boulogne","2-2",2,2,"1",1,4,0,"D"
"23912",2009-12-23,2009,"Paris Saint-Germain","Grenoble Foot 38","4-0",4,0,"1",1,4,4,"H"
"23913",2009-12-23,2009,"FC Sochaux","Stade Rennes","2-0",2,0,"1",1,2,2,"H"
"23914",2009-12-23,2009,"Toulouse FC","Girondins Bordeaux","1-2",1,2,"1",1,3,-1,"D"
"23915",2010-01-13,2009,"AS Monaco","Montpellier HSC","4-0",4,0,"1",1,4,4,"H"
"23916",2010-01-13,2009,"US Boulogne","FC Sochaux","0-0",0,0,"1",1,0,0,"D"
"23917",2010-01-16,2009,"AJ Auxerre","US Boulogne","0-0",0,0,"1",1,0,0,"D"
"23918",2010-01-16,2009,"Stade Rennes","RC Lens","1-1",1,1,"1",1,2,0,"D"
"23919",2010-01-16,2009,"Le Mans UC 72","FC Lorient","0-3",0,3,"1",1,3,-3,"D"
"23920",2010-01-16,2009,"AS Nancy","Olympique Lyon","0-2",0,2,"1",1,2,-2,"D"
"23921",2010-01-16,2009,"Montpellier HSC","OGC Nice","1-0",1,0,"1",1,1,1,"H"
"23922",2010-01-16,2009,"Lille OSC","Paris Saint-Germain","3-1",3,1,"1",1,4,2,"H"
"23923",2010-01-16,2009,"Grenoble Foot 38","AS Saint-Etienne","1-2",1,2,"1",1,3,-1,"D"
"23924",2010-01-16,2009,"AS Monaco","FC Sochaux","2-0",2,0,"1",1,2,2,"H"
"23925",2010-01-16,2009,"Valenciennes FC","Toulouse FC","1-3",1,3,"1",1,4,-2,"D"
"23926",2010-01-17,2009,"Girondins Bordeaux","Olympique Marseille","1-1",1,1,"1",1,2,0,"D"
"23927",2010-01-19,2009,"AS Saint-Etienne","Stade Rennes","0-0",0,0,"1",1,0,0,"D"
"23928",2010-01-20,2009,"OGC Nice","AJ Auxerre","0-1",0,1,"1",1,1,-1,"D"
"23929",2010-01-20,2009,"Grenoble Foot 38","Girondins Bordeaux","1-3",1,3,"1",1,4,-2,"D"
"23930",2010-01-20,2009,"Olympique Marseille","Le Mans UC 72","2-1",2,1,"1",1,3,1,"H"
"23931",2010-01-20,2009,"FC Sochaux","Lille OSC","2-1",2,1,"1",1,3,1,"H"
"23932",2010-01-20,2009,"FC Lorient","Olympique Lyon","1-3",1,3,"1",1,4,-2,"D"
"23933",2010-01-20,2009,"Paris Saint-Germain","AS Monaco","0-1",0,1,"1",1,1,-1,"D"
"23934",2010-01-20,2009,"RC Lens","Montpellier HSC","0-1",0,1,"1",1,1,-1,"D"
"23935",2010-01-20,2009,"Toulouse FC","AS Nancy","0-0",0,0,"1",1,0,0,"D"
"23936",2010-01-20,2009,"US Boulogne","Valenciennes FC","0-2",0,2,"1",1,2,-2,"D"
"23937",2010-01-30,2009,"Girondins Bordeaux","US Boulogne","0-0",0,0,"1",1,0,0,"D"
"23938",2010-01-30,2009,"Stade Rennes","Grenoble Foot 38","4-0",4,0,"1",1,4,4,"H"
"23939",2010-01-30,2009,"Lille OSC","RC Lens","1-0",1,0,"1",1,1,1,"H"
"23940",2010-01-30,2009,"AS Nancy","FC Lorient","1-0",1,0,"1",1,1,1,"H"
"23941",2010-01-30,2009,"AS Monaco","OGC Nice","3-2",3,2,"1",1,5,1,"H"
"23942",2010-01-30,2009,"Le Mans UC 72","Toulouse FC","1-3",1,3,"1",1,4,-2,"D"
"23943",2010-01-30,2009,"Montpellier HSC","Olympique Marseille","2-0",2,0,"1",1,2,2,"H"
"23944",2010-01-31,2009,"AJ Auxerre","AS Saint-Etienne","1-0",1,0,"1",1,1,1,"H"
"23945",2010-01-31,2009,"Valenciennes FC","FC Sochaux","1-1",1,1,"1",1,2,0,"D"
"23946",2010-01-31,2009,"Olympique Lyon","Paris Saint-Germain","2-1",2,1,"1",1,3,1,"H"
"23947",2010-02-06,2009,"US Boulogne","Montpellier HSC","0-2",0,2,"1",1,2,-2,"D"
"23948",2010-02-06,2009,"FC Sochaux","AS Nancy","1-1",1,1,"1",1,2,0,"D"
"23949",2010-02-06,2009,"Grenoble Foot 38","AJ Auxerre","5-0",5,0,"1",1,5,5,"H"
"23950",2010-02-06,2009,"RC Lens","Le Mans UC 72","2-1",2,1,"1",1,3,1,"H"
"23951",2010-02-06,2009,"OGC Nice","Lille OSC","1-1",1,1,"1",1,2,0,"D"
"23952",2010-02-06,2009,"Paris Saint-Germain","FC Lorient","0-3",0,3,"1",1,3,-3,"D"
"23953",2010-02-06,2009,"Stade Rennes","Girondins Bordeaux","4-2",4,2,"1",1,6,2,"H"
"23954",2010-02-07,2009,"Toulouse FC","Olympique Lyon","0-0",0,0,"1",1,0,0,"D"
"23955",2010-02-07,2009,"AS Saint-Etienne","AS Monaco","3-0",3,0,"1",1,3,3,"H"
"23956",2010-02-07,2009,"Olympique Marseille","Valenciennes FC","5-1",5,1,"1",1,6,4,"H"
"23957",2010-02-13,2009,"Lille OSC","US Boulogne","3-1",3,1,"1",1,4,2,"H"
"23958",2010-02-13,2009,"Montpellier HSC","Grenoble Foot 38","1-0",1,0,"1",1,1,1,"H"
"23959",2010-02-13,2009,"AS Monaco","Olympique Marseille","1-2",1,2,"1",1,3,-1,"D"
"23960",2010-02-13,2009,"Valenciennes FC","OGC Nice","2-1",2,1,"1",1,3,1,"H"
"23961",2010-02-13,2009,"AS Nancy","Paris Saint-Germain","0-0",0,0,"1",1,0,0,"D"
"23962",2010-02-13,2009,"Le Mans UC 72","FC Sochaux","0-0",0,0,"1",1,0,0,"D"
"23963",2010-02-13,2009,"Olympique Lyon","RC Lens","1-0",1,0,"1",1,1,1,"H"
"23964",2010-02-14,2009,"AJ Auxerre","Stade Rennes","1-0",1,0,"1",1,1,1,"H"
"23965",2010-02-14,2009,"FC Lorient","Toulouse FC","1-1",1,1,"1",1,2,0,"D"
"23966",2010-02-14,2009,"Girondins Bordeaux","AS Saint-Etienne","3-1",3,1,"1",1,4,2,"H"
"23967",2010-02-20,2009,"US Boulogne","Le Mans UC 72","1-3",1,3,"1",1,4,-2,"D"
"23968",2010-02-20,2009,"OGC Nice","FC Lorient","1-0",1,0,"1",1,1,1,"H"
"23969",2010-02-20,2009,"RC Lens","AS Monaco","3-0",3,0,"1",1,3,3,"H"
"23970",2010-02-20,2009,"AS Saint-Etienne","Montpellier HSC","1-0",1,0,"1",1,1,1,"H"
"23971",2010-02-20,2009,"Grenoble Foot 38","Valenciennes FC","0-1",0,1,"1",1,1,-1,"D"
"23972",2010-02-20,2009,"Paris Saint-Germain","Toulouse FC","1-0",1,0,"1",1,1,1,"H"
"23973",2010-02-21,2009,"FC Sochaux","Olympique Lyon","0-4",0,4,"1",1,4,-4,"D"
"23974",2010-02-21,2009,"Olympique Marseille","AS Nancy","3-1",3,1,"1",1,4,2,"H"
"23975",2010-02-21,2009,"Stade Rennes","Lille OSC","1-2",1,2,"1",1,3,-1,"D"
"23976",2010-02-27,2009,"AS Monaco","US Boulogne","1-0",1,0,"1",1,1,1,"H"
"23977",2010-02-27,2009,"AS Nancy","Grenoble Foot 38","0-2",0,2,"1",1,2,-2,"D"
"23978",2010-02-27,2009,"Toulouse FC","RC Lens","1-0",1,0,"1",1,1,1,"H"
"23979",2010-02-27,2009,"Olympique Lyon","OGC Nice","2-0",2,0,"1",1,2,2,"H"
"23980",2010-02-27,2009,"Valenciennes FC","AS Saint-Etienne","1-0",1,0,"1",1,1,1,"H"
"23981",2010-02-27,2009,"FC Lorient","FC Sochaux","1-0",1,0,"1",1,1,1,"H"
"23982",2010-02-27,2009,"Montpellier HSC","Stade Rennes","3-1",3,1,"1",1,4,2,"H"
"23983",2010-02-28,2009,"Lille OSC","AJ Auxerre","1-2",1,2,"1",1,3,-1,"D"
"23984",2010-02-28,2009,"Paris Saint-Germain","Olympique Marseille","0-3",0,3,"1",1,3,-3,"D"
"23985",2010-03-06,2009,"US Boulogne","Olympique Lyon","0-0",0,0,"1",1,0,0,"D"
"23986",2010-03-06,2009,"Stade Rennes","AS Monaco","1-0",1,0,"1",1,1,1,"H"
"23987",2010-03-06,2009,"OGC Nice","AS Nancy","2-3",2,3,"1",1,5,-1,"D"
"23988",2010-03-06,2009,"RC Lens","Paris Saint-Germain","1-1",1,1,"1",1,2,0,"D"
"23989",2010-03-06,2009,"FC Sochaux","Toulouse FC","1-0",1,0,"1",1,1,1,"H"
"23990",2010-03-06,2009,"AJ Auxerre","Valenciennes FC","1-0",1,0,"1",1,1,1,"H"
"23991",2010-03-06,2009,"AS Saint-Etienne","Lille OSC","1-1",1,1,"1",1,2,0,"D"
"23992",2010-03-07,2009,"Grenoble Foot 38","Le Mans UC 72","1-1",1,1,"1",1,2,0,"D"
"23993",2010-03-07,2009,"Olympique Marseille","FC Lorient","1-1",1,1,"1",1,2,0,"D"
"23994",2010-03-07,2009,"Girondins Bordeaux","Montpellier HSC","1-1",1,1,"1",1,2,0,"D"
"23995",2010-03-10,2009,"Girondins Bordeaux","AJ Auxerre","1-2",1,2,"1",1,3,-1,"D"
"23996",2010-03-13,2009,"Montpellier HSC","AJ Auxerre","1-1",1,1,"1",1,2,0,"D"
"23997",2010-03-13,2009,"AS Monaco","Girondins Bordeaux","0-0",0,0,"1",1,0,0,"D"
"23998",2010-03-13,2009,"AS Nancy","US Boulogne","1-3",1,3,"1",1,4,-2,"D"
"23999",2010-03-13,2009,"FC Lorient","RC Lens","1-0",1,0,"1",1,1,1,"H"
"24000",2010-03-13,2009,"Le Mans UC 72","OGC Nice","0-1",0,1,"1",1,1,-1,"D"
"24001",2010-03-13,2009,"Paris Saint-Germain","FC Sochaux","4-1",4,1,"1",1,5,3,"H"
"24002",2010-03-13,2009,"Olympique Lyon","AS Saint-Etienne","1-1",1,1,"1",1,2,0,"D"
"24003",2010-03-14,2009,"Lille OSC","Grenoble Foot 38","1-0",1,0,"1",1,1,1,"H"
"24004",2010-03-14,2009,"Valenciennes FC","Stade Rennes","0-2",0,2,"1",1,2,-2,"D"
"24005",2010-03-14,2009,"Toulouse FC","Olympique Marseille","1-1",1,1,"1",1,2,0,"D"
"24006",2010-03-20,2009,"AJ Auxerre","Le Mans UC 72","2-1",2,1,"1",1,3,1,"H"
"24007",2010-03-20,2009,"US Boulogne","FC Lorient","2-0",2,0,"1",1,2,2,"H"
"24008",2010-03-20,2009,"Grenoble Foot 38","AS Monaco","0-0",0,0,"1",1,0,0,"D"
"24009",2010-03-20,2009,"AS Saint-Etienne","AS Nancy","0-0",0,0,"1",1,0,0,"D"
"24010",2010-03-20,2009,"OGC Nice","Paris Saint-Germain","1-0",1,0,"1",1,1,1,"H"
"24011",2010-03-20,2009,"Stade Rennes","Toulouse FC","4-1",4,1,"1",1,5,3,"H"
"24012",2010-03-20,2009,"RC Lens","FC Sochaux","0-0",0,0,"1",1,0,0,"D"
"24013",2010-03-21,2009,"Girondins Bordeaux","Lille OSC","3-1",3,1,"1",1,4,2,"H"
"24014",2010-03-21,2009,"Montpellier HSC","Valenciennes FC","2-1",2,1,"1",1,3,1,"H"
"24015",2010-03-21,2009,"Olympique Marseille","Olympique Lyon","2-1",2,1,"1",1,3,1,"H"
"24016",2010-03-27,2009,"Olympique Lyon","Grenoble Foot 38","2-0",2,0,"1",1,2,2,"H"
"24017",2010-03-28,2009,"Paris Saint-Germain","US Boulogne","3-0",3,0,"1",1,3,3,"H"
"24018",2010-03-28,2009,"AS Nancy","RC Lens","5-1",5,1,"1",1,6,4,"H"
"24019",2010-03-28,2009,"Toulouse FC","OGC Nice","0-2",0,2,"1",1,2,-2,"D"
"24020",2010-03-28,2009,"Le Mans UC 72","Stade Rennes","1-3",1,3,"1",1,4,-2,"D"
"24021",2010-03-28,2009,"FC Lorient","AS Saint-Etienne","4-0",4,0,"1",1,4,4,"H"
"24022",2010-03-28,2009,"Lille OSC","Montpellier HSC","4-1",4,1,"1",1,5,3,"H"
"24023",2010-03-29,2009,"AS Monaco","AJ Auxerre","0-0",0,0,"1",1,0,0,"D"
"24024",2010-04-03,2009,"AS Saint-Etienne","Le Mans UC 72","2-0",2,0,"1",1,2,2,"H"
"24025",2010-04-03,2009,"Valenciennes FC","Lille OSC","1-0",1,0,"1",1,1,1,"H"
"24026",2010-04-03,2009,"Grenoble Foot 38","FC Lorient","1-2",1,2,"1",1,3,-1,"D"
"24027",2010-04-03,2009,"Stade Rennes","Olympique Lyon","1-2",1,2,"1",1,3,-1,"D"
"24028",2010-04-03,2009,"Girondins Bordeaux","AS Nancy","1-2",1,2,"1",1,3,-1,"D"
"24029",2010-04-03,2009,"OGC Nice","FC Sochaux","0-0",0,0,"1",1,0,0,"D"
"24030",2010-04-03,2009,"Montpellier HSC","AS Monaco","0-0",0,0,"1",1,0,0,"D"
"24031",2010-04-04,2009,"Olympique Marseille","RC Lens","1-0",1,0,"1",1,1,1,"H"
"24032",2010-04-04,2009,"US Boulogne","Toulouse FC","1-1",1,1,"1",1,2,0,"D"
"24033",2010-04-04,2009,"AJ Auxerre","Paris Saint-Germain","1-1",1,1,"1",1,2,0,"D"
"24034",2010-04-07,2009,"Olympique Marseille","FC Sochaux","3-0",3,0,"1",1,3,3,"H"
"24035",2010-04-10,2009,"RC Lens","US Boulogne","3-0",3,0,"1",1,3,3,"H"
"24036",2010-04-10,2009,"Toulouse FC","Grenoble Foot 38","4-0",4,0,"1",1,4,4,"H"
"24037",2010-04-10,2009,"Le Mans UC 72","Montpellier HSC","2-2",2,2,"1",1,4,0,"D"
"24038",2010-04-10,2009,"FC Lorient","Stade Rennes","1-1",1,1,"1",1,2,0,"D"
"24039",2010-04-10,2009,"FC Sochaux","AS Saint-Etienne","0-2",0,2,"1",1,2,-2,"D"
"24040",2010-04-10,2009,"AS Monaco","Valenciennes FC","2-1",2,1,"1",1,3,1,"H"
"24041",2010-04-10,2009,"Paris Saint-Germain","Girondins Bordeaux","3-1",3,1,"1",1,4,2,"H"
"24042",2010-04-11,2009,"AS Nancy","AJ Auxerre","0-1",0,1,"1",1,1,-1,"D"
"24043",2010-04-11,2009,"Olympique Lyon","Lille OSC","1-1",1,1,"1",1,2,0,"D"
"24044",2010-04-11,2009,"Olympique Marseille","OGC Nice","4-1",4,1,"1",1,5,3,"H"
"24045",2010-04-14,2009,"Le Mans UC 72","Girondins Bordeaux","2-1",2,1,"1",1,3,1,"H"
"24046",2010-04-14,2009,"FC Sochaux","Olympique Marseille","0-1",0,1,"1",1,1,-1,"D"
"24047",2010-04-17,2009,"Valenciennes FC","Le Mans UC 72","0-1",0,1,"1",1,1,-1,"D"
"24048",2010-04-17,2009,"OGC Nice","RC Lens","0-0",0,0,"1",1,0,0,"D"
"24049",2010-04-17,2009,"AJ Auxerre","FC Lorient","4-1",4,1,"1",1,5,3,"H"
"24050",2010-04-17,2009,"US Boulogne","Olympique Marseille","1-2",1,2,"1",1,3,-1,"D"
"24051",2010-04-17,2009,"Stade Rennes","AS Nancy","0-0",0,0,"1",1,0,0,"D"
"24052",2010-04-17,2009,"Grenoble Foot 38","FC Sochaux","2-2",2,2,"1",1,4,0,"D"
"24053",2010-04-17,2009,"Girondins Bordeaux","Olympique Lyon","2-2",2,2,"1",1,4,0,"D"
"24054",2010-04-18,2009,"Lille OSC","AS Monaco","4-0",4,0,"1",1,4,4,"H"
"24055",2010-04-18,2009,"Montpellier HSC","Toulouse FC","1-1",1,1,"1",1,2,0,"D"
"24056",2010-04-18,2009,"AS Saint-Etienne","Paris Saint-Germain","0-0",0,0,"1",1,0,0,"D"
"24057",2010-04-24,2009,"FC Lorient","Girondins Bordeaux","1-0",1,0,"1",1,1,1,"H"
"24058",2010-04-24,2009,"FC Sochaux","US Boulogne","0-3",0,3,"1",1,3,-3,"D"
"24059",2010-04-24,2009,"OGC Nice","Grenoble Foot 38","2-1",2,1,"1",1,3,1,"H"
"24060",2010-04-24,2009,"Le Mans UC 72","Lille OSC","1-2",1,2,"1",1,3,-1,"D"
"24061",2010-04-24,2009,"AS Nancy","Montpellier HSC","0-0",0,0,"1",1,0,0,"D"
"24062",2010-04-24,2009,"Paris Saint-Germain","Stade Rennes","1-1",1,1,"1",1,2,0,"D"
"24063",2010-04-25,2009,"Toulouse FC","AJ Auxerre","0-3",0,3,"1",1,3,-3,"D"
"24064",2010-04-25,2009,"RC Lens","Valenciennes FC","1-1",1,1,"1",1,2,0,"D"
"24065",2010-04-25,2009,"Olympique Marseille","AS Saint-Etienne","1-0",1,0,"1",1,1,1,"H"
"24066",2010-04-27,2009,"AS Monaco","Le Mans UC 72","1-1",1,1,"1",1,2,0,"D"
"24067",2010-04-27,2009,"Grenoble Foot 38","Paris Saint-Germain","4-0",4,0,"1",1,4,4,"H"
"24068",2010-04-28,2009,"Valenciennes FC","Girondins Bordeaux","2-0",2,0,"1",1,2,2,"H"
"24069",2010-04-30,2009,"AJ Auxerre","Olympique Marseille","0-0",0,0,"1",1,0,0,"D"
"24070",2010-05-02,2009,"AS Saint-Etienne","RC Lens","1-4",1,4,"1",1,5,-3,"D"
"24071",2010-05-02,2009,"Valenciennes FC","FC Lorient","0-0",0,0,"1",1,0,0,"D"
"24072",2010-05-02,2009,"Lille OSC","AS Nancy","3-1",3,1,"1",1,4,2,"H"
"24073",2010-05-02,2009,"US Boulogne","OGC Nice","3-3",3,3,"1",1,6,0,"D"
"24074",2010-05-02,2009,"Stade Rennes","FC Sochaux","1-2",1,2,"1",1,3,-1,"D"
"24075",2010-05-02,2009,"Girondins Bordeaux","Toulouse FC","1-0",1,0,"1",1,1,1,"H"
"24076",2010-05-02,2009,"Montpellier HSC","Olympique Lyon","0-1",0,1,"1",1,1,-1,"D"
"24077",2010-05-05,2009,"Olympique Lyon","AJ Auxerre","2-1",2,1,"1",1,3,1,"H"
"24078",2010-05-05,2009,"OGC Nice","Girondins Bordeaux","1-1",1,1,"1",1,2,0,"D"
"24079",2010-05-05,2009,"RC Lens","Grenoble Foot 38","1-1",1,1,"1",1,2,0,"D"
"24080",2010-05-05,2009,"AS Nancy","Le Mans UC 72","3-2",3,2,"1",1,5,1,"H"
"24081",2010-05-05,2009,"Toulouse FC","Lille OSC","0-2",0,2,"1",1,2,-2,"D"
"24082",2010-05-05,2009,"FC Lorient","AS Monaco","2-2",2,2,"1",1,4,0,"D"
"24083",2010-05-05,2009,"FC Sochaux","Montpellier HSC","0-1",0,1,"1",1,1,-1,"D"
"24084",2010-05-05,2009,"US Boulogne","AS Saint-Etienne","0-1",0,1,"1",1,1,-1,"D"
"24085",2010-05-05,2009,"Paris Saint-Germain","Valenciennes FC","2-2",2,2,"1",1,4,0,"D"
"24086",2010-05-05,2009,"Olympique Marseille","Stade Rennes","3-1",3,1,"1",1,4,2,"H"
"24087",2010-05-08,2009,"Grenoble Foot 38","US Boulogne","2-0",2,0,"1",1,2,2,"H"
"24088",2010-05-08,2009,"AJ Auxerre","RC Lens","0-0",0,0,"1",1,0,0,"D"
"24089",2010-05-08,2009,"Montpellier HSC","FC Lorient","2-1",2,1,"1",1,3,1,"H"
"24090",2010-05-08,2009,"Valenciennes FC","Olympique Lyon","2-2",2,2,"1",1,4,0,"D"
"24091",2010-05-08,2009,"Lille OSC","Olympique Marseille","3-2",3,2,"1",1,5,1,"H"
"24092",2010-05-08,2009,"AS Monaco","AS Nancy","2-1",2,1,"1",1,3,1,"H"
"24093",2010-05-08,2009,"Stade Rennes","OGC Nice","2-2",2,2,"1",1,4,0,"D"
"24094",2010-05-08,2009,"Le Mans UC 72","Paris Saint-Germain","1-0",1,0,"1",1,1,1,"H"
"24095",2010-05-08,2009,"Girondins Bordeaux","FC Sochaux","2-0",2,0,"1",1,2,2,"H"
"24096",2010-05-08,2009,"AS Saint-Etienne","Toulouse FC","0-1",0,1,"1",1,1,-1,"D"
"24097",2010-05-12,2009,"Olympique Lyon","AS Monaco","3-0",3,0,"1",1,3,3,"H"
"24098",2010-05-15,2009,"FC Sochaux","AJ Auxerre","1-2",1,2,"1",1,3,-1,"D"
"24099",2010-05-15,2009,"RC Lens","Girondins Bordeaux","4-3",4,3,"1",1,7,1,"H"
"24100",2010-05-15,2009,"Olympique Marseille","Grenoble Foot 38","2-0",2,0,"1",1,2,2,"H"
"24101",2010-05-15,2009,"Olympique Lyon","Le Mans UC 72","2-0",2,0,"1",1,2,2,"H"
"24102",2010-05-15,2009,"Toulouse FC","AS Monaco","0-0",0,0,"1",1,0,0,"D"
"24103",2010-05-15,2009,"Paris Saint-Germain","Montpellier HSC","1-3",1,3,"1",1,4,-2,"D"
"24104",2010-05-15,2009,"US Boulogne","Stade Rennes","1-0",1,0,"1",1,1,1,"H"
"24105",2010-05-15,2009,"OGC Nice","AS Saint-Etienne","1-1",1,1,"1",1,2,0,"D"
"24106",2010-05-15,2009,"AS Nancy","Valenciennes FC","1-1",1,1,"1",1,2,0,"D"
"24107",2010-05-15,2009,"FC Lorient","Lille OSC","2-1",2,1,"1",1,3,1,"H"
"24108",2010-08-07,2010,"AJ Auxerre","FC Lorient","2-2",2,2,"1",1,4,0,"D"
"24109",2010-08-07,2010,"RC Lens","AS Nancy","1-2",1,2,"1",1,3,-1,"D"
"24110",2010-08-07,2010,"Olympique Lyon","AS Monaco","0-0",0,0,"1",1,0,0,"D"
"24111",2010-08-07,2010,"Olympique Marseille","SM Caen","1-2",1,2,"1",1,3,-1,"D"
"24112",2010-08-07,2010,"OGC Nice","Valenciennes FC","0-0",0,0,"1",1,0,0,"D"
"24113",2010-08-07,2010,"Paris Saint-Germain","AS Saint-Etienne","3-1",3,1,"1",1,4,2,"H"
"24114",2010-08-07,2010,"Stade Rennes","Lille OSC","1-1",1,1,"1",1,2,0,"D"
"24115",2010-08-07,2010,"FC Sochaux","AC Arles-Avignon","2-1",2,1,"1",1,3,1,"H"
"24116",2010-08-07,2010,"Toulouse FC","Stade Brest","2-0",2,0,"1",1,2,2,"H"
"24117",2010-08-08,2010,"Montpellier HSC","Girondins Bordeaux","1-0",1,0,"1",1,1,1,"H"
"24118",2010-08-14,2010,"Stade Brest","AJ Auxerre","1-1",1,1,"1",1,2,0,"D"
"24119",2010-08-14,2010,"FC Lorient","OGC Nice","1-2",1,2,"1",1,3,-1,"D"
"24120",2010-08-14,2010,"AS Nancy","Stade Rennes","0-3",0,3,"1",1,3,-3,"D"
"24121",2010-08-14,2010,"AS Saint-Etienne","FC Sochaux","3-2",3,2,"1",1,5,1,"H"
"24122",2010-08-14,2010,"Valenciennes FC","Olympique Marseille","3-2",3,2,"1",1,5,1,"H"
"24123",2010-08-14,2010,"AC Arles-Avignon","RC Lens","0-1",0,1,"1",1,1,-1,"D"
"24124",2010-08-15,2010,"Girondins Bordeaux","Toulouse FC","1-2",1,2,"1",1,3,-1,"D"
"24125",2010-08-15,2010,"SM Caen","Olympique Lyon","3-2",3,2,"1",1,5,1,"H"
"24126",2010-08-15,2010,"Lille OSC","Paris Saint-Germain","0-0",0,0,"1",1,0,0,"D"
"24127",2010-08-17,2010,"AS Monaco","Montpellier HSC","0-0",0,0,"1",1,0,0,"D"
"24128",2010-08-21,2010,"RC Lens","AS Monaco","2-2",2,2,"1",1,4,0,"D"
"24129",2010-08-21,2010,"Olympique Lyon","Stade Brest","1-0",1,0,"1",1,1,1,"H"
"24130",2010-08-21,2010,"Olympique Marseille","FC Lorient","2-0",2,0,"1",1,2,2,"H"
"24131",2010-08-21,2010,"OGC Nice","AS Nancy","1-1",1,1,"1",1,2,0,"D"
"24132",2010-08-21,2010,"Stade Rennes","AS Saint-Etienne","0-0",0,0,"1",1,0,0,"D"
"24133",2010-08-21,2010,"Toulouse FC","AC Arles-Avignon","2-1",2,1,"1",1,3,1,"H"
"24134",2010-08-21,2010,"AJ Auxerre","Valenciennes FC","1-1",1,1,"1",1,2,0,"D"
"24135",2010-08-22,2010,"Montpellier HSC","SM Caen","0-0",0,0,"1",1,0,0,"D"
"24136",2010-08-22,2010,"FC Sochaux","Lille OSC","0-0",0,0,"1",1,0,0,"D"
"24137",2010-08-22,2010,"Paris Saint-Germain","Girondins Bordeaux","1-2",1,2,"1",1,3,-1,"D"
"24138",2010-08-28,2010,"AC Arles-Avignon","Stade Rennes","0-1",0,1,"1",1,1,-1,"D"
"24139",2010-08-28,2010,"FC Lorient","Olympique Lyon","2-0",2,0,"1",1,2,2,"H"
"24140",2010-08-28,2010,"AS Nancy","Toulouse FC","0-2",0,2,"1",1,2,-2,"D"
"24141",2010-08-28,2010,"AS Saint-Etienne","RC Lens","3-1",3,1,"1",1,4,2,"H"
"24142",2010-08-28,2010,"Valenciennes FC","Montpellier HSC","0-1",0,1,"1",1,1,-1,"D"
"24143",2010-08-28,2010,"SM Caen","Stade Brest","0-2",0,2,"1",1,2,-2,"D"
"24144",2010-08-29,2010,"Lille OSC","OGC Nice","1-1",1,1,"1",1,2,0,"D"
"24145",2010-08-29,2010,"AS Monaco","AJ Auxerre","2-0",2,0,"1",1,2,2,"H"
"24146",2010-08-29,2010,"FC Sochaux","Paris Saint-Germain","3-1",3,1,"1",1,4,2,"H"
"24147",2010-08-29,2010,"Girondins Bordeaux","Olympique Marseille","1-1",1,1,"1",1,2,0,"D"
"24148",2010-09-11,2010,"AJ Auxerre","SM Caen","1-1",1,1,"1",1,2,0,"D"
"24149",2010-09-11,2010,"Olympique Lyon","Valenciennes FC","1-1",1,1,"1",1,2,0,"D"
"24150",2010-09-11,2010,"Montpellier HSC","AS Nancy","1-2",1,2,"1",1,3,-1,"D"
"24151",2010-09-11,2010,"Paris Saint-Germain","AC Arles-Avignon","4-0",4,0,"1",1,4,4,"H"
"24152",2010-09-11,2010,"Stade Rennes","FC Sochaux","2-1",2,1,"1",1,3,1,"H"
"24153",2010-09-11,2010,"Toulouse FC","AS Saint-Etienne","0-1",0,1,"1",1,1,-1,"D"
"24154",2010-09-11,2010,"RC Lens","Lille OSC","1-4",1,4,"1",1,5,-3,"D"
"24155",2010-09-12,2010,"Stade Brest","FC Lorient","0-0",0,0,"1",1,0,0,"D"
"24156",2010-09-12,2010,"OGC Nice","Girondins Bordeaux","2-1",2,1,"1",1,3,1,"H"
"24157",2010-09-12,2010,"Olympique Marseille","AS Monaco","2-2",2,2,"1",1,4,0,"D"
"24158",2010-09-18,2010,"FC Lorient","SM Caen","0-1",0,1,"1",1,1,-1,"D"
"24159",2010-09-18,2010,"AS Monaco","Toulouse FC","0-0",0,0,"1",1,0,0,"D"
"24160",2010-09-18,2010,"AS Nancy","Stade Brest","0-2",0,2,"1",1,2,-2,"D"
"24161",2010-09-18,2010,"AS Saint-Etienne","Montpellier HSC","3-0",3,0,"1",1,3,3,"H"
"24162",2010-09-18,2010,"FC Sochaux","OGC Nice","4-0",4,0,"1",1,4,4,"H"
"24163",2010-09-18,2010,"Valenciennes FC","RC Lens","1-1",1,1,"1",1,2,0,"D"
"24164",2010-09-18,2010,"AC Arles-Avignon","Olympique Marseille","0-3",0,3,"1",1,3,-3,"D"
"24165",2010-09-19,2010,"Lille OSC","AJ Auxerre","1-0",1,0,"1",1,1,1,"H"
"24166",2010-09-19,2010,"Paris Saint-Germain","Stade Rennes","0-0",0,0,"1",1,0,0,"D"
"24167",2010-09-19,2010,"Girondins Bordeaux","Olympique Lyon","2-0",2,0,"1",1,2,2,"H"
"24168",2010-09-25,2010,"AJ Auxerre","AS Nancy","2-2",2,2,"1",1,4,0,"D"
"24169",2010-09-25,2010,"SM Caen","Girondins Bordeaux","0-0",0,0,"1",1,0,0,"D"
"24170",2010-09-25,2010,"FC Lorient","AS Monaco","2-1",2,1,"1",1,3,1,"H"
"24171",2010-09-25,2010,"Olympique Marseille","FC Sochaux","2-1",2,1,"1",1,3,1,"H"
"24172",2010-09-25,2010,"Montpellier HSC","AC Arles-Avignon","3-1",3,1,"1",1,4,2,"H"
"24173",2010-09-25,2010,"OGC Nice","Stade Rennes","1-2",1,2,"1",1,3,-1,"D"
"24174",2010-09-25,2010,"Olympique Lyon","AS Saint-Etienne","0-1",0,1,"1",1,1,-1,"D"
"24175",2010-09-26,2010,"Stade Brest","Valenciennes FC","1-0",1,0,"1",1,1,1,"H"
"24176",2010-09-26,2010,"Toulouse FC","Lille OSC","1-1",1,1,"1",1,2,0,"D"
"24177",2010-09-26,2010,"RC Lens","Paris Saint-Germain","0-2",0,2,"1",1,2,-2,"D"
"24178",2010-10-02,2010,"AC Arles-Avignon","AJ Auxerre","0-4",0,4,"1",1,4,-4,"D"
"24179",2010-10-02,2010,"Girondins Bordeaux","FC Lorient","1-0",1,0,"1",1,1,1,"H"
"24180",2010-10-02,2010,"AS Monaco","Stade Brest","0-1",0,1,"1",1,1,-1,"D"
"24181",2010-10-02,2010,"AS Nancy","Olympique Lyon","2-3",2,3,"1",1,5,-1,"D"
"24182",2010-10-02,2010,"FC Sochaux","RC Lens","3-0",3,0,"1",1,3,3,"H"
"24183",2010-10-02,2010,"Valenciennes FC","SM Caen","2-1",2,1,"1",1,3,1,"H"
"24184",2010-10-02,2010,"AS Saint-Etienne","Olympique Marseille","1-1",1,1,"1",1,2,0,"D"
"24185",2010-10-03,2010,"Lille OSC","Montpellier HSC","3-1",3,1,"1",1,4,2,"H"
"24186",2010-10-03,2010,"Paris Saint-Germain","OGC Nice","0-0",0,0,"1",1,0,0,"D"
"24187",2010-10-03,2010,"Stade Rennes","Toulouse FC","3-1",3,1,"1",1,4,2,"H"
"24188",2010-10-16,2010,"AJ Auxerre","Girondins Bordeaux","0-1",0,1,"1",1,1,-1,"D"
"24189",2010-10-16,2010,"Stade Brest","AC Arles-Avignon","0-0",0,0,"1",1,0,0,"D"
"24190",2010-10-16,2010,"SM Caen","AS Monaco","0-0",0,0,"1",1,0,0,"D"
"24191",2010-10-16,2010,"Olympique Marseille","AS Nancy","1-0",1,0,"1",1,1,1,"H"
"24192",2010-10-16,2010,"Montpellier HSC","FC Sochaux","2-0",2,0,"1",1,2,2,"H"
"24193",2010-10-16,2010,"Toulouse FC","Paris Saint-Germain","0-2",0,2,"1",1,2,-2,"D"
"24194",2010-10-17,2010,"RC Lens","Stade Rennes","0-0",0,0,"1",1,0,0,"D"
"24195",2010-10-17,2010,"FC Lorient","Valenciennes FC","2-1",2,1,"1",1,3,1,"H"
"24196",2010-10-17,2010,"OGC Nice","AS Saint-Etienne","2-1",2,1,"1",1,3,1,"H"
"24197",2010-10-17,2010,"Olympique Lyon","Lille OSC","3-1",3,1,"1",1,4,2,"H"
"24198",2010-10-23,2010,"Girondins Bordeaux","Stade Brest","0-2",0,2,"1",1,2,-2,"D"
"24199",2010-10-23,2010,"RC Lens","OGC Nice","1-0",1,0,"1",1,1,1,"H"
"24200",2010-10-23,2010,"AS Monaco","Valenciennes FC","0-2",0,2,"1",1,2,-2,"D"
"24201",2010-10-23,2010,"AS Nancy","FC Lorient","1-0",1,0,"1",1,1,1,"H"
"24202",2010-10-23,2010,"Stade Rennes","Montpellier HSC","0-1",0,1,"1",1,1,-1,"D"
"24203",2010-10-23,2010,"AS Saint-Etienne","SM Caen","1-1",1,1,"1",1,2,0,"D"
"24204",2010-10-23,2010,"FC Sochaux","Toulouse FC","1-3",1,3,"1",1,4,-2,"D"
"24205",2010-10-24,2010,"AC Arles-Avignon","Olympique Lyon","1-1",1,1,"1",1,2,0,"D"
"24206",2010-10-24,2010,"Paris Saint-Germain","AJ Auxerre","2-3",2,3,"1",1,5,-1,"D"
"24207",2010-10-24,2010,"Lille OSC","Olympique Marseille","1-3",1,3,"1",1,4,-2,"D"
"24208",2010-10-30,2010,"AJ Auxerre","OGC Nice","2-0",2,0,"1",1,2,2,"H"
"24209",2010-10-30,2010,"Stade Brest","AS Saint-Etienne","2-0",2,0,"1",1,2,2,"H"
"24210",2010-10-30,2010,"SM Caen","AS Nancy","2-3",2,3,"1",1,5,-1,"D"
"24211",2010-10-30,2010,"FC Lorient","AC Arles-Avignon","2-0",2,0,"1",1,2,2,"H"
"24212",2010-10-30,2010,"Olympique Lyon","FC Sochaux","2-1",2,1,"1",1,3,1,"H"
"24213",2010-10-30,2010,"Toulouse FC","RC Lens","1-1",1,1,"1",1,2,0,"D"
"24214",2010-10-31,2010,"Valenciennes FC","Lille OSC","1-1",1,1,"1",1,2,0,"D"
"24215",2010-10-31,2010,"Montpellier HSC","Paris Saint-Germain","1-1",1,1,"1",1,2,0,"D"
"24216",2010-11-02,2010,"AS Monaco","Girondins Bordeaux","2-2",2,2,"1",1,4,0,"D"
"24217",2010-11-06,2010,"AC Arles-Avignon","SM Caen","3-2",3,2,"1",1,5,1,"H"
"24218",2010-11-06,2010,"Girondins Bordeaux","Valenciennes FC","1-1",1,1,"1",1,2,0,"D"
"24219",2010-11-06,2010,"AS Saint-Etienne","FC Lorient","1-2",1,2,"1",1,3,-1,"D"
"24220",2010-11-06,2010,"FC Sochaux","AJ Auxerre","1-1",1,1,"1",1,2,0,"D"
"24221",2010-11-06,2010,"Stade Rennes","Olympique Lyon","1-1",1,1,"1",1,2,0,"D"
"24222",2010-11-07,2010,"RC Lens","Montpellier HSC","2-0",2,0,"1",1,2,2,"H"
"24223",2010-11-07,2010,"Lille OSC","Stade Brest","3-1",3,1,"1",1,4,2,"H"
"24224",2010-11-07,2010,"AS Nancy","AS Monaco","0-4",0,4,"1",1,4,-4,"D"
"24225",2010-11-07,2010,"OGC Nice","Toulouse FC","2-0",2,0,"1",1,2,2,"H"
"24226",2010-11-07,2010,"Paris Saint-Germain","Olympique Marseille","2-1",2,1,"1",1,3,1,"H"
"24227",2010-11-13,2010,"Girondins Bordeaux","AS Nancy","2-1",2,1,"1",1,3,1,"H"
"24228",2010-11-13,2010,"Stade Brest","FC Sochaux","1-1",1,1,"1",1,2,0,"D"
"24229",2010-11-13,2010,"Olympique Marseille","RC Lens","1-1",1,1,"1",1,2,0,"D"
"24230",2010-11-13,2010,"AS Monaco","AC Arles-Avignon","0-0",0,0,"1",1,0,0,"D"
"24231",2010-11-13,2010,"Montpellier HSC","Toulouse FC","1-0",1,0,"1",1,1,1,"H"
"24232",2010-11-13,2010,"SM Caen","Lille OSC","2-5",2,5,"1",1,7,-3,"D"
"24233",2010-11-14,2010,"AJ Auxerre","Stade Rennes","2-1",2,1,"1",1,3,1,"H"
"24234",2010-11-14,2010,"FC Lorient","Paris Saint-Germain","1-1",1,1,"1",1,2,0,"D"
"24235",2010-11-14,2010,"Olympique Lyon","OGC Nice","1-0",1,0,"1",1,1,1,"H"
"24236",2010-11-20,2010,"AS Nancy","Valenciennes FC","2-0",2,0,"1",1,2,2,"H"
"24237",2010-11-20,2010,"Paris Saint-Germain","SM Caen","2-1",2,1,"1",1,3,1,"H"
"24238",2010-11-20,2010,"Stade Rennes","Stade Brest","2-1",2,1,"1",1,3,1,"H"
"24239",2010-11-20,2010,"AS Saint-Etienne","AJ Auxerre","1-1",1,1,"1",1,2,0,"D"
"24240",2010-11-20,2010,"FC Sochaux","FC Lorient","2-0",2,0,"1",1,2,2,"H"
"24241",2010-11-20,2010,"Toulouse FC","Olympique Marseille","0-1",0,1,"1",1,1,-1,"D"
"24242",2010-11-20,2010,"OGC Nice","Montpellier HSC","0-1",0,1,"1",1,1,-1,"D"
"24243",2010-11-21,2010,"AC Arles-Avignon","Girondins Bordeaux","2-4",2,4,"1",1,6,-2,"D"
"24244",2010-11-21,2010,"Lille OSC","AS Monaco","2-1",2,1,"1",1,3,1,"H"
"24245",2010-11-21,2010,"RC Lens","Olympique Lyon","1-3",1,3,"1",1,4,-2,"D"
"24246",2010-11-27,2010,"FC Lorient","Stade Rennes","2-0",2,0,"1",1,2,2,"H"
"24247",2010-11-27,2010,"Olympique Marseille","Montpellier HSC","4-0",4,0,"1",1,4,4,"H"
"24248",2010-11-27,2010,"AS Monaco","OGC Nice","1-1",1,1,"1",1,2,0,"D"
"24249",2010-11-27,2010,"AS Nancy","AS Saint-Etienne","1-1",1,1,"1",1,2,0,"D"
"24250",2010-11-27,2010,"Valenciennes FC","AC Arles-Avignon","3-0",3,0,"1",1,3,3,"H"
"24251",2010-11-27,2010,"Girondins Bordeaux","Lille OSC","1-1",1,1,"1",1,2,0,"D"
"24252",2010-11-28,2010,"AJ Auxerre","Toulouse FC","1-2",1,2,"1",1,3,-1,"D"
"24253",2010-11-28,2010,"SM Caen","FC Sochaux","0-3",0,3,"1",1,3,-3,"D"
"24254",2010-11-28,2010,"Olympique Lyon","Paris Saint-Germain","2-2",2,2,"1",1,4,0,"D"
"24255",2010-11-30,2010,"Stade Brest","RC Lens","4-1",4,1,"1",1,5,3,"H"
"24256",2010-12-01,2010,"Olympique Marseille","Stade Rennes","0-0",0,0,"1",1,0,0,"D"
"24257",2010-12-01,2010,"Valenciennes FC","AS Saint-Etienne","1-1",1,1,"1",1,2,0,"D"
"24258",2010-12-04,2010,"AC Arles-Avignon","AS Nancy","1-1",1,1,"1",1,2,0,"D"
"24259",2010-12-04,2010,"RC Lens","AJ Auxerre","1-1",1,1,"1",1,2,0,"D"
"24260",2010-12-04,2010,"Stade Rennes","AS Monaco","1-0",1,0,"1",1,1,1,"H"
"24261",2010-12-04,2010,"FC Sochaux","Valenciennes FC","2-1",2,1,"1",1,3,1,"H"
"24262",2010-12-04,2010,"Toulouse FC","SM Caen","1-0",1,0,"1",1,1,1,"H"
"24263",2010-12-04,2010,"Montpellier HSC","Olympique Lyon","1-2",1,2,"1",1,3,-1,"D"
"24264",2010-12-05,2010,"Lille OSC","FC Lorient","6-3",6,3,"1",1,9,3,"H"
"24265",2010-12-05,2010,"OGC Nice","Olympique Marseille","1-0",1,0,"1",1,1,1,"H"
"24266",2010-12-05,2010,"Paris Saint-Germain","Stade Brest","3-1",3,1,"1",1,4,2,"H"
"24267",2010-12-05,2010,"AS Saint-Etienne","Girondins Bordeaux","2-2",2,2,"1",1,4,0,"D"
"24268",2010-12-11,2010,"AC Arles-Avignon","Lille OSC","0-1",0,1,"1",1,1,-1,"D"
"24269",2010-12-11,2010,"Stade Brest","Montpellier HSC","0-0",0,0,"1",1,0,0,"D"
"24270",2010-12-11,2010,"SM Caen","OGC Nice","0-0",0,0,"1",1,0,0,"D"
"24271",2010-12-11,2010,"FC Lorient","RC Lens","3-0",3,0,"1",1,3,3,"H"
"24272",2010-12-11,2010,"AS Nancy","FC Sochaux","1-0",1,0,"1",1,1,1,"H"
"24273",2010-12-11,2010,"Valenciennes FC","Paris Saint-Germain","1-2",1,2,"1",1,3,-1,"D"
"24274",2010-12-11,2010,"AJ Auxerre","Olympique Marseille","1-1",1,1,"1",1,2,0,"D"
"24275",2010-12-12,2010,"Olympique Lyon","Toulouse FC","2-0",2,0,"1",1,2,2,"H"
"24276",2010-12-12,2010,"AS Monaco","AS Saint-Etienne","0-2",0,2,"1",1,2,-2,"D"
"24277",2010-12-12,2010,"Girondins Bordeaux","Stade Rennes","0-0",0,0,"1",1,0,0,"D"
"24278",2010-12-18,2010,"Montpellier HSC","AJ Auxerre","1-1",1,1,"1",1,2,0,"D"
"24279",2010-12-18,2010,"OGC Nice","Stade Brest","1-1",1,1,"1",1,2,0,"D"
"24280",2010-12-18,2010,"Stade Rennes","Valenciennes FC","1-0",1,0,"1",1,1,1,"H"
"24281",2010-12-18,2010,"AS Saint-Etienne","AC Arles-Avignon","2-0",2,0,"1",1,2,2,"H"
"24282",2010-12-18,2010,"Toulouse FC","FC Lorient","3-0",3,0,"1",1,3,3,"H"
"24283",2010-12-18,2010,"Paris Saint-Germain","AS Monaco","2-2",2,2,"1",1,4,0,"D"
"24284",2010-12-19,2010,"FC Sochaux","Girondins Bordeaux","1-1",1,1,"1",1,2,0,"D"
"24285",2010-12-19,2010,"Olympique Marseille","Olympique Lyon","1-1",1,1,"1",1,2,0,"D"
"24286",2010-12-21,2010,"FC Lorient","Montpellier HSC","0-0",0,0,"1",1,0,0,"D"
"24287",2010-12-22,2010,"AC Arles-Avignon","OGC Nice","0-0",0,0,"1",1,0,0,"D"
"24288",2010-12-22,2010,"Stade Brest","Olympique Marseille","0-0",0,0,"1",1,0,0,"D"
"24289",2010-12-22,2010,"SM Caen","Stade Rennes","1-0",1,0,"1",1,1,1,"H"
"24290",2010-12-22,2010,"Lille OSC","AS Saint-Etienne","1-1",1,1,"1",1,2,0,"D"
"24291",2010-12-22,2010,"Olympique Lyon","AJ Auxerre","1-1",1,1,"1",1,2,0,"D"
"24292",2010-12-22,2010,"AS Monaco","FC Sochaux","2-1",2,1,"1",1,3,1,"H"
"24293",2010-12-22,2010,"AS Nancy","Paris Saint-Germain","2-0",2,0,"1",1,2,2,"H"
"24294",2010-12-22,2010,"Valenciennes FC","Toulouse FC","2-1",2,1,"1",1,3,1,"H"
"24295",2010-12-22,2010,"Girondins Bordeaux","RC Lens","2-2",2,2,"1",1,4,0,"D"
"24296",2011-01-15,2010,"AJ Auxerre","AS Monaco","1-1",1,1,"1",1,2,0,"D"
"24297",2011-01-15,2010,"Stade Brest","SM Caen","1-3",1,3,"1",1,4,-2,"D"
"24298",2011-01-15,2010,"RC Lens","AS Saint-Etienne","2-1",2,1,"1",1,3,1,"H"
"24299",2011-01-15,2010,"Olympique Lyon","FC Lorient","3-0",3,0,"1",1,3,3,"H"
"24300",2011-01-15,2010,"Montpellier HSC","Valenciennes FC","2-1",2,1,"1",1,3,1,"H"
"24301",2011-01-15,2010,"OGC Nice","Lille OSC","0-2",0,2,"1",1,2,-2,"D"
"24302",2011-01-15,2010,"Paris Saint-Germain","FC Sochaux","2-1",2,1,"1",1,3,1,"H"
"24303",2011-01-15,2010,"Stade Rennes","AC Arles-Avignon","4-0",4,0,"1",1,4,4,"H"
"24304",2011-01-15,2010,"Toulouse FC","AS Nancy","1-0",1,0,"1",1,1,1,"H"
"24305",2011-01-16,2010,"Olympique Marseille","Girondins Bordeaux","2-1",2,1,"1",1,3,1,"H"
"24306",2011-01-19,2010,"Lille OSC","AS Nancy","3-0",3,0,"1",1,3,3,"H"
"24307",2011-01-22,2010,"RC Lens","SM Caen","2-0",2,0,"1",1,2,2,"H"
"24308",2011-01-29,2010,"AC Arles-Avignon","Paris Saint-Germain","1-2",1,2,"1",1,3,-1,"D"
"24309",2011-01-29,2010,"SM Caen","AJ Auxerre","2-0",2,0,"1",1,2,2,"H"
"24310",2011-01-29,2010,"FC Lorient","Stade Brest","2-0",2,0,"1",1,2,2,"H"
"24311",2011-01-29,2010,"AS Saint-Etienne","Toulouse FC","2-1",2,1,"1",1,3,1,"H"
"24312",2011-01-29,2010,"FC Sochaux","Stade Rennes","5-1",5,1,"1",1,6,4,"H"
"24313",2011-01-29,2010,"Valenciennes FC","Olympique Lyon","2-1",2,1,"1",1,3,1,"H"
"24314",2011-01-29,2010,"Lille OSC","RC Lens","1-0",1,0,"1",1,1,1,"H"
"24315",2011-01-30,2010,"Girondins Bordeaux","OGC Nice","2-0",2,0,"1",1,2,2,"H"
"24316",2011-01-30,2010,"AS Nancy","Montpellier HSC","1-2",1,2,"1",1,3,-1,"D"
"24317",2011-01-30,2010,"AS Monaco","Olympique Marseille","0-0",0,0,"1",1,0,0,"D"
"24318",2011-02-05,2010,"Stade Brest","AS Nancy","2-1",2,1,"1",1,3,1,"H"
"24319",2011-02-05,2010,"SM Caen","FC Lorient","0-2",0,2,"1",1,2,-2,"D"
"24320",2011-02-05,2010,"RC Lens","Valenciennes FC","1-1",1,1,"1",1,2,0,"D"
"24321",2011-02-05,2010,"Olympique Marseille","AC Arles-Avignon","1-0",1,0,"1",1,1,1,"H"
"24322",2011-02-05,2010,"Montpellier HSC","AS Saint-Etienne","1-2",1,2,"1",1,3,-1,"D"
"24323",2011-02-05,2010,"OGC Nice","FC Sochaux","1-0",1,0,"1",1,1,1,"H"
"24324",2011-02-05,2010,"Stade Rennes","Paris Saint-Germain","1-0",1,0,"1",1,1,1,"H"
"24325",2011-02-06,2010,"AJ Auxerre","Lille OSC","1-1",1,1,"1",1,2,0,"D"
"24326",2011-02-06,2010,"Toulouse FC","AS Monaco","2-0",2,0,"1",1,2,2,"H"
"24327",2011-02-06,2010,"Olympique Lyon","Girondins Bordeaux","0-0",0,0,"1",1,0,0,"D"
"24328",2011-02-12,2010,"AC Arles-Avignon","Montpellier HSC","0-0",0,0,"1",1,0,0,"D"
"24329",2011-02-12,2010,"Girondins Bordeaux","SM Caen","1-2",1,2,"1",1,3,-1,"D"
"24330",2011-02-12,2010,"AS Monaco","FC Lorient","3-1",3,1,"1",1,4,2,"H"
"24331",2011-02-12,2010,"AS Nancy","AJ Auxerre","3-1",3,1,"1",1,4,2,"H"
"24332",2011-02-12,2010,"Paris Saint-Germain","RC Lens","0-0",0,0,"1",1,0,0,"D"
"24333",2011-02-12,2010,"FC Sochaux","Olympique Marseille","1-2",1,2,"1",1,3,-1,"D"
"24334",2011-02-12,2010,"AS Saint-Etienne","Olympique Lyon","1-4",1,4,"1",1,5,-3,"D"
"24335",2011-02-13,2010,"Stade Rennes","OGC Nice","2-0",2,0,"1",1,2,2,"H"
"24336",2011-02-13,2010,"Valenciennes FC","Stade Brest","3-0",3,0,"1",1,3,3,"H"
"24337",2011-02-13,2010,"Lille OSC","Toulouse FC","2-0",2,0,"1",1,2,2,"H"
"24338",2011-02-18,2010,"Olympique Lyon","AS Nancy","4-0",4,0,"1",1,4,4,"H"
"24339",2011-02-19,2010,"AJ Auxerre","AC Arles-Avignon","1-1",1,1,"1",1,2,0,"D"
"24340",2011-02-19,2010,"Stade Brest","AS Monaco","2-0",2,0,"1",1,2,2,"H"
"24341",2011-02-19,2010,"SM Caen","Valenciennes FC","2-2",2,2,"1",1,4,0,"D"
"24342",2011-02-19,2010,"RC Lens","FC Sochaux","2-3",2,3,"1",1,5,-1,"D"
"24343",2011-02-19,2010,"Olympique Marseille","AS Saint-Etienne","2-1",2,1,"1",1,3,1,"H"
"24344",2011-02-19,2010,"FC Lorient","Girondins Bordeaux","5-1",5,1,"1",1,6,4,"H"
"24345",2011-02-20,2010,"Montpellier HSC","Lille OSC","1-0",1,0,"1",1,1,1,"H"
"24346",2011-02-20,2010,"OGC Nice","Paris Saint-Germain","0-3",0,3,"1",1,3,-3,"D"
"24347",2011-02-20,2010,"Toulouse FC","Stade Rennes","1-2",1,2,"1",1,3,-1,"D"
"24348",2011-02-26,2010,"AC Arles-Avignon","Stade Brest","1-1",1,1,"1",1,2,0,"D"
"24349",2011-02-26,2010,"AS Monaco","SM Caen","2-2",2,2,"1",1,4,0,"D"
"24350",2011-02-26,2010,"Stade Rennes","RC Lens","2-0",2,0,"1",1,2,2,"H"
"24351",2011-02-26,2010,"AS Saint-Etienne","OGC Nice","0-2",0,2,"1",1,2,-2,"D"
"24352",2011-02-26,2010,"FC Sochaux","Montpellier HSC","0-0",0,0,"1",1,0,0,"D"
"24353",2011-02-26,2010,"Valenciennes FC","FC Lorient","0-0",0,0,"1",1,0,0,"D"
"24354",2011-02-26,2010,"Girondins Bordeaux","AJ Auxerre","3-0",3,0,"1",1,3,3,"H"
"24355",2011-02-27,2010,"AS Nancy","Olympique Marseille","1-2",1,2,"1",1,3,-1,"D"
"24356",2011-02-27,2010,"Paris Saint-Germain","Toulouse FC","2-1",2,1,"1",1,3,1,"H"
"24357",2011-02-27,2010,"Lille OSC","Olympique Lyon","1-1",1,1,"1",1,2,0,"D"
"24358",2011-03-05,2010,"SM Caen","AS Saint-Etienne","1-0",1,0,"1",1,1,1,"H"
"24359",2011-03-05,2010,"FC Lorient","AS Nancy","0-0",0,0,"1",1,0,0,"D"
"24360",2011-03-05,2010,"Montpellier HSC","Stade Rennes","0-1",0,1,"1",1,1,-1,"D"
"24361",2011-03-05,2010,"OGC Nice","RC Lens","0-0",0,0,"1",1,0,0,"D"
"24362",2011-03-05,2010,"Toulouse FC","FC Sochaux","0-1",0,1,"1",1,1,-1,"D"
"24363",2011-03-05,2010,"Valenciennes FC","AS Monaco","0-0",0,0,"1",1,0,0,"D"
"24364",2011-03-05,2010,"AJ Auxerre","Paris Saint-Germain","1-0",1,0,"1",1,1,1,"H"
"24365",2011-03-06,2010,"Stade Brest","Girondins Bordeaux","1-3",1,3,"1",1,4,-2,"D"
"24366",2011-03-06,2010,"Olympique Lyon","AC Arles-Avignon","5-0",5,0,"1",1,5,5,"H"
"24367",2011-03-06,2010,"Olympique Marseille","Lille OSC","1-2",1,2,"1",1,3,-1,"D"
"24368",2011-03-11,2010,"Stade Rennes","Olympique Marseille","0-2",0,2,"1",1,2,-2,"D"
"24369",2011-03-12,2010,"AC Arles-Avignon","FC Lorient","3-3",3,3,"1",1,6,0,"D"
"24370",2011-03-12,2010,"RC Lens","Toulouse FC","0-1",0,1,"1",1,1,-1,"D"
"24371",2011-03-12,2010,"AS Nancy","SM Caen","2-0",2,0,"1",1,2,2,"H"
"24372",2011-03-12,2010,"OGC Nice","AJ Auxerre","1-0",1,0,"1",1,1,1,"H"
"24373",2011-03-12,2010,"AS Saint-Etienne","Stade Brest","2-0",2,0,"1",1,2,2,"H"
"24374",2011-03-12,2010,"FC Sochaux","Olympique Lyon","0-2",0,2,"1",1,2,-2,"D"
"24375",2011-03-13,2010,"Girondins Bordeaux","AS Monaco","0-1",0,1,"1",1,1,-1,"D"
"24376",2011-03-13,2010,"Lille OSC","Valenciennes FC","2-1",2,1,"1",1,3,1,"H"
"24377",2011-03-13,2010,"Paris Saint-Germain","Montpellier HSC","2-2",2,2,"1",1,4,0,"D"
"24378",2011-03-19,2010,"AJ Auxerre","FC Sochaux","2-0",2,0,"1",1,2,2,"H"
"24379",2011-03-19,2010,"Stade Brest","Lille OSC","1-2",1,2,"1",1,3,-1,"D"
"24380",2011-03-19,2010,"FC Lorient","AS Saint-Etienne","0-0",0,0,"1",1,0,0,"D"
"24381",2011-03-19,2010,"Montpellier HSC","RC Lens","1-4",1,4,"1",1,5,-3,"D"
"24382",2011-03-19,2010,"Toulouse FC","OGC Nice","1-1",1,1,"1",1,2,0,"D"
"24383",2011-03-19,2010,"Valenciennes FC","Girondins Bordeaux","2-2",2,2,"1",1,4,0,"D"
"24384",2011-03-19,2010,"Olympique Lyon","Stade Rennes","1-1",1,1,"1",1,2,0,"D"
"24385",2011-03-20,2010,"SM Caen","AC Arles-Avignon","2-0",2,0,"1",1,2,2,"H"
"24386",2011-03-20,2010,"AS Monaco","AS Nancy","0-1",0,1,"1",1,1,-1,"D"
"24387",2011-03-20,2010,"Olympique Marseille","Paris Saint-Germain","2-1",2,1,"1",1,3,1,"H"
"24388",2011-04-02,2010,"AC Arles-Avignon","AS Monaco","0-2",0,2,"1",1,2,-2,"D"
"24389",2011-04-02,2010,"Lille OSC","SM Caen","3-1",3,1,"1",1,4,2,"H"
"24390",2011-04-02,2010,"AS Nancy","Girondins Bordeaux","0-0",0,0,"1",1,0,0,"D"
"24391",2011-04-02,2010,"Paris Saint-Germain","FC Lorient","0-0",0,0,"1",1,0,0,"D"
"24392",2011-04-02,2010,"Stade Rennes","AJ Auxerre","0-0",0,0,"1",1,0,0,"D"
"24393",2011-04-02,2010,"FC Sochaux","Stade Brest","2-1",2,1,"1",1,3,1,"H"
"24394",2011-04-02,2010,"Toulouse FC","Montpellier HSC","0-1",0,1,"1",1,1,-1,"D"
"24395",2011-04-03,2010,"OGC Nice","Olympique Lyon","2-2",2,2,"1",1,4,0,"D"
"24396",2011-04-03,2010,"AS Saint-Etienne","Valenciennes FC","1-1",1,1,"1",1,2,0,"D"
"24397",2011-04-03,2010,"RC Lens","Olympique Marseille","0-1",0,1,"1",1,1,-1,"D"
"24398",2011-04-09,2010,"AJ Auxerre","AS Saint-Etienne","2-2",2,2,"1",1,4,0,"D"
"24399",2011-04-09,2010,"Girondins Bordeaux","AC Arles-Avignon","0-0",0,0,"1",1,0,0,"D"
"24400",2011-04-09,2010,"SM Caen","Paris Saint-Germain","1-2",1,2,"1",1,3,-1,"D"
"24401",2011-04-09,2010,"FC Lorient","FC Sochaux","1-1",1,1,"1",1,2,0,"D"
"24402",2011-04-09,2010,"AS Monaco","Lille OSC","1-0",1,0,"1",1,1,1,"H"
"24403",2011-04-09,2010,"Valenciennes FC","AS Nancy","1-1",1,1,"1",1,2,0,"D"
"24404",2011-04-09,2010,"Stade Brest","Stade Rennes","2-0",2,0,"1",1,2,2,"H"
"24405",2011-04-10,2010,"Olympique Marseille","Toulouse FC","2-2",2,2,"1",1,4,0,"D"
"24406",2011-04-10,2010,"Montpellier HSC","OGC Nice","1-1",1,1,"1",1,2,0,"D"
"24407",2011-04-10,2010,"Olympique Lyon","RC Lens","3-0",3,0,"1",1,3,3,"H"
"24408",2011-04-16,2010,"RC Lens","Stade Brest","1-1",1,1,"1",1,2,0,"D"
"24409",2011-04-16,2010,"OGC Nice","AS Monaco","3-2",3,2,"1",1,5,1,"H"
"24410",2011-04-16,2010,"Stade Rennes","FC Lorient","1-2",1,2,"1",1,3,-1,"D"
"24411",2011-04-16,2010,"AS Saint-Etienne","AS Nancy","2-1",2,1,"1",1,3,1,"H"
"24412",2011-04-16,2010,"FC Sochaux","SM Caen","3-2",3,2,"1",1,5,1,"H"
"24413",2011-04-16,2010,"Toulouse FC","AJ Auxerre","0-1",0,1,"1",1,1,-1,"D"
"24414",2011-04-16,2010,"Lille OSC","Girondins Bordeaux","1-1",1,1,"1",1,2,0,"D"
"24415",2011-04-17,2010,"AC Arles-Avignon","Valenciennes FC","0-1",0,1,"1",1,1,-1,"D"
"24416",2011-04-17,2010,"Montpellier HSC","Olympique Marseille","1-2",1,2,"1",1,3,-1,"D"
"24417",2011-04-17,2010,"Paris Saint-Germain","Olympique Lyon","1-0",1,0,"1",1,1,1,"H"
"24418",2011-04-24,2010,"AJ Auxerre","RC Lens","1-1",1,1,"1",1,2,0,"D"
"24419",2011-04-24,2010,"Girondins Bordeaux","AS Saint-Etienne","2-0",2,0,"1",1,2,2,"H"
"24420",2011-04-24,2010,"Stade Brest","Paris Saint-Germain","2-2",2,2,"1",1,4,0,"D"
"24421",2011-04-24,2010,"SM Caen","Toulouse FC","1-1",1,1,"1",1,2,0,"D"
"24422",2011-04-24,2010,"AS Monaco","Stade Rennes","1-0",1,0,"1",1,1,1,"H"
"24423",2011-04-24,2010,"AS Nancy","AC Arles-Avignon","0-0",0,0,"1",1,0,0,"D"
"24424",2011-04-24,2010,"Valenciennes FC","FC Sochaux","1-1",1,1,"1",1,2,0,"D"
"24425",2011-04-24,2010,"FC Lorient","Lille OSC","1-1",1,1,"1",1,2,0,"D"
"24426",2011-04-27,2010,"Olympique Lyon","Montpellier HSC","3-2",3,2,"1",1,5,1,"H"
"24427",2011-04-27,2010,"Olympique Marseille","OGC Nice","4-2",4,2,"1",1,6,2,"H"
"24428",2011-04-30,2010,"RC Lens","FC Lorient","2-3",2,3,"1",1,5,-1,"D"
"24429",2011-04-30,2010,"Lille OSC","AC Arles-Avignon","5-0",5,0,"1",1,5,5,"H"
"24430",2011-04-30,2010,"Stade Rennes","Girondins Bordeaux","0-0",0,0,"1",1,0,0,"D"
"24431",2011-04-30,2010,"FC Sochaux","AS Nancy","1-0",1,0,"1",1,1,1,"H"
"24432",2011-04-30,2010,"Paris Saint-Germain","Valenciennes FC","3-1",3,1,"1",1,4,2,"H"
"24433",2011-05-01,2010,"Olympique Marseille","AJ Auxerre","1-1",1,1,"1",1,2,0,"D"
"24434",2011-05-01,2010,"Montpellier HSC","Stade Brest","0-0",0,0,"1",1,0,0,"D"
"24435",2011-05-01,2010,"OGC Nice","SM Caen","0-4",0,4,"1",1,4,-4,"D"
"24436",2011-05-01,2010,"Toulouse FC","Olympique Lyon","2-0",2,0,"1",1,2,2,"H"
"24437",2011-05-01,2010,"AS Saint-Etienne","AS Monaco","1-1",1,1,"1",1,2,0,"D"
"24438",2011-05-07,2010,"AC Arles-Avignon","AS Saint-Etienne","0-1",0,1,"1",1,1,-1,"D"
"24439",2011-05-07,2010,"AJ Auxerre","Montpellier HSC","1-0",1,0,"1",1,1,1,"H"
"24440",2011-05-07,2010,"Girondins Bordeaux","FC Sochaux","0-4",0,4,"1",1,4,-4,"D"
"24441",2011-05-07,2010,"Stade Brest","OGC Nice","0-0",0,0,"1",1,0,0,"D"
"24442",2011-05-07,2010,"SM Caen","RC Lens","1-1",1,1,"1",1,2,0,"D"
"24443",2011-05-07,2010,"FC Lorient","Toulouse FC","0-0",0,0,"1",1,0,0,"D"
"24444",2011-05-07,2010,"AS Monaco","Paris Saint-Germain","1-1",1,1,"1",1,2,0,"D"
"24445",2011-05-07,2010,"AS Nancy","Lille OSC","0-1",0,1,"1",1,1,-1,"D"
"24446",2011-05-08,2010,"Valenciennes FC","Stade Rennes","2-0",2,0,"1",1,2,2,"H"
"24447",2011-05-08,2010,"Olympique Lyon","Olympique Marseille","3-2",3,2,"1",1,5,1,"H"
"24448",2011-05-10,2010,"Paris Saint-Germain","AS Nancy","2-2",2,2,"1",1,4,0,"D"
"24449",2011-05-10,2010,"AS Saint-Etienne","Lille OSC","1-2",1,2,"1",1,3,-1,"D"
"24450",2011-05-11,2010,"AJ Auxerre","Olympique Lyon","4-0",4,0,"1",1,4,4,"H"
"24451",2011-05-11,2010,"RC Lens","Girondins Bordeaux","1-0",1,0,"1",1,1,1,"H"
"24452",2011-05-11,2010,"Montpellier HSC","FC Lorient","3-1",3,1,"1",1,4,2,"H"
"24453",2011-05-11,2010,"OGC Nice","AC Arles-Avignon","3-2",3,2,"1",1,5,1,"H"
"24454",2011-05-11,2010,"Stade Rennes","SM Caen","1-1",1,1,"1",1,2,0,"D"
"24455",2011-05-11,2010,"FC Sochaux","AS Monaco","3-0",3,0,"1",1,3,3,"H"
"24456",2011-05-11,2010,"Toulouse FC","Valenciennes FC","0-0",0,0,"1",1,0,0,"D"
"24457",2011-05-11,2010,"Olympique Marseille","Stade Brest","3-0",3,0,"1",1,3,3,"H"
"24458",2011-05-15,2010,"AC Arles-Avignon","Toulouse FC","1-0",1,0,"1",1,1,1,"H"
"24459",2011-05-15,2010,"SM Caen","Montpellier HSC","2-0",2,0,"1",1,2,2,"H"
"24460",2011-05-15,2010,"AS Monaco","RC Lens","1-1",1,1,"1",1,2,0,"D"
"24461",2011-05-15,2010,"AS Nancy","OGC Nice","3-0",3,0,"1",1,3,3,"H"
"24462",2011-05-15,2010,"AS Saint-Etienne","Stade Rennes","1-2",1,2,"1",1,3,-1,"D"
"24463",2011-05-15,2010,"Valenciennes FC","AJ Auxerre","1-1",1,1,"1",1,2,0,"D"
"24464",2011-05-15,2010,"FC Lorient","Olympique Marseille","2-2",2,2,"1",1,4,0,"D"
"24465",2011-05-16,2010,"Stade Brest","Olympique Lyon","1-1",1,1,"1",1,2,0,"D"
"24466",2011-05-18,2010,"Girondins Bordeaux","Paris Saint-Germain","1-0",1,0,"1",1,1,1,"H"
"24467",2011-05-18,2010,"Lille OSC","FC Sochaux","1-0",1,0,"1",1,1,1,"H"
"24468",2011-05-21,2010,"AJ Auxerre","Stade Brest","0-1",0,1,"1",1,1,-1,"D"
"24469",2011-05-21,2010,"RC Lens","AC Arles-Avignon","0-1",0,1,"1",1,1,-1,"D"
"24470",2011-05-21,2010,"Olympique Lyon","SM Caen","0-0",0,0,"1",1,0,0,"D"
"24471",2011-05-21,2010,"Olympique Marseille","Valenciennes FC","2-2",2,2,"1",1,4,0,"D"
"24472",2011-05-21,2010,"Montpellier HSC","AS Monaco","0-1",0,1,"1",1,1,-1,"D"
"24473",2011-05-21,2010,"OGC Nice","FC Lorient","2-0",2,0,"1",1,2,2,"H"
"24474",2011-05-21,2010,"Paris Saint-Germain","Lille OSC","2-2",2,2,"1",1,4,0,"D"
"24475",2011-05-21,2010,"Stade Rennes","AS Nancy","0-2",0,2,"1",1,2,-2,"D"
"24476",2011-05-21,2010,"FC Sochaux","AS Saint-Etienne","2-1",2,1,"1",1,3,1,"H"
"24477",2011-05-21,2010,"Toulouse FC","Girondins Bordeaux","2-0",2,0,"1",1,2,2,"H"
"24478",2011-05-29,2010,"AC Arles-Avignon","FC Sochaux","1-3",1,3,"1",1,4,-2,"D"
"24479",2011-05-29,2010,"Girondins Bordeaux","Montpellier HSC","2-0",2,0,"1",1,2,2,"H"
"24480",2011-05-29,2010,"Stade Brest","Toulouse FC","0-2",0,2,"1",1,2,-2,"D"
"24481",2011-05-29,2010,"SM Caen","Olympique Marseille","2-2",2,2,"1",1,4,0,"D"
"24482",2011-05-29,2010,"Lille OSC","Stade Rennes","3-2",3,2,"1",1,5,1,"H"
"24483",2011-05-29,2010,"FC Lorient","AJ Auxerre","1-2",1,2,"1",1,3,-1,"D"
"24484",2011-05-29,2010,"AS Monaco","Olympique Lyon","0-2",0,2,"1",1,2,-2,"D"
"24485",2011-05-29,2010,"AS Nancy","RC Lens","4-0",4,0,"1",1,4,4,"H"
"24486",2011-05-29,2010,"AS Saint-Etienne","Paris Saint-Germain","1-1",1,1,"1",1,2,0,"D"
"24487",2011-05-29,2010,"Valenciennes FC","OGC Nice","2-1",2,1,"1",1,3,1,"H"
"24488",2011-08-06,2011,"AC Ajaccio","Toulouse FC","0-2",0,2,"1",1,2,-2,"D"
"24489",2011-08-06,2011,"Stade Brest","Evian Thonon Gaillard","2-2",2,2,"1",1,4,0,"D"
"24490",2011-08-06,2011,"SM Caen","Valenciennes FC","1-0",1,0,"1",1,1,1,"H"
"24491",2011-08-06,2011,"Olympique Marseille","FC Sochaux","2-2",2,2,"1",1,4,0,"D"
"24492",2011-08-06,2011,"Montpellier HSC","AJ Auxerre","3-1",3,1,"1",1,4,2,"H"
"24493",2011-08-06,2011,"AS Nancy","Lille OSC","1-1",1,1,"1",1,2,0,"D"
"24494",2011-08-06,2011,"OGC Nice","Olympique Lyon","1-3",1,3,"1",1,4,-2,"D"
"24495",2011-08-06,2011,"Paris Saint-Germain","FC Lorient","0-1",0,1,"1",1,1,-1,"D"
"24496",2011-08-07,2011,"Dijon FCO","Stade Rennes","1-5",1,5,"1",1,6,-4,"D"
"24497",2011-08-07,2011,"Girondins Bordeaux","AS Saint-Etienne","1-2",1,2,"1",1,3,-1,"D"
"24498",2011-08-13,2011,"FC Lorient","Girondins Bordeaux","1-1",1,1,"1",1,2,0,"D"
"24499",2011-08-13,2011,"Olympique Lyon","AC Ajaccio","1-1",1,1,"1",1,2,0,"D"
"24500",2011-08-13,2011,"Stade Rennes","Paris Saint-Germain","1-1",1,1,"1",1,2,0,"D"
"24501",2011-08-13,2011,"FC Sochaux","SM Caen","1-2",1,2,"1",1,3,-1,"D"
"24502",2011-08-13,2011,"Toulouse FC","Dijon FCO","2-0",2,0,"1",1,2,2,"H"
"24503",2011-08-13,2011,"AS Saint-Etienne","AS Nancy","1-0",1,0,"1",1,1,1,"H"
"24504",2011-08-13,2011,"Valenciennes FC","Stade Brest","0-0",0,0,"1",1,0,0,"D"
"24505",2011-08-14,2011,"AJ Auxerre","Olympique Marseille","2-2",2,2,"1",1,4,0,"D"
"24506",2011-08-14,2011,"Evian Thonon Gaillard","OGC Nice","1-0",1,0,"1",1,1,1,"H"
"24507",2011-08-14,2011,"Lille OSC","Montpellier HSC","0-1",0,1,"1",1,1,-1,"D"
"24508",2011-08-20,2011,"Girondins Bordeaux","AJ Auxerre","1-1",1,1,"1",1,2,0,"D"
"24509",2011-08-20,2011,"Stade Brest","Olympique Lyon","1-1",1,1,"1",1,2,0,"D"
"24510",2011-08-20,2011,"SM Caen","Lille OSC","1-2",1,2,"1",1,3,-1,"D"
"24511",2011-08-20,2011,"Dijon FCO","FC Lorient","2-0",2,0,"1",1,2,2,"H"
"24512",2011-08-20,2011,"OGC Nice","Toulouse FC","1-1",1,1,"1",1,2,0,"D"
"24513",2011-08-20,2011,"AC Ajaccio","Evian Thonon Gaillard","1-1",1,1,"1",1,2,0,"D"
"24514",2011-08-21,2011,"Montpellier HSC","Stade Rennes","4-0",4,0,"1",1,4,4,"H"
"24515",2011-08-21,2011,"AS Nancy","FC Sochaux","1-2",1,2,"1",1,3,-1,"D"
"24516",2011-08-21,2011,"Paris Saint-Germain","Valenciennes FC","2-1",2,1,"1",1,3,1,"H"
"24517",2011-08-21,2011,"Olympique Marseille","AS Saint-Etienne","0-0",0,0,"1",1,0,0,"D"
"24518",2011-08-27,2011,"AJ Auxerre","AC Ajaccio","4-1",4,1,"1",1,5,3,"H"
"24519",2011-08-27,2011,"Evian Thonon Gaillard","Dijon FCO","0-1",0,1,"1",1,1,-1,"D"
"24520",2011-08-27,2011,"FC Lorient","AS Nancy","2-1",2,1,"1",1,3,1,"H"
"24521",2011-08-27,2011,"OGC Nice","Stade Brest","0-0",0,0,"1",1,0,0,"D"
"24522",2011-08-27,2011,"Valenciennes FC","Girondins Bordeaux","1-2",1,2,"1",1,3,-1,"D"
"24523",2011-08-27,2011,"Olympique Lyon","Montpellier HSC","2-1",2,1,"1",1,3,1,"H"
"24524",2011-08-28,2011,"Stade Rennes","SM Caen","3-2",3,2,"1",1,5,1,"H"
"24525",2011-08-28,2011,"FC Sochaux","AS Saint-Etienne","2-1",2,1,"1",1,3,1,"H"
"24526",2011-08-28,2011,"Toulouse FC","Paris Saint-Germain","1-3",1,3,"1",1,4,-2,"D"
"24527",2011-08-28,2011,"Lille OSC","Olympique Marseille","3-2",3,2,"1",1,5,1,"H"
"24528",2011-09-10,2011,"AC Ajaccio","Valenciennes FC","3-1",3,1,"1",1,4,2,"H"
"24529",2011-09-10,2011,"Girondins Bordeaux","Evian Thonon Gaillard","0-0",0,0,"1",1,0,0,"D"
"24530",2011-09-10,2011,"SM Caen","Toulouse FC","0-1",0,1,"1",1,1,-1,"D"
"24531",2011-09-10,2011,"Dijon FCO","Olympique Lyon","1-2",1,2,"1",1,3,-1,"D"
"24532",2011-09-10,2011,"AS Saint-Etienne","Lille OSC","1-3",1,3,"1",1,4,-2,"D"
"24533",2011-09-10,2011,"FC Sochaux","FC Lorient","1-1",1,1,"1",1,2,0,"D"
"24534",2011-09-10,2011,"Olympique Marseille","Stade Rennes","0-1",0,1,"1",1,1,-1,"D"
"24535",2011-09-11,2011,"Montpellier HSC","OGC Nice","1-0",1,0,"1",1,1,1,"H"
"24536",2011-09-11,2011,"AS Nancy","AJ Auxerre","0-0",0,0,"1",1,0,0,"D"
"24537",2011-09-11,2011,"Paris Saint-Germain","Stade Brest","1-0",1,0,"1",1,1,1,"H"
"24538",2011-09-17,2011,"AJ Auxerre","SM Caen","1-1",1,1,"1",1,2,0,"D"
"24539",2011-09-17,2011,"Stade Brest","Montpellier HSC","2-2",2,2,"1",1,4,0,"D"
"24540",2011-09-17,2011,"FC Lorient","AS Saint-Etienne","3-0",3,0,"1",1,3,3,"H"
"24541",2011-09-17,2011,"OGC Nice","AC Ajaccio","3-0",3,0,"1",1,3,3,"H"
"24542",2011-09-17,2011,"Toulouse FC","Girondins Bordeaux","3-2",3,2,"1",1,5,1,"H"
"24543",2011-09-17,2011,"Valenciennes FC","Dijon FCO","4-0",4,0,"1",1,4,4,"H"
"24544",2011-09-17,2011,"Lille OSC","FC Sochaux","2-2",2,2,"1",1,4,0,"D"
"24545",2011-09-18,2011,"Evian Thonon Gaillard","Paris Saint-Germain","2-2",2,2,"1",1,4,0,"D"
"24546",2011-09-18,2011,"Stade Rennes","AS Nancy","1-1",1,1,"1",1,2,0,"D"
"24547",2011-09-18,2011,"Olympique Lyon","Olympique Marseille","2-0",2,0,"1",1,2,2,"H"
"24548",2011-09-20,2011,"Girondins Bordeaux","Lille OSC","1-1",1,1,"1",1,2,0,"D"
"24549",2011-09-21,2011,"AC Ajaccio","Montpellier HSC","1-3",1,3,"1",1,4,-2,"D"
"24550",2011-09-21,2011,"SM Caen","Olympique Lyon","1-0",1,0,"1",1,1,1,"H"
"24551",2011-09-21,2011,"Dijon FCO","Stade Brest","1-0",1,0,"1",1,1,1,"H"
"24552",2011-09-21,2011,"FC Lorient","AJ Auxerre","1-1",1,1,"1",1,2,0,"D"
"24553",2011-09-21,2011,"Olympique Marseille","Evian Thonon Gaillard","2-0",2,0,"1",1,2,2,"H"
"24554",2011-09-21,2011,"AS Nancy","Valenciennes FC","1-1",1,1,"1",1,2,0,"D"
"24555",2011-09-21,2011,"Paris Saint-Germain","OGC Nice","2-1",2,1,"1",1,3,1,"H"
"24556",2011-09-21,2011,"FC Sochaux","Stade Rennes","2-6",2,6,"1",1,8,-4,"D"
"24557",2011-09-21,2011,"AS Saint-Etienne","Toulouse FC","1-1",1,1,"1",1,2,0,"D"
"24558",2011-09-24,2011,"Evian Thonon Gaillard","SM Caen","2-4",2,4,"1",1,6,-2,"D"
"24559",2011-09-24,2011,"Lille OSC","FC Lorient","1-1",1,1,"1",1,2,0,"D"
"24560",2011-09-24,2011,"Olympique Lyon","Girondins Bordeaux","3-1",3,1,"1",1,4,2,"H"
"24561",2011-09-24,2011,"OGC Nice","Dijon FCO","1-1",1,1,"1",1,2,0,"D"
"24562",2011-09-24,2011,"Toulouse FC","AS Nancy","1-0",1,0,"1",1,1,1,"H"
"24563",2011-09-24,2011,"Valenciennes FC","Olympique Marseille","1-1",1,1,"1",1,2,0,"D"
"24564",2011-09-24,2011,"Montpellier HSC","Paris Saint-Germain","0-3",0,3,"1",1,3,-3,"D"
"24565",2011-09-25,2011,"AJ Auxerre","FC Sochaux","4-1",4,1,"1",1,5,3,"H"
"24566",2011-09-25,2011,"Stade Brest","AC Ajaccio","1-1",1,1,"1",1,2,0,"D"
"24567",2011-09-25,2011,"Stade Rennes","AS Saint-Etienne","1-1",1,1,"1",1,2,0,"D"
"24568",2011-10-01,2011,"SM Caen","OGC Nice","1-1",1,1,"1",1,2,0,"D"
"24569",2011-10-01,2011,"Dijon FCO","AC Ajaccio","1-1",1,1,"1",1,2,0,"D"
"24570",2011-10-01,2011,"FC Lorient","Valenciennes FC","2-0",2,0,"1",1,2,2,"H"
"24571",2011-10-01,2011,"AS Nancy","Evian Thonon Gaillard","1-1",1,1,"1",1,2,0,"D"
"24572",2011-10-01,2011,"AS Saint-Etienne","AJ Auxerre","1-1",1,1,"1",1,2,0,"D"
"24573",2011-10-01,2011,"FC Sochaux","Toulouse FC","3-0",3,0,"1",1,3,3,"H"
"24574",2011-10-01,2011,"Girondins Bordeaux","Montpellier HSC","2-2",2,2,"1",1,4,0,"D"
"24575",2011-10-02,2011,"Lille OSC","Stade Rennes","2-0",2,0,"1",1,2,2,"H"
"24576",2011-10-02,2011,"Olympique Marseille","Stade Brest","1-1",1,1,"1",1,2,0,"D"
"24577",2011-10-02,2011,"Paris Saint-Germain","Olympique Lyon","2-0",2,0,"1",1,2,2,"H"
"24578",2011-10-15,2011,"AJ Auxerre","Lille OSC","1-3",1,3,"1",1,4,-2,"D"
"24579",2011-10-15,2011,"Stade Brest","SM Caen","1-1",1,1,"1",1,2,0,"D"
"24580",2011-10-15,2011,"Evian Thonon Gaillard","AS Saint-Etienne","1-2",1,2,"1",1,3,-1,"D"
"24581",2011-10-15,2011,"Olympique Lyon","AS Nancy","3-1",3,1,"1",1,4,2,"H"
"24582",2011-10-15,2011,"Montpellier HSC","Dijon FCO","5-3",5,3,"1",1,8,2,"H"
"24583",2011-10-15,2011,"Toulouse FC","Olympique Marseille","0-0",0,0,"1",1,0,0,"D"
"24584",2011-10-15,2011,"OGC Nice","Girondins Bordeaux","3-0",3,0,"1",1,3,3,"H"
"24585",2011-10-16,2011,"AC Ajaccio","Paris Saint-Germain","1-3",1,3,"1",1,4,-2,"D"
"24586",2011-10-16,2011,"Valenciennes FC","FC Sochaux","3-0",3,0,"1",1,3,3,"H"
"24587",2011-10-16,2011,"Stade Rennes","FC Lorient","2-0",2,0,"1",1,2,2,"H"
"24588",2011-10-22,2011,"Girondins Bordeaux","Stade Brest","1-1",1,1,"1",1,2,0,"D"
"24589",2011-10-22,2011,"SM Caen","Montpellier HSC","1-3",1,3,"1",1,4,-2,"D"
"24590",2011-10-22,2011,"Olympique Marseille","AC Ajaccio","2-0",2,0,"1",1,2,2,"H"
"24591",2011-10-22,2011,"AS Nancy","OGC Nice","1-0",1,0,"1",1,1,1,"H"
"24592",2011-10-22,2011,"AS Saint-Etienne","Valenciennes FC","1-0",1,0,"1",1,1,1,"H"
"24593",2011-10-22,2011,"FC Sochaux","Evian Thonon Gaillard","1-1",1,1,"1",1,2,0,"D"
"24594",2011-10-22,2011,"FC Lorient","Toulouse FC","0-0",0,0,"1",1,0,0,"D"
"24595",2011-10-23,2011,"AJ Auxerre","Stade Rennes","0-1",0,1,"1",1,1,-1,"D"
"24596",2011-10-23,2011,"Paris Saint-Germain","Dijon FCO","2-0",2,0,"1",1,2,2,"H"
"24597",2011-10-23,2011,"Lille OSC","Olympique Lyon","3-1",3,1,"1",1,4,2,"H"
"24598",2011-10-29,2011,"AC Ajaccio","Girondins Bordeaux","0-2",0,2,"1",1,2,-2,"D"
"24599",2011-10-29,2011,"Stade Brest","FC Lorient","3-1",3,1,"1",1,4,2,"H"
"24600",2011-10-29,2011,"Dijon FCO","Olympique Marseille","2-3",2,3,"1",1,5,-1,"D"
"24601",2011-10-29,2011,"Evian Thonon Gaillard","AJ Auxerre","3-1",3,1,"1",1,4,2,"H"
"24602",2011-10-29,2011,"Montpellier HSC","AS Nancy","2-0",2,0,"1",1,2,2,"H"
"24603",2011-10-29,2011,"Paris Saint-Germain","SM Caen","4-2",4,2,"1",1,6,2,"H"
"24604",2011-10-29,2011,"Olympique Lyon","AS Saint-Etienne","2-0",2,0,"1",1,2,2,"H"
"24605",2011-10-30,2011,"OGC Nice","FC Sochaux","1-1",1,1,"1",1,2,0,"D"
"24606",2011-10-30,2011,"Toulouse FC","Stade Rennes","1-0",1,0,"1",1,1,1,"H"
"24607",2011-10-30,2011,"Valenciennes FC","Lille OSC","0-0",0,0,"1",1,0,0,"D"
"24608",2011-11-05,2011,"Lille OSC","Evian Thonon Gaillard","1-1",1,1,"1",1,2,0,"D"
"24609",2011-11-06,2011,"SM Caen","Dijon FCO","3-0",3,0,"1",1,3,3,"H"
"24610",2011-11-06,2011,"FC Lorient","AC Ajaccio","2-0",2,0,"1",1,2,2,"H"
"24611",2011-11-06,2011,"Olympique Marseille","OGC Nice","2-0",2,0,"1",1,2,2,"H"
"24612",2011-11-06,2011,"AS Nancy","Stade Brest","2-1",2,1,"1",1,3,1,"H"
"24613",2011-11-06,2011,"Stade Rennes","Valenciennes FC","1-1",1,1,"1",1,2,0,"D"
"24614",2011-11-06,2011,"AS Saint-Etienne","Montpellier HSC","1-1",1,1,"1",1,2,0,"D"
"24615",2011-11-06,2011,"FC Sochaux","Olympique Lyon","2-1",2,1,"1",1,3,1,"H"
"24616",2011-11-06,2011,"AJ Auxerre","Toulouse FC","2-0",2,0,"1",1,2,2,"H"
"24617",2011-11-06,2011,"Girondins Bordeaux","Paris Saint-Germain","1-1",1,1,"1",1,2,0,"D"
"24618",2011-11-18,2011,"Olympique Lyon","Stade Rennes","1-2",1,2,"1",1,3,-1,"D"
"24619",2011-11-18,2011,"Toulouse FC","Lille OSC","0-0",0,0,"1",1,0,0,"D"
"24620",2011-11-19,2011,"AC Ajaccio","SM Caen","2-2",2,2,"1",1,4,0,"D"
"24621",2011-11-19,2011,"Dijon FCO","Girondins Bordeaux","2-0",2,0,"1",1,2,2,"H"
"24622",2011-11-19,2011,"Evian Thonon Gaillard","FC Lorient","2-1",2,1,"1",1,3,1,"H"
"24623",2011-11-19,2011,"OGC Nice","AS Saint-Etienne","0-2",0,2,"1",1,2,-2,"D"
"24624",2011-11-19,2011,"Montpellier HSC","Olympique Marseille","1-0",1,0,"1",1,1,1,"H"
"24625",2011-11-20,2011,"Stade Brest","FC Sochaux","2-0",2,0,"1",1,2,2,"H"
"24626",2011-11-20,2011,"Valenciennes FC","AJ Auxerre","2-1",2,1,"1",1,3,1,"H"
"24627",2011-11-20,2011,"Paris Saint-Germain","AS Nancy","0-1",0,1,"1",1,1,-1,"D"
"24628",2011-11-26,2011,"Girondins Bordeaux","SM Caen","2-0",2,0,"1",1,2,2,"H"
"24629",2011-11-26,2011,"AS Nancy","Dijon FCO","1-2",1,2,"1",1,3,-1,"D"
"24630",2011-11-26,2011,"Stade Rennes","Evian Thonon Gaillard","3-2",3,2,"1",1,5,1,"H"
"24631",2011-11-26,2011,"AS Saint-Etienne","AC Ajaccio","3-1",3,1,"1",1,4,2,"H"
"24632",2011-11-26,2011,"FC Sochaux","Montpellier HSC","1-3",1,3,"1",1,4,-2,"D"
"24633",2011-11-26,2011,"Toulouse FC","Valenciennes FC","2-0",2,0,"1",1,2,2,"H"
"24634",2011-11-26,2011,"Lille OSC","Stade Brest","2-0",2,0,"1",1,2,2,"H"
"24635",2011-11-27,2011,"AJ Auxerre","Olympique Lyon","0-3",0,3,"1",1,3,-3,"D"
"24636",2011-11-27,2011,"FC Lorient","OGC Nice","1-0",1,0,"1",1,1,1,"H"
"24637",2011-11-27,2011,"Olympique Marseille","Paris Saint-Germain","3-0",3,0,"1",1,3,3,"H"
"24638",2011-12-02,2011,"SM Caen","Olympique Marseille","1-2",1,2,"1",1,3,-1,"D"
"24639",2011-12-03,2011,"AC Ajaccio","Lille OSC","2-3",2,3,"1",1,5,-1,"D"
"24640",2011-12-03,2011,"Stade Brest","AS Saint-Etienne","2-2",2,2,"1",1,4,0,"D"
"24641",2011-12-03,2011,"Dijon FCO","FC Sochaux","0-0",0,0,"1",1,0,0,"D"
"24642",2011-12-03,2011,"Evian Thonon Gaillard","Valenciennes FC","2-1",2,1,"1",1,3,1,"H"
"24643",2011-12-03,2011,"Montpellier HSC","FC Lorient","4-0",4,0,"1",1,4,4,"H"
"24644",2011-12-03,2011,"OGC Nice","Stade Rennes","2-0",2,0,"1",1,2,2,"H"
"24645",2011-12-04,2011,"Girondins Bordeaux","AS Nancy","2-0",2,0,"1",1,2,2,"H"
"24646",2011-12-04,2011,"Paris Saint-Germain","AJ Auxerre","3-2",3,2,"1",1,5,1,"H"
"24647",2011-12-04,2011,"Olympique Lyon","Toulouse FC","3-2",3,2,"1",1,5,1,"H"
"24648",2011-12-10,2011,"AS Nancy","AC Ajaccio","2-2",2,2,"1",1,4,0,"D"
"24649",2011-12-10,2011,"Stade Rennes","Stade Brest","1-1",1,1,"1",1,2,0,"D"
"24650",2011-12-10,2011,"AS Saint-Etienne","SM Caen","2-0",2,0,"1",1,2,2,"H"
"24651",2011-12-10,2011,"FC Sochaux","Paris Saint-Germain","0-1",0,1,"1",1,1,-1,"D"
"24652",2011-12-10,2011,"Toulouse FC","Evian Thonon Gaillard","2-1",2,1,"1",1,3,1,"H"
"24653",2011-12-10,2011,"Valenciennes FC","Montpellier HSC","1-0",1,0,"1",1,1,1,"H"
"24654",2011-12-10,2011,"Olympique Marseille","Girondins Bordeaux","0-0",0,0,"1",1,0,0,"D"
"24655",2011-12-11,2011,"AJ Auxerre","OGC Nice","2-1",2,1,"1",1,3,1,"H"
"24656",2011-12-11,2011,"Lille OSC","Dijon FCO","2-0",2,0,"1",1,2,2,"H"
"24657",2011-12-11,2011,"FC Lorient","Olympique Lyon","0-1",0,1,"1",1,1,-1,"D"
"24658",2011-12-17,2011,"Stade Brest","AJ Auxerre","1-0",1,0,"1",1,1,1,"H"
"24659",2011-12-17,2011,"SM Caen","AS Nancy","1-2",1,2,"1",1,3,-1,"D"
"24660",2011-12-17,2011,"Dijon FCO","AS Saint-Etienne","1-2",1,2,"1",1,3,-1,"D"
"24661",2011-12-17,2011,"Olympique Marseille","FC Lorient","2-1",2,1,"1",1,3,1,"H"
"24662",2011-12-17,2011,"Montpellier HSC","Toulouse FC","1-1",1,1,"1",1,2,0,"D"
"24663",2011-12-17,2011,"OGC Nice","Valenciennes FC","2-0",2,0,"1",1,2,2,"H"
"24664",2011-12-17,2011,"Olympique Lyon","Evian Thonon Gaillard","2-1",2,1,"1",1,3,1,"H"
"24665",2011-12-18,2011,"AC Ajaccio","Stade Rennes","1-0",1,0,"1",1,1,1,"H"
"24666",2011-12-18,2011,"Girondins Bordeaux","FC Sochaux","1-0",1,0,"1",1,1,1,"H"
"24667",2011-12-18,2011,"Paris Saint-Germain","Lille OSC","0-0",0,0,"1",1,0,0,"D"
"24668",2011-12-20,2011,"AS Nancy","Olympique Marseille","1-3",1,3,"1",1,4,-2,"D"
"24669",2011-12-21,2011,"AJ Auxerre","Dijon FCO","2-2",2,2,"1",1,4,0,"D"
"24670",2011-12-21,2011,"Evian Thonon Gaillard","Montpellier HSC","4-2",4,2,"1",1,6,2,"H"
"24671",2011-12-21,2011,"Lille OSC","OGC Nice","4-4",4,4,"1",1,8,0,"D"
"24672",2011-12-21,2011,"FC Lorient","SM Caen","0-0",0,0,"1",1,0,0,"D"
"24673",2011-12-21,2011,"Stade Rennes","Girondins Bordeaux","1-0",1,0,"1",1,1,1,"H"
"24674",2011-12-21,2011,"FC Sochaux","AC Ajaccio","0-2",0,2,"1",1,2,-2,"D"
"24675",2011-12-21,2011,"Toulouse FC","Stade Brest","0-0",0,0,"1",1,0,0,"D"
"24676",2011-12-21,2011,"Valenciennes FC","Olympique Lyon","1-0",1,0,"1",1,1,1,"H"
"24677",2011-12-21,2011,"AS Saint-Etienne","Paris Saint-Germain","0-1",0,1,"1",1,1,-1,"D"
"24678",2012-01-14,2011,"AC Ajaccio","AJ Auxerre","2-1",2,1,"1",1,3,1,"H"
"24679",2012-01-14,2011,"Dijon FCO","Evian Thonon Gaillard","3-1",3,1,"1",1,4,2,"H"
"24680",2012-01-14,2011,"AS Nancy","FC Lorient","2-2",2,2,"1",1,4,0,"D"
"24681",2012-01-14,2011,"Montpellier HSC","Olympique Lyon","1-0",1,0,"1",1,1,1,"H"
"24682",2012-01-14,2011,"Stade Brest","OGC Nice","1-0",1,0,"1",1,1,1,"H"
"24683",2012-01-14,2011,"SM Caen","Stade Rennes","0-2",0,2,"1",1,2,-2,"D"
"24684",2012-01-14,2011,"AS Saint-Etienne","FC Sochaux","1-0",1,0,"1",1,1,1,"H"
"24685",2012-01-14,2011,"Paris Saint-Germain","Toulouse FC","3-1",3,1,"1",1,4,2,"H"
"24686",2012-01-14,2011,"Girondins Bordeaux","Valenciennes FC","2-1",2,1,"1",1,3,1,"H"
"24687",2012-01-15,2011,"Olympique Marseille","Lille OSC","2-0",2,0,"1",1,2,2,"H"
"24688",2012-01-28,2011,"Toulouse FC","SM Caen","1-0",1,0,"1",1,1,1,"H"
"24689",2012-01-28,2011,"Olympique Lyon","Dijon FCO","3-1",3,1,"1",1,4,2,"H"
"24690",2012-01-28,2011,"OGC Nice","Montpellier HSC","0-1",0,1,"1",1,1,-1,"D"
"24691",2012-01-28,2011,"AJ Auxerre","AS Nancy","1-3",1,3,"1",1,4,-2,"D"
"24692",2012-01-28,2011,"Stade Brest","Paris Saint-Germain","0-1",0,1,"1",1,1,-1,"D"
"24693",2012-01-28,2011,"FC Lorient","FC Sochaux","1-1",1,1,"1",1,2,0,"D"
"24694",2012-01-28,2011,"Lille OSC","AS Saint-Etienne","3-0",3,0,"1",1,3,3,"H"
"24695",2012-01-29,2011,"Valenciennes FC","AC Ajaccio","1-2",1,2,"1",1,3,-1,"D"
"24696",2012-01-29,2011,"Evian Thonon Gaillard","Girondins Bordeaux","0-0",0,0,"1",1,0,0,"D"
"24697",2012-01-29,2011,"Stade Rennes","Olympique Marseille","1-2",1,2,"1",1,3,-1,"D"
"24698",2012-02-04,2011,"AS Nancy","Stade Rennes","0-0",0,0,"1",1,0,0,"D"
"24699",2012-02-04,2011,"Dijon FCO","Valenciennes FC","1-2",1,2,"1",1,3,-1,"D"
"24700",2012-02-04,2011,"Montpellier HSC","Stade Brest","1-0",1,0,"1",1,1,1,"H"
"24701",2012-02-04,2011,"Paris Saint-Germain","Evian Thonon Gaillard","3-1",3,1,"1",1,4,2,"H"
"24702",2012-02-04,2011,"AC Ajaccio","OGC Nice","1-1",1,1,"1",1,2,0,"D"
"24703",2012-02-04,2011,"Girondins Bordeaux","Toulouse FC","2-0",2,0,"1",1,2,2,"H"
"24704",2012-02-05,2011,"Olympique Marseille","Olympique Lyon","2-2",2,2,"1",1,4,0,"D"
"24705",2012-02-11,2011,"Montpellier HSC","AC Ajaccio","3-0",3,0,"1",1,3,3,"H"
"24706",2012-02-11,2011,"Olympique Lyon","SM Caen","1-2",1,2,"1",1,3,-1,"D"
"24707",2012-02-11,2011,"AJ Auxerre","FC Lorient","1-1",1,1,"1",1,2,0,"D"
"24708",2012-02-11,2011,"Valenciennes FC","AS Nancy","1-0",1,0,"1",1,1,1,"H"
"24709",2012-02-11,2011,"Stade Rennes","FC Sochaux","1-0",1,0,"1",1,1,1,"H"
"24710",2012-02-11,2011,"Stade Brest","Dijon FCO","1-1",1,1,"1",1,2,0,"D"
"24711",2012-02-12,2011,"Lille OSC","Girondins Bordeaux","4-5",4,5,"1",1,9,-1,"D"
"24712",2012-02-12,2011,"OGC Nice","Paris Saint-Germain","0-0",0,0,"1",1,0,0,"D"
"24713",2012-02-12,2011,"Toulouse FC","AS Saint-Etienne","0-1",0,1,"1",1,1,-1,"D"
"24714",2012-02-18,2011,"FC Sochaux","AJ Auxerre","0-0",0,0,"1",1,0,0,"D"
"24715",2012-02-18,2011,"AC Ajaccio","Stade Brest","0-0",0,0,"1",1,0,0,"D"
"24716",2012-02-18,2011,"SM Caen","Evian Thonon Gaillard","2-2",2,2,"1",1,4,0,"D"
"24717",2012-02-18,2011,"FC Lorient","Lille OSC","0-1",0,1,"1",1,1,-1,"D"
"24718",2012-02-18,2011,"Dijon FCO","OGC Nice","3-0",3,0,"1",1,3,3,"H"
"24719",2012-02-18,2011,"AS Nancy","Toulouse FC","0-3",0,3,"1",1,3,-3,"D"
"24720",2012-02-18,2011,"Olympique Marseille","Valenciennes FC","1-1",1,1,"1",1,2,0,"D"
"24721",2012-02-19,2011,"Girondins Bordeaux","Olympique Lyon","1-0",1,0,"1",1,1,1,"H"
"24722",2012-02-19,2011,"AS Saint-Etienne","Stade Rennes","4-0",4,0,"1",1,4,4,"H"
"24723",2012-02-19,2011,"Paris Saint-Germain","Montpellier HSC","2-2",2,2,"1",1,4,0,"D"
"24724",2012-02-22,2011,"SM Caen","AJ Auxerre","2-1",2,1,"1",1,3,1,"H"
"24725",2012-02-22,2011,"FC Sochaux","Lille OSC","0-1",0,1,"1",1,1,-1,"D"
"24726",2012-02-22,2011,"AS Saint-Etienne","FC Lorient","4-2",4,2,"1",1,6,2,"H"
"24727",2012-02-25,2011,"Montpellier HSC","Girondins Bordeaux","1-0",1,0,"1",1,1,1,"H"
"24728",2012-02-25,2011,"OGC Nice","SM Caen","1-0",1,0,"1",1,1,1,"H"
"24729",2012-02-25,2011,"AC Ajaccio","Dijon FCO","2-1",2,1,"1",1,3,1,"H"
"24730",2012-02-25,2011,"Valenciennes FC","FC Lorient","2-0",2,0,"1",1,2,2,"H"
"24731",2012-02-25,2011,"Evian Thonon Gaillard","AS Nancy","2-0",2,0,"1",1,2,2,"H"
"24732",2012-02-25,2011,"AJ Auxerre","AS Saint-Etienne","0-0",0,0,"1",1,0,0,"D"
"24733",2012-02-25,2011,"Olympique Lyon","Paris Saint-Germain","4-4",4,4,"1",1,8,0,"D"
"24734",2012-02-26,2011,"Stade Brest","Olympique Marseille","1-0",1,0,"1",1,1,1,"H"
"24735",2012-02-26,2011,"Toulouse FC","FC Sochaux","2-0",2,0,"1",1,2,2,"H"
"24736",2012-02-26,2011,"Stade Rennes","Lille OSC","1-1",1,1,"1",1,2,0,"D"
"24737",2012-03-03,2011,"Lille OSC","AJ Auxerre","2-2",2,2,"1",1,4,0,"D"
"24738",2012-03-03,2011,"AS Saint-Etienne","Evian Thonon Gaillard","0-2",0,2,"1",1,2,-2,"D"
"24739",2012-03-03,2011,"AS Nancy","Olympique Lyon","2-0",2,0,"1",1,2,2,"H"
"24740",2012-03-03,2011,"Dijon FCO","Montpellier HSC","1-1",1,1,"1",1,2,0,"D"
"24741",2012-03-03,2011,"Olympique Marseille","Toulouse FC","0-1",0,1,"1",1,1,-1,"D"
"24742",2012-03-03,2011,"FC Sochaux","Valenciennes FC","1-1",1,1,"1",1,2,0,"D"
"24743",2012-03-03,2011,"Girondins Bordeaux","OGC Nice","1-2",1,2,"1",1,3,-1,"D"
"24744",2012-03-04,2011,"Paris Saint-Germain","AC Ajaccio","4-1",4,1,"1",1,5,3,"H"
"24745",2012-03-04,2011,"SM Caen","Stade Brest","0-0",0,0,"1",1,0,0,"D"
"24746",2012-03-04,2011,"FC Lorient","Stade Rennes","0-2",0,2,"1",1,2,-2,"D"
"24747",2012-03-06,2011,"Evian Thonon Gaillard","Olympique Marseille","2-0",2,0,"1",1,2,2,"H"
"24748",2012-03-09,2011,"AC Ajaccio","Olympique Marseille","1-0",1,0,"1",1,1,1,"H"
"24749",2012-03-10,2011,"Stade Brest","Girondins Bordeaux","0-2",0,2,"1",1,2,-2,"D"
"24750",2012-03-10,2011,"Toulouse FC","FC Lorient","1-1",1,1,"1",1,2,0,"D"
"24751",2012-03-10,2011,"OGC Nice","AS Nancy","1-1",1,1,"1",1,2,0,"D"
"24752",2012-03-10,2011,"Valenciennes FC","AS Saint-Etienne","1-2",1,2,"1",1,3,-1,"D"
"24753",2012-03-10,2011,"Evian Thonon Gaillard","FC Sochaux","2-3",2,3,"1",1,5,-1,"D"
"24754",2012-03-10,2011,"Olympique Lyon","Lille OSC","2-1",2,1,"1",1,3,1,"H"
"24755",2012-03-11,2011,"Stade Rennes","AJ Auxerre","1-1",1,1,"1",1,2,0,"D"
"24756",2012-03-11,2011,"Dijon FCO","Paris Saint-Germain","1-2",1,2,"1",1,3,-1,"D"
"24757",2012-03-11,2011,"Montpellier HSC","SM Caen","3-0",3,0,"1",1,3,3,"H"
"24758",2012-03-17,2011,"Girondins Bordeaux","AC Ajaccio","1-1",1,1,"1",1,2,0,"D"
"24759",2012-03-17,2011,"FC Lorient","Stade Brest","2-1",2,1,"1",1,3,1,"H"
"24760",2012-03-17,2011,"Olympique Marseille","Dijon FCO","1-2",1,2,"1",1,3,-1,"D"
"24761",2012-03-17,2011,"AJ Auxerre","Evian Thonon Gaillard","0-2",0,2,"1",1,2,-2,"D"
"24762",2012-03-17,2011,"AS Nancy","Montpellier HSC","1-0",1,0,"1",1,1,1,"H"
"24763",2012-03-17,2011,"SM Caen","Paris Saint-Germain","2-2",2,2,"1",1,4,0,"D"
"24764",2012-03-17,2011,"AS Saint-Etienne","Olympique Lyon","0-1",0,1,"1",1,1,-1,"D"
"24765",2012-03-18,2011,"FC Sochaux","OGC Nice","2-0",2,0,"1",1,2,2,"H"
"24766",2012-03-18,2011,"Stade Rennes","Toulouse FC","0-1",0,1,"1",1,1,-1,"D"
"24767",2012-03-18,2011,"Lille OSC","Valenciennes FC","4-0",4,0,"1",1,4,4,"H"
"24768",2012-03-24,2011,"Evian Thonon Gaillard","Lille OSC","0-3",0,3,"1",1,3,-3,"D"
"24769",2012-03-24,2011,"AC Ajaccio","FC Lorient","1-1",1,1,"1",1,2,0,"D"
"24770",2012-03-24,2011,"OGC Nice","Olympique Marseille","1-1",1,1,"1",1,2,0,"D"
"24771",2012-03-24,2011,"Stade Brest","AS Nancy","0-1",0,1,"1",1,1,-1,"D"
"24772",2012-03-24,2011,"Montpellier HSC","AS Saint-Etienne","1-0",1,0,"1",1,1,1,"H"
"24773",2012-03-24,2011,"Olympique Lyon","FC Sochaux","2-1",2,1,"1",1,3,1,"H"
"24774",2012-03-24,2011,"Valenciennes FC","Stade Rennes","1-0",1,0,"1",1,1,1,"H"
"24775",2012-03-25,2011,"Toulouse FC","AJ Auxerre","1-0",1,0,"1",1,1,1,"H"
"24776",2012-03-25,2011,"Dijon FCO","SM Caen","2-0",2,0,"1",1,2,2,"H"
"24777",2012-03-25,2011,"Paris Saint-Germain","Girondins Bordeaux","1-1",1,1,"1",1,2,0,"D"
"24778",2012-03-31,2011,"FC Sochaux","Stade Brest","2-1",2,1,"1",1,3,1,"H"
"24779",2012-03-31,2011,"Girondins Bordeaux","Dijon FCO","1-1",1,1,"1",1,2,0,"D"
"24780",2012-03-31,2011,"FC Lorient","Evian Thonon Gaillard","0-1",0,1,"1",1,1,-1,"D"
"24781",2012-03-31,2011,"AS Saint-Etienne","OGC Nice","2-3",2,3,"1",1,5,-1,"D"
"24782",2012-03-31,2011,"AJ Auxerre","Valenciennes FC","2-0",2,0,"1",1,2,2,"H"
"24783",2012-03-31,2011,"AS Nancy","Paris Saint-Germain","2-1",2,1,"1",1,3,1,"H"
"24784",2012-04-01,2011,"SM Caen","AC Ajaccio","0-0",0,0,"1",1,0,0,"D"
"24785",2012-04-01,2011,"Lille OSC","Toulouse FC","2-1",2,1,"1",1,3,1,"H"
"24786",2012-04-01,2011,"Stade Rennes","Olympique Lyon","1-1",1,1,"1",1,2,0,"D"
"24787",2012-04-07,2011,"Stade Brest","Lille OSC","3-1",3,1,"1",1,4,2,"H"
"24788",2012-04-07,2011,"Dijon FCO","AS Nancy","0-2",0,2,"1",1,2,-2,"D"
"24789",2012-04-07,2011,"Evian Thonon Gaillard","Stade Rennes","1-3",1,3,"1",1,4,-2,"D"
"24790",2012-04-07,2011,"AC Ajaccio","AS Saint-Etienne","1-1",1,1,"1",1,2,0,"D"
"24791",2012-04-07,2011,"Montpellier HSC","FC Sochaux","2-1",2,1,"1",1,3,1,"H"
"24792",2012-04-07,2011,"Valenciennes FC","Toulouse FC","2-0",2,0,"1",1,2,2,"H"
"24793",2012-04-07,2011,"Olympique Lyon","AJ Auxerre","2-1",2,1,"1",1,3,1,"H"
"24794",2012-04-08,2011,"SM Caen","Girondins Bordeaux","1-0",1,0,"1",1,1,1,"H"
"24795",2012-04-08,2011,"OGC Nice","FC Lorient","2-0",2,0,"1",1,2,2,"H"
"24796",2012-04-08,2011,"Paris Saint-Germain","Olympique Marseille","2-1",2,1,"1",1,3,1,"H"
"24797",2012-04-11,2011,"Olympique Marseille","Montpellier HSC","1-3",1,3,"1",1,4,-2,"D"
"24798",2012-04-15,2011,"Lille OSC","AC Ajaccio","4-1",4,1,"1",1,5,3,"H"
"24799",2012-04-15,2011,"AS Nancy","Girondins Bordeaux","2-2",2,2,"1",1,4,0,"D"
"24800",2012-04-15,2011,"AS Saint-Etienne","Stade Brest","2-1",2,1,"1",1,3,1,"H"
"24801",2012-04-15,2011,"FC Sochaux","Dijon FCO","1-0",1,0,"1",1,1,1,"H"
"24802",2012-04-15,2011,"Valenciennes FC","Evian Thonon Gaillard","0-3",0,3,"1",1,3,-3,"D"
"24803",2012-04-15,2011,"FC Lorient","Montpellier HSC","2-1",2,1,"1",1,3,1,"H"
"24804",2012-04-15,2011,"AJ Auxerre","Paris Saint-Germain","1-1",1,1,"1",1,2,0,"D"
"24805",2012-04-16,2011,"Stade Rennes","OGC Nice","3-1",3,1,"1",1,4,2,"H"
"24806",2012-04-18,2011,"Olympique Marseille","SM Caen","1-1",1,1,"1",1,2,0,"D"
"24807",2012-04-18,2011,"Toulouse FC","Olympique Lyon","3-0",3,0,"1",1,3,3,"H"
"24808",2012-04-21,2011,"OGC Nice","AJ Auxerre","1-0",1,0,"1",1,1,1,"H"
"24809",2012-04-21,2011,"Dijon FCO","Lille OSC","0-2",0,2,"1",1,2,-2,"D"
"24810",2012-04-21,2011,"Stade Brest","Stade Rennes","0-1",0,1,"1",1,1,-1,"D"
"24811",2012-04-21,2011,"SM Caen","AS Saint-Etienne","1-4",1,4,"1",1,5,-3,"D"
"24812",2012-04-21,2011,"Evian Thonon Gaillard","Toulouse FC","2-1",2,1,"1",1,3,1,"H"
"24813",2012-04-21,2011,"Montpellier HSC","Valenciennes FC","1-0",1,0,"1",1,1,1,"H"
"24814",2012-04-21,2011,"Girondins Bordeaux","Olympique Marseille","2-1",2,1,"1",1,3,1,"H"
"24815",2012-04-22,2011,"AC Ajaccio","AS Nancy","0-0",0,0,"1",1,0,0,"D"
"24816",2012-04-22,2011,"Paris Saint-Germain","FC Sochaux","6-1",6,1,"1",1,7,5,"H"
"24817",2012-04-22,2011,"Olympique Lyon","FC Lorient","3-2",3,2,"1",1,5,1,"H"
"24818",2012-04-27,2011,"Toulouse FC","Montpellier HSC","0-1",0,1,"1",1,1,-1,"D"
"24819",2012-04-27,2011,"FC Lorient","Olympique Marseille","2-1",2,1,"1",1,3,1,"H"
"24820",2012-04-29,2011,"Stade Rennes","AC Ajaccio","3-1",3,1,"1",1,4,2,"H"
"24821",2012-04-29,2011,"FC Sochaux","Girondins Bordeaux","0-3",0,3,"1",1,3,-3,"D"
"24822",2012-04-29,2011,"AJ Auxerre","Stade Brest","4-0",4,0,"1",1,4,4,"H"
"24823",2012-04-29,2011,"AS Nancy","SM Caen","1-1",1,1,"1",1,2,0,"D"
"24824",2012-04-29,2011,"AS Saint-Etienne","Dijon FCO","1-0",1,0,"1",1,1,1,"H"
"24825",2012-04-29,2011,"Valenciennes FC","OGC Nice","2-0",2,0,"1",1,2,2,"H"
"24826",2012-04-29,2011,"Lille OSC","Paris Saint-Germain","2-1",2,1,"1",1,3,1,"H"
"24827",2012-05-01,2011,"Montpellier HSC","Evian Thonon Gaillard","2-2",2,2,"1",1,4,0,"D"
"24828",2012-05-02,2011,"OGC Nice","Lille OSC","0-1",0,1,"1",1,1,-1,"D"
"24829",2012-05-02,2011,"SM Caen","FC Lorient","1-0",1,0,"1",1,1,1,"H"
"24830",2012-05-02,2011,"Olympique Marseille","AS Nancy","1-0",1,0,"1",1,1,1,"H"
"24831",2012-05-02,2011,"Girondins Bordeaux","Stade Rennes","2-0",2,0,"1",1,2,2,"H"
"24832",2012-05-02,2011,"AC Ajaccio","FC Sochaux","2-1",2,1,"1",1,3,1,"H"
"24833",2012-05-02,2011,"Stade Brest","Toulouse FC","0-0",0,0,"1",1,0,0,"D"
"24834",2012-05-02,2011,"Olympique Lyon","Valenciennes FC","4-1",4,1,"1",1,5,3,"H"
"24835",2012-05-02,2011,"Paris Saint-Germain","AS Saint-Etienne","2-0",2,0,"1",1,2,2,"H"
"24836",2012-05-03,2011,"Dijon FCO","AJ Auxerre","0-2",0,2,"1",1,2,-2,"D"
"24837",2012-05-06,2011,"Evian Thonon Gaillard","AC Ajaccio","2-1",2,1,"1",1,3,1,"H"
"24838",2012-05-06,2011,"Olympique Lyon","Stade Brest","1-1",1,1,"1",1,2,0,"D"
"24839",2012-05-06,2011,"Valenciennes FC","Paris Saint-Germain","3-4",3,4,"1",1,7,-1,"D"
"24840",2012-05-07,2011,"AJ Auxerre","Girondins Bordeaux","2-4",2,4,"1",1,6,-2,"D"
"24841",2012-05-07,2011,"Lille OSC","SM Caen","3-0",3,0,"1",1,3,3,"H"
"24842",2012-05-07,2011,"FC Lorient","Dijon FCO","0-0",0,0,"1",1,0,0,"D"
"24843",2012-05-07,2011,"AS Saint-Etienne","Olympique Marseille","0-0",0,0,"1",1,0,0,"D"
"24844",2012-05-07,2011,"FC Sochaux","AS Nancy","1-0",1,0,"1",1,1,1,"H"
"24845",2012-05-07,2011,"Toulouse FC","OGC Nice","0-0",0,0,"1",1,0,0,"D"
"24846",2012-05-07,2011,"Stade Rennes","Montpellier HSC","0-2",0,2,"1",1,2,-2,"D"
"24847",2012-05-10,2011,"Evian Thonon Gaillard","Olympique Lyon","1-3",1,3,"1",1,4,-2,"D"
"24848",2012-05-13,2011,"Olympique Marseille","AJ Auxerre","3-0",3,0,"1",1,3,3,"H"
"24849",2012-05-13,2011,"OGC Nice","Evian Thonon Gaillard","1-1",1,1,"1",1,2,0,"D"
"24850",2012-05-13,2011,"Montpellier HSC","Lille OSC","1-0",1,0,"1",1,1,1,"H"
"24851",2012-05-13,2011,"Girondins Bordeaux","FC Lorient","1-0",1,0,"1",1,1,1,"H"
"24852",2012-05-13,2011,"AC Ajaccio","Olympique Lyon","1-1",1,1,"1",1,2,0,"D"
"24853",2012-05-13,2011,"Paris Saint-Germain","Stade Rennes","3-0",3,0,"1",1,3,3,"H"
"24854",2012-05-13,2011,"SM Caen","FC Sochaux","1-3",1,3,"1",1,4,-2,"D"
"24855",2012-05-13,2011,"Dijon FCO","Toulouse FC","1-1",1,1,"1",1,2,0,"D"
"24856",2012-05-13,2011,"Stade Brest","Valenciennes FC","1-0",1,0,"1",1,1,1,"H"
"24857",2012-05-13,2011,"AS Nancy","AS Saint-Etienne","3-2",3,2,"1",1,5,1,"H"
"24858",2012-05-20,2011,"Toulouse FC","AC Ajaccio","0-2",0,2,"1",1,2,-2,"D"
"24859",2012-05-20,2011,"AS Saint-Etienne","Girondins Bordeaux","2-3",2,3,"1",1,5,-1,"D"
"24860",2012-05-20,2011,"Evian Thonon Gaillard","Stade Brest","0-1",0,1,"1",1,1,-1,"D"
"24861",2012-05-20,2011,"Valenciennes FC","SM Caen","3-1",3,1,"1",1,4,2,"H"
"24862",2012-05-20,2011,"Stade Rennes","Dijon FCO","5-0",5,0,"1",1,5,5,"H"
"24863",2012-05-20,2011,"FC Sochaux","Olympique Marseille","1-0",1,0,"1",1,1,1,"H"
"24864",2012-05-20,2011,"AJ Auxerre","Montpellier HSC","1-2",1,2,"1",1,3,-1,"D"
"24865",2012-05-20,2011,"Lille OSC","AS Nancy","4-1",4,1,"1",1,5,3,"H"
"24866",2012-05-20,2011,"Olympique Lyon","OGC Nice","3-4",3,4,"1",1,7,-1,"D"
"24867",2012-05-20,2011,"FC Lorient","Paris Saint-Germain","1-2",1,2,"1",1,3,-1,"D"
"24868",2012-08-10,2012,"Montpellier HSC","Toulouse FC","1-1",1,1,"1",1,2,0,"D"
"24869",2012-08-11,2012,"AS Nancy","Stade Brest","1-0",1,0,"1",1,1,1,"H"
"24870",2012-08-11,2012,"AS Saint-Etienne","Lille OSC","1-2",1,2,"1",1,3,-1,"D"
"24871",2012-08-11,2012,"ESTAC Troyes","Valenciennes FC","0-1",0,1,"1",1,1,-1,"D"
"24872",2012-08-11,2012,"Evian Thonon Gaillard","Girondins Bordeaux","2-3",2,3,"1",1,5,-1,"D"
"24873",2012-08-11,2012,"FC Sochaux","SC Bastia","2-3",2,3,"1",1,5,-1,"D"
"24874",2012-08-11,2012,"OGC Nice","AC Ajaccio","0-1",0,1,"1",1,1,-1,"D"
"24875",2012-08-11,2012,"Paris Saint-Germain","FC Lorient","2-2",2,2,"1",1,4,0,"D"
"24876",2012-08-11,2012,"Stade Rennes","Olympique Lyon","0-1",0,1,"1",1,1,-1,"D"
"24877",2012-08-12,2012,"Stade Reims","Olympique Marseille","0-1",0,1,"1",1,1,-1,"D"
"24878",2012-08-17,2012,"Lille OSC","AS Nancy","1-1",1,1,"1",1,2,0,"D"
"24879",2012-08-18,2012,"Olympique Lyon","ESTAC Troyes","4-1",4,1,"1",1,5,3,"H"
"24880",2012-08-18,2012,"FC Lorient","Montpellier HSC","2-1",2,1,"1",1,3,1,"H"
"24881",2012-08-18,2012,"SC Bastia","Stade Reims","2-1",2,1,"1",1,3,1,"H"
"24882",2012-08-18,2012,"Stade Brest","Evian Thonon Gaillard","1-0",1,0,"1",1,1,1,"H"
"24883",2012-08-18,2012,"Toulouse FC","AS Saint-Etienne","2-1",2,1,"1",1,3,1,"H"
"24884",2012-08-18,2012,"Valenciennes FC","OGC Nice","0-0",0,0,"1",1,0,0,"D"
"24885",2012-08-19,2012,"Girondins Bordeaux","Stade Rennes","1-0",1,0,"1",1,1,1,"H"
"24886",2012-08-19,2012,"Olympique Marseille","FC Sochaux","2-0",2,0,"1",1,2,2,"H"
"24887",2012-08-19,2012,"AC Ajaccio","Paris Saint-Germain","0-0",0,0,"1",1,0,0,"D"
"24888",2012-08-24,2012,"Evian Thonon Gaillard","Olympique Lyon","1-1",1,1,"1",1,2,0,"D"
"24889",2012-08-25,2012,"OGC Nice","Lille OSC","2-2",2,2,"1",1,4,0,"D"
"24890",2012-08-25,2012,"AS Nancy","Toulouse FC","0-1",0,1,"1",1,1,-1,"D"
"24891",2012-08-25,2012,"ESTAC Troyes","FC Lorient","2-2",2,2,"1",1,4,0,"D"
"24892",2012-08-25,2012,"Stade Reims","FC Sochaux","1-0",1,0,"1",1,1,1,"H"
"24893",2012-08-25,2012,"Stade Rennes","SC Bastia","3-2",3,2,"1",1,5,1,"H"
"24894",2012-08-25,2012,"Valenciennes FC","AC Ajaccio","3-0",3,0,"1",1,3,3,"H"
"24895",2012-08-26,2012,"AS Saint-Etienne","Stade Brest","4-0",4,0,"1",1,4,4,"H"
"24896",2012-08-26,2012,"Montpellier HSC","Olympique Marseille","0-1",0,1,"1",1,1,-1,"D"
"24897",2012-08-26,2012,"Paris Saint-Germain","Girondins Bordeaux","0-0",0,0,"1",1,0,0,"D"
"24898",2012-09-01,2012,"Olympique Lyon","Valenciennes FC","3-2",3,2,"1",1,5,1,"H"
"24899",2012-09-01,2012,"AC Ajaccio","Evian Thonon Gaillard","2-0",2,0,"1",1,2,2,"H"
"24900",2012-09-01,2012,"FC Lorient","AS Nancy","3-0",3,0,"1",1,3,3,"H"
"24901",2012-09-01,2012,"FC Sochaux","Montpellier HSC","1-3",1,3,"1",1,4,-2,"D"
"24902",2012-09-01,2012,"SC Bastia","AS Saint-Etienne","0-3",0,3,"1",1,3,-3,"D"
"24903",2012-09-01,2012,"Stade Brest","ESTAC Troyes","2-1",2,1,"1",1,3,1,"H"
"24904",2012-09-01,2012,"Toulouse FC","Stade Reims","1-1",1,1,"1",1,2,0,"D"
"24905",2012-09-02,2012,"Girondins Bordeaux","OGC Nice","1-1",1,1,"1",1,2,0,"D"
"24906",2012-09-02,2012,"Olympique Marseille","Stade Rennes","3-1",3,1,"1",1,4,2,"H"
"24907",2012-09-02,2012,"Lille OSC","Paris Saint-Germain","1-2",1,2,"1",1,3,-1,"D"
"24908",2012-09-14,2012,"Paris Saint-Germain","Toulouse FC","2-0",2,0,"1",1,2,2,"H"
"24909",2012-09-14,2012,"Stade Reims","Montpellier HSC","3-1",3,1,"1",1,4,2,"H"
"24910",2012-09-15,2012,"ESTAC Troyes","Lille OSC","1-1",1,1,"1",1,2,0,"D"
"24911",2012-09-15,2012,"AS Saint-Etienne","FC Sochaux","0-1",0,1,"1",1,1,-1,"D"
"24912",2012-09-15,2012,"Evian Thonon Gaillard","SC Bastia","3-0",3,0,"1",1,3,3,"H"
"24913",2012-09-15,2012,"OGC Nice","Stade Brest","4-2",4,2,"1",1,6,2,"H"
"24914",2012-09-15,2012,"Valenciennes FC","Girondins Bordeaux","0-0",0,0,"1",1,0,0,"D"
"24915",2012-09-16,2012,"Stade Rennes","FC Lorient","1-2",1,2,"1",1,3,-1,"D"
"24916",2012-09-16,2012,"Olympique Lyon","AC Ajaccio","2-0",2,0,"1",1,2,2,"H"
"24917",2012-09-16,2012,"AS Nancy","Olympique Marseille","0-1",0,1,"1",1,1,-1,"D"
"24918",2012-09-21,2012,"Montpellier HSC","AS Saint-Etienne","1-1",1,1,"1",1,2,0,"D"
"24919",2012-09-22,2012,"SC Bastia","Paris Saint-Germain","0-4",0,4,"1",1,4,-4,"D"
"24920",2012-09-22,2012,"FC Lorient","OGC Nice","1-1",1,1,"1",1,2,0,"D"
"24921",2012-09-22,2012,"FC Sochaux","ESTAC Troyes","3-1",3,1,"1",1,4,2,"H"
"24922",2012-09-22,2012,"Stade Brest","Valenciennes FC","2-1",2,1,"1",1,3,1,"H"
"24923",2012-09-22,2012,"Stade Reims","AS Nancy","2-0",2,0,"1",1,2,2,"H"
"24924",2012-09-22,2012,"Toulouse FC","Stade Rennes","2-2",2,2,"1",1,4,0,"D"
"24925",2012-09-23,2012,"Girondins Bordeaux","AC Ajaccio","2-2",2,2,"1",1,4,0,"D"
"24926",2012-09-23,2012,"Olympique Marseille","Evian Thonon Gaillard","1-0",1,0,"1",1,1,1,"H"
"24927",2012-09-23,2012,"Lille OSC","Olympique Lyon","1-1",1,1,"1",1,2,0,"D"
"24928",2012-09-28,2012,"Stade Rennes","Lille OSC","2-0",2,0,"1",1,2,2,"H"
"24929",2012-09-29,2012,"Paris Saint-Germain","FC Sochaux","2-0",2,0,"1",1,2,2,"H"
"24930",2012-09-29,2012,"AC Ajaccio","Stade Brest","1-0",1,0,"1",1,1,1,"H"
"24931",2012-09-29,2012,"AS Nancy","Montpellier HSC","0-2",0,2,"1",1,2,-2,"D"
"24932",2012-09-29,2012,"ESTAC Troyes","Toulouse FC","0-2",0,2,"1",1,2,-2,"D"
"24933",2012-09-29,2012,"Evian Thonon Gaillard","FC Lorient","1-1",1,1,"1",1,2,0,"D"
"24934",2012-09-29,2012,"OGC Nice","SC Bastia","2-2",2,2,"1",1,4,0,"D"
"24935",2012-09-30,2012,"Valenciennes FC","Olympique Marseille","4-1",4,1,"1",1,5,3,"H"
"24936",2012-09-30,2012,"AS Saint-Etienne","Stade Reims","0-0",0,0,"1",1,0,0,"D"
"24937",2012-09-30,2012,"Olympique Lyon","Girondins Bordeaux","0-2",0,2,"1",1,2,-2,"D"
"24938",2012-10-05,2012,"AS Saint-Etienne","AS Nancy","4-0",4,0,"1",1,4,4,"H"
"24939",2012-10-06,2012,"Montpellier HSC","Evian Thonon Gaillard","2-3",2,3,"1",1,5,-1,"D"
"24940",2012-10-06,2012,"FC Sochaux","Stade Rennes","0-1",0,1,"1",1,1,-1,"D"
"24941",2012-10-06,2012,"Lille OSC","AC Ajaccio","2-0",2,0,"1",1,2,2,"H"
"24942",2012-10-06,2012,"SC Bastia","ESTAC Troyes","3-2",3,2,"1",1,5,1,"H"
"24943",2012-10-06,2012,"Stade Reims","OGC Nice","3-1",3,1,"1",1,4,2,"H"
"24944",2012-10-06,2012,"Toulouse FC","Valenciennes FC","2-2",2,2,"1",1,4,0,"D"
"24945",2012-10-07,2012,"Stade Brest","Girondins Bordeaux","1-1",1,1,"1",1,2,0,"D"
"24946",2012-10-07,2012,"FC Lorient","Olympique Lyon","1-1",1,1,"1",1,2,0,"D"
"24947",2012-10-07,2012,"Olympique Marseille","Paris Saint-Germain","2-2",2,2,"1",1,4,0,"D"
"24948",2012-10-19,2012,"Girondins Bordeaux","Lille OSC","1-1",1,1,"1",1,2,0,"D"
"24949",2012-10-20,2012,"Paris Saint-Germain","Stade Reims","1-0",1,0,"1",1,1,1,"H"
"24950",2012-10-20,2012,"AS Nancy","FC Sochaux","1-1",1,1,"1",1,2,0,"D"
"24951",2012-10-20,2012,"Evian Thonon Gaillard","Toulouse FC","0-4",0,4,"1",1,4,-4,"D"
"24952",2012-10-20,2012,"OGC Nice","AS Saint-Etienne","1-1",1,1,"1",1,2,0,"D"
"24953",2012-10-20,2012,"Stade Rennes","Montpellier HSC","2-1",2,1,"1",1,3,1,"H"
"24954",2012-10-20,2012,"Valenciennes FC","FC Lorient","6-1",6,1,"1",1,7,5,"H"
"24955",2012-10-21,2012,"AC Ajaccio","SC Bastia","0-0",0,0,"1",1,0,0,"D"
"24956",2012-10-21,2012,"Olympique Lyon","Stade Brest","1-0",1,0,"1",1,1,1,"H"
"24957",2012-10-21,2012,"ESTAC Troyes","Olympique Marseille","1-0",1,0,"1",1,1,1,"H"
"24958",2012-10-26,2012,"AS Saint-Etienne","Stade Rennes","2-0",2,0,"1",1,2,2,"H"
"24959",2012-10-27,2012,"Lille OSC","Valenciennes FC","2-1",2,1,"1",1,3,1,"H"
"24960",2012-10-27,2012,"AS Nancy","Paris Saint-Germain","0-1",0,1,"1",1,1,-1,"D"
"24961",2012-10-27,2012,"Montpellier HSC","OGC Nice","3-1",3,1,"1",1,4,2,"H"
"24962",2012-10-27,2012,"Stade Reims","ESTAC Troyes","1-1",1,1,"1",1,2,0,"D"
"24963",2012-10-27,2012,"Toulouse FC","Stade Brest","3-1",3,1,"1",1,4,2,"H"
"24964",2012-10-28,2012,"FC Lorient","AC Ajaccio","4-4",4,4,"1",1,8,0,"D"
"24965",2012-10-28,2012,"SC Bastia","Girondins Bordeaux","3-1",3,1,"1",1,4,2,"H"
"24966",2012-11-02,2012,"Stade Brest","FC Lorient","2-0",2,0,"1",1,2,2,"H"
"24967",2012-11-03,2012,"Paris Saint-Germain","AS Saint-Etienne","1-2",1,2,"1",1,3,-1,"D"
"24968",2012-11-03,2012,"ESTAC Troyes","Montpellier HSC","1-1",1,1,"1",1,2,0,"D"
"24969",2012-11-03,2012,"Evian Thonon Gaillard","Lille OSC","0-2",0,2,"1",1,2,-2,"D"
"24970",2012-11-03,2012,"OGC Nice","AS Nancy","2-1",2,1,"1",1,3,1,"H"
"24971",2012-11-03,2012,"Stade Rennes","Stade Reims","1-0",1,0,"1",1,1,1,"H"
"24972",2012-11-03,2012,"Valenciennes FC","FC Sochaux","3-1",3,1,"1",1,4,2,"H"
"24973",2012-11-04,2012,"AC Ajaccio","Olympique Marseille","0-2",0,2,"1",1,2,-2,"D"
"24974",2012-11-04,2012,"Olympique Lyon","SC Bastia","5-2",5,2,"1",1,7,3,"H"
"24975",2012-11-04,2012,"Girondins Bordeaux","Toulouse FC","1-0",1,0,"1",1,1,1,"H"
"24976",2012-11-07,2012,"FC Sochaux","Evian Thonon Gaillard","2-1",2,1,"1",1,3,1,"H"
"24977",2012-11-09,2012,"AS Nancy","Stade Rennes","1-3",1,3,"1",1,4,-2,"D"
"24978",2012-11-10,2012,"Lille OSC","Stade Brest","1-0",1,0,"1",1,1,1,"H"
"24979",2012-11-10,2012,"AS Saint-Etienne","ESTAC Troyes","2-0",2,0,"1",1,2,2,"H"
"24980",2012-11-10,2012,"SC Bastia","Valenciennes FC","2-3",2,3,"1",1,5,-1,"D"
"24981",2012-11-10,2012,"Stade Reims","Evian Thonon Gaillard","1-2",1,2,"1",1,3,-1,"D"
"24982",2012-11-10,2012,"Toulouse FC","AC Ajaccio","2-4",2,4,"1",1,6,-2,"D"
"24983",2012-11-11,2012,"Olympique Marseille","OGC Nice","2-2",2,2,"1",1,4,0,"D"
"24984",2012-11-11,2012,"FC Lorient","Girondins Bordeaux","0-4",0,4,"1",1,4,-4,"D"
"24985",2012-11-11,2012,"FC Sochaux","Olympique Lyon","1-1",1,1,"1",1,2,0,"D"
"24986",2012-11-11,2012,"Montpellier HSC","Paris Saint-Germain","1-1",1,1,"1",1,2,0,"D"
"24987",2012-11-16,2012,"FC Lorient","Lille OSC","2-0",2,0,"1",1,2,2,"H"
"24988",2012-11-17,2012,"Paris Saint-Germain","Stade Rennes","1-2",1,2,"1",1,3,-1,"D"
"24989",2012-11-17,2012,"AC Ajaccio","FC Sochaux","0-1",0,1,"1",1,1,-1,"D"
"24990",2012-11-17,2012,"ESTAC Troyes","AS Nancy","3-3",3,3,"1",1,6,0,"D"
"24991",2012-11-17,2012,"Evian Thonon Gaillard","AS Saint-Etienne","2-2",2,2,"1",1,4,0,"D"
"24992",2012-11-17,2012,"Stade Brest","SC Bastia","3-0",3,0,"1",1,3,3,"H"
"24993",2012-11-17,2012,"Valenciennes FC","Montpellier HSC","1-1",1,1,"1",1,2,0,"D"
"24994",2012-11-18,2012,"Olympique Lyon","Stade Reims","3-0",3,0,"1",1,3,3,"H"
"24995",2012-11-18,2012,"OGC Nice","Toulouse FC","1-0",1,0,"1",1,1,1,"H"
"24996",2012-11-18,2012,"Girondins Bordeaux","Olympique Marseille","1-0",1,0,"1",1,1,1,"H"
"24997",2012-11-23,2012,"AS Saint-Etienne","Valenciennes FC","1-0",1,0,"1",1,1,1,"H"
"24998",2012-11-24,2012,"Paris Saint-Germain","ESTAC Troyes","4-0",4,0,"1",1,4,4,"H"
"24999",2012-11-24,2012,"AS Nancy","AC Ajaccio","1-1",1,1,"1",1,2,0,"D"
"25000",2012-11-24,2012,"FC Sochaux","OGC Nice","0-1",0,1,"1",1,1,-1,"D"
"25001",2012-11-24,2012,"SC Bastia","FC Lorient","2-1",2,1,"1",1,3,1,"H"
"25002",2012-11-24,2012,"Stade Reims","Stade Brest","0-0",0,0,"1",1,0,0,"D"
"25003",2012-11-24,2012,"Stade Rennes","Evian Thonon Gaillard","0-1",0,1,"1",1,1,-1,"D"
"25004",2012-11-25,2012,"Montpellier HSC","Girondins Bordeaux","1-0",1,0,"1",1,1,1,"H"
"25005",2012-11-25,2012,"Toulouse FC","Olympique Lyon","3-0",3,0,"1",1,3,3,"H"
"25006",2012-11-25,2012,"Olympique Marseille","Lille OSC","1-0",1,0,"1",1,1,1,"H"
"25007",2012-11-28,2012,"Olympique Marseille","Olympique Lyon","1-4",1,4,"1",1,5,-3,"D"
"25008",2012-11-30,2012,"AC Ajaccio","AS Saint-Etienne","0-0",0,0,"1",1,0,0,"D"
"25009",2012-12-01,2012,"Olympique Lyon","Montpellier HSC","1-0",1,0,"1",1,1,1,"H"
"25010",2012-12-01,2012,"Evian Thonon Gaillard","AS Nancy","1-1",1,1,"1",1,2,0,"D"
"25011",2012-12-01,2012,"Girondins Bordeaux","FC Sochaux","2-2",2,2,"1",1,4,0,"D"
"25012",2012-12-01,2012,"Lille OSC","SC Bastia","0-0",0,0,"1",1,0,0,"D"
"25013",2012-12-01,2012,"OGC Nice","Paris Saint-Germain","2-1",2,1,"1",1,3,1,"H"
"25014",2012-12-01,2012,"Valenciennes FC","Stade Reims","1-0",1,0,"1",1,1,1,"H"
"25015",2012-12-02,2012,"Stade Brest","Olympique Marseille","1-2",1,2,"1",1,3,-1,"D"
"25016",2012-12-02,2012,"ESTAC Troyes","Stade Rennes","2-3",2,3,"1",1,5,-1,"D"
"25017",2012-12-02,2012,"FC Lorient","Toulouse FC","1-0",1,0,"1",1,1,1,"H"
"25018",2012-12-07,2012,"Toulouse FC","SC Bastia","0-0",0,0,"1",1,0,0,"D"
"25019",2012-12-08,2012,"Paris Saint-Germain","Evian Thonon Gaillard","4-0",4,0,"1",1,4,4,"H"
"25020",2012-12-08,2012,"AS Nancy","Valenciennes FC","1-1",1,1,"1",1,2,0,"D"
"25021",2012-12-08,2012,"ESTAC Troyes","OGC Nice","1-1",1,1,"1",1,2,0,"D"
"25022",2012-12-08,2012,"FC Sochaux","Lille OSC","1-1",1,1,"1",1,2,0,"D"
"25023",2012-12-08,2012,"Montpellier HSC","AC Ajaccio","3-0",3,0,"1",1,3,3,"H"
"25024",2012-12-08,2012,"Stade Rennes","Stade Brest","2-2",2,2,"1",1,4,0,"D"
"25025",2012-12-09,2012,"Stade Reims","Girondins Bordeaux","0-0",0,0,"1",1,0,0,"D"
"25026",2012-12-09,2012,"Olympique Marseille","FC Lorient","0-3",0,3,"1",1,3,-3,"D"
"25027",2012-12-09,2012,"AS Saint-Etienne","Olympique Lyon","0-1",0,1,"1",1,1,-1,"D"
"25028",2012-12-11,2012,"OGC Nice","Stade Rennes","1-0",1,0,"1",1,1,1,"H"
"25029",2012-12-11,2012,"Valenciennes FC","Paris Saint-Germain","0-4",0,4,"1",1,4,-4,"D"
"25030",2012-12-11,2012,"Lille OSC","Toulouse FC","2-0",2,0,"1",1,2,2,"H"
"25031",2012-12-12,2012,"AC Ajaccio","Stade Reims","2-0",2,0,"1",1,2,2,"H"
"25032",2012-12-12,2012,"Evian Thonon Gaillard","ESTAC Troyes","2-0",2,0,"1",1,2,2,"H"
"25033",2012-12-12,2012,"FC Lorient","FC Sochaux","2-0",2,0,"1",1,2,2,"H"
"25034",2012-12-12,2012,"Olympique Lyon","AS Nancy","1-1",1,1,"1",1,2,0,"D"
"25035",2012-12-12,2012,"Stade Brest","Montpellier HSC","1-2",1,2,"1",1,3,-1,"D"
"25036",2012-12-12,2012,"SC Bastia","Olympique Marseille","1-2",1,2,"1",1,3,-1,"D"
"25037",2012-12-13,2012,"Girondins Bordeaux","AS Saint-Etienne","0-0",0,0,"1",1,0,0,"D"
"25038",2012-12-14,2012,"Stade Rennes","Valenciennes FC","2-0",2,0,"1",1,2,2,"H"
"25039",2012-12-15,2012,"Toulouse FC","Olympique Marseille","0-1",0,1,"1",1,1,-1,"D"
"25040",2012-12-15,2012,"ESTAC Troyes","AC Ajaccio","3-2",3,2,"1",1,5,1,"H"
"25041",2012-12-15,2012,"FC Sochaux","Stade Brest","1-2",1,2,"1",1,3,-1,"D"
"25042",2012-12-15,2012,"Montpellier HSC","SC Bastia","4-0",4,0,"1",1,4,4,"H"
"25043",2012-12-15,2012,"OGC Nice","Evian Thonon Gaillard","3-2",3,2,"1",1,5,1,"H"
"25044",2012-12-15,2012,"Stade Reims","Lille OSC","1-1",1,1,"1",1,2,0,"D"
"25045",2012-12-16,2012,"AS Nancy","Girondins Bordeaux","1-1",1,1,"1",1,2,0,"D"
"25046",2012-12-16,2012,"AS Saint-Etienne","FC Lorient","0-2",0,2,"1",1,2,-2,"D"
"25047",2012-12-16,2012,"Paris Saint-Germain","Olympique Lyon","1-0",1,0,"1",1,1,1,"H"
"25048",2012-12-21,2012,"Stade Brest","Paris Saint-Germain","0-3",0,3,"1",1,3,-3,"D"
"25049",2012-12-22,2012,"Lille OSC","Montpellier HSC","4-1",4,1,"1",1,5,3,"H"
"25050",2012-12-22,2012,"AC Ajaccio","Stade Rennes","2-4",2,4,"1",1,6,-2,"D"
"25051",2012-12-22,2012,"FC Lorient","Stade Reims","2-2",2,2,"1",1,4,0,"D"
"25052",2012-12-22,2012,"Girondins Bordeaux","ESTAC Troyes","0-0",0,0,"1",1,0,0,"D"
"25053",2012-12-22,2012,"Olympique Lyon","OGC Nice","3-0",3,0,"1",1,3,3,"H"
"25054",2012-12-22,2012,"SC Bastia","AS Nancy","4-2",4,2,"1",1,6,2,"H"
"25055",2012-12-23,2012,"Valenciennes FC","Evian Thonon Gaillard","2-1",2,1,"1",1,3,1,"H"
"25056",2012-12-23,2012,"Toulouse FC","FC Sochaux","2-0",2,0,"1",1,2,2,"H"
"25057",2012-12-23,2012,"Olympique Marseille","AS Saint-Etienne","1-0",1,0,"1",1,1,1,"H"
"25058",2013-01-11,2012,"AS Saint-Etienne","Toulouse FC","2-2",2,2,"1",1,4,0,"D"
"25059",2013-01-11,2012,"Paris Saint-Germain","AC Ajaccio","0-0",0,0,"1",1,0,0,"D"
"25060",2013-01-12,2012,"ESTAC Troyes","Olympique Lyon","1-2",1,2,"1",1,3,-1,"D"
"25061",2013-01-12,2012,"AS Nancy","Lille OSC","2-2",2,2,"1",1,4,0,"D"
"25062",2013-01-12,2012,"Evian Thonon Gaillard","Stade Brest","0-2",0,2,"1",1,2,-2,"D"
"25063",2013-01-12,2012,"Montpellier HSC","FC Lorient","2-0",2,0,"1",1,2,2,"H"
"25064",2013-01-12,2012,"Stade Rennes","Girondins Bordeaux","0-2",0,2,"1",1,2,-2,"D"
"25065",2013-01-13,2012,"Stade Reims","SC Bastia","1-2",1,2,"1",1,3,-1,"D"
"25066",2013-01-13,2012,"OGC Nice","Valenciennes FC","5-0",5,0,"1",1,5,5,"H"
"25067",2013-01-13,2012,"FC Sochaux","Olympique Marseille","3-1",3,1,"1",1,4,2,"H"
"25068",2013-01-18,2012,"Olympique Lyon","Evian Thonon Gaillard","0-0",0,0,"1",1,0,0,"D"
"25069",2013-01-19,2012,"FC Sochaux","Stade Reims","1-0",1,0,"1",1,1,1,"H"
"25070",2013-01-19,2012,"Olympique Marseille","Montpellier HSC","3-2",3,2,"1",1,5,1,"H"
"25071",2013-01-19,2012,"AC Ajaccio","Valenciennes FC","1-1",1,1,"1",1,2,0,"D"
"25072",2013-01-19,2012,"FC Lorient","ESTAC Troyes","3-2",3,2,"1",1,5,1,"H"
"25073",2013-01-19,2012,"Stade Brest","AS Saint-Etienne","0-1",0,1,"1",1,1,-1,"D"
"25074",2013-01-19,2012,"Toulouse FC","AS Nancy","2-1",2,1,"1",1,3,1,"H"
"25075",2013-01-20,2012,"SC Bastia","Stade Rennes","0-2",0,2,"1",1,2,-2,"D"
"25076",2013-01-20,2012,"Lille OSC","OGC Nice","0-2",0,2,"1",1,2,-2,"D"
"25077",2013-01-20,2012,"Girondins Bordeaux","Paris Saint-Germain","0-1",0,1,"1",1,1,-1,"D"
"25078",2013-01-25,2012,"Valenciennes FC","Olympique Lyon","0-2",0,2,"1",1,2,-2,"D"
"25079",2013-01-26,2012,"Stade Rennes","Olympique Marseille","2-2",2,2,"1",1,4,0,"D"
"25080",2013-01-26,2012,"AS Nancy","FC Lorient","2-1",2,1,"1",1,3,1,"H"
"25081",2013-01-26,2012,"ESTAC Troyes","Stade Brest","2-1",2,1,"1",1,3,1,"H"
"25082",2013-01-26,2012,"Evian Thonon Gaillard","AC Ajaccio","1-1",1,1,"1",1,2,0,"D"
"25083",2013-01-26,2012,"Montpellier HSC","FC Sochaux","2-0",2,0,"1",1,2,2,"H"
"25084",2013-01-26,2012,"Stade Reims","Toulouse FC","1-1",1,1,"1",1,2,0,"D"
"25085",2013-01-27,2012,"AS Saint-Etienne","SC Bastia","3-0",3,0,"1",1,3,3,"H"
"25086",2013-01-27,2012,"OGC Nice","Girondins Bordeaux","0-1",0,1,"1",1,1,-1,"D"
"25087",2013-01-27,2012,"Paris Saint-Germain","Lille OSC","1-0",1,0,"1",1,1,1,"H"
"25088",2013-02-01,2012,"Toulouse FC","Paris Saint-Germain","0-4",0,4,"1",1,4,-4,"D"
"25089",2013-02-02,2012,"FC Lorient","Stade Rennes","2-2",2,2,"1",1,4,0,"D"
"25090",2013-02-02,2012,"FC Sochaux","AS Saint-Etienne","1-2",1,2,"1",1,3,-1,"D"
"25091",2013-02-02,2012,"Girondins Bordeaux","Valenciennes FC","2-0",2,0,"1",1,2,2,"H"
"25092",2013-02-02,2012,"Lille OSC","ESTAC Troyes","1-1",1,1,"1",1,2,0,"D"
"25093",2013-02-02,2012,"SC Bastia","Evian Thonon Gaillard","0-0",0,0,"1",1,0,0,"D"
"25094",2013-02-02,2012,"Stade Brest","OGC Nice","0-2",0,2,"1",1,2,-2,"D"
"25095",2013-02-03,2012,"AC Ajaccio","Olympique Lyon","3-1",3,1,"1",1,4,2,"H"
"25096",2013-02-03,2012,"Montpellier HSC","Stade Reims","3-1",3,1,"1",1,4,2,"H"
"25097",2013-02-03,2012,"Olympique Marseille","AS Nancy","0-1",0,1,"1",1,1,-1,"D"
"25098",2013-02-08,2012,"Paris Saint-Germain","SC Bastia","3-1",3,1,"1",1,4,2,"H"
"25099",2013-02-09,2012,"AS Saint-Etienne","Montpellier HSC","4-1",4,1,"1",1,5,3,"H"
"25100",2013-02-09,2012,"AC Ajaccio","Girondins Bordeaux","1-0",1,0,"1",1,1,1,"H"
"25101",2013-02-09,2012,"AS Nancy","Stade Reims","1-2",1,2,"1",1,3,-1,"D"
"25102",2013-02-09,2012,"ESTAC Troyes","FC Sochaux","0-0",0,0,"1",1,0,0,"D"
"25103",2013-02-09,2012,"OGC Nice","FC Lorient","1-1",1,1,"1",1,2,0,"D"
"25104",2013-02-09,2012,"Valenciennes FC","Stade Brest","2-1",2,1,"1",1,3,1,"H"
"25105",2013-02-10,2012,"Evian Thonon Gaillard","Olympique Marseille","1-1",1,1,"1",1,2,0,"D"
"25106",2013-02-10,2012,"Stade Rennes","Toulouse FC","2-0",2,0,"1",1,2,2,"H"
"25107",2013-02-10,2012,"Olympique Lyon","Lille OSC","1-3",1,3,"1",1,4,-2,"D"
"25108",2013-02-15,2012,"Lille OSC","Stade Rennes","2-0",2,0,"1",1,2,2,"H"
"25109",2013-02-16,2012,"Olympique Marseille","Valenciennes FC","1-0",1,0,"1",1,1,1,"H"
"25110",2013-02-16,2012,"FC Lorient","Evian Thonon Gaillard","2-1",2,1,"1",1,3,1,"H"
"25111",2013-02-16,2012,"Montpellier HSC","AS Nancy","1-0",1,0,"1",1,1,1,"H"
"25112",2013-02-16,2012,"SC Bastia","OGC Nice","0-1",0,1,"1",1,1,-1,"D"
"25113",2013-02-16,2012,"Stade Brest","AC Ajaccio","1-1",1,1,"1",1,2,0,"D"
"25114",2013-02-16,2012,"Toulouse FC","ESTAC Troyes","2-2",2,2,"1",1,4,0,"D"
"25115",2013-02-17,2012,"Girondins Bordeaux","Olympique Lyon","0-4",0,4,"1",1,4,-4,"D"
"25116",2013-02-17,2012,"Stade Reims","AS Saint-Etienne","1-1",1,1,"1",1,2,0,"D"
"25117",2013-02-17,2012,"FC Sochaux","Paris Saint-Germain","3-2",3,2,"1",1,5,1,"H"
"25118",2013-02-22,2012,"OGC Nice","Stade Reims","2-0",2,0,"1",1,2,2,"H"
"25119",2013-02-23,2012,"Stade Rennes","FC Sochaux","2-2",2,2,"1",1,4,0,"D"
"25120",2013-02-23,2012,"AC Ajaccio","Lille OSC","1-3",1,3,"1",1,4,-2,"D"
"25121",2013-02-23,2012,"AS Nancy","AS Saint-Etienne","0-3",0,3,"1",1,3,-3,"D"
"25122",2013-02-23,2012,"ESTAC Troyes","SC Bastia","0-0",0,0,"1",1,0,0,"D"
"25123",2013-02-23,2012,"Evian Thonon Gaillard","Montpellier HSC","0-1",0,1,"1",1,1,-1,"D"
"25124",2013-02-23,2012,"Valenciennes FC","Toulouse FC","0-0",0,0,"1",1,0,0,"D"
"25125",2013-02-24,2012,"Olympique Lyon","FC Lorient","3-1",3,1,"1",1,4,2,"H"
"25126",2013-02-24,2012,"Girondins Bordeaux","Stade Brest","0-2",0,2,"1",1,2,-2,"D"
"25127",2013-02-24,2012,"Paris Saint-Germain","Olympique Marseille","2-0",2,0,"1",1,2,2,"H"
"25128",2013-03-01,2012,"Montpellier HSC","Stade Rennes","2-0",2,0,"1",1,2,2,"H"
"25129",2013-03-02,2012,"Stade Reims","Paris Saint-Germain","1-0",1,0,"1",1,1,1,"H"
"25130",2013-03-02,2012,"AS Saint-Etienne","OGC Nice","4-0",4,0,"1",1,4,4,"H"
"25131",2013-03-02,2012,"FC Lorient","Valenciennes FC","1-1",1,1,"1",1,2,0,"D"
"25132",2013-03-02,2012,"FC Sochaux","AS Nancy","1-2",1,2,"1",1,3,-1,"D"
"25133",2013-03-02,2012,"SC Bastia","AC Ajaccio","1-0",1,0,"1",1,1,1,"H"
"25134",2013-03-02,2012,"Toulouse FC","Evian Thonon Gaillard","0-0",0,0,"1",1,0,0,"D"
"25135",2013-03-03,2012,"Stade Brest","Olympique Lyon","1-1",1,1,"1",1,2,0,"D"
"25136",2013-03-03,2012,"Olympique Marseille","ESTAC Troyes","2-1",2,1,"1",1,3,1,"H"
"25137",2013-03-03,2012,"Lille OSC","Girondins Bordeaux","2-1",2,1,"1",1,3,1,"H"
"25138",2013-03-08,2012,"Stade Rennes","AS Saint-Etienne","2-2",2,2,"1",1,4,0,"D"
"25139",2013-03-09,2012,"Paris Saint-Germain","AS Nancy","2-1",2,1,"1",1,3,1,"H"
"25140",2013-03-09,2012,"AC Ajaccio","FC Lorient","1-0",1,0,"1",1,1,1,"H"
"25141",2013-03-09,2012,"ESTAC Troyes","Stade Reims","4-2",4,2,"1",1,6,2,"H"
"25142",2013-03-09,2012,"Evian Thonon Gaillard","FC Sochaux","5-1",5,1,"1",1,6,4,"H"
"25143",2013-03-09,2012,"Stade Brest","Toulouse FC","0-1",0,1,"1",1,1,-1,"D"
"25144",2013-03-09,2012,"Valenciennes FC","Lille OSC","1-3",1,3,"1",1,4,-2,"D"
"25145",2013-03-10,2012,"OGC Nice","Montpellier HSC","2-0",2,0,"1",1,2,2,"H"
"25146",2013-03-10,2012,"Girondins Bordeaux","SC Bastia","1-0",1,0,"1",1,1,1,"H"
"25147",2013-03-10,2012,"Olympique Lyon","Olympique Marseille","0-0",0,0,"1",1,0,0,"D"
"25148",2013-03-15,2012,"Olympique Marseille","AC Ajaccio","0-0",0,0,"1",1,0,0,"D"
"25149",2013-03-16,2012,"SC Bastia","Olympique Lyon","4-1",4,1,"1",1,5,3,"H"
"25150",2013-03-16,2012,"FC Lorient","Stade Brest","4-0",4,0,"1",1,4,4,"H"
"25151",2013-03-16,2012,"FC Sochaux","Valenciennes FC","1-1",1,1,"1",1,2,0,"D"
"25152",2013-03-16,2012,"Lille OSC","Evian Thonon Gaillard","1-2",1,2,"1",1,3,-1,"D"
"25153",2013-03-16,2012,"Montpellier HSC","ESTAC Troyes","1-1",1,1,"1",1,2,0,"D"
"25154",2013-03-16,2012,"Stade Reims","Stade Rennes","1-0",1,0,"1",1,1,1,"H"
"25155",2013-03-17,2012,"AS Nancy","OGC Nice","1-0",1,0,"1",1,1,1,"H"
"25156",2013-03-17,2012,"Toulouse FC","Girondins Bordeaux","0-0",0,0,"1",1,0,0,"D"
"25157",2013-03-17,2012,"AS Saint-Etienne","Paris Saint-Germain","2-2",2,2,"1",1,4,0,"D"
"25158",2013-03-29,2012,"Paris Saint-Germain","Montpellier HSC","1-0",1,0,"1",1,1,1,"H"
"25159",2013-03-30,2012,"ESTAC Troyes","AS Saint-Etienne","2-2",2,2,"1",1,4,0,"D"
"25160",2013-03-30,2012,"AC Ajaccio","Toulouse FC","2-3",2,3,"1",1,5,-1,"D"
"25161",2013-03-30,2012,"Evian Thonon Gaillard","Stade Reims","2-2",2,2,"1",1,4,0,"D"
"25162",2013-03-30,2012,"Girondins Bordeaux","FC Lorient","1-1",1,1,"1",1,2,0,"D"
"25163",2013-03-30,2012,"Stade Rennes","AS Nancy","0-2",0,2,"1",1,2,-2,"D"
"25164",2013-03-30,2012,"Valenciennes FC","SC Bastia","3-4",3,4,"1",1,7,-1,"D"
"25165",2013-03-31,2012,"OGC Nice","Olympique Marseille","0-1",0,1,"1",1,1,-1,"D"
"25166",2013-03-31,2012,"Stade Brest","Lille OSC","1-2",1,2,"1",1,3,-1,"D"
"25167",2013-03-31,2012,"Olympique Lyon","FC Sochaux","1-2",1,2,"1",1,3,-1,"D"
"25168",2013-04-05,2012,"Olympique Marseille","Girondins Bordeaux","1-0",1,0,"1",1,1,1,"H"
"25169",2013-04-06,2012,"Stade Rennes","Paris Saint-Germain","0-2",0,2,"1",1,2,-2,"D"
"25170",2013-04-06,2012,"AS Nancy","ESTAC Troyes","1-0",1,0,"1",1,1,1,"H"
"25171",2013-04-06,2012,"FC Sochaux","AC Ajaccio","0-0",0,0,"1",1,0,0,"D"
"25172",2013-04-06,2012,"Montpellier HSC","Valenciennes FC","3-1",3,1,"1",1,4,2,"H"
"25173",2013-04-06,2012,"SC Bastia","Stade Brest","4-0",4,0,"1",1,4,4,"H"
"25174",2013-04-06,2012,"Toulouse FC","OGC Nice","3-4",3,4,"1",1,7,-1,"D"
"25175",2013-04-07,2012,"AS Saint-Etienne","Evian Thonon Gaillard","1-0",1,0,"1",1,1,1,"H"
"25176",2013-04-07,2012,"Stade Reims","Olympique Lyon","1-0",1,0,"1",1,1,1,"H"
"25177",2013-04-07,2012,"Lille OSC","FC Lorient","5-0",5,0,"1",1,5,5,"H"
"25178",2013-04-12,2012,"Valenciennes FC","AS Saint-Etienne","0-0",0,0,"1",1,0,0,"D"
"25179",2013-04-13,2012,"ESTAC Troyes","Paris Saint-Germain","0-1",0,1,"1",1,1,-1,"D"
"25180",2013-04-13,2012,"AC Ajaccio","AS Nancy","1-1",1,1,"1",1,2,0,"D"
"25181",2013-04-13,2012,"Evian Thonon Gaillard","Stade Rennes","4-2",4,2,"1",1,6,2,"H"
"25182",2013-04-13,2012,"FC Lorient","SC Bastia","4-1",4,1,"1",1,5,3,"H"
"25183",2013-04-13,2012,"Girondins Bordeaux","Montpellier HSC","4-2",4,2,"1",1,6,2,"H"
"25184",2013-04-13,2012,"Stade Brest","Stade Reims","0-2",0,2,"1",1,2,-2,"D"
"25185",2013-04-14,2012,"OGC Nice","FC Sochaux","3-0",3,0,"1",1,3,3,"H"
"25186",2013-04-14,2012,"Olympique Lyon","Toulouse FC","3-1",3,1,"1",1,4,2,"H"
"25187",2013-04-14,2012,"Lille OSC","Olympique Marseille","0-0",0,0,"1",1,0,0,"D"
"25188",2013-04-19,2012,"Montpellier HSC","Olympique Lyon","1-2",1,2,"1",1,3,-1,"D"
"25189",2013-04-20,2012,"Olympique Marseille","Stade Brest","1-0",1,0,"1",1,1,1,"H"
"25190",2013-04-21,2012,"SC Bastia","Lille OSC","1-2",1,2,"1",1,3,-1,"D"
"25191",2013-04-21,2012,"AS Nancy","Evian Thonon Gaillard","3-1",3,1,"1",1,4,2,"H"
"25192",2013-04-21,2012,"FC Sochaux","Girondins Bordeaux","2-2",2,2,"1",1,4,0,"D"
"25193",2013-04-21,2012,"Stade Reims","Valenciennes FC","0-1",0,1,"1",1,1,-1,"D"
"25194",2013-04-21,2012,"Toulouse FC","FC Lorient","0-1",0,1,"1",1,1,-1,"D"
"25195",2013-04-21,2012,"Paris Saint-Germain","OGC Nice","3-0",3,0,"1",1,3,3,"H"
"25196",2013-04-24,2012,"AS Saint-Etienne","AC Ajaccio","4-2",4,2,"1",1,6,2,"H"
"25197",2013-04-24,2012,"Stade Rennes","ESTAC Troyes","1-2",1,2,"1",1,3,-1,"D"
"25198",2013-04-26,2012,"Lille OSC","FC Sochaux","3-3",3,3,"1",1,6,0,"D"
"25199",2013-04-27,2012,"FC Lorient","Olympique Marseille","0-1",0,1,"1",1,1,-1,"D"
"25200",2013-04-27,2012,"AC Ajaccio","Montpellier HSC","2-1",2,1,"1",1,3,1,"H"
"25201",2013-04-27,2012,"Girondins Bordeaux","Stade Reims","0-0",0,0,"1",1,0,0,"D"
"25202",2013-04-27,2012,"SC Bastia","Toulouse FC","0-0",0,0,"1",1,0,0,"D"
"25203",2013-04-27,2012,"Stade Brest","Stade Rennes","0-2",0,2,"1",1,2,-2,"D"
"25204",2013-04-27,2012,"Valenciennes FC","AS Nancy","0-0",0,0,"1",1,0,0,"D"
"25205",2013-04-28,2012,"Olympique Lyon","AS Saint-Etienne","1-1",1,1,"1",1,2,0,"D"
"25206",2013-04-28,2012,"OGC Nice","ESTAC Troyes","3-1",3,1,"1",1,4,2,"H"
"25207",2013-04-28,2012,"Evian Thonon Gaillard","Paris Saint-Germain","0-1",0,1,"1",1,1,-1,"D"
"25208",2013-05-03,2012,"AS Saint-Etienne","Girondins Bordeaux","0-0",0,0,"1",1,0,0,"D"
"25209",2013-05-04,2012,"Olympique Marseille","SC Bastia","2-1",2,1,"1",1,3,1,"H"
"25210",2013-05-04,2012,"ESTAC Troyes","Evian Thonon Gaillard","1-0",1,0,"1",1,1,1,"H"
"25211",2013-05-04,2012,"FC Sochaux","FC Lorient","1-0",1,0,"1",1,1,1,"H"
"25212",2013-05-04,2012,"Montpellier HSC","Stade Brest","2-1",2,1,"1",1,3,1,"H"
"25213",2013-05-04,2012,"Stade Reims","AC Ajaccio","1-1",1,1,"1",1,2,0,"D"
"25214",2013-05-04,2012,"Toulouse FC","Lille OSC","4-2",4,2,"1",1,6,2,"H"
"25215",2013-05-05,2012,"Stade Rennes","OGC Nice","0-3",0,3,"1",1,3,-3,"D"
"25216",2013-05-05,2012,"AS Nancy","Olympique Lyon","0-3",0,3,"1",1,3,-3,"D"
"25217",2013-05-05,2012,"Paris Saint-Germain","Valenciennes FC","1-1",1,1,"1",1,2,0,"D"
"25218",2013-05-10,2012,"Lille OSC","Stade Reims","3-0",3,0,"1",1,3,3,"H"
"25219",2013-05-11,2012,"Olympique Marseille","Toulouse FC","2-1",2,1,"1",1,3,1,"H"
"25220",2013-05-11,2012,"AC Ajaccio","ESTAC Troyes","0-1",0,1,"1",1,1,-1,"D"
"25221",2013-05-11,2012,"Girondins Bordeaux","AS Nancy","3-2",3,2,"1",1,5,1,"H"
"25222",2013-05-11,2012,"SC Bastia","Montpellier HSC","3-1",3,1,"1",1,4,2,"H"
"25223",2013-05-11,2012,"Stade Brest","FC Sochaux","0-2",0,2,"1",1,2,-2,"D"
"25224",2013-05-11,2012,"Valenciennes FC","Stade Rennes","4-1",4,1,"1",1,5,3,"H"
"25225",2013-05-12,2012,"FC Lorient","AS Saint-Etienne","3-1",3,1,"1",1,4,2,"H"
"25226",2013-05-12,2012,"Evian Thonon Gaillard","OGC Nice","4-0",4,0,"1",1,4,4,"H"
"25227",2013-05-12,2012,"Olympique Lyon","Paris Saint-Germain","0-1",0,1,"1",1,1,-1,"D"
"25228",2013-05-18,2012,"AS Nancy","SC Bastia","1-2",1,2,"1",1,3,-1,"D"
"25229",2013-05-18,2012,"AS Saint-Etienne","Olympique Marseille","2-0",2,0,"1",1,2,2,"H"
"25230",2013-05-18,2012,"ESTAC Troyes","Girondins Bordeaux","1-0",1,0,"1",1,1,1,"H"
"25231",2013-05-18,2012,"Evian Thonon Gaillard","Valenciennes FC","2-0",2,0,"1",1,2,2,"H"
"25232",2013-05-18,2012,"FC Sochaux","Toulouse FC","1-2",1,2,"1",1,3,-1,"D"
"25233",2013-05-18,2012,"Montpellier HSC","Lille OSC","0-0",0,0,"1",1,0,0,"D"
"25234",2013-05-18,2012,"Paris Saint-Germain","Stade Brest","3-1",3,1,"1",1,4,2,"H"
"25235",2013-05-18,2012,"Stade Reims","FC Lorient","1-0",1,0,"1",1,1,1,"H"
"25236",2013-05-18,2012,"Stade Rennes","AC Ajaccio","1-1",1,1,"1",1,2,0,"D"
"25237",2013-05-19,2012,"OGC Nice","Olympique Lyon","1-1",1,1,"1",1,2,0,"D"
"25238",2013-05-26,2012,"AC Ajaccio","OGC Nice","0-2",0,2,"1",1,2,-2,"D"
"25239",2013-05-26,2012,"FC Lorient","Paris Saint-Germain","1-3",1,3,"1",1,4,-2,"D"
"25240",2013-05-26,2012,"Girondins Bordeaux","Evian Thonon Gaillard","2-1",2,1,"1",1,3,1,"H"
"25241",2013-05-26,2012,"Lille OSC","AS Saint-Etienne","1-1",1,1,"1",1,2,0,"D"
"25242",2013-05-26,2012,"Olympique Marseille","Stade Reims","0-0",0,0,"1",1,0,0,"D"
"25243",2013-05-26,2012,"Olympique Lyon","Stade Rennes","2-0",2,0,"1",1,2,2,"H"
"25244",2013-05-26,2012,"SC Bastia","FC Sochaux","0-0",0,0,"1",1,0,0,"D"
"25245",2013-05-26,2012,"Stade Brest","AS Nancy","1-2",1,2,"1",1,3,-1,"D"
"25246",2013-05-26,2012,"Toulouse FC","Montpellier HSC","2-0",2,0,"1",1,2,2,"H"
"25247",2013-05-26,2012,"Valenciennes FC","ESTAC Troyes","2-1",2,1,"1",1,3,1,"H"
"25248",2013-08-09,2013,"Montpellier HSC","Paris Saint-Germain","1-1",1,1,"1",1,2,0,"D"
"25249",2013-08-10,2013,"Girondins Bordeaux","AS Monaco","0-2",0,2,"1",1,2,-2,"D"
"25250",2013-08-10,2013,"Evian Thonon Gaillard","FC Sochaux","1-1",1,1,"1",1,2,0,"D"
"25251",2013-08-10,2013,"Lille OSC","FC Lorient","1-0",1,0,"1",1,1,1,"H"
"25252",2013-08-10,2013,"Olympique Lyon","OGC Nice","4-0",4,0,"1",1,4,4,"H"
"25253",2013-08-10,2013,"FC Nantes","SC Bastia","0-0",0,0,"1",1,0,0,"D"
"25254",2013-08-10,2013,"Stade Rennes","Stade Reims","2-1",2,1,"1",1,3,1,"H"
"25255",2013-08-10,2013,"Valenciennes FC","Toulouse FC","3-0",3,0,"1",1,3,3,"H"
"25256",2013-08-11,2013,"AC Ajaccio","AS Saint-Etienne","0-1",0,1,"1",1,1,-1,"D"
"25257",2013-08-11,2013,"EA Guingamp","Olympique Marseille","1-3",1,3,"1",1,4,-2,"D"
"25258",2013-08-16,2013,"FC Sochaux","Olympique Lyon","1-3",1,3,"1",1,4,-2,"D"
"25259",2013-08-17,2013,"Olympique Marseille","Evian Thonon Gaillard","2-0",2,0,"1",1,2,2,"H"
"25260",2013-08-17,2013,"SC Bastia","Valenciennes FC","2-0",2,0,"1",1,2,2,"H"
"25261",2013-08-17,2013,"OGC Nice","Stade Rennes","2-1",2,1,"1",1,3,1,"H"
"25262",2013-08-17,2013,"Stade Reims","Lille OSC","2-1",2,1,"1",1,3,1,"H"
"25263",2013-08-17,2013,"AS Saint-Etienne","EA Guingamp","1-0",1,0,"1",1,1,1,"H"
"25264",2013-08-17,2013,"Toulouse FC","Girondins Bordeaux","1-1",1,1,"1",1,2,0,"D"
"25265",2013-08-18,2013,"AS Monaco","Montpellier HSC","4-1",4,1,"1",1,5,3,"H"
"25266",2013-08-18,2013,"FC Lorient","FC Nantes","2-1",2,1,"1",1,3,1,"H"
"25267",2013-08-18,2013,"Paris Saint-Germain","AC Ajaccio","1-1",1,1,"1",1,2,0,"D"
"25268",2013-08-23,2013,"AS Monaco","Toulouse FC","0-0",0,0,"1",1,0,0,"D"
"25269",2013-08-24,2013,"Valenciennes FC","Olympique Marseille","0-1",0,1,"1",1,1,-1,"D"
"25270",2013-08-24,2013,"Girondins Bordeaux","SC Bastia","1-0",1,0,"1",1,1,1,"H"
"25271",2013-08-24,2013,"Evian Thonon Gaillard","Stade Rennes","1-2",1,2,"1",1,3,-1,"D"
"25272",2013-08-24,2013,"EA Guingamp","FC Lorient","2-0",2,0,"1",1,2,2,"H"
"25273",2013-08-24,2013,"Olympique Lyon","Stade Reims","0-1",0,1,"1",1,1,-1,"D"
"25274",2013-08-24,2013,"Montpellier HSC","FC Sochaux","2-1",2,1,"1",1,3,1,"H"
"25275",2013-08-25,2013,"Lille OSC","AS Saint-Etienne","1-0",1,0,"1",1,1,1,"H"
"25276",2013-08-25,2013,"AC Ajaccio","OGC Nice","0-0",0,0,"1",1,0,0,"D"
"25277",2013-08-25,2013,"FC Nantes","Paris Saint-Germain","1-2",1,2,"1",1,3,-1,"D"
"25278",2013-08-31,2013,"Evian Thonon Gaillard","Olympique Lyon","2-1",2,1,"1",1,3,1,"H"
"25279",2013-08-31,2013,"Paris Saint-Germain","EA Guingamp","2-0",2,0,"1",1,2,2,"H"
"25280",2013-08-31,2013,"SC Bastia","Toulouse FC","2-1",2,1,"1",1,3,1,"H"
"25281",2013-08-31,2013,"FC Lorient","Valenciennes FC","1-0",1,0,"1",1,1,1,"H"
"25282",2013-08-31,2013,"Stade Reims","FC Nantes","0-0",0,0,"1",1,0,0,"D"
"25283",2013-08-31,2013,"Stade Rennes","Lille OSC","0-0",0,0,"1",1,0,0,"D"
"25284",2013-08-31,2013,"FC Sochaux","AC Ajaccio","0-0",0,0,"1",1,0,0,"D"
"25285",2013-09-01,2013,"AS Saint-Etienne","Girondins Bordeaux","2-1",2,1,"1",1,3,1,"H"
"25286",2013-09-01,2013,"OGC Nice","Montpellier HSC","2-2",2,2,"1",1,4,0,"D"
"25287",2013-09-01,2013,"Olympique Marseille","AS Monaco","1-2",1,2,"1",1,3,-1,"D"
"25288",2013-09-13,2013,"Girondins Bordeaux","Paris Saint-Germain","0-2",0,2,"1",1,2,-2,"D"
"25289",2013-09-14,2013,"Toulouse FC","Olympique Marseille","1-1",1,1,"1",1,2,0,"D"
"25290",2013-09-14,2013,"AC Ajaccio","Evian Thonon Gaillard","2-3",2,3,"1",1,5,-1,"D"
"25291",2013-09-14,2013,"EA Guingamp","SC Bastia","1-1",1,1,"1",1,2,0,"D"
"25292",2013-09-14,2013,"Montpellier HSC","Stade Reims","0-0",0,0,"1",1,0,0,"D"
"25293",2013-09-14,2013,"FC Nantes","FC Sochaux","1-0",1,0,"1",1,1,1,"H"
"25294",2013-09-14,2013,"Valenciennes FC","AS Saint-Etienne","1-3",1,3,"1",1,4,-2,"D"
"25295",2013-09-15,2013,"AS Monaco","FC Lorient","1-0",1,0,"1",1,1,1,"H"
"25296",2013-09-15,2013,"Lille OSC","OGC Nice","0-2",0,2,"1",1,2,-2,"D"
"25297",2013-09-15,2013,"Olympique Lyon","Stade Rennes","0-0",0,0,"1",1,0,0,"D"
"25298",2013-09-20,2013,"AS Saint-Etienne","Toulouse FC","1-2",1,2,"1",1,3,-1,"D"
"25299",2013-09-21,2013,"SC Bastia","Olympique Marseille","0-0",0,0,"1",1,0,0,"D"
"25300",2013-09-21,2013,"Evian Thonon Gaillard","Montpellier HSC","2-2",2,2,"1",1,4,0,"D"
"25301",2013-09-21,2013,"Stade Reims","EA Guingamp","1-1",1,1,"1",1,2,0,"D"
"25302",2013-09-21,2013,"Stade Rennes","AC Ajaccio","2-0",2,0,"1",1,2,2,"H"
"25303",2013-09-21,2013,"FC Sochaux","Lille OSC","0-2",0,2,"1",1,2,-2,"D"
"25304",2013-09-22,2013,"FC Lorient","Girondins Bordeaux","3-3",3,3,"1",1,6,0,"D"
"25305",2013-09-22,2013,"Olympique Lyon","FC Nantes","3-1",3,1,"1",1,4,2,"H"
"25306",2013-09-22,2013,"OGC Nice","Valenciennes FC","4-0",4,0,"1",1,4,4,"H"
"25307",2013-09-22,2013,"Paris Saint-Germain","AS Monaco","1-1",1,1,"1",1,2,0,"D"
"25308",2013-09-24,2013,"Lille OSC","Evian Thonon Gaillard","3-0",3,0,"1",1,3,3,"H"
"25309",2013-09-24,2013,"Olympique Marseille","AS Saint-Etienne","2-1",2,1,"1",1,3,1,"H"
"25310",2013-09-25,2013,"AC Ajaccio","Olympique Lyon","2-1",2,1,"1",1,3,1,"H"
"25311",2013-09-25,2013,"Girondins Bordeaux","Stade Reims","0-0",0,0,"1",1,0,0,"D"
"25312",2013-09-25,2013,"EA Guingamp","FC Sochaux","5-1",5,1,"1",1,6,4,"H"
"25313",2013-09-25,2013,"FC Nantes","OGC Nice","2-0",2,0,"1",1,2,2,"H"
"25314",2013-09-25,2013,"Toulouse FC","FC Lorient","1-0",1,0,"1",1,1,1,"H"
"25315",2013-09-25,2013,"Valenciennes FC","Paris Saint-Germain","0-1",0,1,"1",1,1,-1,"D"
"25316",2013-09-25,2013,"AS Monaco","SC Bastia","3-0",3,0,"1",1,3,3,"H"
"25317",2013-09-26,2013,"Montpellier HSC","Stade Rennes","0-0",0,0,"1",1,0,0,"D"
"25318",2013-09-28,2013,"FC Lorient","Olympique Marseille","0-2",0,2,"1",1,2,-2,"D"
"25319",2013-09-28,2013,"Paris Saint-Germain","Toulouse FC","2-0",2,0,"1",1,2,2,"H"
"25320",2013-09-28,2013,"Evian Thonon Gaillard","Girondins Bordeaux","1-1",1,1,"1",1,2,0,"D"
"25321",2013-09-28,2013,"Olympique Lyon","Lille OSC","0-0",0,0,"1",1,0,0,"D"
"25322",2013-09-28,2013,"OGC Nice","EA Guingamp","1-0",1,0,"1",1,1,1,"H"
"25323",2013-09-28,2013,"AS Saint-Etienne","SC Bastia","2-2",2,2,"1",1,4,0,"D"
"25324",2013-09-28,2013,"FC Sochaux","Valenciennes FC","2-0",2,0,"1",1,2,2,"H"
"25325",2013-09-29,2013,"Stade Rennes","FC Nantes","1-3",1,3,"1",1,4,-2,"D"
"25326",2013-09-29,2013,"AC Ajaccio","Montpellier HSC","1-1",1,1,"1",1,2,0,"D"
"25327",2013-09-29,2013,"Stade Reims","AS Monaco","1-1",1,1,"1",1,2,0,"D"
"25328",2013-10-04,2013,"SC Bastia","FC Lorient","4-1",4,1,"1",1,5,3,"H"
"25329",2013-10-05,2013,"AS Monaco","AS Saint-Etienne","2-1",2,1,"1",1,3,1,"H"
"25330",2013-10-05,2013,"EA Guingamp","Stade Rennes","2-0",2,0,"1",1,2,2,"H"
"25331",2013-10-05,2013,"Lille OSC","AC Ajaccio","3-0",3,0,"1",1,3,3,"H"
"25332",2013-10-05,2013,"FC Nantes","Evian Thonon Gaillard","3-0",3,0,"1",1,3,3,"H"
"25333",2013-10-05,2013,"Toulouse FC","OGC Nice","1-0",1,0,"1",1,1,1,"H"
"25334",2013-10-05,2013,"Valenciennes FC","Stade Reims","1-1",1,1,"1",1,2,0,"D"
"25335",2013-10-06,2013,"Montpellier HSC","Olympique Lyon","5-1",5,1,"1",1,6,4,"H"
"25336",2013-10-06,2013,"Girondins Bordeaux","FC Sochaux","4-1",4,1,"1",1,5,3,"H"
"25337",2013-10-06,2013,"Olympique Marseille","Paris Saint-Germain","1-2",1,2,"1",1,3,-1,"D"
"25338",2013-10-18,2013,"OGC Nice","Olympique Marseille","1-0",1,0,"1",1,1,1,"H"
"25339",2013-10-18,2013,"Stade Reims","Toulouse FC","1-2",1,2,"1",1,3,-1,"D"
"25340",2013-10-19,2013,"Paris Saint-Germain","SC Bastia","4-0",4,0,"1",1,4,4,"H"
"25341",2013-10-19,2013,"AC Ajaccio","FC Nantes","0-1",0,1,"1",1,1,-1,"D"
"25342",2013-10-19,2013,"Evian Thonon Gaillard","EA Guingamp","1-2",1,2,"1",1,3,-1,"D"
"25343",2013-10-19,2013,"Montpellier HSC","Lille OSC","0-1",0,1,"1",1,1,-1,"D"
"25344",2013-10-19,2013,"Stade Rennes","Valenciennes FC","2-2",2,2,"1",1,4,0,"D"
"25345",2013-10-20,2013,"FC Sochaux","AS Monaco","2-2",2,2,"1",1,4,0,"D"
"25346",2013-10-20,2013,"AS Saint-Etienne","FC Lorient","3-2",3,2,"1",1,5,1,"H"
"25347",2013-10-20,2013,"Olympique Lyon","Girondins Bordeaux","1-1",1,1,"1",1,2,0,"D"
"25348",2013-10-25,2013,"FC Nantes","Lille OSC","0-1",0,1,"1",1,1,-1,"D"
"25349",2013-10-26,2013,"Olympique Marseille","Stade Reims","2-3",2,3,"1",1,5,-1,"D"
"25350",2013-10-26,2013,"SC Bastia","OGC Nice","1-0",1,0,"1",1,1,1,"H"
"25351",2013-10-26,2013,"EA Guingamp","AC Ajaccio","2-1",2,1,"1",1,3,1,"H"
"25352",2013-10-26,2013,"FC Lorient","FC Sochaux","2-1",2,1,"1",1,3,1,"H"
"25353",2013-10-26,2013,"Toulouse FC","Stade Rennes","0-5",0,5,"1",1,5,-5,"D"
"25354",2013-10-26,2013,"Valenciennes FC","Evian Thonon Gaillard","0-1",0,1,"1",1,1,-1,"D"
"25355",2013-10-27,2013,"Girondins Bordeaux","Montpellier HSC","2-0",2,0,"1",1,2,2,"H"
"25356",2013-10-27,2013,"AS Monaco","Olympique Lyon","2-1",2,1,"1",1,3,1,"H"
"25357",2013-10-27,2013,"AS Saint-Etienne","Paris Saint-Germain","2-2",2,2,"1",1,4,0,"D"
"25358",2013-11-01,2013,"Paris Saint-Germain","FC Lorient","4-0",4,0,"1",1,4,4,"H"
"25359",2013-11-02,2013,"Stade Rennes","Olympique Marseille","1-1",1,1,"1",1,2,0,"D"
"25360",2013-11-02,2013,"AC Ajaccio","Valenciennes FC","1-3",1,3,"1",1,4,-2,"D"
"25361",2013-11-02,2013,"Evian Thonon Gaillard","Toulouse FC","2-1",2,1,"1",1,3,1,"H"
"25362",2013-11-02,2013,"Olympique Lyon","EA Guingamp","2-0",2,0,"1",1,2,2,"H"
"25363",2013-11-02,2013,"Stade Reims","SC Bastia","4-2",4,2,"1",1,6,2,"H"
"25364",2013-11-02,2013,"FC Sochaux","AS Saint-Etienne","0-0",0,0,"1",1,0,0,"D"
"25365",2013-11-03,2013,"OGC Nice","Girondins Bordeaux","1-2",1,2,"1",1,3,-1,"D"
"25366",2013-11-03,2013,"Montpellier HSC","FC Nantes","1-1",1,1,"1",1,2,0,"D"
"25367",2013-11-03,2013,"Lille OSC","AS Monaco","2-0",2,0,"1",1,2,2,"H"
"25368",2013-11-08,2013,"AS Monaco","Evian Thonon Gaillard","1-1",1,1,"1",1,2,0,"D"
"25369",2013-11-09,2013,"Paris Saint-Germain","OGC Nice","3-1",3,1,"1",1,4,2,"H"
"25370",2013-11-09,2013,"SC Bastia","Stade Rennes","1-0",1,0,"1",1,1,1,"H"
"25371",2013-11-09,2013,"EA Guingamp","Lille OSC","0-0",0,0,"1",1,0,0,"D"
"25372",2013-11-09,2013,"FC Lorient","Stade Reims","0-0",0,0,"1",1,0,0,"D"
"25373",2013-11-09,2013,"Toulouse FC","AC Ajaccio","1-1",1,1,"1",1,2,0,"D"
"25374",2013-11-09,2013,"Valenciennes FC","Montpellier HSC","1-1",1,1,"1",1,2,0,"D"
"25375",2013-11-10,2013,"Girondins Bordeaux","FC Nantes","0-3",0,3,"1",1,3,-3,"D"
"25376",2013-11-10,2013,"Olympique Marseille","FC Sochaux","2-1",2,1,"1",1,3,1,"H"
"25377",2013-11-10,2013,"AS Saint-Etienne","Olympique Lyon","1-2",1,2,"1",1,3,-1,"D"
"25378",2013-11-22,2013,"AC Ajaccio","Olympique Marseille","1-3",1,3,"1",1,4,-2,"D"
"25379",2013-11-23,2013,"Stade Reims","Paris Saint-Germain","0-3",0,3,"1",1,3,-3,"D"
"25380",2013-11-23,2013,"Evian Thonon Gaillard","FC Lorient","0-4",0,4,"1",1,4,-4,"D"
"25381",2013-11-23,2013,"Olympique Lyon","Valenciennes FC","1-1",1,1,"1",1,2,0,"D"
"25382",2013-11-23,2013,"Montpellier HSC","EA Guingamp","1-1",1,1,"1",1,2,0,"D"
"25383",2013-11-23,2013,"Stade Rennes","Girondins Bordeaux","1-1",1,1,"1",1,2,0,"D"
"25384",2013-11-23,2013,"FC Sochaux","SC Bastia","1-1",1,1,"1",1,2,0,"D"
"25385",2013-11-24,2013,"Lille OSC","Toulouse FC","1-0",1,0,"1",1,1,1,"H"
"25386",2013-11-24,2013,"OGC Nice","AS Saint-Etienne","0-1",0,1,"1",1,1,-1,"D"
"25387",2013-11-24,2013,"FC Nantes","AS Monaco","0-1",0,1,"1",1,1,-1,"D"
"25388",2013-11-29,2013,"Olympique Marseille","Montpellier HSC","2-0",2,0,"1",1,2,2,"H"
"25389",2013-11-30,2013,"AS Saint-Etienne","Stade Reims","4-0",4,0,"1",1,4,4,"H"
"25390",2013-11-30,2013,"AS Monaco","Stade Rennes","2-0",2,0,"1",1,2,2,"H"
"25391",2013-11-30,2013,"EA Guingamp","FC Nantes","1-0",1,0,"1",1,1,1,"H"
"25392",2013-11-30,2013,"FC Lorient","OGC Nice","3-0",3,0,"1",1,3,3,"H"
"25393",2013-11-30,2013,"Toulouse FC","FC Sochaux","5-1",5,1,"1",1,6,4,"H"
"25394",2013-11-30,2013,"Valenciennes FC","Lille OSC","0-1",0,1,"1",1,1,-1,"D"
"25395",2013-12-01,2013,"Girondins Bordeaux","AC Ajaccio","4-0",4,0,"1",1,4,4,"H"
"25396",2013-12-01,2013,"SC Bastia","Evian Thonon Gaillard","2-0",2,0,"1",1,2,2,"H"
"25397",2013-12-01,2013,"Paris Saint-Germain","Olympique Lyon","4-0",4,0,"1",1,4,4,"H"
"25398",2013-12-03,2013,"Lille OSC","Olympique Marseille","1-0",1,0,"1",1,1,1,"H"
"25399",2013-12-03,2013,"FC Nantes","Valenciennes FC","2-1",2,1,"1",1,3,1,"H"
"25400",2013-12-03,2013,"OGC Nice","AS Monaco","0-3",0,3,"1",1,3,-3,"D"
"25401",2013-12-04,2013,"AC Ajaccio","SC Bastia","1-1",1,1,"1",1,2,0,"D"
"25402",2013-12-04,2013,"EA Guingamp","Girondins Bordeaux","0-1",0,1,"1",1,1,-1,"D"
"25403",2013-12-04,2013,"Montpellier HSC","FC Lorient","0-2",0,2,"1",1,2,-2,"D"
"25404",2013-12-04,2013,"Stade Rennes","AS Saint-Etienne","3-1",3,1,"1",1,4,2,"H"
"25405",2013-12-04,2013,"FC Sochaux","Stade Reims","0-2",0,2,"1",1,2,-2,"D"
"25406",2013-12-04,2013,"Evian Thonon Gaillard","Paris Saint-Germain","2-0",2,0,"1",1,2,2,"H"
"25407",2013-12-05,2013,"Olympique Lyon","Toulouse FC","1-1",1,1,"1",1,2,0,"D"
"25408",2013-12-06,2013,"Olympique Marseille","FC Nantes","0-1",0,1,"1",1,1,-1,"D"
"25409",2013-12-07,2013,"Paris Saint-Germain","FC Sochaux","5-0",5,0,"1",1,5,5,"H"
"25410",2013-12-07,2013,"FC Lorient","Stade Rennes","2-0",2,0,"1",1,2,2,"H"
"25411",2013-12-07,2013,"Stade Reims","OGC Nice","1-0",1,0,"1",1,1,1,"H"
"25412",2013-12-07,2013,"Valenciennes FC","EA Guingamp","1-1",1,1,"1",1,2,0,"D"
"25413",2013-12-08,2013,"Girondins Bordeaux","Lille OSC","1-0",1,0,"1",1,1,1,"H"
"25414",2013-12-08,2013,"SC Bastia","Olympique Lyon","1-3",1,3,"1",1,4,-2,"D"
"25415",2013-12-08,2013,"Toulouse FC","Montpellier HSC","1-1",1,1,"1",1,2,0,"D"
"25416",2013-12-08,2013,"AS Monaco","AC Ajaccio","1-0",1,0,"1",1,1,1,"H"
"25417",2013-12-13,2013,"Montpellier HSC","AS Saint-Etienne","0-1",0,1,"1",1,1,-1,"D"
"25418",2013-12-14,2013,"Stade Rennes","Paris Saint-Germain","1-3",1,3,"1",1,4,-2,"D"
"25419",2013-12-14,2013,"AC Ajaccio","FC Lorient","1-2",1,2,"1",1,3,-1,"D"
"25420",2013-12-14,2013,"Evian Thonon Gaillard","Stade Reims","1-1",1,1,"1",1,2,0,"D"
"25421",2013-12-14,2013,"EA Guingamp","AS Monaco","0-2",0,2,"1",1,2,-2,"D"
"25422",2013-12-14,2013,"FC Nantes","Toulouse FC","1-2",1,2,"1",1,3,-1,"D"
"25423",2013-12-14,2013,"OGC Nice","FC Sochaux","1-0",1,0,"1",1,1,1,"H"
"25424",2013-12-15,2013,"Girondins Bordeaux","Valenciennes FC","2-1",2,1,"1",1,3,1,"H"
"25425",2013-12-15,2013,"Lille OSC","SC Bastia","2-1",2,1,"1",1,3,1,"H"
"25426",2013-12-15,2013,"Olympique Lyon","Olympique Marseille","2-2",2,2,"1",1,4,0,"D"
"25427",2013-12-20,2013,"AS Monaco","Valenciennes FC","1-2",1,2,"1",1,3,-1,"D"
"25428",2013-12-21,2013,"AS Saint-Etienne","FC Nantes","2-0",2,0,"1",1,2,2,"H"
"25429",2013-12-21,2013,"SC Bastia","Montpellier HSC","0-0",0,0,"1",1,0,0,"D"
"25430",2013-12-21,2013,"OGC Nice","Evian Thonon Gaillard","3-1",3,1,"1",1,4,2,"H"
"25431",2013-12-21,2013,"Stade Reims","AC Ajaccio","4-1",4,1,"1",1,5,3,"H"
"25432",2013-12-21,2013,"FC Sochaux","Stade Rennes","2-1",2,1,"1",1,3,1,"H"
"25433",2013-12-21,2013,"Toulouse FC","EA Guingamp","0-0",0,0,"1",1,0,0,"D"
"25434",2013-12-22,2013,"Olympique Marseille","Girondins Bordeaux","2-2",2,2,"1",1,4,0,"D"
"25435",2013-12-22,2013,"FC Lorient","Olympique Lyon","2-2",2,2,"1",1,4,0,"D"
"25436",2013-12-22,2013,"Paris Saint-Germain","Lille OSC","2-2",2,2,"1",1,4,0,"D"
"25437",2014-01-08,2013,"AS Saint-Etienne","Evian Thonon Gaillard","1-0",1,0,"1",1,1,1,"H"
"25438",2014-01-10,2013,"Montpellier HSC","AS Monaco","1-1",1,1,"1",1,2,0,"D"
"25439",2014-01-11,2013,"AC Ajaccio","Paris Saint-Germain","1-2",1,2,"1",1,3,-1,"D"
"25440",2014-01-11,2013,"Girondins Bordeaux","Toulouse FC","0-1",0,1,"1",1,1,-1,"D"
"25441",2014-01-11,2013,"EA Guingamp","AS Saint-Etienne","0-0",0,0,"1",1,0,0,"D"
"25442",2014-01-11,2013,"Olympique Lyon","FC Sochaux","2-0",2,0,"1",1,2,2,"H"
"25443",2014-01-11,2013,"Stade Rennes","OGC Nice","0-0",0,0,"1",1,0,0,"D"
"25444",2014-01-11,2013,"Valenciennes FC","SC Bastia","3-2",3,2,"1",1,5,1,"H"
"25445",2014-01-12,2013,"FC Nantes","FC Lorient","1-0",1,0,"1",1,1,1,"H"
"25446",2014-01-12,2013,"Evian Thonon Gaillard","Olympique Marseille","1-2",1,2,"1",1,3,-1,"D"
"25447",2014-01-12,2013,"Lille OSC","Stade Reims","1-2",1,2,"1",1,3,-1,"D"
"25448",2014-01-17,2013,"AS Saint-Etienne","Lille OSC","2-0",2,0,"1",1,2,2,"H"
"25449",2014-01-18,2013,"SC Bastia","Girondins Bordeaux","1-0",1,0,"1",1,1,1,"H"
"25450",2014-01-18,2013,"FC Lorient","EA Guingamp","2-0",2,0,"1",1,2,2,"H"
"25451",2014-01-18,2013,"OGC Nice","AC Ajaccio","2-0",2,0,"1",1,2,2,"H"
"25452",2014-01-18,2013,"Stade Rennes","Evian Thonon Gaillard","0-0",0,0,"1",1,0,0,"D"
"25453",2014-01-18,2013,"FC Sochaux","Montpellier HSC","0-2",0,2,"1",1,2,-2,"D"
"25454",2014-01-19,2013,"Stade Reims","Olympique Lyon","0-2",0,2,"1",1,2,-2,"D"
"25455",2014-01-19,2013,"Toulouse FC","AS Monaco","0-2",0,2,"1",1,2,-2,"D"
"25456",2014-01-19,2013,"Paris Saint-Germain","FC Nantes","5-0",5,0,"1",1,5,5,"H"
"25457",2014-01-24,2013,"Lille OSC","Stade Rennes","1-1",1,1,"1",1,2,0,"D"
"25458",2014-01-25,2013,"EA Guingamp","Paris Saint-Germain","1-1",1,1,"1",1,2,0,"D"
"25459",2014-01-25,2013,"AC Ajaccio","FC Sochaux","1-1",1,1,"1",1,2,0,"D"
"25460",2014-01-25,2013,"Montpellier HSC","OGC Nice","3-1",3,1,"1",1,4,2,"H"
"25461",2014-01-25,2013,"FC Nantes","Stade Reims","0-0",0,0,"1",1,0,0,"D"
"25462",2014-01-25,2013,"Valenciennes FC","FC Lorient","1-1",1,1,"1",1,2,0,"D"
"25463",2014-01-26,2013,"Olympique Lyon","Evian Thonon Gaillard","3-0",3,0,"1",1,3,3,"H"
"25464",2014-01-26,2013,"Girondins Bordeaux","AS Saint-Etienne","2-0",2,0,"1",1,2,2,"H"
"25465",2014-01-26,2013,"AS Monaco","Olympique Marseille","2-0",2,0,"1",1,2,2,"H"
"25466",2014-01-29,2013,"Olympique Marseille","Valenciennes FC","2-1",2,1,"1",1,3,1,"H"
"25467",2014-01-31,2013,"Paris Saint-Germain","Girondins Bordeaux","2-0",2,0,"1",1,2,2,"H"
"25468",2014-02-01,2013,"FC Lorient","AS Monaco","2-2",2,2,"1",1,4,0,"D"
"25469",2014-02-01,2013,"SC Bastia","EA Guingamp","3-2",3,2,"1",1,5,1,"H"
"25470",2014-02-01,2013,"Evian Thonon Gaillard","AC Ajaccio","1-1",1,1,"1",1,2,0,"D"
"25471",2014-02-01,2013,"Stade Reims","Montpellier HSC","2-4",2,4,"1",1,6,-2,"D"
"25472",2014-02-01,2013,"AS Saint-Etienne","Valenciennes FC","3-0",3,0,"1",1,3,3,"H"
"25473",2014-02-01,2013,"FC Sochaux","FC Nantes","1-0",1,0,"1",1,1,1,"H"
"25474",2014-02-02,2013,"OGC Nice","Lille OSC","1-0",1,0,"1",1,1,1,"H"
"25475",2014-02-02,2013,"Stade Rennes","Olympique Lyon","2-0",2,0,"1",1,2,2,"H"
"25476",2014-02-02,2013,"Olympique Marseille","Toulouse FC","2-2",2,2,"1",1,4,0,"D"
"25477",2014-02-07,2013,"Toulouse FC","AS Saint-Etienne","0-0",0,0,"1",1,0,0,"D"
"25478",2014-02-08,2013,"Olympique Marseille","SC Bastia","3-0",3,0,"1",1,3,3,"H"
"25479",2014-02-08,2013,"AC Ajaccio","Stade Rennes","3-1",3,1,"1",1,4,2,"H"
"25480",2014-02-08,2013,"EA Guingamp","Stade Reims","1-2",1,2,"1",1,3,-1,"D"
"25481",2014-02-08,2013,"Lille OSC","FC Sochaux","2-0",2,0,"1",1,2,2,"H"
"25482",2014-02-08,2013,"Montpellier HSC","Evian Thonon Gaillard","1-1",1,1,"1",1,2,0,"D"
"25483",2014-02-08,2013,"Valenciennes FC","OGC Nice","2-1",2,1,"1",1,3,1,"H"
"25484",2014-02-09,2013,"FC Nantes","Olympique Lyon","1-2",1,2,"1",1,3,-1,"D"
"25485",2014-02-09,2013,"AS Monaco","Paris Saint-Germain","1-1",1,1,"1",1,2,0,"D"
"25486",2014-02-11,2013,"Toulouse FC","SC Bastia","1-3",1,3,"1",1,4,-2,"D"
"25487",2014-02-14,2013,"Paris Saint-Germain","Valenciennes FC","3-0",3,0,"1",1,3,3,"H"
"25488",2014-02-15,2013,"SC Bastia","AS Monaco","0-2",0,2,"1",1,2,-2,"D"
"25489",2014-02-15,2013,"FC Lorient","Toulouse FC","1-3",1,3,"1",1,4,-2,"D"
"25490",2014-02-15,2013,"OGC Nice","FC Nantes","0-0",0,0,"1",1,0,0,"D"
"25491",2014-02-15,2013,"Stade Reims","Girondins Bordeaux","1-0",1,0,"1",1,1,1,"H"
"25492",2014-02-15,2013,"Stade Rennes","Montpellier HSC","2-2",2,2,"1",1,4,0,"D"
"25493",2014-02-15,2013,"FC Sochaux","EA Guingamp","1-0",1,0,"1",1,1,1,"H"
"25494",2014-02-16,2013,"Olympique Lyon","AC Ajaccio","3-1",3,1,"1",1,4,2,"H"
"25495",2014-02-16,2013,"Evian Thonon Gaillard","Lille OSC","2-2",2,2,"1",1,4,0,"D"
"25496",2014-02-16,2013,"AS Saint-Etienne","Olympique Marseille","1-1",1,1,"1",1,2,0,"D"
"25497",2014-02-21,2013,"AS Monaco","Stade Reims","3-2",3,2,"1",1,5,1,"H"
"25498",2014-02-22,2013,"Olympique Marseille","FC Lorient","1-0",1,0,"1",1,1,1,"H"
"25499",2014-02-22,2013,"SC Bastia","AS Saint-Etienne","0-2",0,2,"1",1,2,-2,"D"
"25500",2014-02-22,2013,"Girondins Bordeaux","Evian Thonon Gaillard","2-1",2,1,"1",1,3,1,"H"
"25501",2014-02-22,2013,"EA Guingamp","OGC Nice","1-0",1,0,"1",1,1,1,"H"
"25502",2014-02-22,2013,"Montpellier HSC","AC Ajaccio","2-0",2,0,"1",1,2,2,"H"
"25503",2014-02-22,2013,"Valenciennes FC","FC Sochaux","2-2",2,2,"1",1,4,0,"D"
"25504",2014-02-23,2013,"Toulouse FC","Paris Saint-Germain","2-4",2,4,"1",1,6,-2,"D"
"25505",2014-02-23,2013,"FC Nantes","Stade Rennes","0-3",0,3,"1",1,3,-3,"D"
"25506",2014-02-23,2013,"Lille OSC","Olympique Lyon","0-0",0,0,"1",1,0,0,"D"
"25507",2014-02-25,2013,"Girondins Bordeaux","FC Lorient","3-2",3,2,"1",1,5,1,"H"
"25508",2014-02-28,2013,"Evian Thonon Gaillard","FC Nantes","2-0",2,0,"1",1,2,2,"H"
"25509",2014-03-01,2013,"AS Saint-Etienne","AS Monaco","2-0",2,0,"1",1,2,2,"H"
"25510",2014-03-01,2013,"FC Lorient","SC Bastia","1-1",1,1,"1",1,2,0,"D"
"25511",2014-03-01,2013,"OGC Nice","Toulouse FC","0-2",0,2,"1",1,2,-2,"D"
"25512",2014-03-01,2013,"Stade Reims","Valenciennes FC","3-1",3,1,"1",1,4,2,"H"
"25513",2014-03-01,2013,"Stade Rennes","EA Guingamp","0-2",0,2,"1",1,2,-2,"D"
"25514",2014-03-01,2013,"FC Sochaux","Girondins Bordeaux","2-0",2,0,"1",1,2,2,"H"
"25515",2014-03-02,2013,"AC Ajaccio","Lille OSC","2-3",2,3,"1",1,5,-1,"D"
"25516",2014-03-02,2013,"Olympique Lyon","Montpellier HSC","0-0",0,0,"1",1,0,0,"D"
"25517",2014-03-02,2013,"Paris Saint-Germain","Olympique Marseille","2-0",2,0,"1",1,2,2,"H"
"25518",2014-03-07,2013,"Olympique Marseille","OGC Nice","0-1",0,1,"1",1,1,-1,"D"
"25519",2014-03-08,2013,"SC Bastia","Paris Saint-Germain","0-3",0,3,"1",1,3,-3,"D"
"25520",2014-03-08,2013,"EA Guingamp","Evian Thonon Gaillard","0-1",0,1,"1",1,1,-1,"D"
"25521",2014-03-08,2013,"AS Monaco","FC Sochaux","2-1",2,1,"1",1,3,1,"H"
"25522",2014-03-08,2013,"FC Nantes","AC Ajaccio","2-2",2,2,"1",1,4,0,"D"
"25523",2014-03-08,2013,"Toulouse FC","Stade Reims","3-2",3,2,"1",1,5,1,"H"
"25524",2014-03-08,2013,"Valenciennes FC","Stade Rennes","2-1",2,1,"1",1,3,1,"H"
"25525",2014-03-09,2013,"Lille OSC","Montpellier HSC","2-0",2,0,"1",1,2,2,"H"
"25526",2014-03-09,2013,"FC Lorient","AS Saint-Etienne","1-0",1,0,"1",1,1,1,"H"
"25527",2014-03-09,2013,"Girondins Bordeaux","Olympique Lyon","1-2",1,2,"1",1,3,-1,"D"
"25528",2014-03-14,2013,"Stade Reims","Olympique Marseille","1-1",1,1,"1",1,2,0,"D"
"25529",2014-03-15,2013,"Lille OSC","FC Nantes","0-0",0,0,"1",1,0,0,"D"
"25530",2014-03-15,2013,"AC Ajaccio","EA Guingamp","1-2",1,2,"1",1,3,-1,"D"
"25531",2014-03-15,2013,"Evian Thonon Gaillard","Valenciennes FC","0-1",0,1,"1",1,1,-1,"D"
"25532",2014-03-15,2013,"OGC Nice","SC Bastia","2-0",2,0,"1",1,2,2,"H"
"25533",2014-03-15,2013,"Stade Rennes","Toulouse FC","2-3",2,3,"1",1,5,-1,"D"
"25534",2014-03-15,2013,"FC Sochaux","FC Lorient","2-0",2,0,"1",1,2,2,"H"
"25535",2014-03-16,2013,"Montpellier HSC","Girondins Bordeaux","1-1",1,1,"1",1,2,0,"D"
"25536",2014-03-16,2013,"Olympique Lyon","AS Monaco","2-3",2,3,"1",1,5,-1,"D"
"25537",2014-03-16,2013,"Paris Saint-Germain","AS Saint-Etienne","2-0",2,0,"1",1,2,2,"H"
"25538",2014-03-21,2013,"FC Lorient","Paris Saint-Germain","0-1",0,1,"1",1,1,-1,"D"
"25539",2014-03-22,2013,"Olympique Marseille","Stade Rennes","0-1",0,1,"1",1,1,-1,"D"
"25540",2014-03-22,2013,"SC Bastia","Stade Reims","2-0",2,0,"1",1,2,2,"H"
"25541",2014-03-22,2013,"Girondins Bordeaux","OGC Nice","1-1",1,1,"1",1,2,0,"D"
"25542",2014-03-22,2013,"FC Nantes","Montpellier HSC","2-1",2,1,"1",1,3,1,"H"
"25543",2014-03-22,2013,"Toulouse FC","Evian Thonon Gaillard","1-1",1,1,"1",1,2,0,"D"
"25544",2014-03-22,2013,"Valenciennes FC","AC Ajaccio","2-3",2,3,"1",1,5,-1,"D"
"25545",2014-03-23,2013,"AS Saint-Etienne","FC Sochaux","3-1",3,1,"1",1,4,2,"H"
"25546",2014-03-23,2013,"EA Guingamp","Olympique Lyon","0-1",0,1,"1",1,1,-1,"D"
"25547",2014-03-23,2013,"AS Monaco","Lille OSC","1-1",1,1,"1",1,2,0,"D"
"25548",2014-03-28,2013,"OGC Nice","Paris Saint-Germain","0-1",0,1,"1",1,1,-1,"D"
"25549",2014-03-29,2013,"FC Sochaux","Olympique Marseille","1-1",1,1,"1",1,2,0,"D"
"25550",2014-03-29,2013,"AC Ajaccio","Toulouse FC","2-2",2,2,"1",1,4,0,"D"
"25551",2014-03-29,2013,"Evian Thonon Gaillard","AS Monaco","1-0",1,0,"1",1,1,1,"H"
"25552",2014-03-29,2013,"Montpellier HSC","Valenciennes FC","0-0",0,0,"1",1,0,0,"D"
"25553",2014-03-29,2013,"FC Nantes","Girondins Bordeaux","0-0",0,0,"1",1,0,0,"D"
"25554",2014-03-29,2013,"Stade Reims","FC Lorient","1-1",1,1,"1",1,2,0,"D"
"25555",2014-03-30,2013,"Stade Rennes","SC Bastia","3-0",3,0,"1",1,3,3,"H"
"25556",2014-03-30,2013,"Lille OSC","EA Guingamp","1-0",1,0,"1",1,1,1,"H"
"25557",2014-03-30,2013,"Olympique Lyon","AS Saint-Etienne","1-2",1,2,"1",1,3,-1,"D"
"25558",2014-04-04,2013,"Olympique Marseille","AC Ajaccio","3-1",3,1,"1",1,4,2,"H"
"25559",2014-04-05,2013,"Paris Saint-Germain","Stade Reims","3-0",3,0,"1",1,3,3,"H"
"25560",2014-04-05,2013,"SC Bastia","FC Sochaux","2-2",2,2,"1",1,4,0,"D"
"25561",2014-04-05,2013,"Girondins Bordeaux","Stade Rennes","2-2",2,2,"1",1,4,0,"D"
"25562",2014-04-05,2013,"EA Guingamp","Montpellier HSC","1-2",1,2,"1",1,3,-1,"D"
"25563",2014-04-05,2013,"FC Lorient","Evian Thonon Gaillard","1-1",1,1,"1",1,2,0,"D"
"25564",2014-04-05,2013,"Toulouse FC","Lille OSC","1-2",1,2,"1",1,3,-1,"D"
"25565",2014-04-06,2013,"AS Saint-Etienne","OGC Nice","1-1",1,1,"1",1,2,0,"D"
"25566",2014-04-06,2013,"Valenciennes FC","Olympique Lyon","1-2",1,2,"1",1,3,-1,"D"
"25567",2014-04-06,2013,"AS Monaco","FC Nantes","3-1",3,1,"1",1,4,2,"H"
"25568",2014-04-11,2013,"Montpellier HSC","Olympique Marseille","2-3",2,3,"1",1,5,-1,"D"
"25569",2014-04-12,2013,"Lille OSC","Valenciennes FC","1-0",1,0,"1",1,1,1,"H"
"25570",2014-04-12,2013,"AC Ajaccio","Girondins Bordeaux","1-1",1,1,"1",1,2,0,"D"
"25571",2014-04-12,2013,"Evian Thonon Gaillard","SC Bastia","2-1",2,1,"1",1,3,1,"H"
"25572",2014-04-12,2013,"OGC Nice","FC Lorient","1-2",1,2,"1",1,3,-1,"D"
"25573",2014-04-12,2013,"Stade Rennes","AS Monaco","0-1",0,1,"1",1,1,-1,"D"
"25574",2014-04-12,2013,"FC Sochaux","Toulouse FC","2-0",2,0,"1",1,2,2,"H"
"25575",2014-04-13,2013,"FC Nantes","EA Guingamp","1-0",1,0,"1",1,1,1,"H"
"25576",2014-04-13,2013,"Stade Reims","AS Saint-Etienne","2-2",2,2,"1",1,4,0,"D"
"25577",2014-04-13,2013,"Olympique Lyon","Paris Saint-Germain","1-0",1,0,"1",1,1,1,"H"
"25578",2014-04-18,2013,"AS Saint-Etienne","Stade Rennes","0-0",0,0,"1",1,0,0,"D"
"25579",2014-04-20,2013,"AS Monaco","OGC Nice","1-0",1,0,"1",1,1,1,"H"
"25580",2014-04-20,2013,"SC Bastia","AC Ajaccio","2-1",2,1,"1",1,3,1,"H"
"25581",2014-04-20,2013,"Girondins Bordeaux","EA Guingamp","5-1",5,1,"1",1,6,4,"H"
"25582",2014-04-20,2013,"FC Lorient","Montpellier HSC","4-4",4,4,"1",1,8,0,"D"
"25583",2014-04-20,2013,"Stade Reims","FC Sochaux","0-1",0,1,"1",1,1,-1,"D"
"25584",2014-04-20,2013,"Valenciennes FC","FC Nantes","2-6",2,6,"1",1,8,-4,"D"
"25585",2014-04-20,2013,"Olympique Marseille","Lille OSC","0-0",0,0,"1",1,0,0,"D"
"25586",2014-04-23,2013,"Paris Saint-Germain","Evian Thonon Gaillard","1-0",1,0,"1",1,1,1,"H"
"25587",2014-04-23,2013,"Toulouse FC","Olympique Lyon","0-0",0,0,"1",1,0,0,"D"
"25588",2014-04-25,2013,"FC Nantes","Olympique Marseille","1-1",1,1,"1",1,2,0,"D"
"25589",2014-04-26,2013,"AC Ajaccio","AS Monaco","1-4",1,4,"1",1,5,-3,"D"
"25590",2014-04-26,2013,"Evian Thonon Gaillard","AS Saint-Etienne","1-2",1,2,"1",1,3,-1,"D"
"25591",2014-04-26,2013,"EA Guingamp","Valenciennes FC","1-0",1,0,"1",1,1,1,"H"
"25592",2014-04-26,2013,"Montpellier HSC","Toulouse FC","2-1",2,1,"1",1,3,1,"H"
"25593",2014-04-26,2013,"OGC Nice","Stade Reims","1-0",1,0,"1",1,1,1,"H"
"25594",2014-04-26,2013,"Stade Rennes","FC Lorient","1-1",1,1,"1",1,2,0,"D"
"25595",2014-04-27,2013,"FC Sochaux","Paris Saint-Germain","1-1",1,1,"1",1,2,0,"D"
"25596",2014-04-27,2013,"Olympique Lyon","SC Bastia","4-1",4,1,"1",1,5,3,"H"
"25597",2014-04-27,2013,"Lille OSC","Girondins Bordeaux","2-1",2,1,"1",1,3,1,"H"
"25598",2014-05-02,2013,"SC Bastia","Lille OSC","1-1",1,1,"1",1,2,0,"D"
"25599",2014-05-04,2013,"AS Saint-Etienne","Montpellier HSC","2-0",2,0,"1",1,2,2,"H"
"25600",2014-05-04,2013,"FC Lorient","AC Ajaccio","1-0",1,0,"1",1,1,1,"H"
"25601",2014-05-04,2013,"Stade Reims","Evian Thonon Gaillard","1-0",1,0,"1",1,1,1,"H"
"25602",2014-05-04,2013,"FC Sochaux","OGC Nice","2-0",2,0,"1",1,2,2,"H"
"25603",2014-05-04,2013,"Toulouse FC","FC Nantes","1-1",1,1,"1",1,2,0,"D"
"25604",2014-05-04,2013,"Valenciennes FC","Girondins Bordeaux","0-1",0,1,"1",1,1,-1,"D"
"25605",2014-05-04,2013,"Olympique Marseille","Olympique Lyon","4-2",4,2,"1",1,6,2,"H"
"25606",2014-05-07,2013,"AS Monaco","EA Guingamp","1-1",1,1,"1",1,2,0,"D"
"25607",2014-05-07,2013,"Paris Saint-Germain","Stade Rennes","1-2",1,2,"1",1,3,-1,"D"
"25608",2014-05-10,2013,"AC Ajaccio","Stade Reims","2-1",2,1,"1",1,3,1,"H"
"25609",2014-05-10,2013,"Girondins Bordeaux","Olympique Marseille","1-1",1,1,"1",1,2,0,"D"
"25610",2014-05-10,2013,"Evian Thonon Gaillard","OGC Nice","2-0",2,0,"1",1,2,2,"H"
"25611",2014-05-10,2013,"EA Guingamp","Toulouse FC","2-0",2,0,"1",1,2,2,"H"
"25612",2014-05-10,2013,"Lille OSC","Paris Saint-Germain","1-3",1,3,"1",1,4,-2,"D"
"25613",2014-05-10,2013,"Olympique Lyon","FC Lorient","0-1",0,1,"1",1,1,-1,"D"
"25614",2014-05-10,2013,"Montpellier HSC","SC Bastia","0-2",0,2,"1",1,2,-2,"D"
"25615",2014-05-10,2013,"FC Nantes","AS Saint-Etienne","1-3",1,3,"1",1,4,-2,"D"
"25616",2014-05-10,2013,"Stade Rennes","FC Sochaux","1-2",1,2,"1",1,3,-1,"D"
"25617",2014-05-10,2013,"Valenciennes FC","AS Monaco","1-2",1,2,"1",1,3,-1,"D"
"25618",2014-05-17,2013,"SC Bastia","FC Nantes","0-0",0,0,"1",1,0,0,"D"
"25619",2014-05-17,2013,"FC Lorient","Lille OSC","1-4",1,4,"1",1,5,-3,"D"
"25620",2014-05-17,2013,"Olympique Marseille","EA Guingamp","1-0",1,0,"1",1,1,1,"H"
"25621",2014-05-17,2013,"AS Monaco","Girondins Bordeaux","1-1",1,1,"1",1,2,0,"D"
"25622",2014-05-17,2013,"OGC Nice","Olympique Lyon","0-1",0,1,"1",1,1,-1,"D"
"25623",2014-05-17,2013,"Paris Saint-Germain","Montpellier HSC","4-0",4,0,"1",1,4,4,"H"
"25624",2014-05-17,2013,"Stade Reims","Stade Rennes","1-3",1,3,"1",1,4,-2,"D"
"25625",2014-05-17,2013,"AS Saint-Etienne","AC Ajaccio","3-1",3,1,"1",1,4,2,"H"
"25626",2014-05-17,2013,"FC Sochaux","Evian Thonon Gaillard","0-3",0,3,"1",1,3,-3,"D"
"25627",2014-05-17,2013,"Toulouse FC","Valenciennes FC","3-1",3,1,"1",1,4,2,"H"
"25628",2014-08-08,2014,"Stade Reims","Paris Saint-Germain","2-2",2,2,"1",1,4,0,"D"
"25629",2014-08-09,2014,"SC Bastia","Olympique Marseille","3-3",3,3,"1",1,6,0,"D"
"25630",2014-08-09,2014,"Evian Thonon Gaillard","SM Caen","0-3",0,3,"1",1,3,-3,"D"
"25631",2014-08-09,2014,"EA Guingamp","AS Saint-Etienne","0-2",0,2,"1",1,2,-2,"D"
"25632",2014-08-09,2014,"Lille OSC","FC Metz","0-0",0,0,"1",1,0,0,"D"
"25633",2014-08-09,2014,"Montpellier HSC","Girondins Bordeaux","0-1",0,1,"1",1,1,-1,"D"
"25634",2014-08-09,2014,"FC Nantes","RC Lens","1-0",1,0,"1",1,1,1,"H"
"25635",2014-08-09,2014,"OGC Nice","Toulouse FC","3-2",3,2,"1",1,5,1,"H"
"25636",2014-08-10,2014,"Olympique Lyon","Stade Rennes","2-0",2,0,"1",1,2,2,"H"
"25637",2014-08-10,2014,"AS Monaco","FC Lorient","1-2",1,2,"1",1,3,-1,"D"
"25638",2014-08-15,2014,"SM Caen","Lille OSC","0-1",0,1,"1",1,1,-1,"D"
"25639",2014-08-16,2014,"Paris Saint-Germain","SC Bastia","2-0",2,0,"1",1,2,2,"H"
"25640",2014-08-16,2014,"RC Lens","EA Guingamp","0-1",0,1,"1",1,1,-1,"D"
"25641",2014-08-16,2014,"FC Lorient","OGC Nice","0-0",0,0,"1",1,0,0,"D"
"25642",2014-08-16,2014,"FC Metz","FC Nantes","1-1",1,1,"1",1,2,0,"D"
"25643",2014-08-16,2014,"Stade Rennes","Evian Thonon Gaillard","6-2",6,2,"1",1,8,4,"H"
"25644",2014-08-16,2014,"Toulouse FC","Olympique Lyon","2-1",2,1,"1",1,3,1,"H"
"25645",2014-08-17,2014,"Olympique Marseille","Montpellier HSC","0-2",0,2,"1",1,2,-2,"D"
"25646",2014-08-17,2014,"AS Saint-Etienne","Stade Reims","3-1",3,1,"1",1,4,2,"H"
"25647",2014-08-17,2014,"Girondins Bordeaux","AS Monaco","4-1",4,1,"1",1,5,3,"H"
"25648",2014-08-22,2014,"Evian Thonon Gaillard","Paris Saint-Germain","0-0",0,0,"1",1,0,0,"D"
"25649",2014-08-23,2014,"EA Guingamp","Olympique Marseille","0-1",0,1,"1",1,1,-1,"D"
"25650",2014-08-23,2014,"SC Bastia","Toulouse FC","1-0",1,0,"1",1,1,1,"H"
"25651",2014-08-23,2014,"Lille OSC","FC Lorient","2-0",2,0,"1",1,2,2,"H"
"25652",2014-08-23,2014,"Montpellier HSC","FC Metz","2-0",2,0,"1",1,2,2,"H"
"25653",2014-08-23,2014,"OGC Nice","Girondins Bordeaux","1-3",1,3,"1",1,4,-2,"D"
"25654",2014-08-23,2014,"Stade Reims","SM Caen","0-2",0,2,"1",1,2,-2,"D"
"25655",2014-08-24,2014,"Olympique Lyon","RC Lens","0-1",0,1,"1",1,1,-1,"D"
"25656",2014-08-24,2014,"AS Saint-Etienne","Stade Rennes","0-0",0,0,"1",1,0,0,"D"
"25657",2014-08-24,2014,"FC Nantes","AS Monaco","0-1",0,1,"1",1,1,-1,"D"
"25658",2014-08-29,2014,"Olympique Marseille","OGC Nice","4-0",4,0,"1",1,4,4,"H"
"25659",2014-08-30,2014,"AS Monaco","Lille OSC","1-1",1,1,"1",1,2,0,"D"
"25660",2014-08-30,2014,"SM Caen","Stade Rennes","0-1",0,1,"1",1,1,-1,"D"
"25661",2014-08-30,2014,"RC Lens","Stade Reims","4-2",4,2,"1",1,6,2,"H"
"25662",2014-08-30,2014,"FC Lorient","EA Guingamp","4-0",4,0,"1",1,4,4,"H"
"25663",2014-08-30,2014,"FC Nantes","Montpellier HSC","1-0",1,0,"1",1,1,1,"H"
"25664",2014-08-30,2014,"Toulouse FC","Evian Thonon Gaillard","1-0",1,0,"1",1,1,1,"H"
"25665",2014-08-31,2014,"Girondins Bordeaux","SC Bastia","1-1",1,1,"1",1,2,0,"D"
"25666",2014-08-31,2014,"FC Metz","Olympique Lyon","2-1",2,1,"1",1,3,1,"H"
"25667",2014-08-31,2014,"Paris Saint-Germain","AS Saint-Etienne","5-0",5,0,"1",1,5,5,"H"
"25668",2014-09-12,2014,"Olympique Lyon","AS Monaco","2-1",2,1,"1",1,3,1,"H"
"25669",2014-09-13,2014,"Stade Rennes","Paris Saint-Germain","1-1",1,1,"1",1,2,0,"D"
"25670",2014-09-13,2014,"SC Bastia","RC Lens","1-1",1,1,"1",1,2,0,"D"
"25671",2014-09-13,2014,"Montpellier HSC","FC Lorient","1-0",1,0,"1",1,1,1,"H"
"25672",2014-09-13,2014,"OGC Nice","FC Metz","1-0",1,0,"1",1,1,1,"H"
"25673",2014-09-13,2014,"Stade Reims","Toulouse FC","2-0",2,0,"1",1,2,2,"H"
"25674",2014-09-13,2014,"AS Saint-Etienne","SM Caen","1-0",1,0,"1",1,1,1,"H"
"25675",2014-09-14,2014,"Lille OSC","FC Nantes","2-0",2,0,"1",1,2,2,"H"
"25676",2014-09-14,2014,"EA Guingamp","Girondins Bordeaux","2-1",2,1,"1",1,3,1,"H"
"25677",2014-09-14,2014,"Evian Thonon Gaillard","Olympique Marseille","1-3",1,3,"1",1,4,-2,"D"
"25678",2014-09-19,2014,"Girondins Bordeaux","Evian Thonon Gaillard","2-1",2,1,"1",1,3,1,"H"
"25679",2014-09-20,2014,"Olympique Marseille","Stade Rennes","3-0",3,0,"1",1,3,3,"H"
"25680",2014-09-20,2014,"FC Lorient","Stade Reims","0-1",0,1,"1",1,1,-1,"D"
"25681",2014-09-20,2014,"FC Metz","SC Bastia","3-1",3,1,"1",1,4,2,"H"
"25682",2014-09-20,2014,"FC Nantes","OGC Nice","2-1",2,1,"1",1,3,1,"H"
"25683",2014-09-20,2014,"Toulouse FC","SM Caen","3-3",3,3,"1",1,6,0,"D"
"25684",2014-09-21,2014,"Lille OSC","Montpellier HSC","0-0",0,0,"1",1,0,0,"D"
"25685",2014-09-21,2014,"RC Lens","AS Saint-Etienne","0-1",0,1,"1",1,1,-1,"D"
"25686",2014-09-21,2014,"AS Monaco","EA Guingamp","1-0",1,0,"1",1,1,1,"H"
"25687",2014-09-21,2014,"Paris Saint-Germain","Olympique Lyon","1-1",1,1,"1",1,2,0,"D"
"25688",2014-09-23,2014,"Stade Reims","Olympique Marseille","0-5",0,5,"1",1,5,-5,"D"
"25689",2014-09-23,2014,"Stade Rennes","Toulouse FC","0-3",0,3,"1",1,3,-3,"D"
"25690",2014-09-24,2014,"SC Bastia","FC Nantes","0-0",0,0,"1",1,0,0,"D"
"25691",2014-09-24,2014,"Evian Thonon Gaillard","RC Lens","2-1",2,1,"1",1,3,1,"H"
"25692",2014-09-24,2014,"EA Guingamp","FC Metz","0-1",0,1,"1",1,1,-1,"D"
"25693",2014-09-24,2014,"Olympique Lyon","FC Lorient","4-0",4,0,"1",1,4,4,"H"
"25694",2014-09-24,2014,"Montpellier HSC","AS Monaco","0-1",0,1,"1",1,1,-1,"D"
"25695",2014-09-24,2014,"OGC Nice","Lille OSC","1-0",1,0,"1",1,1,1,"H"
"25696",2014-09-24,2014,"SM Caen","Paris Saint-Germain","0-2",0,2,"1",1,2,-2,"D"
"25697",2014-09-25,2014,"AS Saint-Etienne","Girondins Bordeaux","1-1",1,1,"1",1,2,0,"D"
"25698",2014-09-27,2014,"AS Monaco","OGC Nice","0-1",0,1,"1",1,1,-1,"D"
"25699",2014-09-27,2014,"Toulouse FC","Paris Saint-Germain","1-1",1,1,"1",1,2,0,"D"
"25700",2014-09-27,2014,"Lille OSC","SC Bastia","1-0",1,0,"1",1,1,1,"H"
"25701",2014-09-27,2014,"FC Lorient","Evian Thonon Gaillard","0-2",0,2,"1",1,2,-2,"D"
"25702",2014-09-27,2014,"FC Metz","Stade Reims","3-0",3,0,"1",1,3,3,"H"
"25703",2014-09-27,2014,"Montpellier HSC","EA Guingamp","2-1",2,1,"1",1,3,1,"H"
"25704",2014-09-28,2014,"Girondins Bordeaux","Stade Rennes","2-1",2,1,"1",1,3,1,"H"
"25705",2014-09-28,2014,"RC Lens","SM Caen","0-0",0,0,"1",1,0,0,"D"
"25706",2014-09-28,2014,"FC Nantes","Olympique Lyon","1-1",1,1,"1",1,2,0,"D"
"25707",2014-09-28,2014,"Olympique Marseille","AS Saint-Etienne","2-1",2,1,"1",1,3,1,"H"
"25708",2014-10-03,2014,"Stade Reims","Girondins Bordeaux","1-0",1,0,"1",1,1,1,"H"
"25709",2014-10-04,2014,"SM Caen","Olympique Marseille","1-2",1,2,"1",1,3,-1,"D"
"25710",2014-10-04,2014,"SC Bastia","FC Lorient","0-2",0,2,"1",1,2,-2,"D"
"25711",2014-10-04,2014,"Evian Thonon Gaillard","FC Metz","3-0",3,0,"1",1,3,3,"H"
"25712",2014-10-04,2014,"OGC Nice","Montpellier HSC","1-1",1,1,"1",1,2,0,"D"
"25713",2014-10-04,2014,"Stade Rennes","RC Lens","2-0",2,0,"1",1,2,2,"H"
"25714",2014-10-05,2014,"AS Saint-Etienne","Toulouse FC","0-1",0,1,"1",1,1,-1,"D"
"25715",2014-10-05,2014,"EA Guingamp","FC Nantes","0-1",0,1,"1",1,1,-1,"D"
"25716",2014-10-05,2014,"Olympique Lyon","Lille OSC","3-0",3,0,"1",1,3,3,"H"
"25717",2014-10-05,2014,"Paris Saint-Germain","AS Monaco","1-1",1,1,"1",1,2,0,"D"
"25718",2014-10-17,2014,"RC Lens","Paris Saint-Germain","1-3",1,3,"1",1,4,-2,"D"
"25719",2014-10-18,2014,"FC Lorient","AS Saint-Etienne","0-1",0,1,"1",1,1,-1,"D"
"25720",2014-10-18,2014,"Lille OSC","EA Guingamp","1-2",1,2,"1",1,3,-1,"D"
"25721",2014-10-18,2014,"FC Metz","Stade Rennes","0-0",0,0,"1",1,0,0,"D"
"25722",2014-10-18,2014,"AS Monaco","Evian Thonon Gaillard","2-0",2,0,"1",1,2,2,"H"
"25723",2014-10-18,2014,"FC Nantes","Stade Reims","1-1",1,1,"1",1,2,0,"D"
"25724",2014-10-18,2014,"OGC Nice","SC Bastia","0-1",0,1,"1",1,1,-1,"D"
"25725",2014-10-19,2014,"Olympique Marseille","Toulouse FC","2-0",2,0,"1",1,2,2,"H"
"25726",2014-10-19,2014,"Girondins Bordeaux","SM Caen","1-1",1,1,"1",1,2,0,"D"
"25727",2014-10-19,2014,"Olympique Lyon","Montpellier HSC","5-1",5,1,"1",1,6,4,"H"
"25728",2014-10-24,2014,"Toulouse FC","RC Lens","0-2",0,2,"1",1,2,-2,"D"
"25729",2014-10-25,2014,"Paris Saint-Germain","Girondins Bordeaux","3-0",3,0,"1",1,3,3,"H"
"25730",2014-10-25,2014,"SC Bastia","AS Monaco","1-3",1,3,"1",1,4,-2,"D"
"25731",2014-10-25,2014,"SM Caen","FC Lorient","2-1",2,1,"1",1,3,1,"H"
"25732",2014-10-25,2014,"Evian Thonon Gaillard","FC Nantes","0-2",0,2,"1",1,2,-2,"D"
"25733",2014-10-25,2014,"Stade Reims","Montpellier HSC","1-0",1,0,"1",1,1,1,"H"
"25734",2014-10-26,2014,"Stade Rennes","Lille OSC","2-0",2,0,"1",1,2,2,"H"
"25735",2014-10-26,2014,"EA Guingamp","OGC Nice","2-7",2,7,"1",1,9,-5,"D"
"25736",2014-10-26,2014,"AS Saint-Etienne","FC Metz","1-0",1,0,"1",1,1,1,"H"
"25737",2014-10-26,2014,"Olympique Lyon","Olympique Marseille","1-0",1,0,"1",1,1,1,"H"
"25738",2014-10-31,2014,"AS Monaco","Stade Reims","1-1",1,1,"1",1,2,0,"D"
"25739",2014-11-01,2014,"FC Lorient","Paris Saint-Germain","1-2",1,2,"1",1,3,-1,"D"
"25740",2014-11-01,2014,"EA Guingamp","SC Bastia","1-0",1,0,"1",1,1,1,"H"
"25741",2014-11-01,2014,"Lille OSC","AS Saint-Etienne","1-1",1,1,"1",1,2,0,"D"
"25742",2014-11-01,2014,"FC Metz","SM Caen","3-2",3,2,"1",1,5,1,"H"
"25743",2014-11-01,2014,"Montpellier HSC","Evian Thonon Gaillard","2-0",2,0,"1",1,2,2,"H"
"25744",2014-11-01,2014,"OGC Nice","Olympique Lyon","1-3",1,3,"1",1,4,-2,"D"
"25745",2014-11-02,2014,"FC Nantes","Stade Rennes","1-1",1,1,"1",1,2,0,"D"
"25746",2014-11-02,2014,"Girondins Bordeaux","Toulouse FC","2-1",2,1,"1",1,3,1,"H"
"25747",2014-11-02,2014,"Olympique Marseille","RC Lens","2-1",2,1,"1",1,3,1,"H"
"25748",2014-11-07,2014,"Stade Rennes","FC Lorient","1-0",1,0,"1",1,1,1,"H"
"25749",2014-11-08,2014,"RC Lens","Girondins Bordeaux","1-2",1,2,"1",1,3,-1,"D"
"25750",2014-11-08,2014,"SC Bastia","Montpellier HSC","2-0",2,0,"1",1,2,2,"H"
"25751",2014-11-08,2014,"SM Caen","FC Nantes","1-2",1,2,"1",1,3,-1,"D"
"25752",2014-11-08,2014,"Evian Thonon Gaillard","OGC Nice","1-0",1,0,"1",1,1,1,"H"
"25753",2014-11-08,2014,"Toulouse FC","FC Metz","3-0",3,0,"1",1,3,3,"H"
"25754",2014-11-09,2014,"Olympique Lyon","EA Guingamp","3-1",3,1,"1",1,4,2,"H"
"25755",2014-11-09,2014,"Stade Reims","Lille OSC","2-0",2,0,"1",1,2,2,"H"
"25756",2014-11-09,2014,"AS Saint-Etienne","AS Monaco","1-1",1,1,"1",1,2,0,"D"
"25757",2014-11-09,2014,"Paris Saint-Germain","Olympique Marseille","2-0",2,0,"1",1,2,2,"H"
"25758",2014-11-21,2014,"FC Metz","Paris Saint-Germain","2-3",2,3,"1",1,5,-1,"D"
"25759",2014-11-22,2014,"SC Bastia","Olympique Lyon","0-0",0,0,"1",1,0,0,"D"
"25760",2014-11-22,2014,"EA Guingamp","Stade Rennes","0-1",0,1,"1",1,1,-1,"D"
"25761",2014-11-22,2014,"FC Lorient","RC Lens","1-0",1,0,"1",1,1,1,"H"
"25762",2014-11-22,2014,"AS Monaco","SM Caen","2-2",2,2,"1",1,4,0,"D"
"25763",2014-11-22,2014,"OGC Nice","Stade Reims","0-0",0,0,"1",1,0,0,"D"
"25764",2014-11-23,2014,"FC Nantes","AS Saint-Etienne","0-0",0,0,"1",1,0,0,"D"
"25765",2014-11-23,2014,"Montpellier HSC","Toulouse FC","2-0",2,0,"1",1,2,2,"H"
"25766",2014-11-23,2014,"Olympique Marseille","Girondins Bordeaux","3-1",3,1,"1",1,4,2,"H"
"25767",2014-11-28,2014,"Olympique Marseille","FC Nantes","2-0",2,0,"1",1,2,2,"H"
"25768",2014-11-29,2014,"Paris Saint-Germain","OGC Nice","1-0",1,0,"1",1,1,1,"H"
"25769",2014-11-29,2014,"SM Caen","Montpellier HSC","1-1",1,1,"1",1,2,0,"D"
"25770",2014-11-29,2014,"RC Lens","FC Metz","2-0",2,0,"1",1,2,2,"H"
"25771",2014-11-29,2014,"Stade Reims","SC Bastia","2-1",2,1,"1",1,3,1,"H"
"25772",2014-11-29,2014,"Stade Rennes","AS Monaco","2-0",2,0,"1",1,2,2,"H"
"25773",2014-11-29,2014,"Toulouse FC","FC Lorient","2-3",2,3,"1",1,5,-1,"D"
"25774",2014-11-30,2014,"Girondins Bordeaux","Lille OSC","1-0",1,0,"1",1,1,1,"H"
"25775",2014-11-30,2014,"Evian Thonon Gaillard","EA Guingamp","2-0",2,0,"1",1,2,2,"H"
"25776",2014-11-30,2014,"AS Saint-Etienne","Olympique Lyon","3-0",3,0,"1",1,3,3,"H"
"25777",2014-12-02,2014,"FC Lorient","Olympique Marseille","1-1",1,1,"1",1,2,0,"D"
"25778",2014-12-02,2014,"FC Nantes","Toulouse FC","1-2",1,2,"1",1,3,-1,"D"
"25779",2014-12-02,2014,"AS Monaco","RC Lens","2-0",2,0,"1",1,2,2,"H"
"25780",2014-12-03,2014,"SC Bastia","Evian Thonon Gaillard","1-2",1,2,"1",1,3,-1,"D"
"25781",2014-12-03,2014,"EA Guingamp","SM Caen","5-1",5,1,"1",1,6,4,"H"
"25782",2014-12-03,2014,"FC Metz","Girondins Bordeaux","0-0",0,0,"1",1,0,0,"D"
"25783",2014-12-03,2014,"Montpellier HSC","AS Saint-Etienne","0-2",0,2,"1",1,2,-2,"D"
"25784",2014-12-03,2014,"OGC Nice","Stade Rennes","1-2",1,2,"1",1,3,-1,"D"
"25785",2014-12-03,2014,"Lille OSC","Paris Saint-Germain","1-1",1,1,"1",1,2,0,"D"
"25786",2014-12-04,2014,"Olympique Lyon","Stade Reims","2-1",2,1,"1",1,3,1,"H"
"25787",2014-12-05,2014,"Toulouse FC","AS Monaco","0-2",0,2,"1",1,2,-2,"D"
"25788",2014-12-06,2014,"Paris Saint-Germain","FC Nantes","2-1",2,1,"1",1,3,1,"H"
"25789",2014-12-06,2014,"Girondins Bordeaux","FC Lorient","3-2",3,2,"1",1,5,1,"H"
"25790",2014-12-06,2014,"SM Caen","OGC Nice","2-3",2,3,"1",1,5,-1,"D"
"25791",2014-12-06,2014,"Stade Rennes","Montpellier HSC","0-4",0,4,"1",1,4,-4,"D"
"25792",2014-12-06,2014,"AS Saint-Etienne","SC Bastia","1-0",1,0,"1",1,1,1,"H"
"25793",2014-12-07,2014,"Evian Thonon Gaillard","Olympique Lyon","2-3",2,3,"1",1,5,-1,"D"
"25794",2014-12-07,2014,"RC Lens","Lille OSC","1-1",1,1,"1",1,2,0,"D"
"25795",2014-12-07,2014,"Stade Reims","EA Guingamp","2-3",2,3,"1",1,5,-1,"D"
"25796",2014-12-07,2014,"Olympique Marseille","FC Metz","3-1",3,1,"1",1,4,2,"H"
"25797",2014-12-12,2014,"Olympique Lyon","SM Caen","3-0",3,0,"1",1,3,3,"H"
"25798",2014-12-13,2014,"FC Nantes","Girondins Bordeaux","2-1",2,1,"1",1,3,1,"H"
"25799",2014-12-13,2014,"SC Bastia","Stade Rennes","2-0",2,0,"1",1,2,2,"H"
"25800",2014-12-13,2014,"FC Lorient","FC Metz","3-1",3,1,"1",1,4,2,"H"
"25801",2014-12-13,2014,"Montpellier HSC","RC Lens","3-3",3,3,"1",1,6,0,"D"
"25802",2014-12-13,2014,"Stade Reims","Evian Thonon Gaillard","3-2",3,2,"1",1,5,1,"H"
"25803",2014-12-14,2014,"OGC Nice","AS Saint-Etienne","0-0",0,0,"1",1,0,0,"D"
"25804",2014-12-14,2014,"EA Guingamp","Paris Saint-Germain","1-0",1,0,"1",1,1,1,"H"
"25805",2014-12-14,2014,"Lille OSC","Toulouse FC","3-0",3,0,"1",1,3,3,"H"
"25806",2014-12-14,2014,"AS Monaco","Olympique Marseille","1-0",1,0,"1",1,1,1,"H"
"25807",2014-12-19,2014,"RC Lens","OGC Nice","2-0",2,0,"1",1,2,2,"H"
"25808",2014-12-20,2014,"Paris Saint-Germain","Montpellier HSC","0-0",0,0,"1",1,0,0,"D"
"25809",2014-12-20,2014,"SM Caen","SC Bastia","1-1",1,1,"1",1,2,0,"D"
"25810",2014-12-20,2014,"FC Lorient","FC Nantes","1-2",1,2,"1",1,3,-1,"D"
"25811",2014-12-20,2014,"FC Metz","AS Monaco","0-1",0,1,"1",1,1,-1,"D"
"25812",2014-12-20,2014,"Stade Rennes","Stade Reims","1-3",1,3,"1",1,4,-2,"D"
"25813",2014-12-20,2014,"Toulouse FC","EA Guingamp","1-1",1,1,"1",1,2,0,"D"
"25814",2014-12-21,2014,"Olympique Marseille","Lille OSC","2-1",2,1,"1",1,3,1,"H"
"25815",2014-12-21,2014,"AS Saint-Etienne","Evian Thonon Gaillard","3-0",3,0,"1",1,3,3,"H"
"25816",2014-12-21,2014,"Girondins Bordeaux","Olympique Lyon","0-5",0,5,"1",1,5,-5,"D"
"25817",2015-01-07,2014,"Lille OSC","Evian Thonon Gaillard","1-0",1,0,"1",1,1,1,"H"
"25818",2015-01-09,2014,"Montpellier HSC","Olympique Marseille","2-1",2,1,"1",1,3,1,"H"
"25819",2015-01-10,2014,"SC Bastia","Paris Saint-Germain","4-2",4,2,"1",1,6,2,"H"
"25820",2015-01-10,2014,"Lille OSC","SM Caen","1-0",1,0,"1",1,1,1,"H"
"25821",2015-01-10,2014,"EA Guingamp","RC Lens","2-0",2,0,"1",1,2,2,"H"
"25822",2015-01-10,2014,"OGC Nice","FC Lorient","3-1",3,1,"1",1,4,2,"H"
"25823",2015-01-10,2014,"Evian Thonon Gaillard","Stade Rennes","1-1",1,1,"1",1,2,0,"D"
"25824",2015-01-10,2014,"Stade Reims","AS Saint-Etienne","1-2",1,2,"1",1,3,-1,"D"
"25825",2015-01-11,2014,"FC Nantes","FC Metz","0-0",0,0,"1",1,0,0,"D"
"25826",2015-01-11,2014,"Olympique Lyon","Toulouse FC","3-0",3,0,"1",1,3,3,"H"
"25827",2015-01-11,2014,"AS Monaco","Girondins Bordeaux","0-0",0,0,"1",1,0,0,"D"
"25828",2015-01-16,2014,"Girondins Bordeaux","OGC Nice","1-2",1,2,"1",1,3,-1,"D"
"25829",2015-01-17,2014,"RC Lens","Olympique Lyon","0-2",0,2,"1",1,2,-2,"D"
"25830",2015-01-17,2014,"Toulouse FC","SC Bastia","1-1",1,1,"1",1,2,0,"D"
"25831",2015-01-17,2014,"FC Lorient","Lille OSC","1-0",1,0,"1",1,1,1,"H"
"25832",2015-01-17,2014,"FC Metz","Montpellier HSC","2-3",2,3,"1",1,5,-1,"D"
"25833",2015-01-17,2014,"AS Monaco","FC Nantes","1-0",1,0,"1",1,1,1,"H"
"25834",2015-01-17,2014,"SM Caen","Stade Reims","4-1",4,1,"1",1,5,3,"H"
"25835",2015-01-18,2014,"Paris Saint-Germain","Evian Thonon Gaillard","4-2",4,2,"1",1,6,2,"H"
"25836",2015-01-18,2014,"Stade Rennes","AS Saint-Etienne","0-0",0,0,"1",1,0,0,"D"
"25837",2015-01-18,2014,"Olympique Marseille","EA Guingamp","2-1",2,1,"1",1,3,1,"H"
"25838",2015-01-23,2014,"OGC Nice","Olympique Marseille","2-1",2,1,"1",1,3,1,"H"
"25839",2015-01-24,2014,"Lille OSC","AS Monaco","0-1",0,1,"1",1,1,-1,"D"
"25840",2015-01-24,2014,"SC Bastia","Girondins Bordeaux","0-0",0,0,"1",1,0,0,"D"
"25841",2015-01-24,2014,"EA Guingamp","FC Lorient","3-2",3,2,"1",1,5,1,"H"
"25842",2015-01-24,2014,"Montpellier HSC","FC Nantes","4-0",4,0,"1",1,4,4,"H"
"25843",2015-01-25,2014,"Olympique Lyon","FC Metz","2-0",2,0,"1",1,2,2,"H"
"25844",2015-01-25,2014,"Evian Thonon Gaillard","Toulouse FC","1-0",1,0,"1",1,1,1,"H"
"25845",2015-01-25,2014,"Stade Rennes","SM Caen","1-4",1,4,"1",1,5,-3,"D"
"25846",2015-01-25,2014,"Stade Reims","RC Lens","0-0",0,0,"1",1,0,0,"D"
"25847",2015-01-25,2014,"AS Saint-Etienne","Paris Saint-Germain","0-1",0,1,"1",1,1,-1,"D"
"25848",2015-01-30,2014,"Paris Saint-Germain","Stade Rennes","1-0",1,0,"1",1,1,1,"H"
"25849",2015-01-31,2014,"Olympique Marseille","Evian Thonon Gaillard","1-0",1,0,"1",1,1,1,"H"
"25850",2015-01-31,2014,"RC Lens","SC Bastia","1-1",1,1,"1",1,2,0,"D"
"25851",2015-01-31,2014,"FC Nantes","Lille OSC","1-1",1,1,"1",1,2,0,"D"
"25852",2015-01-31,2014,"FC Lorient","Montpellier HSC","0-0",0,0,"1",1,0,0,"D"
"25853",2015-01-31,2014,"FC Metz","OGC Nice","0-0",0,0,"1",1,0,0,"D"
"25854",2015-01-31,2014,"Toulouse FC","Stade Reims","1-0",1,0,"1",1,1,1,"H"
"25855",2015-02-01,2014,"SM Caen","AS Saint-Etienne","1-0",1,0,"1",1,1,1,"H"
"25856",2015-02-01,2014,"Girondins Bordeaux","EA Guingamp","1-1",1,1,"1",1,2,0,"D"
"25857",2015-02-01,2014,"AS Monaco","Olympique Lyon","0-0",0,0,"1",1,0,0,"D"
"25858",2015-02-06,2014,"AS Saint-Etienne","RC Lens","3-3",3,3,"1",1,6,0,"D"
"25859",2015-02-07,2014,"Stade Rennes","Olympique Marseille","1-1",1,1,"1",1,2,0,"D"
"25860",2015-02-07,2014,"Evian Thonon Gaillard","Girondins Bordeaux","0-1",0,1,"1",1,1,-1,"D"
"25861",2015-02-07,2014,"Montpellier HSC","Lille OSC","1-2",1,2,"1",1,3,-1,"D"
"25862",2015-02-07,2014,"Stade Reims","FC Lorient","1-3",1,3,"1",1,4,-2,"D"
"25863",2015-02-07,2014,"SC Bastia","FC Metz","2-0",2,0,"1",1,2,2,"H"
"25864",2015-02-07,2014,"SM Caen","Toulouse FC","2-0",2,0,"1",1,2,2,"H"
"25865",2015-02-08,2014,"EA Guingamp","AS Monaco","1-0",1,0,"1",1,1,1,"H"
"25866",2015-02-08,2014,"OGC Nice","FC Nantes","0-0",0,0,"1",1,0,0,"D"
"25867",2015-02-08,2014,"Olympique Lyon","Paris Saint-Germain","1-1",1,1,"1",1,2,0,"D"
"25868",2015-02-13,2014,"Olympique Marseille","Stade Reims","2-2",2,2,"1",1,4,0,"D"
"25869",2015-02-14,2014,"Paris Saint-Germain","SM Caen","2-2",2,2,"1",1,4,0,"D"
"25870",2015-02-14,2014,"FC Nantes","SC Bastia","0-2",0,2,"1",1,2,-2,"D"
"25871",2015-02-14,2014,"RC Lens","Evian Thonon Gaillard","0-2",0,2,"1",1,2,-2,"D"
"25872",2015-02-14,2014,"Lille OSC","OGC Nice","0-0",0,0,"1",1,0,0,"D"
"25873",2015-02-14,2014,"Toulouse FC","Stade Rennes","2-1",2,1,"1",1,3,1,"H"
"25874",2015-02-15,2014,"Girondins Bordeaux","AS Saint-Etienne","1-0",1,0,"1",1,1,1,"H"
"25875",2015-02-15,2014,"FC Metz","EA Guingamp","0-2",0,2,"1",1,2,-2,"D"
"25876",2015-02-15,2014,"FC Lorient","Olympique Lyon","1-1",1,1,"1",1,2,0,"D"
"25877",2015-02-20,2014,"OGC Nice","AS Monaco","0-1",0,1,"1",1,1,-1,"D"
"25878",2015-02-21,2014,"Paris Saint-Germain","Toulouse FC","3-1",3,1,"1",1,4,2,"H"
"25879",2015-02-21,2014,"Stade Rennes","Girondins Bordeaux","1-1",1,1,"1",1,2,0,"D"
"25880",2015-02-21,2014,"SM Caen","RC Lens","4-1",4,1,"1",1,5,3,"H"
"25881",2015-02-21,2014,"SC Bastia","Lille OSC","2-1",2,1,"1",1,3,1,"H"
"25882",2015-02-22,2014,"EA Guingamp","Montpellier HSC","0-2",0,2,"1",1,2,-2,"D"
"25883",2015-02-22,2014,"Stade Reims","FC Metz","0-0",0,0,"1",1,0,0,"D"
"25884",2015-02-22,2014,"Olympique Lyon","FC Nantes","1-0",1,0,"1",1,1,1,"H"
"25885",2015-02-22,2014,"AS Saint-Etienne","Olympique Marseille","2-2",2,2,"1",1,4,0,"D"
"25886",2015-02-27,2014,"Olympique Marseille","SM Caen","2-3",2,3,"1",1,5,-1,"D"
"25887",2015-02-28,2014,"Lille OSC","Olympique Lyon","2-1",2,1,"1",1,3,1,"H"
"25888",2015-02-28,2014,"FC Lorient","SC Bastia","2-0",2,0,"1",1,2,2,"H"
"25889",2015-02-28,2014,"FC Metz","Evian Thonon Gaillard","1-2",1,2,"1",1,3,-1,"D"
"25890",2015-02-28,2014,"Girondins Bordeaux","Stade Reims","1-1",1,1,"1",1,2,0,"D"
"25891",2015-02-28,2014,"RC Lens","Stade Rennes","0-1",0,1,"1",1,1,-1,"D"
"25892",2015-02-28,2014,"Toulouse FC","AS Saint-Etienne","1-1",1,1,"1",1,2,0,"D"
"25893",2015-03-01,2014,"FC Nantes","EA Guingamp","1-0",1,0,"1",1,1,1,"H"
"25894",2015-03-01,2014,"Montpellier HSC","OGC Nice","2-1",2,1,"1",1,3,1,"H"
"25895",2015-03-01,2014,"AS Monaco","Paris Saint-Germain","0-0",0,0,"1",1,0,0,"D"
"25896",2015-03-04,2014,"Evian Thonon Gaillard","FC Lorient","1-0",1,0,"1",1,1,1,"H"
"25897",2015-03-06,2014,"Toulouse FC","Olympique Marseille","1-6",1,6,"1",1,7,-5,"D"
"25898",2015-03-07,2014,"Paris Saint-Germain","RC Lens","4-1",4,1,"1",1,5,3,"H"
"25899",2015-03-07,2014,"SM Caen","Girondins Bordeaux","1-2",1,2,"1",1,3,-1,"D"
"25900",2015-03-07,2014,"Stade Rennes","FC Metz","1-0",1,0,"1",1,1,1,"H"
"25901",2015-03-07,2014,"Evian Thonon Gaillard","AS Monaco","1-3",1,3,"1",1,4,-2,"D"
"25902",2015-03-07,2014,"Stade Reims","FC Nantes","3-1",3,1,"1",1,4,2,"H"
"25903",2015-03-07,2014,"SC Bastia","OGC Nice","2-1",2,1,"1",1,3,1,"H"
"25904",2015-03-08,2014,"AS Saint-Etienne","FC Lorient","2-0",2,0,"1",1,2,2,"H"
"25905",2015-03-08,2014,"EA Guingamp","Lille OSC","0-1",0,1,"1",1,1,-1,"D"
"25906",2015-03-08,2014,"Montpellier HSC","Olympique Lyon","1-5",1,5,"1",1,6,-4,"D"
"25907",2015-03-13,2014,"AS Monaco","SC Bastia","3-0",3,0,"1",1,3,3,"H"
"25908",2015-03-13,2014,"OGC Nice","EA Guingamp","1-2",1,2,"1",1,3,-1,"D"
"25909",2015-03-14,2014,"FC Metz","AS Saint-Etienne","2-3",2,3,"1",1,5,-1,"D"
"25910",2015-03-14,2014,"FC Lorient","SM Caen","2-1",2,1,"1",1,3,1,"H"
"25911",2015-03-14,2014,"FC Nantes","Evian Thonon Gaillard","2-1",2,1,"1",1,3,1,"H"
"25912",2015-03-14,2014,"Montpellier HSC","Stade Reims","3-1",3,1,"1",1,4,2,"H"
"25913",2015-03-14,2014,"RC Lens","Toulouse FC","1-0",1,0,"1",1,1,1,"H"
"25914",2015-03-15,2014,"Lille OSC","Stade Rennes","3-0",3,0,"1",1,3,3,"H"
"25915",2015-03-15,2014,"Girondins Bordeaux","Paris Saint-Germain","3-2",3,2,"1",1,5,1,"H"
"25916",2015-03-15,2014,"Olympique Marseille","Olympique Lyon","0-0",0,0,"1",1,0,0,"D"
"25917",2015-03-20,2014,"Paris Saint-Germain","FC Lorient","3-1",3,1,"1",1,4,2,"H"
"25918",2015-03-21,2014,"Olympique Lyon","OGC Nice","1-2",1,2,"1",1,3,-1,"D"
"25919",2015-03-21,2014,"Toulouse FC","Girondins Bordeaux","2-1",2,1,"1",1,3,1,"H"
"25920",2015-03-21,2014,"SC Bastia","EA Guingamp","0-0",0,0,"1",1,0,0,"D"
"25921",2015-03-21,2014,"SM Caen","FC Metz","0-0",0,0,"1",1,0,0,"D"
"25922",2015-03-21,2014,"Evian Thonon Gaillard","Montpellier HSC","1-0",1,0,"1",1,1,1,"H"
"25923",2015-03-21,2014,"Stade Rennes","FC Nantes","0-0",0,0,"1",1,0,0,"D"
"25924",2015-03-22,2014,"AS Saint-Etienne","Lille OSC","2-0",2,0,"1",1,2,2,"H"
"25925",2015-03-22,2014,"Stade Reims","AS Monaco","1-3",1,3,"1",1,4,-2,"D"
"25926",2015-03-22,2014,"RC Lens","Olympique Marseille","0-4",0,4,"1",1,4,-4,"D"
"25927",2015-04-03,2014,"AS Monaco","AS Saint-Etienne","1-1",1,1,"1",1,2,0,"D"
"25928",2015-04-04,2014,"EA Guingamp","Olympique Lyon","1-3",1,3,"1",1,4,-2,"D"
"25929",2015-04-04,2014,"Montpellier HSC","SC Bastia","3-1",3,1,"1",1,4,2,"H"
"25930",2015-04-04,2014,"OGC Nice","Evian Thonon Gaillard","2-2",2,2,"1",1,4,0,"D"
"25931",2015-04-04,2014,"Lille OSC","Stade Reims","3-1",3,1,"1",1,4,2,"H"
"25932",2015-04-04,2014,"FC Lorient","Stade Rennes","0-3",0,3,"1",1,3,-3,"D"
"25933",2015-04-04,2014,"FC Metz","Toulouse FC","3-2",3,2,"1",1,5,1,"H"
"25934",2015-04-05,2014,"Girondins Bordeaux","RC Lens","2-1",2,1,"1",1,3,1,"H"
"25935",2015-04-05,2014,"FC Nantes","SM Caen","1-2",1,2,"1",1,3,-1,"D"
"25936",2015-04-05,2014,"Olympique Marseille","Paris Saint-Germain","2-3",2,3,"1",1,5,-1,"D"
"25937",2015-04-07,2014,"AS Monaco","Montpellier HSC","0-0",0,0,"1",1,0,0,"D"
"25938",2015-04-10,2014,"SM Caen","AS Monaco","0-3",0,3,"1",1,3,-3,"D"
"25939",2015-04-12,2014,"AS Saint-Etienne","FC Nantes","1-0",1,0,"1",1,1,1,"H"
"25940",2015-04-12,2014,"Stade Rennes","EA Guingamp","1-0",1,0,"1",1,1,1,"H"
"25941",2015-04-12,2014,"Evian Thonon Gaillard","Lille OSC","0-1",0,1,"1",1,1,-1,"D"
"25942",2015-04-12,2014,"RC Lens","FC Lorient","0-0",0,0,"1",1,0,0,"D"
"25943",2015-04-12,2014,"Toulouse FC","Montpellier HSC","1-0",1,0,"1",1,1,1,"H"
"25944",2015-04-12,2014,"Stade Reims","OGC Nice","0-1",0,1,"1",1,1,-1,"D"
"25945",2015-04-12,2014,"Girondins Bordeaux","Olympique Marseille","1-0",1,0,"1",1,1,1,"H"
"25946",2015-04-15,2014,"Olympique Lyon","SC Bastia","2-0",2,0,"1",1,2,2,"H"
"25947",2015-04-17,2014,"FC Nantes","Olympique Marseille","1-0",1,0,"1",1,1,1,"H"
"25948",2015-04-18,2014,"OGC Nice","Paris Saint-Germain","1-3",1,3,"1",1,4,-2,"D"
"25949",2015-04-18,2014,"EA Guingamp","Evian Thonon Gaillard","1-1",1,1,"1",1,2,0,"D"
"25950",2015-04-18,2014,"FC Metz","RC Lens","3-1",3,1,"1",1,4,2,"H"
"25951",2015-04-18,2014,"SC Bastia","Stade Reims","1-2",1,2,"1",1,3,-1,"D"
"25952",2015-04-18,2014,"AS Monaco","Stade Rennes","1-1",1,1,"1",1,2,0,"D"
"25953",2015-04-18,2014,"FC Lorient","Toulouse FC","0-1",0,1,"1",1,1,-1,"D"
"25954",2015-04-19,2014,"Lille OSC","Girondins Bordeaux","2-0",2,0,"1",1,2,2,"H"
"25955",2015-04-19,2014,"Montpellier HSC","SM Caen","1-0",1,0,"1",1,1,1,"H"
"25956",2015-04-19,2014,"Olympique Lyon","AS Saint-Etienne","2-2",2,2,"1",1,4,0,"D"
"25957",2015-04-24,2014,"Olympique Marseille","FC Lorient","3-5",3,5,"1",1,8,-2,"D"
"25958",2015-04-25,2014,"Paris Saint-Germain","Lille OSC","6-1",6,1,"1",1,7,5,"H"
"25959",2015-04-25,2014,"Evian Thonon Gaillard","SC Bastia","1-2",1,2,"1",1,3,-1,"D"
"25960",2015-04-25,2014,"SM Caen","EA Guingamp","0-2",0,2,"1",1,2,-2,"D"
"25961",2015-04-25,2014,"Girondins Bordeaux","FC Metz","1-1",1,1,"1",1,2,0,"D"
"25962",2015-04-25,2014,"Toulouse FC","FC Nantes","1-1",1,1,"1",1,2,0,"D"
"25963",2015-04-25,2014,"Stade Rennes","OGC Nice","2-1",2,1,"1",1,3,1,"H"
"25964",2015-04-26,2014,"AS Saint-Etienne","Montpellier HSC","1-0",1,0,"1",1,1,1,"H"
"25965",2015-04-26,2014,"RC Lens","AS Monaco","0-3",0,3,"1",1,3,-3,"D"
"25966",2015-04-26,2014,"Stade Reims","Olympique Lyon","2-4",2,4,"1",1,6,-2,"D"
"25967",2015-04-28,2014,"Paris Saint-Germain","FC Metz","3-1",3,1,"1",1,4,2,"H"
"25968",2015-05-01,2014,"FC Metz","Olympique Marseille","0-2",0,2,"1",1,2,-2,"D"
"25969",2015-05-02,2014,"Olympique Lyon","Evian Thonon Gaillard","2-0",2,0,"1",1,2,2,"H"
"25970",2015-05-02,2014,"FC Lorient","Girondins Bordeaux","0-0",0,0,"1",1,0,0,"D"
"25971",2015-05-02,2014,"OGC Nice","SM Caen","1-1",1,1,"1",1,2,0,"D"
"25972",2015-05-02,2014,"EA Guingamp","Stade Reims","2-0",2,0,"1",1,2,2,"H"
"25973",2015-05-02,2014,"Montpellier HSC","Stade Rennes","0-0",0,0,"1",1,0,0,"D"
"25974",2015-05-02,2014,"SC Bastia","AS Saint-Etienne","1-0",1,0,"1",1,1,1,"H"
"25975",2015-05-03,2014,"Lille OSC","RC Lens","3-1",3,1,"1",1,4,2,"H"
"25976",2015-05-03,2014,"AS Monaco","Toulouse FC","4-1",4,1,"1",1,5,3,"H"
"25977",2015-05-03,2014,"FC Nantes","Paris Saint-Germain","0-2",0,2,"1",1,2,-2,"D"
"25978",2015-05-08,2014,"Paris Saint-Germain","EA Guingamp","6-0",6,0,"1",1,6,6,"H"
"25979",2015-05-09,2014,"SM Caen","Olympique Lyon","3-0",3,0,"1",1,3,3,"H"
"25980",2015-05-09,2014,"Stade Rennes","SC Bastia","0-1",0,1,"1",1,1,-1,"D"
"25981",2015-05-09,2014,"Toulouse FC","Lille OSC","3-2",3,2,"1",1,5,1,"H"
"25982",2015-05-09,2014,"FC Metz","FC Lorient","0-4",0,4,"1",1,4,-4,"D"
"25983",2015-05-09,2014,"Girondins Bordeaux","FC Nantes","2-1",2,1,"1",1,3,1,"H"
"25984",2015-05-09,2014,"Evian Thonon Gaillard","Stade Reims","2-3",2,3,"1",1,5,-1,"D"
"25985",2015-05-10,2014,"RC Lens","Montpellier HSC","0-1",0,1,"1",1,1,-1,"D"
"25986",2015-05-10,2014,"AS Saint-Etienne","OGC Nice","5-0",5,0,"1",1,5,5,"H"
"25987",2015-05-10,2014,"Olympique Marseille","AS Monaco","2-1",2,1,"1",1,3,1,"H"
"25988",2015-05-16,2014,"Olympique Lyon","Girondins Bordeaux","1-1",1,1,"1",1,2,0,"D"
"25989",2015-05-16,2014,"SC Bastia","SM Caen","1-1",1,1,"1",1,2,0,"D"
"25990",2015-05-16,2014,"OGC Nice","RC Lens","2-1",2,1,"1",1,3,1,"H"
"25991",2015-05-16,2014,"FC Nantes","FC Lorient","1-1",1,1,"1",1,2,0,"D"
"25992",2015-05-16,2014,"Lille OSC","Olympique Marseille","0-4",0,4,"1",1,4,-4,"D"
"25993",2015-05-16,2014,"AS Monaco","FC Metz","2-0",2,0,"1",1,2,2,"H"
"25994",2015-05-16,2014,"Montpellier HSC","Paris Saint-Germain","1-2",1,2,"1",1,3,-1,"D"
"25995",2015-05-16,2014,"Stade Reims","Stade Rennes","1-0",1,0,"1",1,1,1,"H"
"25996",2015-05-16,2014,"Evian Thonon Gaillard","AS Saint-Etienne","1-2",1,2,"1",1,3,-1,"D"
"25997",2015-05-16,2014,"EA Guingamp","Toulouse FC","2-1",2,1,"1",1,3,1,"H"
"25998",2015-05-23,2014,"Olympique Marseille","SC Bastia","3-0",3,0,"1",1,3,3,"H"
"25999",2015-05-23,2014,"SM Caen","Evian Thonon Gaillard","3-2",3,2,"1",1,5,1,"H"
"26000",2015-05-23,2014,"AS Saint-Etienne","EA Guingamp","2-1",2,1,"1",1,3,1,"H"
"26001",2015-05-23,2014,"FC Metz","Lille OSC","1-4",1,4,"1",1,5,-3,"D"
"26002",2015-05-23,2014,"Stade Rennes","Olympique Lyon","0-1",0,1,"1",1,1,-1,"D"
"26003",2015-05-23,2014,"FC Lorient","AS Monaco","0-1",0,1,"1",1,1,-1,"D"
"26004",2015-05-23,2014,"Girondins Bordeaux","Montpellier HSC","2-1",2,1,"1",1,3,1,"H"
"26005",2015-05-23,2014,"RC Lens","FC Nantes","1-0",1,0,"1",1,1,1,"H"
"26006",2015-05-23,2014,"Toulouse FC","OGC Nice","2-3",2,3,"1",1,5,-1,"D"
"26007",2015-05-23,2014,"Paris Saint-Germain","Stade Reims","3-2",3,2,"1",1,5,1,"H"
"26008",2015-08-07,2015,"Lille OSC","Paris Saint-Germain","0-1",0,1,"1",1,1,-1,"A"
"26009",2015-08-08,2015,"SC Bastia","Stade Rennes","2-1",2,1,"1",1,3,1,"H"
"26010",2015-08-08,2015,"Olympique Marseille","SM Caen","0-1",0,1,"1",1,1,-1,"A"
"26011",2015-08-08,2015,"Montpellier HSC","Angers SCO","0-2",0,2,"1",1,2,-2,"A"
"26012",2015-08-08,2015,"FC Nantes","EA Guingamp","1-0",1,0,"1",1,1,1,"H"
"26013",2015-08-08,2015,"OGC Nice","AS Monaco","1-2",1,2,"1",1,3,-1,"A"
"26014",2015-08-08,2015,"ESTAC Troyes","AC Ajaccio","0-0",0,0,"1",1,0,0,"D"
"26015",2015-08-09,2015,"Girondins Bordeaux","Stade Reims","1-2",1,2,"1",1,3,-1,"A"
"26016",2015-08-09,2015,"Olympique Lyon","FC Lorient","0-0",0,0,"1",1,0,0,"D"
"26017",2015-08-09,2015,"Toulouse FC","AS Saint-Etienne","2-1",2,1,"1",1,3,1,"H"
"26018",2015-08-14,2015,"AS Monaco","Lille OSC","0-0",0,0,"1",1,0,0,"D"
"26019",2015-08-15,2015,"Angers SCO","FC Nantes","0-0",0,0,"1",1,0,0,"D"
"26020",2015-08-15,2015,"SM Caen","Toulouse FC","1-0",1,0,"1",1,1,1,"H"
"26021",2015-08-15,2015,"EA Guingamp","Olympique Lyon","0-1",0,1,"1",1,1,-1,"A"
"26022",2015-08-15,2015,"Stade Rennes","Montpellier HSC","1-0",1,0,"1",1,1,1,"H"
"26023",2015-08-15,2015,"AS Saint-Etienne","Girondins Bordeaux","1-1",1,1,"1",1,2,0,"D"
"26024",2015-08-15,2015,"ESTAC Troyes","OGC Nice","3-3",3,3,"1",1,6,0,"D"
"26025",2015-08-16,2015,"FC Lorient","SC Bastia","1-1",1,1,"1",1,2,0,"D"
"26026",2015-08-16,2015,"Paris Saint-Germain","AC Ajaccio","2-0",2,0,"1",1,2,2,"H"
"26027",2015-08-16,2015,"Stade Reims","Olympique Marseille","1-0",1,0,"1",1,1,1,"H"
"26028",2015-08-21,2015,"Montpellier HSC","Paris Saint-Germain","0-1",0,1,"1",1,1,-1,"A"
"26029",2015-08-22,2015,"AC Ajaccio","Angers SCO","0-2",0,2,"1",1,2,-2,"A"
"26030",2015-08-22,2015,"SC Bastia","EA Guingamp","3-0",3,0,"1",1,3,3,"H"
"26031",2015-08-22,2015,"Olympique Lyon","Stade Rennes","1-2",1,2,"1",1,3,-1,"A"
"26032",2015-08-22,2015,"FC Nantes","Stade Reims","1-0",1,0,"1",1,1,1,"H"
"26033",2015-08-22,2015,"OGC Nice","SM Caen","2-1",2,1,"1",1,3,1,"H"
"26034",2015-08-22,2015,"Toulouse FC","AS Monaco","1-1",1,1,"1",1,2,0,"D"
"26035",2015-08-23,2015,"Lille OSC","Girondins Bordeaux","0-0",0,0,"1",1,0,0,"D"
"26036",2015-08-23,2015,"FC Lorient","AS Saint-Etienne","0-1",0,1,"1",1,1,-1,"A"
"26037",2015-08-23,2015,"Olympique Marseille","ESTAC Troyes","6-0",6,0,"1",1,6,6,"H"
"26038",2015-08-28,2015,"EA Guingamp","Olympique Marseille","2-0",2,0,"1",1,2,2,"H"
"26039",2015-08-29,2015,"Angers SCO","OGC Nice","1-1",1,1,"1",1,2,0,"D"
"26040",2015-08-29,2015,"SM Caen","Olympique Lyon","0-4",0,4,"1",1,4,-4,"A"
"26041",2015-08-29,2015,"Lille OSC","AC Ajaccio","1-0",1,0,"1",1,1,1,"H"
"26042",2015-08-29,2015,"Stade Reims","FC Lorient","4-1",4,1,"1",1,5,3,"H"
"26043",2015-08-29,2015,"Stade Rennes","Toulouse FC","3-1",3,1,"1",1,4,2,"H"
"26044",2015-08-29,2015,"ESTAC Troyes","Montpellier HSC","0-0",0,0,"1",1,0,0,"D"
"26045",2015-08-30,2015,"Girondins Bordeaux","FC Nantes","2-0",2,0,"1",1,2,2,"H"
"26046",2015-08-30,2015,"AS Monaco","Paris Saint-Germain","0-3",0,3,"1",1,3,-3,"A"
"26047",2015-08-30,2015,"AS Saint-Etienne","SC Bastia","2-1",2,1,"1",1,3,1,"H"
"26048",2015-09-11,2015,"Paris Saint-Germain","Girondins Bordeaux","2-2",2,2,"1",1,4,0,"D"
"26049",2015-09-12,2015,"FC Lorient","Angers SCO","3-1",3,1,"1",1,4,2,"H"
"26050",2015-09-12,2015,"Olympique Lyon","Lille OSC","0-0",0,0,"1",1,0,0,"D"
"26051",2015-09-12,2015,"Montpellier HSC","AS Saint-Etienne","1-2",1,2,"1",1,3,-1,"A"
"26052",2015-09-12,2015,"OGC Nice","EA Guingamp","0-1",0,1,"1",1,1,-1,"A"
"26053",2015-09-12,2015,"Toulouse FC","Stade Reims","2-2",2,2,"1",1,4,0,"D"
"26054",2015-09-12,2015,"ESTAC Troyes","SM Caen","1-3",1,3,"1",1,4,-2,"A"
"26055",2015-09-13,2015,"AC Ajaccio","AS Monaco","0-1",0,1,"1",1,1,-1,"A"
"26056",2015-09-13,2015,"Olympique Marseille","SC Bastia","4-1",4,1,"1",1,5,3,"H"
"26057",2015-09-13,2015,"FC Nantes","Stade Rennes","0-2",0,2,"1",1,2,-2,"A"
"26058",2015-09-18,2015,"Stade Rennes","Lille OSC","1-1",1,1,"1",1,2,0,"D"
"26059",2015-09-19,2015,"Angers SCO","ESTAC Troyes","1-0",1,0,"1",1,1,1,"H"
"26060",2015-09-19,2015,"SC Bastia","OGC Nice","1-3",1,3,"1",1,4,-2,"A"
"26061",2015-09-19,2015,"SM Caen","Montpellier HSC","2-1",2,1,"1",1,3,1,"H"
"26062",2015-09-19,2015,"EA Guingamp","AC Ajaccio","2-1",2,1,"1",1,3,1,"H"
"26063",2015-09-19,2015,"Stade Reims","Paris Saint-Germain","1-1",1,1,"1",1,2,0,"D"
"26064",2015-09-20,2015,"Girondins Bordeaux","Toulouse FC","1-1",1,1,"1",1,2,0,"D"
"26065",2015-09-20,2015,"Olympique Marseille","Olympique Lyon","1-1",1,1,"1",1,2,0,"D"
"26066",2015-09-20,2015,"AS Monaco","FC Lorient","2-3",2,3,"1",1,5,-1,"A"
"26067",2015-09-20,2015,"AS Saint-Etienne","FC Nantes","2-0",2,0,"1",1,2,2,"H"
"26068",2015-09-22,2015,"Angers SCO","Stade Reims","0-0",0,0,"1",1,0,0,"D"
"26069",2015-09-22,2015,"Paris Saint-Germain","EA Guingamp","3-0",3,0,"1",1,3,3,"H"
"26070",2015-09-23,2015,"AC Ajaccio","Stade Rennes","1-1",1,1,"1",1,2,0,"D"
"26071",2015-09-23,2015,"FC Lorient","SM Caen","2-0",2,0,"1",1,2,2,"H"
"26072",2015-09-23,2015,"Olympique Lyon","SC Bastia","2-0",2,0,"1",1,2,2,"H"
"26073",2015-09-23,2015,"OGC Nice","Girondins Bordeaux","6-1",6,1,"1",1,7,5,"H"
"26074",2015-09-23,2015,"Toulouse FC","Olympique Marseille","1-1",1,1,"1",1,2,0,"D"
"26075",2015-09-23,2015,"ESTAC Troyes","AS Saint-Etienne","0-1",0,1,"1",1,1,-1,"A"
"26076",2015-09-24,2015,"Montpellier HSC","AS Monaco","2-3",2,3,"1",1,5,-1,"A"
"26077",2015-09-25,2015,"Stade Reims","Lille OSC","1-0",1,0,"1",1,1,1,"H"
"26078",2015-09-26,2015,"SC Bastia","Toulouse FC","3-0",3,0,"1",1,3,3,"H"
"26079",2015-09-26,2015,"Girondins Bordeaux","Olympique Lyon","3-1",3,1,"1",1,4,2,"H"
"26080",2015-09-26,2015,"SM Caen","AC Ajaccio","2-0",2,0,"1",1,2,2,"H"
"26081",2015-09-26,2015,"FC Nantes","Paris Saint-Germain","1-4",1,4,"1",1,5,-3,"A"
"26082",2015-09-26,2015,"Stade Rennes","ESTAC Troyes","1-1",1,1,"1",1,2,0,"D"
"26083",2015-09-27,2015,"EA Guingamp","AS Monaco","3-3",3,3,"1",1,6,0,"D"
"26084",2015-09-27,2015,"Olympique Marseille","Angers SCO","1-2",1,2,"1",1,3,-1,"A"
"26085",2015-09-27,2015,"Montpellier HSC","FC Lorient","2-1",2,1,"1",1,3,1,"H"
"26086",2015-09-27,2015,"AS Saint-Etienne","OGC Nice","1-4",1,4,"1",1,5,-3,"A"
"26087",2015-09-29,2015,"Lille OSC","FC Nantes","0-1",0,1,"1",1,1,-1,"A"
"26088",2015-10-02,2015,"Lille OSC","Montpellier HSC","2-0",2,0,"1",1,2,2,"H"
"26089",2015-10-03,2015,"AC Ajaccio","Toulouse FC","2-2",2,2,"1",1,4,0,"D"
"26090",2015-10-03,2015,"Angers SCO","SC Bastia","1-0",1,0,"1",1,1,1,"H"
"26091",2015-10-03,2015,"Olympique Lyon","Stade Reims","1-0",1,0,"1",1,1,1,"H"
"26092",2015-10-03,2015,"ESTAC Troyes","EA Guingamp","0-1",0,1,"1",1,1,-1,"A"
"26093",2015-10-04,2015,"SM Caen","AS Saint-Etienne","1-0",1,0,"1",1,1,1,"H"
"26094",2015-10-04,2015,"FC Lorient","Girondins Bordeaux","3-2",3,2,"1",1,5,1,"H"
"26095",2015-10-04,2015,"AS Monaco","Stade Rennes","1-1",1,1,"1",1,2,0,"D"
"26096",2015-10-04,2015,"Paris Saint-Germain","Olympique Marseille","2-1",2,1,"1",1,3,1,"H"
"26097",2015-10-16,2015,"AS Monaco","Olympique Lyon","1-1",1,1,"1",1,2,0,"D"
"26098",2015-10-17,2015,"SC Bastia","Paris Saint-Germain","0-2",0,2,"1",1,2,-2,"A"
"26099",2015-10-17,2015,"EA Guingamp","Lille OSC","1-1",1,1,"1",1,2,0,"D"
"26100",2015-10-17,2015,"FC Nantes","ESTAC Troyes","3-0",3,0,"1",1,3,3,"H"
"26101",2015-10-17,2015,"Stade Reims","SM Caen","0-1",0,1,"1",1,1,-1,"A"
"26102",2015-10-17,2015,"AS Saint-Etienne","AC Ajaccio","2-0",2,0,"1",1,2,2,"H"
"26103",2015-10-17,2015,"Toulouse FC","Angers SCO","1-2",1,2,"1",1,3,-1,"A"
"26104",2015-10-18,2015,"Girondins Bordeaux","Montpellier HSC","0-0",0,0,"1",1,0,0,"D"
"26105",2015-10-18,2015,"Olympique Marseille","FC Lorient","1-1",1,1,"1",1,2,0,"D"
"26106",2015-10-18,2015,"Stade Rennes","OGC Nice","1-4",1,4,"1",1,5,-3,"A"
"26107",2015-10-23,2015,"SM Caen","FC Nantes","0-2",0,2,"1",1,2,-2,"A"
"26108",2015-10-23,2015,"Olympique Lyon","Toulouse FC","3-0",3,0,"1",1,3,3,"H"
"26109",2015-10-24,2015,"AC Ajaccio","OGC Nice","3-1",3,1,"1",1,4,2,"H"
"26110",2015-10-24,2015,"Angers SCO","EA Guingamp","0-0",0,0,"1",1,0,0,"D"
"26111",2015-10-24,2015,"FC Lorient","Stade Rennes","1-1",1,1,"1",1,2,0,"D"
"26112",2015-10-24,2015,"Montpellier HSC","SC Bastia","2-0",2,0,"1",1,2,2,"H"
"26113",2015-10-25,2015,"Girondins Bordeaux","ESTAC Troyes","1-0",1,0,"1",1,1,1,"H"
"26114",2015-10-25,2015,"Lille OSC","Olympique Marseille","1-2",1,2,"1",1,3,-1,"A"
"26115",2015-10-25,2015,"Paris Saint-Germain","AS Saint-Etienne","4-1",4,1,"1",1,5,3,"H"
"26116",2015-10-25,2015,"Stade Reims","AS Monaco","0-1",0,1,"1",1,1,-1,"A"
"26117",2015-10-30,2015,"Stade Rennes","Paris Saint-Germain","0-1",0,1,"1",1,1,-1,"A"
"26118",2015-10-31,2015,"AC Ajaccio","Girondins Bordeaux","2-0",2,0,"1",1,2,2,"H"
"26119",2015-10-31,2015,"SC Bastia","SM Caen","1-0",1,0,"1",1,1,1,"H"
"26120",2015-10-31,2015,"EA Guingamp","FC Lorient","2-2",2,2,"1",1,4,0,"D"
"26121",2015-10-31,2015,"AS Saint-Etienne","Stade Reims","3-0",3,0,"1",1,3,3,"H"
"26122",2015-10-31,2015,"Toulouse FC","Montpellier HSC","1-1",1,1,"1",1,2,0,"D"
"26123",2015-10-31,2015,"ESTAC Troyes","Olympique Lyon","0-1",0,1,"1",1,1,-1,"A"
"26124",2015-11-01,2015,"AS Monaco","Angers SCO","1-0",1,0,"1",1,1,1,"H"
"26125",2015-11-01,2015,"FC Nantes","Olympique Marseille","0-1",0,1,"1",1,1,-1,"A"
"26126",2015-11-01,2015,"OGC Nice","Lille OSC","0-0",0,0,"1",1,0,0,"D"
"26127",2015-11-04,2015,"OGC Nice","FC Nantes","1-2",1,2,"1",1,3,-1,"A"
"26128",2015-11-06,2015,"Angers SCO","Stade Rennes","0-2",0,2,"1",1,2,-2,"A"
"26129",2015-11-07,2015,"SM Caen","EA Guingamp","2-1",2,1,"1",1,3,1,"H"
"26130",2015-11-07,2015,"Lille OSC","SC Bastia","1-1",1,1,"1",1,2,0,"D"
"26131",2015-11-07,2015,"FC Lorient","ESTAC Troyes","4-1",4,1,"1",1,5,3,"H"
"26132",2015-11-07,2015,"Montpellier HSC","FC Nantes","2-1",2,1,"1",1,3,1,"H"
"26133",2015-11-07,2015,"Paris Saint-Germain","Toulouse FC","5-0",5,0,"1",1,5,5,"H"
"26134",2015-11-07,2015,"Stade Reims","AC Ajaccio","1-2",1,2,"1",1,3,-1,"A"
"26135",2015-11-08,2015,"Girondins Bordeaux","AS Monaco","3-1",3,1,"1",1,4,2,"H"
"26136",2015-11-08,2015,"Olympique Lyon","AS Saint-Etienne","3-0",3,0,"1",1,3,3,"H"
"26137",2015-11-08,2015,"Olympique Marseille","OGC Nice","0-1",0,1,"1",1,1,-1,"A"
"26138",2015-11-20,2015,"OGC Nice","Olympique Lyon","3-0",3,0,"1",1,3,3,"H"
"26139",2015-11-21,2015,"EA Guingamp","Toulouse FC","2-0",2,0,"1",1,2,2,"H"
"26140",2015-11-21,2015,"FC Lorient","Paris Saint-Germain","1-2",1,2,"1",1,3,-1,"A"
"26141",2015-11-21,2015,"AS Monaco","FC Nantes","1-0",1,0,"1",1,1,1,"H"
"26142",2015-11-21,2015,"Montpellier HSC","Stade Reims","3-1",3,1,"1",1,4,2,"H"
"26143",2015-11-21,2015,"ESTAC Troyes","Lille OSC","1-1",1,1,"1",1,2,0,"D"
"26144",2015-11-22,2015,"SC Bastia","AC Ajaccio","1-2",1,2,"1",1,3,-1,"A"
"26145",2015-11-22,2015,"SM Caen","Angers SCO","0-0",0,0,"1",1,0,0,"D"
"26146",2015-11-22,2015,"Stade Rennes","Girondins Bordeaux","2-2",2,2,"1",1,4,0,"D"
"26147",2015-11-22,2015,"AS Saint-Etienne","Olympique Marseille","0-2",0,2,"1",1,2,-2,"A"
"26148",2015-11-27,2015,"Olympique Lyon","Montpellier HSC","2-4",2,4,"1",1,6,-2,"A"
"26149",2015-11-28,2015,"AC Ajaccio","FC Lorient","1-1",1,1,"1",1,2,0,"D"
"26150",2015-11-28,2015,"Angers SCO","Lille OSC","2-0",2,0,"1",1,2,2,"H"
"26151",2015-11-28,2015,"FC Nantes","SC Bastia","0-0",0,0,"1",1,0,0,"D"
"26152",2015-11-28,2015,"Paris Saint-Germain","ESTAC Troyes","4-1",4,1,"1",1,5,3,"H"
"26153",2015-11-28,2015,"Stade Reims","Stade Rennes","2-2",2,2,"1",1,4,0,"D"
"26154",2015-11-28,2015,"Toulouse FC","OGC Nice","2-0",2,0,"1",1,2,2,"H"
"26155",2015-11-29,2015,"Girondins Bordeaux","SM Caen","1-4",1,4,"1",1,5,-3,"A"
"26156",2015-11-29,2015,"Olympique Marseille","AS Monaco","3-3",3,3,"1",1,6,0,"D"
"26157",2015-11-29,2015,"AS Saint-Etienne","EA Guingamp","3-0",3,0,"1",1,3,3,"H"
"26158",2015-12-01,2015,"Angers SCO","Paris Saint-Germain","0-0",0,0,"1",1,0,0,"D"
"26159",2015-12-01,2015,"FC Lorient","OGC Nice","0-0",0,0,"1",1,0,0,"D"
"26160",2015-12-01,2015,"FC Nantes","Olympique Lyon","0-0",0,0,"1",1,0,0,"D"
"26161",2015-12-02,2015,"SC Bastia","Girondins Bordeaux","1-0",1,0,"1",1,1,1,"H"
"26162",2015-12-02,2015,"EA Guingamp","Stade Reims","1-2",1,2,"1",1,3,-1,"A"
"26163",2015-12-02,2015,"Lille OSC","AS Saint-Etienne","1-0",1,0,"1",1,1,1,"H"
"26164",2015-12-02,2015,"AS Monaco","SM Caen","1-1",1,1,"1",1,2,0,"D"
"26165",2015-12-02,2015,"Montpellier HSC","AC Ajaccio","0-2",0,2,"1",1,2,-2,"A"
"26166",2015-12-02,2015,"ESTAC Troyes","Toulouse FC","0-3",0,3,"1",1,3,-3,"A"
"26167",2015-12-03,2015,"Stade Rennes","Olympique Marseille","0-1",0,1,"1",1,1,-1,"A"
"26168",2015-12-04,2015,"OGC Nice","Paris Saint-Germain","0-3",0,3,"1",1,3,-3,"A"
"26169",2015-12-05,2015,"AC Ajaccio","FC Nantes","1-1",1,1,"1",1,2,0,"D"
"26170",2015-12-05,2015,"SC Bastia","AS Monaco","1-2",1,2,"1",1,3,-1,"A"
"26171",2015-12-05,2015,"SM Caen","Lille OSC","1-2",1,2,"1",1,3,-1,"A"
"26172",2015-12-05,2015,"Olympique Lyon","Angers SCO","0-2",0,2,"1",1,2,-2,"A"
"26173",2015-12-05,2015,"Stade Reims","ESTAC Troyes","1-1",1,1,"1",1,2,0,"D"
"26174",2015-12-05,2015,"Toulouse FC","FC Lorient","2-3",2,3,"1",1,5,-1,"A"
"26175",2015-12-06,2015,"Girondins Bordeaux","EA Guingamp","1-0",1,0,"1",1,1,1,"H"
"26176",2015-12-06,2015,"Olympique Marseille","Montpellier HSC","2-2",2,2,"1",1,4,0,"D"
"26177",2015-12-06,2015,"AS Saint-Etienne","Stade Rennes","1-1",1,1,"1",1,2,0,"D"
"26178",2015-12-11,2015,"Stade Rennes","SM Caen","1-1",1,1,"1",1,2,0,"D"
"26179",2015-12-12,2015,"Lille OSC","FC Lorient","3-0",3,0,"1",1,3,3,"H"
"26180",2015-12-12,2015,"Montpellier HSC","EA Guingamp","2-1",2,1,"1",1,3,1,"H"
"26181",2015-12-12,2015,"FC Nantes","Toulouse FC","1-1",1,1,"1",1,2,0,"D"
"26182",2015-12-12,2015,"Stade Reims","OGC Nice","1-1",1,1,"1",1,2,0,"D"
"26183",2015-12-12,2015,"ESTAC Troyes","SC Bastia","1-1",1,1,"1",1,2,0,"D"
"26184",2015-12-13,2015,"Angers SCO","Girondins Bordeaux","1-1",1,1,"1",1,2,0,"D"
"26185",2015-12-13,2015,"Olympique Marseille","AC Ajaccio","1-1",1,1,"1",1,2,0,"D"
"26186",2015-12-13,2015,"AS Monaco","AS Saint-Etienne","1-0",1,0,"1",1,1,1,"H"
"26187",2015-12-13,2015,"Paris Saint-Germain","Olympique Lyon","5-1",5,1,"1",1,6,4,"H"
"26188",2015-12-18,2015,"OGC Nice","Montpellier HSC","1-0",1,0,"1",1,1,1,"H"
"26189",2015-12-19,2015,"SC Bastia","Stade Reims","2-0",2,0,"1",1,2,2,"H"
"26190",2015-12-19,2015,"SM Caen","Paris Saint-Germain","0-3",0,3,"1",1,3,-3,"A"
"26191",2015-12-19,2015,"EA Guingamp","Stade Rennes","0-2",0,2,"1",1,2,-2,"A"
"26192",2015-12-19,2015,"FC Lorient","FC Nantes","0-0",0,0,"1",1,0,0,"D"
"26193",2015-12-19,2015,"Toulouse FC","Lille OSC","1-1",1,1,"1",1,2,0,"D"
"26194",2015-12-19,2015,"ESTAC Troyes","AS Monaco","0-0",0,0,"1",1,0,0,"D"
"26195",2015-12-20,2015,"AC Ajaccio","Olympique Lyon","2-1",2,1,"1",1,3,1,"H"
"26196",2015-12-20,2015,"Girondins Bordeaux","Olympique Marseille","1-1",1,1,"1",1,2,0,"D"
"26197",2015-12-20,2015,"AS Saint-Etienne","Angers SCO","1-0",1,0,"1",1,1,1,"H"
"26198",2016-01-08,2015,"Paris Saint-Germain","SC Bastia","2-0",2,0,"1",1,2,2,"H"
"26199",2016-01-09,2015,"Angers SCO","SM Caen","2-0",2,0,"1",1,2,2,"H"
"26200",2016-01-09,2015,"Olympique Lyon","ESTAC Troyes","4-1",4,1,"1",1,5,3,"H"
"26201",2016-01-09,2015,"AS Monaco","AC Ajaccio","2-2",2,2,"1",1,4,0,"D"
"26202",2016-01-09,2015,"Montpellier HSC","Girondins Bordeaux","0-1",0,1,"1",1,1,-1,"A"
"26203",2016-01-09,2015,"Stade Reims","Toulouse FC","1-3",1,3,"1",1,4,-2,"A"
"26204",2016-01-09,2015,"Stade Rennes","FC Lorient","2-2",2,2,"1",1,4,0,"D"
"26205",2016-01-10,2015,"Lille OSC","OGC Nice","1-1",1,1,"1",1,2,0,"D"
"26206",2016-01-10,2015,"Olympique Marseille","EA Guingamp","0-0",0,0,"1",1,0,0,"D"
"26207",2016-01-10,2015,"FC Nantes","AS Saint-Etienne","2-1",2,1,"1",1,3,1,"H"
"26208",2016-01-15,2015,"OGC Nice","Angers SCO","2-1",2,1,"1",1,3,1,"H"
"26209",2016-01-16,2015,"AC Ajaccio","Stade Reims","2-2",2,2,"1",1,4,0,"D"
"26210",2016-01-16,2015,"SC Bastia","Montpellier HSC","1-0",1,0,"1",1,1,1,"H"
"26211",2016-01-16,2015,"Girondins Bordeaux","Lille OSC","1-0",1,0,"1",1,1,1,"H"
"26212",2016-01-16,2015,"EA Guingamp","FC Nantes","2-2",2,2,"1",1,4,0,"D"
"26213",2016-01-16,2015,"Toulouse FC","Paris Saint-Germain","0-1",0,1,"1",1,1,-1,"A"
"26214",2016-01-16,2015,"ESTAC Troyes","Stade Rennes","2-4",2,4,"1",1,6,-2,"A"
"26215",2016-01-17,2015,"SM Caen","Olympique Marseille","1-3",1,3,"1",1,4,-2,"A"
"26216",2016-01-17,2015,"FC Lorient","AS Monaco","0-2",0,2,"1",1,2,-2,"A"
"26217",2016-01-17,2015,"AS Saint-Etienne","Olympique Lyon","1-0",1,0,"1",1,1,1,"H"
"26218",2016-01-22,2015,"Stade Rennes","AC Ajaccio","1-0",1,0,"1",1,1,1,"H"
"26219",2016-01-23,2015,"EA Guingamp","SC Bastia","1-0",1,0,"1",1,1,1,"H"
"26220",2016-01-23,2015,"Lille OSC","ESTAC Troyes","1-3",1,3,"1",1,4,-2,"A"
"26221",2016-01-23,2015,"Montpellier HSC","SM Caen","1-2",1,2,"1",1,3,-1,"A"
"26222",2016-01-23,2015,"FC Nantes","Girondins Bordeaux","2-2",2,2,"1",1,4,0,"D"
"26223",2016-01-23,2015,"OGC Nice","FC Lorient","2-1",2,1,"1",1,3,1,"H"
"26224",2016-01-23,2015,"Paris Saint-Germain","Angers SCO","5-1",5,1,"1",1,6,4,"H"
"26225",2016-01-24,2015,"Olympique Lyon","Olympique Marseille","1-1",1,1,"1",1,2,0,"D"
"26226",2016-01-24,2015,"AS Monaco","Toulouse FC","4-0",4,0,"1",1,4,4,"H"
"26227",2016-01-24,2015,"Stade Reims","AS Saint-Etienne","1-1",1,1,"1",1,2,0,"D"
"26228",2016-01-29,2015,"Olympique Marseille","Lille OSC","1-1",1,1,"1",1,2,0,"D"
"26229",2016-01-30,2015,"AC Ajaccio","Montpellier HSC","0-4",0,4,"1",1,4,-4,"A"
"26230",2016-01-30,2015,"Angers SCO","AS Monaco","3-0",3,0,"1",1,3,3,"H"
"26231",2016-01-30,2015,"SC Bastia","Olympique Lyon","1-0",1,0,"1",1,1,1,"H"
"26232",2016-01-30,2015,"FC Lorient","Stade Reims","2-0",2,0,"1",1,2,2,"H"
"26233",2016-01-30,2015,"Toulouse FC","EA Guingamp","1-2",1,2,"1",1,3,-1,"A"
"26234",2016-01-30,2015,"ESTAC Troyes","FC Nantes","0-1",0,1,"1",1,1,-1,"A"
"26235",2016-01-31,2015,"Girondins Bordeaux","Stade Rennes","4-0",4,0,"1",1,4,4,"H"
"26236",2016-01-31,2015,"SM Caen","OGC Nice","2-0",2,0,"1",1,2,2,"H"
"26237",2016-01-31,2015,"AS Saint-Etienne","Paris Saint-Germain","0-2",0,2,"1",1,2,-2,"A"
"26238",2016-02-02,2015,"AS Monaco","SC Bastia","2-0",2,0,"1",1,2,2,"H"
"26239",2016-02-02,2015,"Montpellier HSC","Olympique Marseille","0-1",0,1,"1",1,1,-1,"A"
"26240",2016-02-03,2015,"EA Guingamp","ESTAC Troyes","4-0",4,0,"1",1,4,4,"H"
"26241",2016-02-03,2015,"Lille OSC","SM Caen","1-0",1,0,"1",1,1,1,"H"
"26242",2016-02-03,2015,"Olympique Lyon","Girondins Bordeaux","3-0",3,0,"1",1,3,3,"H"
"26243",2016-02-03,2015,"FC Nantes","AC Ajaccio","3-1",3,1,"1",1,4,2,"H"
"26244",2016-02-03,2015,"OGC Nice","Toulouse FC","1-0",1,0,"1",1,1,1,"H"
"26245",2016-02-03,2015,"Paris Saint-Germain","FC Lorient","3-1",3,1,"1",1,4,2,"H"
"26246",2016-02-03,2015,"Stade Reims","Angers SCO","2-1",2,1,"1",1,3,1,"H"
"26247",2016-02-04,2015,"Stade Rennes","AS Saint-Etienne","0-1",0,1,"1",1,1,-1,"A"
"26248",2016-02-06,2015,"AC Ajaccio","EA Guingamp","0-0",0,0,"1",1,0,0,"D"
"26249",2016-02-06,2015,"Angers SCO","Olympique Lyon","0-3",0,3,"1",1,3,-3,"A"
"26250",2016-02-06,2015,"SC Bastia","ESTAC Troyes","2-0",2,0,"1",1,2,2,"H"
"26251",2016-02-06,2015,"SM Caen","Stade Reims","0-2",0,2,"1",1,2,-2,"A"
"26252",2016-02-06,2015,"FC Lorient","Montpellier HSC","1-1",1,1,"1",1,2,0,"D"
"26253",2016-02-06,2015,"AS Monaco","OGC Nice","1-0",1,0,"1",1,1,1,"H"
"26254",2016-02-06,2015,"Toulouse FC","FC Nantes","0-0",0,0,"1",1,0,0,"D"
"26255",2016-02-07,2015,"Girondins Bordeaux","AS Saint-Etienne","1-4",1,4,"1",1,5,-3,"A"
"26256",2016-02-07,2015,"Lille OSC","Stade Rennes","1-1",1,1,"1",1,2,0,"D"
"26257",2016-02-07,2015,"Olympique Marseille","Paris Saint-Germain","1-2",1,2,"1",1,3,-1,"A"
"26258",2016-02-12,2015,"Stade Rennes","Angers SCO","1-0",1,0,"1",1,1,1,"H"
"26259",2016-02-13,2015,"AC Ajaccio","ESTAC Troyes","2-3",2,3,"1",1,5,-1,"A"
"26260",2016-02-13,2015,"EA Guingamp","Girondins Bordeaux","2-4",2,4,"1",1,6,-2,"A"
"26261",2016-02-13,2015,"Montpellier HSC","Toulouse FC","2-0",2,0,"1",1,2,2,"H"
"26262",2016-02-13,2015,"FC Nantes","FC Lorient","2-1",2,1,"1",1,3,1,"H"
"26263",2016-02-13,2015,"Paris Saint-Germain","Lille OSC","0-0",0,0,"1",1,0,0,"D"
"26264",2016-02-13,2015,"Stade Reims","SC Bastia","0-1",0,1,"1",1,1,-1,"A"
"26265",2016-02-14,2015,"Olympique Lyon","SM Caen","4-1",4,1,"1",1,5,3,"H"
"26266",2016-02-14,2015,"OGC Nice","Olympique Marseille","1-1",1,1,"1",1,2,0,"D"
"26267",2016-02-14,2015,"AS Saint-Etienne","AS Monaco","1-1",1,1,"1",1,2,0,"D"
"26268",2016-02-19,2015,"Girondins Bordeaux","OGC Nice","0-0",0,0,"1",1,0,0,"D"
"26269",2016-02-20,2015,"Angers SCO","Montpellier HSC","2-3",2,3,"1",1,5,-1,"A"
"26270",2016-02-20,2015,"FC Lorient","EA Guingamp","4-3",4,3,"1",1,7,1,"H"
"26271",2016-02-20,2015,"AS Monaco","ESTAC Troyes","3-1",3,1,"1",1,4,2,"H"
"26272",2016-02-20,2015,"Paris Saint-Germain","Stade Reims","4-1",4,1,"1",1,5,3,"H"
"26273",2016-02-20,2015,"Toulouse FC","AC Ajaccio","1-1",1,1,"1",1,2,0,"D"
"26274",2016-02-21,2015,"SM Caen","Stade Rennes","1-0",1,0,"1",1,1,1,"H"
"26275",2016-02-21,2015,"Lille OSC","Olympique Lyon","1-0",1,0,"1",1,1,1,"H"
"26276",2016-02-21,2015,"Olympique Marseille","AS Saint-Etienne","1-1",1,1,"1",1,2,0,"D"
"26277",2016-02-26,2015,"OGC Nice","SC Bastia","0-2",0,2,"1",1,2,-2,"A"
"26278",2016-02-27,2015,"EA Guingamp","Angers SCO","2-2",2,2,"1",1,4,0,"D"
"26279",2016-02-27,2015,"Montpellier HSC","Lille OSC","3-0",3,0,"1",1,3,3,"H"
"26280",2016-02-27,2015,"Stade Reims","Girondins Bordeaux","4-1",4,1,"1",1,5,3,"H"
"26281",2016-02-27,2015,"Toulouse FC","Stade Rennes","1-2",1,2,"1",1,3,-1,"A"
"26282",2016-02-27,2015,"ESTAC Troyes","FC Lorient","0-1",0,1,"1",1,1,-1,"A"
"26283",2016-02-28,2015,"Olympique Lyon","Paris Saint-Germain","2-1",2,1,"1",1,3,1,"H"
"26284",2016-02-28,2015,"FC Nantes","AS Monaco","0-0",0,0,"1",1,0,0,"D"
"26285",2016-02-28,2015,"AS Saint-Etienne","SM Caen","1-2",1,2,"1",1,3,-1,"A"
"26286",2016-03-04,2015,"SM Caen","AS Monaco","2-2",2,2,"1",1,4,0,"D"
"26287",2016-03-05,2015,"Angers SCO","AS Saint-Etienne","0-0",0,0,"1",1,0,0,"D"
"26288",2016-03-05,2015,"SC Bastia","FC Lorient","0-0",0,0,"1",1,0,0,"D"
"26289",2016-03-05,2015,"Girondins Bordeaux","AC Ajaccio","1-1",1,1,"1",1,2,0,"D"
"26290",2016-03-05,2015,"Lille OSC","Stade Reims","2-0",2,0,"1",1,2,2,"H"
"26291",2016-03-05,2015,"OGC Nice","ESTAC Troyes","2-1",2,1,"1",1,3,1,"H"
"26292",2016-03-05,2015,"Paris Saint-Germain","Montpellier HSC","0-0",0,0,"1",1,0,0,"D"
"26293",2016-03-06,2015,"Olympique Lyon","EA Guingamp","5-1",5,1,"1",1,6,4,"H"
"26294",2016-03-06,2015,"Olympique Marseille","Toulouse FC","1-1",1,1,"1",1,2,0,"D"
"26295",2016-03-06,2015,"Stade Rennes","FC Nantes","4-1",4,1,"1",1,5,3,"H"
"26296",2016-03-09,2015,"AC Ajaccio","Olympique Marseille","1-1",1,1,"1",1,2,0,"D"
"26297",2016-03-09,2015,"SC Bastia","FC Nantes","0-0",0,0,"1",1,0,0,"D"
"26298",2016-03-11,2015,"AS Monaco","Stade Reims","2-2",2,2,"1",1,4,0,"D"
"26299",2016-03-12,2015,"AC Ajaccio","SM Caen","1-0",1,0,"1",1,1,1,"H"
"26300",2016-03-12,2015,"SC Bastia","Lille OSC","1-2",1,2,"1",1,3,-1,"A"
"26301",2016-03-12,2015,"EA Guingamp","AS Saint-Etienne","2-0",2,0,"1",1,2,2,"H"
"26302",2016-03-12,2015,"FC Lorient","Olympique Marseille","1-1",1,1,"1",1,2,0,"D"
"26303",2016-03-12,2015,"Montpellier HSC","OGC Nice","0-2",0,2,"1",1,2,-2,"A"
"26304",2016-03-12,2015,"Toulouse FC","Girondins Bordeaux","4-0",4,0,"1",1,4,4,"H"
"26305",2016-03-13,2015,"FC Nantes","Angers SCO","2-0",2,0,"1",1,2,2,"H"
"26306",2016-03-13,2015,"Stade Rennes","Olympique Lyon","2-2",2,2,"1",1,4,0,"D"
"26307",2016-03-13,2015,"ESTAC Troyes","Paris Saint-Germain","0-9",0,9,"1",1,9,-9,"A"
"26308",2016-03-18,2015,"Olympique Marseille","Stade Rennes","2-5",2,5,"1",1,7,-3,"A"
"26309",2016-03-19,2015,"Angers SCO","FC Lorient","5-1",5,1,"1",1,6,4,"H"
"26310",2016-03-19,2015,"SM Caen","ESTAC Troyes","2-1",2,1,"1",1,3,1,"H"
"26311",2016-03-19,2015,"Lille OSC","Toulouse FC","1-0",1,0,"1",1,1,1,"H"
"26312",2016-03-19,2015,"Olympique Lyon","FC Nantes","2-0",2,0,"1",1,2,2,"H"
"26313",2016-03-19,2015,"Stade Reims","EA Guingamp","0-1",0,1,"1",1,1,-1,"A"
"26314",2016-03-19,2015,"AS Saint-Etienne","Montpellier HSC","3-0",3,0,"1",1,3,3,"H"
"26315",2016-03-20,2015,"Girondins Bordeaux","SC Bastia","1-1",1,1,"1",1,2,0,"D"
"26316",2016-03-20,2015,"OGC Nice","AC Ajaccio","3-0",3,0,"1",1,3,3,"H"
"26317",2016-03-20,2015,"Paris Saint-Germain","AS Monaco","0-2",0,2,"1",1,2,-2,"A"
"26318",2016-04-01,2015,"AS Monaco","Girondins Bordeaux","1-2",1,2,"1",1,3,-1,"A"
"26319",2016-04-02,2015,"AC Ajaccio","AS Saint-Etienne","0-2",0,2,"1",1,2,-2,"A"
"26320",2016-04-02,2015,"EA Guingamp","Montpellier HSC","2-2",2,2,"1",1,4,0,"D"
"26321",2016-04-02,2015,"Paris Saint-Germain","OGC Nice","4-1",4,1,"1",1,5,3,"H"
"26322",2016-04-02,2015,"Stade Rennes","Stade Reims","3-1",3,1,"1",1,4,2,"H"
"26323",2016-04-02,2015,"Toulouse FC","SM Caen","2-0",2,0,"1",1,2,2,"H"
"26324",2016-04-02,2015,"ESTAC Troyes","Angers SCO","0-1",0,1,"1",1,1,-1,"A"
"26325",2016-04-03,2015,"SC Bastia","Olympique Marseille","2-1",2,1,"1",1,3,1,"H"
"26326",2016-04-03,2015,"FC Lorient","Olympique Lyon","1-3",1,3,"1",1,4,-2,"A"
"26327",2016-04-03,2015,"FC Nantes","Lille OSC","0-3",0,3,"1",1,3,-3,"A"
"26328",2016-04-08,2015,"Montpellier HSC","Olympique Lyon","0-2",0,2,"1",1,2,-2,"A"
"26329",2016-04-09,2015,"Angers SCO","AC Ajaccio","0-0",0,0,"1",1,0,0,"D"
"26330",2016-04-09,2015,"SM Caen","FC Lorient","1-2",1,2,"1",1,3,-1,"A"
"26331",2016-04-09,2015,"EA Guingamp","Paris Saint-Germain","0-2",0,2,"1",1,2,-2,"A"
"26332",2016-04-09,2015,"Stade Reims","FC Nantes","2-1",2,1,"1",1,3,1,"H"
"26333",2016-04-09,2015,"AS Saint-Etienne","ESTAC Troyes","1-0",1,0,"1",1,1,1,"H"
"26334",2016-04-09,2015,"Toulouse FC","SC Bastia","4-0",4,0,"1",1,4,4,"H"
"26335",2016-04-10,2015,"Lille OSC","AS Monaco","4-1",4,1,"1",1,5,3,"H"
"26336",2016-04-10,2015,"Olympique Marseille","Girondins Bordeaux","0-0",0,0,"1",1,0,0,"D"
"26337",2016-04-10,2015,"OGC Nice","Stade Rennes","3-0",3,0,"1",1,3,3,"H"
"26338",2016-04-15,2015,"Olympique Lyon","OGC Nice","1-1",1,1,"1",1,2,0,"D"
"26339",2016-04-16,2015,"AC Ajaccio","Lille OSC","2-4",2,4,"1",1,6,-2,"A"
"26340",2016-04-16,2015,"SC Bastia","AS Saint-Etienne","0-1",0,1,"1",1,1,-1,"A"
"26341",2016-04-16,2015,"Girondins Bordeaux","Angers SCO","1-3",1,3,"1",1,4,-2,"A"
"26342",2016-04-16,2015,"FC Lorient","Toulouse FC","1-1",1,1,"1",1,2,0,"D"
"26343",2016-04-16,2015,"Paris Saint-Germain","SM Caen","6-0",6,0,"1",1,6,6,"H"
"26344",2016-04-16,2015,"ESTAC Troyes","Stade Reims","2-1",2,1,"1",1,3,1,"H"
"26345",2016-04-17,2015,"AS Monaco","Olympique Marseille","2-1",2,1,"1",1,3,1,"H"
"26346",2016-04-17,2015,"FC Nantes","Montpellier HSC","0-2",0,2,"1",1,2,-2,"A"
"26347",2016-04-17,2015,"Stade Rennes","EA Guingamp","0-3",0,3,"1",1,3,-3,"A"
"26348",2016-04-22,2015,"OGC Nice","Stade Reims","2-0",2,0,"1",1,2,2,"H"
"26349",2016-04-23,2015,"Toulouse FC","Olympique Lyon","2-3",2,3,"1",1,5,-1,"A"
"26350",2016-04-24,2015,"AC Ajaccio","SC Bastia","3-2",3,2,"1",1,5,1,"H"
"26351",2016-04-24,2015,"EA Guingamp","SM Caen","1-1",1,1,"1",1,2,0,"D"
"26352",2016-04-24,2015,"Olympique Marseille","FC Nantes","1-1",1,1,"1",1,2,0,"D"
"26353",2016-04-24,2015,"Montpellier HSC","ESTAC Troyes","4-1",4,1,"1",1,5,3,"H"
"26354",2016-04-24,2015,"Stade Rennes","AS Monaco","1-1",1,1,"1",1,2,0,"D"
"26355",2016-04-24,2015,"AS Saint-Etienne","FC Lorient","2-0",2,0,"1",1,2,2,"H"
"26356",2016-04-27,2015,"Lille OSC","Angers SCO","0-0",0,0,"1",1,0,0,"D"
"26357",2016-04-29,2015,"Paris Saint-Germain","Stade Rennes","4-0",4,0,"1",1,4,4,"H"
"26358",2016-04-30,2015,"SM Caen","SC Bastia","0-0",0,0,"1",1,0,0,"D"
"26359",2016-04-30,2015,"FC Lorient","Lille OSC","0-1",0,1,"1",1,1,-1,"A"
"26360",2016-04-30,2015,"Olympique Lyon","AC Ajaccio","2-1",2,1,"1",1,3,1,"H"
"26361",2016-04-30,2015,"AS Monaco","EA Guingamp","3-2",3,2,"1",1,5,1,"H"
"26362",2016-04-30,2015,"FC Nantes","OGC Nice","1-0",1,0,"1",1,1,1,"H"
"26363",2016-04-30,2015,"Stade Reims","Montpellier HSC","2-3",2,3,"1",1,5,-1,"A"
"26364",2016-04-30,2015,"AS Saint-Etienne","Toulouse FC","0-0",0,0,"1",1,0,0,"D"
"26365",2016-04-30,2015,"ESTAC Troyes","Girondins Bordeaux","2-4",2,4,"1",1,6,-2,"A"
"26366",2016-05-01,2015,"Angers SCO","Olympique Marseille","0-1",0,1,"1",1,1,-1,"A"
"26367",2016-05-07,2015,"AC Ajaccio","Paris Saint-Germain","0-4",0,4,"1",1,4,-4,"A"
"26368",2016-05-07,2015,"SC Bastia","Angers SCO","1-0",1,0,"1",1,1,1,"H"
"26369",2016-05-07,2015,"Girondins Bordeaux","FC Lorient","3-0",3,0,"1",1,3,3,"H"
"26370",2016-05-07,2015,"Lille OSC","EA Guingamp","0-0",0,0,"1",1,0,0,"D"
"26371",2016-05-07,2015,"Olympique Lyon","AS Monaco","6-1",6,1,"1",1,7,5,"H"
"26372",2016-05-07,2015,"Olympique Marseille","Stade Reims","1-0",1,0,"1",1,1,1,"H"
"26373",2016-05-07,2015,"Montpellier HSC","Stade Rennes","2-0",2,0,"1",1,2,2,"H"
"26374",2016-05-07,2015,"FC Nantes","SM Caen","1-2",1,2,"1",1,3,-1,"A"
"26375",2016-05-07,2015,"OGC Nice","AS Saint-Etienne","2-0",2,0,"1",1,2,2,"H"
"26376",2016-05-07,2015,"Toulouse FC","ESTAC Troyes","1-0",1,0,"1",1,1,1,"H"
"26377",2016-05-11,2015,"Girondins Bordeaux","Paris Saint-Germain","1-1",1,1,"1",1,2,0,"D"
"26378",2016-05-14,2015,"Angers SCO","Toulouse FC","2-3",2,3,"1",1,5,-1,"A"
"26379",2016-05-14,2015,"SM Caen","Girondins Bordeaux","1-0",1,0,"1",1,1,1,"H"
"26380",2016-05-14,2015,"EA Guingamp","OGC Nice","2-3",2,3,"1",1,5,-1,"A"
"26381",2016-05-14,2015,"FC Lorient","AC Ajaccio","1-0",1,0,"1",1,1,1,"H"
"26382",2016-05-14,2015,"AS Monaco","Montpellier HSC","2-0",2,0,"1",1,2,2,"H"
"26383",2016-05-14,2015,"Paris Saint-Germain","FC Nantes","4-0",4,0,"1",1,4,4,"H"
"26384",2016-05-14,2015,"Stade Reims","Olympique Lyon","4-1",4,1,"1",1,5,3,"H"
"26385",2016-05-14,2015,"Stade Rennes","SC Bastia","1-2",1,2,"1",1,3,-1,"A"
"26386",2016-05-14,2015,"AS Saint-Etienne","Lille OSC","0-1",0,1,"1",1,1,-1,"A"
"26387",2016-05-14,2015,"ESTAC Troyes","Olympique Marseille","1-1",1,1,"1",1,2,0,"D"
"26388",2016-08-12,2016,"SC Bastia","Paris Saint-Germain","0-1",0,1,"F1",1,1,-1,"A"
"26389",2016-08-12,2016,"AS Monaco","EA Guingamp","2-2",2,2,"F1",1,4,0,"D"
"26390",2016-08-13,2016,"Girondins Bordeaux","AS Saint-Etienne","3-2",3,2,"F1",1,5,1,"H"
"26391",2016-08-13,2016,"SM Caen","FC Lorient","3-2",3,2,"F1",1,5,1,"H"
"26392",2016-08-13,2016,"Dijon FCO","FC Nantes","0-1",0,1,"F1",1,1,-1,"A"
"26393",2016-08-13,2016,"FC Metz","Lille OSC","3-2",3,2,"F1",1,5,1,"H"
"26394",2016-08-13,2016,"Montpellier HSC","Angers SCO","1-0",1,0,"F1",1,1,1,"H"
"26395",2016-08-14,2016,"Olympique Marseille","Toulouse FC","0-0",0,0,"F1",1,0,0,"D"
"26396",2016-08-14,2016,"AS Nancy","Olympique Lyon","0-3",0,3,"F1",1,3,-3,"A"
"26397",2016-08-14,2016,"OGC Nice","Stade Rennes","1-0",1,0,"F1",1,1,1,"H"
"26398",2016-08-19,2016,"Olympique Lyon","SM Caen","2-0",2,0,"F1",1,2,2,"H"
"26399",2016-08-20,2016,"Angers SCO","OGC Nice","0-1",0,1,"F1",1,1,-1,"A"
"26400",2016-08-20,2016,"Lille OSC","Dijon FCO","1-0",1,0,"F1",1,1,1,"H"
"26401",2016-08-20,2016,"FC Lorient","SC Bastia","0-3",0,3,"F1",1,3,-3,"A"
"26402",2016-08-20,2016,"FC Nantes","AS Monaco","0-1",0,1,"F1",1,1,-1,"A"
"26403",2016-08-20,2016,"Stade Rennes","AS Nancy","2-0",2,0,"F1",1,2,2,"H"
"26404",2016-08-20,2016,"Toulouse FC","Girondins Bordeaux","4-1",4,1,"F1",1,5,3,"H"
"26405",2016-08-21,2016,"EA Guingamp","Olympique Marseille","2-1",2,1,"F1",1,3,1,"H"
"26406",2016-08-21,2016,"Paris Saint-Germain","FC Metz","3-0",3,0,"F1",1,3,3,"H"
"26407",2016-08-21,2016,"AS Saint-Etienne","Montpellier HSC","3-1",3,1,"F1",1,4,2,"H"
"26408",2016-08-26,2016,"Olympique Marseille","FC Lorient","2-0",2,0,"F1",1,2,2,"H"
"26409",2016-08-27,2016,"SM Caen","SC Bastia","2-0",2,0,"F1",1,2,2,"H"
"26410",2016-08-27,2016,"Dijon FCO","Olympique Lyon","4-2",4,2,"F1",1,6,2,"H"
"26411",2016-08-27,2016,"FC Metz","Angers SCO","2-0",2,0,"F1",1,2,2,"H"
"26412",2016-08-27,2016,"Montpellier HSC","Stade Rennes","1-1",1,1,"F1",1,2,0,"D"
"26413",2016-08-27,2016,"AS Nancy","EA Guingamp","0-2",0,2,"F1",1,2,-2,"A"
"26414",2016-08-27,2016,"OGC Nice","Lille OSC","1-1",1,1,"F1",1,2,0,"D"
"26415",2016-08-28,2016,"Girondins Bordeaux","FC Nantes","1-0",1,0,"F1",1,1,1,"H"
"26416",2016-08-28,2016,"AS Monaco","Paris Saint-Germain","3-1",3,1,"F1",1,4,2,"H"
"26417",2016-08-28,2016,"AS Saint-Etienne","Toulouse FC","0-0",0,0,"F1",1,0,0,"D"
"26418",2016-09-09,2016,"Paris Saint-Germain","AS Saint-Etienne","1-1",1,1,"F1",1,2,0,"D"
"26419",2016-09-10,2016,"Angers SCO","Dijon FCO","3-1",3,1,"F1",1,4,2,"H"
"26420",2016-09-10,2016,"SC Bastia","Toulouse FC","2-1",2,1,"F1",1,3,1,"H"
"26421",2016-09-10,2016,"EA Guingamp","Montpellier HSC","1-1",1,1,"F1",1,2,0,"D"
"26422",2016-09-10,2016,"Lille OSC","AS Monaco","1-4",1,4,"F1",1,5,-3,"A"
"26423",2016-09-10,2016,"FC Lorient","AS Nancy","0-2",0,2,"F1",1,2,-2,"A"
"26424",2016-09-10,2016,"Olympique Lyon","Girondins Bordeaux","1-3",1,3,"F1",1,4,-2,"A"
"26425",2016-09-11,2016,"FC Nantes","FC Metz","0-3",0,3,"F1",1,3,-3,"A"
"26426",2016-09-11,2016,"OGC Nice","Olympique Marseille","3-2",3,2,"F1",1,5,1,"H"
"26427",2016-09-11,2016,"Stade Rennes","SM Caen","2-0",2,0,"F1",1,2,2,"H"
"26428",2016-09-16,2016,"SM Caen","Paris Saint-Germain","0-6",0,6,"F1",1,6,-6,"A"
"26429",2016-09-17,2016,"Girondins Bordeaux","Angers SCO","0-1",0,1,"F1",1,1,-1,"A"
"26430",2016-09-17,2016,"Dijon FCO","FC Metz","0-0",0,0,"F1",1,0,0,"D"
"26431",2016-09-17,2016,"FC Lorient","Lille OSC","1-0",1,0,"F1",1,1,1,"H"
"26432",2016-09-17,2016,"AS Monaco","Stade Rennes","3-0",3,0,"F1",1,3,3,"H"
"26433",2016-09-17,2016,"AS Nancy","FC Nantes","1-1",1,1,"F1",1,2,0,"D"
"26434",2016-09-17,2016,"Toulouse FC","EA Guingamp","2-1",2,1,"F1",1,3,1,"H"
"26435",2016-09-18,2016,"Olympique Marseille","Olympique Lyon","0-0",0,0,"F1",1,0,0,"D"
"26436",2016-09-18,2016,"Montpellier HSC","OGC Nice","1-1",1,1,"F1",1,2,0,"D"
"26437",2016-09-18,2016,"AS Saint-Etienne","SC Bastia","1-0",1,0,"F1",1,1,1,"H"
"26438",2016-09-20,2016,"Lille OSC","Toulouse FC","1-2",1,2,"F1",1,3,-1,"A"
"26439",2016-09-20,2016,"Paris Saint-Germain","Dijon FCO","3-0",3,0,"F1",1,3,3,"H"
"26440",2016-09-21,2016,"Angers SCO","SM Caen","2-1",2,1,"F1",1,3,1,"H"
"26441",2016-09-21,2016,"SC Bastia","AS Nancy","0-0",0,0,"F1",1,0,0,"D"
"26442",2016-09-21,2016,"EA Guingamp","FC Lorient","1-0",1,0,"F1",1,1,1,"H"
"26443",2016-09-21,2016,"Olympique Lyon","Montpellier HSC","5-1",5,1,"F1",1,6,4,"H"
"26444",2016-09-21,2016,"FC Metz","Girondins Bordeaux","0-3",0,3,"F1",1,3,-3,"A"
"26445",2016-09-21,2016,"FC Nantes","AS Saint-Etienne","0-0",0,0,"F1",1,0,0,"D"
"26446",2016-09-21,2016,"OGC Nice","AS Monaco","4-0",4,0,"F1",1,4,4,"H"
"26447",2016-09-21,2016,"Stade Rennes","Olympique Marseille","3-2",3,2,"F1",1,5,1,"H"
"26448",2016-09-23,2016,"Toulouse FC","Paris Saint-Germain","2-0",2,0,"F1",1,2,2,"H"
"26449",2016-09-24,2016,"SC Bastia","EA Guingamp","1-0",1,0,"F1",1,1,1,"H"
"26450",2016-09-24,2016,"Girondins Bordeaux","SM Caen","0-0",0,0,"F1",1,0,0,"D"
"26451",2016-09-24,2016,"Dijon FCO","Stade Rennes","3-0",3,0,"F1",1,3,3,"H"
"26452",2016-09-24,2016,"FC Lorient","Olympique Lyon","1-0",1,0,"F1",1,1,1,"H"
"26453",2016-09-24,2016,"AS Monaco","Angers SCO","2-1",2,1,"F1",1,3,1,"H"
"26454",2016-09-24,2016,"Montpellier HSC","FC Metz","0-1",0,1,"F1",1,1,-1,"A"
"26455",2016-09-25,2016,"Olympique Marseille","FC Nantes","2-1",2,1,"F1",1,3,1,"H"
"26456",2016-09-25,2016,"AS Nancy","OGC Nice","0-1",0,1,"F1",1,1,-1,"A"
"26457",2016-09-25,2016,"AS Saint-Etienne","Lille OSC","3-1",3,1,"F1",1,4,2,"H"
"26458",2016-09-30,2016,"Stade Rennes","EA Guingamp","1-0",1,0,"F1",1,1,1,"H"
"26459",2016-10-01,2016,"SM Caen","Toulouse FC","1-0",1,0,"F1",1,1,1,"H"
"26460",2016-10-01,2016,"Dijon FCO","Montpellier HSC","3-3",3,3,"F1",1,6,0,"D"
"26461",2016-10-01,2016,"Lille OSC","AS Nancy","1-0",1,0,"F1",1,1,1,"H"
"26462",2016-10-01,2016,"FC Metz","AS Monaco","0-7",0,7,"F1",1,7,-7,"A"
"26463",2016-10-01,2016,"FC Nantes","SC Bastia","1-0",1,0,"F1",1,1,1,"H"
"26464",2016-10-01,2016,"Paris Saint-Germain","Girondins Bordeaux","2-0",2,0,"F1",1,2,2,"H"
"26465",2016-10-02,2016,"Angers SCO","Olympique Marseille","1-1",1,1,"F1",1,2,0,"D"
"26466",2016-10-02,2016,"Olympique Lyon","AS Saint-Etienne","2-0",2,0,"F1",1,2,2,"H"
"26467",2016-10-02,2016,"OGC Nice","FC Lorient","2-1",2,1,"F1",1,3,1,"H"
"26468",2016-10-14,2016,"OGC Nice","Olympique Lyon","2-0",2,0,"F1",1,2,2,"H"
"26469",2016-10-14,2016,"Toulouse FC","AS Monaco","3-1",3,1,"F1",1,4,2,"H"
"26470",2016-10-15,2016,"SC Bastia","Angers SCO","1-2",1,2,"F1",1,3,-1,"A"
"26471",2016-10-15,2016,"EA Guingamp","Lille OSC","1-0",1,0,"F1",1,1,1,"H"
"26472",2016-10-15,2016,"FC Lorient","FC Nantes","1-2",1,2,"F1",1,3,-1,"A"
"26473",2016-10-15,2016,"Montpellier HSC","SM Caen","3-2",3,2,"F1",1,5,1,"H"
"26474",2016-10-15,2016,"AS Nancy","Paris Saint-Germain","1-2",1,2,"F1",1,3,-1,"A"
"26475",2016-10-16,2016,"Olympique Marseille","FC Metz","1-0",1,0,"F1",1,1,1,"H"
"26476",2016-10-16,2016,"Stade Rennes","Girondins Bordeaux","1-1",1,1,"F1",1,2,0,"D"
"26477",2016-10-16,2016,"AS Saint-Etienne","Dijon FCO","1-1",1,1,"F1",1,2,0,"D"
"26478",2016-10-21,2016,"AS Monaco","Montpellier HSC","6-2",6,2,"F1",1,8,4,"H"
"26479",2016-10-22,2016,"Angers SCO","Toulouse FC","0-0",0,0,"F1",1,0,0,"D"
"26480",2016-10-22,2016,"Girondins Bordeaux","AS Nancy","1-1",1,1,"F1",1,2,0,"D"
"26481",2016-10-22,2016,"Dijon FCO","FC Lorient","1-0",1,0,"F1",1,1,1,"H"
"26482",2016-10-22,2016,"Lille OSC","SC Bastia","2-1",2,1,"F1",1,3,1,"H"
"26483",2016-10-22,2016,"Olympique Lyon","EA Guingamp","1-3",1,3,"F1",1,4,-2,"A"
"26484",2016-10-22,2016,"FC Nantes","Stade Rennes","1-2",1,2,"F1",1,3,-1,"A"
"26485",2016-10-23,2016,"SM Caen","AS Saint-Etienne","0-2",0,2,"F1",1,2,-2,"A"
"26486",2016-10-23,2016,"FC Metz","OGC Nice","2-4",2,4,"F1",1,6,-2,"A"
"26487",2016-10-23,2016,"Paris Saint-Germain","Olympique Marseille","0-0",0,0,"F1",1,0,0,"D"
"26488",2016-10-28,2016,"Lille OSC","Paris Saint-Germain","0-1",0,1,"F1",1,1,-1,"A"
"26489",2016-10-29,2016,"SC Bastia","Dijon FCO","0-0",0,0,"F1",1,0,0,"D"
"26490",2016-10-29,2016,"EA Guingamp","Angers SCO","1-0",1,0,"F1",1,1,1,"H"
"26491",2016-10-29,2016,"FC Lorient","Montpellier HSC","2-2",2,2,"F1",1,4,0,"D"
"26492",2016-10-29,2016,"AS Nancy","SM Caen","2-0",2,0,"F1",1,2,2,"H"
"26493",2016-10-29,2016,"AS Saint-Etienne","AS Monaco","1-1",1,1,"F1",1,2,0,"D"
"26494",2016-10-29,2016,"Toulouse FC","Olympique Lyon","1-2",1,2,"F1",1,3,-1,"A"
"26495",2016-10-30,2016,"Olympique Marseille","Girondins Bordeaux","0-0",0,0,"F1",1,0,0,"D"
"26496",2016-10-30,2016,"OGC Nice","FC Nantes","4-1",4,1,"F1",1,5,3,"H"
"26497",2016-10-30,2016,"Stade Rennes","FC Metz","1-0",1,0,"F1",1,1,1,"H"
"26498",2016-11-04,2016,"Montpellier HSC","Olympique Marseille","3-1",3,1,"F1",1,4,2,"H"
"26499",2016-11-05,2016,"Angers SCO","Lille OSC","1-0",1,0,"F1",1,1,1,"H"
"26500",2016-11-05,2016,"Girondins Bordeaux","FC Lorient","2-1",2,1,"F1",1,3,1,"H"
"26501",2016-11-05,2016,"Dijon FCO","EA Guingamp","3-3",3,3,"F1",1,6,0,"D"
"26502",2016-11-05,2016,"Olympique Lyon","SC Bastia","2-1",2,1,"F1",1,3,1,"H"
"26503",2016-11-05,2016,"AS Monaco","AS Nancy","6-0",6,0,"F1",1,6,6,"H"
"26504",2016-11-05,2016,"FC Nantes","Toulouse FC","1-1",1,1,"F1",1,2,0,"D"
"26505",2016-11-06,2016,"SM Caen","OGC Nice","1-0",1,0,"F1",1,1,1,"H"
"26506",2016-11-06,2016,"FC Metz","AS Saint-Etienne","0-0",0,0,"F1",1,0,0,"D"
"26507",2016-11-06,2016,"Paris Saint-Germain","Stade Rennes","4-0",4,0,"F1",1,4,4,"H"
"26508",2016-11-18,2016,"Lille OSC","Olympique Lyon","0-1",0,1,"F1",1,1,-1,"A"
"26509",2016-11-18,2016,"FC Lorient","AS Monaco","0-3",0,3,"F1",1,3,-3,"A"
"26510",2016-11-19,2016,"SC Bastia","Montpellier HSC","1-1",1,1,"F1",1,2,0,"D"
"26511",2016-11-19,2016,"AS Nancy","Dijon FCO","1-0",1,0,"F1",1,1,1,"H"
"26512",2016-11-19,2016,"Paris Saint-Germain","FC Nantes","2-0",2,0,"F1",1,2,2,"H"
"26513",2016-11-19,2016,"Stade Rennes","Angers SCO","1-1",1,1,"F1",1,2,0,"D"
"26514",2016-11-19,2016,"Toulouse FC","FC Metz","1-2",1,2,"F1",1,3,-1,"A"
"26515",2016-11-20,2016,"EA Guingamp","Girondins Bordeaux","1-1",1,1,"F1",1,2,0,"D"
"26516",2016-11-20,2016,"Olympique Marseille","SM Caen","1-0",1,0,"F1",1,1,1,"H"
"26517",2016-11-20,2016,"AS Saint-Etienne","OGC Nice","0-1",0,1,"F1",1,1,-1,"A"
"26518",2016-11-25,2016,"Stade Rennes","Toulouse FC","1-0",1,0,"F1",1,1,1,"H"
"26519",2016-11-26,2016,"Girondins Bordeaux","Dijon FCO","3-2",3,2,"F1",1,5,1,"H"
"26520",2016-11-26,2016,"SM Caen","EA Guingamp","1-1",1,1,"F1",1,2,0,"D"
"26521",2016-11-26,2016,"FC Metz","FC Lorient","3-3",3,3,"F1",1,6,0,"D"
"26522",2016-11-26,2016,"AS Monaco","Olympique Marseille","4-0",4,0,"F1",1,4,4,"H"
"26523",2016-11-26,2016,"Montpellier HSC","AS Nancy","0-0",0,0,"F1",1,0,0,"D"
"26524",2016-11-26,2016,"FC Nantes","Lille OSC","0-0",0,0,"F1",1,0,0,"D"
"26525",2016-11-27,2016,"Angers SCO","AS Saint-Etienne","1-2",1,2,"F1",1,3,-1,"A"
"26526",2016-11-27,2016,"Olympique Lyon","Paris Saint-Germain","1-2",1,2,"F1",1,3,-1,"A"
"26527",2016-11-27,2016,"OGC Nice","SC Bastia","1-1",1,1,"F1",1,2,0,"D"
"26528",2016-11-29,2016,"Dijon FCO","AS Monaco","1-1",1,1,"F1",1,2,0,"D"
"26529",2016-11-29,2016,"Lille OSC","SM Caen","4-2",4,2,"F1",1,6,2,"H"
"26530",2016-11-29,2016,"FC Lorient","Stade Rennes","2-1",2,1,"F1",1,3,1,"H"
"26531",2016-11-30,2016,"SC Bastia","Girondins Bordeaux","1-1",1,1,"F1",1,2,0,"D"
"26532",2016-11-30,2016,"EA Guingamp","OGC Nice","0-1",0,1,"F1",1,1,-1,"A"
"26533",2016-11-30,2016,"AS Nancy","FC Metz","4-0",4,0,"F1",1,4,4,"H"
"26534",2016-11-30,2016,"FC Nantes","Olympique Lyon","0-6",0,6,"F1",1,6,-6,"A"
"26535",2016-11-30,2016,"Paris Saint-Germain","Angers SCO","2-0",2,0,"F1",1,2,2,"H"
"26536",2016-11-30,2016,"AS Saint-Etienne","Olympique Marseille","0-0",0,0,"F1",1,0,0,"D"
"26537",2016-11-30,2016,"Toulouse FC","Montpellier HSC","1-0",1,0,"F1",1,1,1,"H"
"26538",2016-12-02,2016,"SM Caen","Dijon FCO","3-3",3,3,"F1",1,6,0,"D"
"26539",2016-12-03,2016,"Angers SCO","FC Lorient","2-2",2,2,"F1",1,4,0,"D"
"26540",2016-12-03,2016,"Girondins Bordeaux","Lille OSC","0-1",0,1,"F1",1,1,-1,"A"
"26541",2016-12-03,2016,"EA Guingamp","FC Nantes","2-0",2,0,"F1",1,2,2,"H"
"26542",2016-12-03,2016,"AS Monaco","SC Bastia","5-0",5,0,"F1",1,5,5,"H"
"26543",2016-12-03,2016,"Montpellier HSC","Paris Saint-Germain","3-0",3,0,"F1",1,3,3,"H"
"26544",2016-12-04,2016,"Olympique Marseille","AS Nancy","3-0",3,0,"F1",1,3,3,"H"
"26545",2016-12-04,2016,"OGC Nice","Toulouse FC","3-0",3,0,"F1",1,3,3,"H"
"26546",2016-12-04,2016,"Stade Rennes","AS Saint-Etienne","2-0",2,0,"F1",1,2,2,"H"
"26547",2016-12-10,2016,"SC Bastia","FC Metz","2-0",2,0,"F1",1,2,2,"H"
"26548",2016-12-10,2016,"Girondins Bordeaux","AS Monaco","0-4",0,4,"F1",1,4,-4,"A"
"26549",2016-12-10,2016,"Dijon FCO","Olympique Marseille","1-2",1,2,"F1",1,3,-1,"A"
"26550",2016-12-10,2016,"Lille OSC","Montpellier HSC","2-1",2,1,"F1",1,3,1,"H"
"26551",2016-12-10,2016,"AS Nancy","Angers SCO","2-0",2,0,"F1",1,2,2,"H"
"26552",2016-12-10,2016,"Toulouse FC","FC Lorient","3-2",3,2,"F1",1,5,1,"H"
"26553",2016-12-11,2016,"Olympique Lyon","Stade Rennes","1-0",1,0,"F1",1,1,1,"H"
"26554",2016-12-11,2016,"Paris Saint-Germain","OGC Nice","2-2",2,2,"F1",1,4,0,"D"
"26555",2016-12-11,2016,"AS Saint-Etienne","EA Guingamp","1-0",1,0,"F1",1,1,1,"H"
"26556",2016-12-16,2016,"Angers SCO","FC Nantes","0-2",0,2,"F1",1,2,-2,"A"
"26557",2016-12-17,2016,"EA Guingamp","Paris Saint-Germain","2-1",2,1,"F1",1,3,1,"H"
"26558",2016-12-17,2016,"FC Lorient","AS Saint-Etienne","2-1",2,1,"F1",1,3,1,"H"
"26559",2016-12-17,2016,"Montpellier HSC","Girondins Bordeaux","4-0",4,0,"F1",1,4,4,"H"
"26560",2016-12-17,2016,"Stade Rennes","SC Bastia","1-2",1,2,"F1",1,3,-1,"A"
"26561",2016-12-17,2016,"Toulouse FC","AS Nancy","1-1",1,1,"F1",1,2,0,"D"
"26562",2016-12-18,2016,"SM Caen","FC Metz","3-0",3,0,"F1",1,3,3,"H"
"26563",2016-12-18,2016,"Olympique Marseille","Lille OSC","2-0",2,0,"F1",1,2,2,"H"
"26564",2016-12-18,2016,"AS Monaco","Olympique Lyon","1-3",1,3,"F1",1,4,-2,"A"
"26565",2016-12-18,2016,"OGC Nice","Dijon FCO","2-1",2,1,"F1",1,3,1,"H"
"26566",2016-12-21,2016,"SC Bastia","Olympique Marseille","1-2",1,2,"F1",1,3,-1,"A"
"26567",2016-12-21,2016,"Girondins Bordeaux","OGC Nice","0-0",0,0,"F1",1,0,0,"D"
"26568",2016-12-21,2016,"Dijon FCO","Toulouse FC","2-0",2,0,"F1",1,2,2,"H"
"26569",2016-12-21,2016,"Lille OSC","Stade Rennes","1-1",1,1,"F1",1,2,0,"D"
"26570",2016-12-21,2016,"Olympique Lyon","Angers SCO","2-0",2,0,"F1",1,2,2,"H"
"26571",2016-12-21,2016,"FC Metz","EA Guingamp","2-2",2,2,"F1",1,4,0,"D"
"26572",2016-12-21,2016,"AS Monaco","SM Caen","2-1",2,1,"F1",1,3,1,"H"
"26573",2016-12-21,2016,"FC Nantes","Montpellier HSC","1-0",1,0,"F1",1,1,1,"H"
"26574",2016-12-21,2016,"Paris Saint-Germain","FC Lorient","5-0",5,0,"F1",1,5,5,"H"
"26575",2016-12-21,2016,"AS Saint-Etienne","AS Nancy","0-0",0,0,"F1",1,0,0,"D"
"26576",2017-01-13,2016,"Lille OSC","AS Saint-Etienne","1-1",1,1,"F1",1,2,0,"D"
"26577",2017-01-14,2016,"Angers SCO","Girondins Bordeaux","1-1",1,1,"F1",1,2,0,"D"
"26578",2017-01-14,2016,"FC Lorient","EA Guingamp","3-1",3,1,"F1",1,4,2,"H"
"26579",2017-01-14,2016,"Montpellier HSC","Dijon FCO","1-1",1,1,"F1",1,2,0,"D"
"26580",2017-01-14,2016,"AS Nancy","SC Bastia","1-0",1,0,"F1",1,1,1,"H"
"26581",2017-01-14,2016,"Stade Rennes","Paris Saint-Germain","0-1",0,1,"F1",1,1,-1,"A"
"26582",2017-01-14,2016,"Toulouse FC","FC Nantes","0-1",0,1,"F1",1,1,-1,"A"
"26583",2017-01-15,2016,"SM Caen","Olympique Lyon","3-2",3,2,"F1",1,5,1,"H"
"26584",2017-01-15,2016,"Olympique Marseille","AS Monaco","1-4",1,4,"F1",1,5,-3,"A"
"26585",2017-01-15,2016,"OGC Nice","FC Metz","0-0",0,0,"F1",1,0,0,"D"
"26586",2017-01-18,2016,"FC Nantes","SM Caen","1-0",1,0,"F1",1,1,1,"H"
"26587",2017-01-20,2016,"SC Bastia","OGC Nice","1-1",1,1,"F1",1,2,0,"D"
"26588",2017-01-21,2016,"Girondins Bordeaux","Toulouse FC","1-0",1,0,"F1",1,1,1,"H"
"26589",2017-01-21,2016,"Dijon FCO","Lille OSC","0-0",0,0,"F1",1,0,0,"D"
"26590",2017-01-21,2016,"EA Guingamp","Stade Rennes","1-1",1,1,"F1",1,2,0,"D"
"26591",2017-01-21,2016,"FC Metz","Montpellier HSC","2-0",2,0,"F1",1,2,2,"H"
"26592",2017-01-21,2016,"FC Nantes","Paris Saint-Germain","0-2",0,2,"F1",1,2,-2,"A"
"26593",2017-01-22,2016,"Olympique Lyon","Olympique Marseille","3-1",3,1,"F1",1,4,2,"H"
"26594",2017-01-22,2016,"AS Monaco","FC Lorient","4-0",4,0,"F1",1,4,4,"H"
"26595",2017-01-22,2016,"AS Saint-Etienne","Angers SCO","2-1",2,1,"F1",1,3,1,"H"
"26596",2017-01-27,2016,"Olympique Marseille","Montpellier HSC","5-1",5,1,"F1",1,6,4,"H"
"26597",2017-01-28,2016,"Angers SCO","FC Metz","2-1",2,1,"F1",1,3,1,"H"
"26598",2017-01-28,2016,"SC Bastia","SM Caen","1-1",1,1,"F1",1,2,0,"D"
"26599",2017-01-28,2016,"FC Lorient","Dijon FCO","2-3",2,3,"F1",1,5,-1,"A"
"26600",2017-01-28,2016,"Olympique Lyon","Lille OSC","1-2",1,2,"F1",1,3,-1,"A"
"26601",2017-01-28,2016,"AS Nancy","Girondins Bordeaux","0-2",0,2,"F1",1,2,-2,"A"
"26602",2017-01-28,2016,"Stade Rennes","FC Nantes","1-1",1,1,"F1",1,2,0,"D"
"26603",2017-01-29,2016,"OGC Nice","EA Guingamp","3-1",3,1,"F1",1,4,2,"H"
"26604",2017-01-29,2016,"Paris Saint-Germain","AS Monaco","1-1",1,1,"F1",1,2,0,"D"
"26605",2017-01-29,2016,"Toulouse FC","AS Saint-Etienne","0-3",0,3,"F1",1,3,-3,"A"
"26606",2017-02-03,2016,"FC Metz","Olympique Marseille","1-0",1,0,"F1",1,1,1,"H"
"26607",2017-02-04,2016,"Girondins Bordeaux","Stade Rennes","1-1",1,1,"F1",1,2,0,"D"
"26608",2017-02-04,2016,"Dijon FCO","Paris Saint-Germain","1-3",1,3,"F1",1,4,-2,"A"
"26609",2017-02-04,2016,"EA Guingamp","SM Caen","0-1",0,1,"F1",1,1,-1,"A"
"26610",2017-02-04,2016,"Lille OSC","FC Lorient","0-1",0,1,"F1",1,1,-1,"A"
"26611",2017-02-04,2016,"AS Monaco","OGC Nice","3-0",3,0,"F1",1,3,3,"H"
"26612",2017-02-04,2016,"Montpellier HSC","SC Bastia","2-1",2,1,"F1",1,3,1,"H"
"26613",2017-02-05,2016,"FC Nantes","AS Nancy","0-2",0,2,"F1",1,2,-2,"A"
"26614",2017-02-05,2016,"AS Saint-Etienne","Olympique Lyon","2-0",2,0,"F1",1,2,2,"H"
"26615",2017-02-05,2016,"Toulouse FC","Angers SCO","4-0",4,0,"F1",1,4,4,"H"
"26616",2017-02-07,2016,"SM Caen","Girondins Bordeaux","0-4",0,4,"F1",1,4,-4,"A"
"26617",2017-02-07,2016,"Montpellier HSC","AS Monaco","1-2",1,2,"F1",1,3,-1,"A"
"26618",2017-02-07,2016,"Paris Saint-Germain","Lille OSC","2-1",2,1,"F1",1,3,1,"H"
"26619",2017-02-08,2016,"Angers SCO","Stade Rennes","0-0",0,0,"F1",1,0,0,"D"
"26620",2017-02-08,2016,"FC Lorient","Toulouse FC","1-1",1,1,"F1",1,2,0,"D"
"26621",2017-02-08,2016,"Olympique Lyon","AS Nancy","4-0",4,0,"F1",1,4,4,"H"
"26622",2017-02-08,2016,"Olympique Marseille","EA Guingamp","2-0",2,0,"F1",1,2,2,"H"
"26623",2017-02-08,2016,"FC Metz","Dijon FCO","2-1",2,1,"F1",1,3,1,"H"
"26624",2017-02-08,2016,"OGC Nice","AS Saint-Etienne","1-0",1,0,"F1",1,1,1,"H"
"26625",2017-02-10,2016,"Girondins Bordeaux","Paris Saint-Germain","0-3",0,3,"F1",1,3,-3,"A"
"26626",2017-02-11,2016,"Dijon FCO","SM Caen","2-0",2,0,"F1",1,2,2,"H"
"26627",2017-02-11,2016,"EA Guingamp","Olympique Lyon","2-1",2,1,"F1",1,3,1,"H"
"26628",2017-02-11,2016,"Lille OSC","Angers SCO","1-2",1,2,"F1",1,3,-1,"A"
"26629",2017-02-11,2016,"AS Monaco","FC Metz","5-0",5,0,"F1",1,5,5,"H"
"26630",2017-02-11,2016,"AS Nancy","Montpellier HSC","0-3",0,3,"F1",1,3,-3,"A"
"26631",2017-02-11,2016,"Toulouse FC","SC Bastia","4-1",4,1,"F1",1,5,3,"H"
"26632",2017-02-12,2016,"FC Nantes","Olympique Marseille","3-2",3,2,"F1",1,5,1,"H"
"26633",2017-02-12,2016,"Stade Rennes","OGC Nice","2-2",2,2,"F1",1,4,0,"D"
"26634",2017-02-12,2016,"AS Saint-Etienne","FC Lorient","4-0",4,0,"F1",1,4,4,"H"
"26635",2017-02-17,2016,"SC Bastia","AS Monaco","1-1",1,1,"F1",1,2,0,"D"
"26636",2017-02-18,2016,"Angers SCO","AS Nancy","1-0",1,0,"F1",1,1,1,"H"
"26637",2017-02-18,2016,"SM Caen","Lille OSC","0-1",0,1,"F1",1,1,-1,"A"
"26638",2017-02-18,2016,"FC Lorient","OGC Nice","0-1",0,1,"F1",1,1,-1,"A"
"26639",2017-02-18,2016,"Olympique Marseille","Stade Rennes","2-0",2,0,"F1",1,2,2,"H"
"26640",2017-02-18,2016,"FC Metz","FC Nantes","1-1",1,1,"F1",1,2,0,"D"
"26641",2017-02-19,2016,"Girondins Bordeaux","EA Guingamp","3-0",3,0,"F1",1,3,3,"H"
"26642",2017-02-19,2016,"Olympique Lyon","Dijon FCO","4-2",4,2,"F1",1,6,2,"H"
"26643",2017-02-19,2016,"Montpellier HSC","AS Saint-Etienne","2-1",2,1,"F1",1,3,1,"H"
"26644",2017-02-19,2016,"Paris Saint-Germain","Toulouse FC","0-0",0,0,"F1",1,0,0,"D"
"26645",2017-02-21,2016,"SM Caen","AS Nancy","1-0",1,0,"F1",1,1,1,"H"
"26646",2017-02-24,2016,"FC Nantes","Dijon FCO","3-1",3,1,"F1",1,4,2,"H"
"26647",2017-02-24,2016,"OGC Nice","Montpellier HSC","2-1",2,1,"F1",1,3,1,"H"
"26648",2017-02-25,2016,"Angers SCO","SC Bastia","3-0",3,0,"F1",1,3,3,"H"
"26649",2017-02-25,2016,"EA Guingamp","AS Monaco","1-2",1,2,"F1",1,3,-1,"A"
"26650",2017-02-25,2016,"Lille OSC","Girondins Bordeaux","2-3",2,3,"F1",1,5,-1,"A"
"26651",2017-02-25,2016,"AS Nancy","Toulouse FC","0-0",0,0,"F1",1,0,0,"D"
"26652",2017-02-25,2016,"Stade Rennes","FC Lorient","1-0",1,0,"F1",1,1,1,"H"
"26653",2017-02-26,2016,"Olympique Lyon","FC Metz","5-0",5,0,"F1",1,5,5,"H"
"26654",2017-02-26,2016,"Olympique Marseille","Paris Saint-Germain","1-5",1,5,"F1",1,6,-4,"A"
"26655",2017-02-26,2016,"AS Saint-Etienne","SM Caen","0-1",0,1,"F1",1,1,-1,"A"
"26656",2017-03-01,2016,"SC Bastia","FC Nantes","2-2",2,2,"F1",1,4,0,"D"
"26657",2017-03-03,2016,"Girondins Bordeaux","Olympique Lyon","1-1",1,1,"F1",1,2,0,"D"
"26658",2017-03-04,2016,"SC Bastia","AS Saint-Etienne","0-0",0,0,"F1",1,0,0,"D"
"26659",2017-03-04,2016,"SM Caen","Angers SCO","2-3",2,3,"F1",1,5,-1,"A"
"26660",2017-03-04,2016,"Dijon FCO","OGC Nice","0-1",0,1,"F1",1,1,-1,"A"
"26661",2017-03-04,2016,"FC Metz","Stade Rennes","1-1",1,1,"F1",1,2,0,"D"
"26662",2017-03-04,2016,"Montpellier HSC","EA Guingamp","1-1",1,1,"F1",1,2,0,"D"
"26663",2017-03-04,2016,"Paris Saint-Germain","AS Nancy","1-0",1,0,"F1",1,1,1,"H"
"26664",2017-03-05,2016,"FC Lorient","Olympique Marseille","1-4",1,4,"F1",1,5,-3,"A"
"26665",2017-03-05,2016,"AS Monaco","FC Nantes","4-0",4,0,"F1",1,4,4,"H"
"26666",2017-03-05,2016,"Toulouse FC","Lille OSC","1-1",1,1,"F1",1,2,0,"D"
"26667",2017-03-10,2016,"Olympique Marseille","Angers SCO","3-0",3,0,"F1",1,3,3,"H"
"26668",2017-03-10,2016,"OGC Nice","SM Caen","2-2",2,2,"F1",1,4,0,"D"
"26669",2017-03-11,2016,"EA Guingamp","SC Bastia","5-0",5,0,"F1",1,5,5,"H"
"26670",2017-03-11,2016,"AS Monaco","Girondins Bordeaux","2-1",2,1,"F1",1,3,1,"H"
"26671",2017-03-11,2016,"Montpellier HSC","FC Nantes","2-3",2,3,"F1",1,5,-1,"A"
"26672",2017-03-11,2016,"AS Nancy","Lille OSC","1-2",1,2,"F1",1,3,-1,"A"
"26673",2017-03-11,2016,"Stade Rennes","Dijon FCO","1-1",1,1,"F1",1,2,0,"D"
"26674",2017-03-12,2016,"FC Lorient","Paris Saint-Germain","1-2",1,2,"F1",1,3,-1,"A"
"26675",2017-03-12,2016,"Olympique Lyon","Toulouse FC","4-0",4,0,"F1",1,4,4,"H"
"26676",2017-03-12,2016,"AS Saint-Etienne","FC Metz","2-2",2,2,"F1",1,4,0,"D"
"26677",2017-03-17,2016,"Lille OSC","Olympique Marseille","0-0",0,0,"F1",1,0,0,"D"
"26678",2017-03-17,2016,"FC Metz","SC Bastia","1-0",1,0,"F1",1,1,1,"H"
"26679",2017-03-18,2016,"Angers SCO","EA Guingamp","3-0",3,0,"F1",1,3,3,"H"
"26680",2017-03-18,2016,"Girondins Bordeaux","Montpellier HSC","5-1",5,1,"F1",1,6,4,"H"
"26681",2017-03-18,2016,"AS Nancy","FC Lorient","2-3",2,3,"F1",1,5,-1,"A"
"26682",2017-03-18,2016,"FC Nantes","OGC Nice","1-1",1,1,"F1",1,2,0,"D"
"26683",2017-03-18,2016,"Toulouse FC","Stade Rennes","0-0",0,0,"F1",1,0,0,"D"
"26684",2017-03-19,2016,"SM Caen","AS Monaco","0-3",0,3,"F1",1,3,-3,"A"
"26685",2017-03-19,2016,"Dijon FCO","AS Saint-Etienne","0-1",0,1,"F1",1,1,-1,"A"
"26686",2017-03-19,2016,"Paris Saint-Germain","Olympique Lyon","2-1",2,1,"F1",1,3,1,"H"
"26687",2017-03-31,2016,"EA Guingamp","AS Nancy","1-0",1,0,"F1",1,1,1,"H"
"26688",2017-04-01,2016,"SC Bastia","Lille OSC","0-1",0,1,"F1",1,1,-1,"A"
"26689",2017-04-01,2016,"Olympique Marseille","Dijon FCO","1-1",1,1,"F1",1,2,0,"D"
"26690",2017-04-02,2016,"FC Lorient","SM Caen","1-0",1,0,"F1",1,1,1,"H"
"26691",2017-04-02,2016,"Montpellier HSC","Toulouse FC","0-1",0,1,"F1",1,1,-1,"A"
"26692",2017-04-02,2016,"FC Nantes","Angers SCO","2-1",2,1,"F1",1,3,1,"H"
"26693",2017-04-02,2016,"OGC Nice","Girondins Bordeaux","2-1",2,1,"F1",1,3,1,"H"
"26694",2017-04-02,2016,"Stade Rennes","Olympique Lyon","1-1",1,1,"F1",1,2,0,"D"
"26695",2017-04-05,2016,"FC Metz","Olympique Lyon","0-3",0,3,"F1",1,3,-3,"A"
"26696",2017-04-07,2016,"Lille OSC","OGC Nice","1-2",1,2,"F1",1,3,-1,"A"
"26697",2017-04-08,2016,"Angers SCO","AS Monaco","0-1",0,1,"F1",1,1,-1,"A"
"26698",2017-04-08,2016,"Girondins Bordeaux","FC Metz","3-0",3,0,"F1",1,3,3,"H"
"26699",2017-04-08,2016,"SM Caen","Montpellier HSC","0-2",0,2,"F1",1,2,-2,"A"
"26700",2017-04-08,2016,"Dijon FCO","SC Bastia","1-2",1,2,"F1",1,3,-1,"A"
"26701",2017-04-08,2016,"Olympique Lyon","FC Lorient","1-4",1,4,"F1",1,5,-3,"A"
"26702",2017-04-08,2016,"AS Nancy","Stade Rennes","3-0",3,0,"F1",1,3,3,"H"
"26703",2017-04-09,2016,"Paris Saint-Germain","EA Guingamp","4-0",4,0,"F1",1,4,4,"H"
"26704",2017-04-09,2016,"AS Saint-Etienne","FC Nantes","1-1",1,1,"F1",1,2,0,"D"
"26705",2017-04-09,2016,"Toulouse FC","Olympique Marseille","0-0",0,0,"F1",1,0,0,"D"
"26706",2017-04-14,2016,"Angers SCO","Paris Saint-Germain","0-2",0,2,"F1",1,2,-2,"A"
"26707",2017-04-15,2016,"EA Guingamp","Toulouse FC","2-1",2,1,"F1",1,3,1,"H"
"26708",2017-04-15,2016,"FC Metz","SM Caen","2-2",2,2,"F1",1,4,0,"D"
"26709",2017-04-15,2016,"AS Monaco","Dijon FCO","2-1",2,1,"F1",1,3,1,"H"
"26710",2017-04-15,2016,"Montpellier HSC","FC Lorient","2-0",2,0,"F1",1,2,2,"H"
"26711",2017-04-15,2016,"OGC Nice","AS Nancy","3-1",3,1,"F1",1,4,2,"H"
"26712",2017-04-15,2016,"Stade Rennes","Lille OSC","2-0",2,0,"F1",1,2,2,"H"
"26713",2017-04-16,2016,"SC Bastia","Olympique Lyon","0-3",0,3,"F1",1,3,-3,"A"
"26714",2017-04-16,2016,"Olympique Marseille","AS Saint-Etienne","4-0",4,0,"F1",1,4,4,"H"
"26715",2017-04-16,2016,"FC Nantes","Girondins Bordeaux","0-1",0,1,"F1",1,1,-1,"A"
"26716",2017-04-18,2016,"FC Metz","Paris Saint-Germain","2-3",2,3,"F1",1,5,-1,"A"
"26717",2017-04-21,2016,"AS Nancy","Olympique Marseille","0-0",0,0,"F1",1,0,0,"D"
"26718",2017-04-22,2016,"Girondins Bordeaux","SC Bastia","2-0",2,0,"F1",1,2,2,"H"
"26719",2017-04-22,2016,"SM Caen","FC Nantes","0-2",0,2,"F1",1,2,-2,"A"
"26720",2017-04-22,2016,"Dijon FCO","Angers SCO","3-2",3,2,"F1",1,5,1,"H"
"26721",2017-04-22,2016,"Lille OSC","EA Guingamp","3-0",3,0,"F1",1,3,3,"H"
"26722",2017-04-22,2016,"FC Lorient","FC Metz","5-1",5,1,"F1",1,6,4,"H"
"26723",2017-04-22,2016,"Paris Saint-Germain","Montpellier HSC","2-0",2,0,"F1",1,2,2,"H"
"26724",2017-04-23,2016,"Olympique Lyon","AS Monaco","1-2",1,2,"F1",1,3,-1,"A"
"26725",2017-04-23,2016,"AS Saint-Etienne","Stade Rennes","1-1",1,1,"F1",1,2,0,"D"
"26726",2017-04-23,2016,"Toulouse FC","OGC Nice","1-1",1,1,"F1",1,2,0,"D"
"26727",2017-04-28,2016,"Angers SCO","Olympique Lyon","1-2",1,2,"F1",1,3,-1,"A"
"26728",2017-04-29,2016,"SC Bastia","Stade Rennes","1-0",1,0,"F1",1,1,1,"H"
"26729",2017-04-29,2016,"EA Guingamp","AS Saint-Etienne","0-2",0,2,"F1",1,2,-2,"A"
"26730",2017-04-29,2016,"FC Metz","AS Nancy","2-1",2,1,"F1",1,3,1,"H"
"26731",2017-04-29,2016,"AS Monaco","Toulouse FC","3-1",3,1,"F1",1,4,2,"H"
"26732",2017-04-29,2016,"Montpellier HSC","Lille OSC","0-3",0,3,"F1",1,3,-3,"A"
"26733",2017-04-29,2016,"FC Nantes","FC Lorient","1-0",1,0,"F1",1,1,1,"H"
"26734",2017-04-30,2016,"SM Caen","Olympique Marseille","1-5",1,5,"F1",1,6,-4,"A"
"26735",2017-04-30,2016,"Dijon FCO","Girondins Bordeaux","0-0",0,0,"F1",1,0,0,"D"
"26736",2017-04-30,2016,"OGC Nice","Paris Saint-Germain","3-1",3,1,"F1",1,4,2,"H"
"26737",2017-05-05,2016,"AS Saint-Etienne","Girondins Bordeaux","2-2",2,2,"F1",1,4,0,"D"
"26738",2017-05-06,2016,"EA Guingamp","Dijon FCO","4-0",4,0,"F1",1,4,4,"H"
"26739",2017-05-06,2016,"Lille OSC","FC Metz","0-2",0,2,"F1",1,2,-2,"A"
"26740",2017-05-06,2016,"FC Lorient","Angers SCO","1-1",1,1,"F1",1,2,0,"D"
"26741",2017-05-06,2016,"AS Nancy","AS Monaco","0-3",0,3,"F1",1,3,-3,"A"
"26742",2017-05-06,2016,"Paris Saint-Germain","SC Bastia","5-0",5,0,"F1",1,5,5,"H"
"26743",2017-05-06,2016,"Toulouse FC","SM Caen","0-1",0,1,"F1",1,1,-1,"A"
"26744",2017-05-07,2016,"Olympique Lyon","FC Nantes","3-2",3,2,"F1",1,5,1,"H"
"26745",2017-05-07,2016,"Olympique Marseille","OGC Nice","2-1",2,1,"F1",1,3,1,"H"
"26746",2017-05-07,2016,"Stade Rennes","Montpellier HSC","1-0",1,0,"F1",1,1,1,"H"
"26747",2017-05-14,2016,"SC Bastia","FC Lorient","2-0",2,0,"F1",1,2,2,"H"
"26748",2017-05-14,2016,"Girondins Bordeaux","Olympique Marseille","1-1",1,1,"F1",1,2,0,"D"
"26749",2017-05-14,2016,"SM Caen","Stade Rennes","0-1",0,1,"F1",1,1,-1,"A"
"26750",2017-05-14,2016,"Dijon FCO","AS Nancy","2-0",2,0,"F1",1,2,2,"H"
"26751",2017-05-14,2016,"FC Metz","Toulouse FC","1-1",1,1,"F1",1,2,0,"D"
"26752",2017-05-14,2016,"AS Monaco","Lille OSC","4-0",4,0,"F1",1,4,4,"H"
"26753",2017-05-14,2016,"Montpellier HSC","Olympique Lyon","1-3",1,3,"F1",1,4,-2,"A"
"26754",2017-05-14,2016,"FC Nantes","EA Guingamp","4-1",4,1,"F1",1,5,3,"H"
"26755",2017-05-14,2016,"OGC Nice","Angers SCO","0-2",0,2,"F1",1,2,-2,"A"
"26756",2017-05-14,2016,"AS Saint-Etienne","Paris Saint-Germain","0-5",0,5,"F1",1,5,-5,"A"
"26757",2017-05-17,2016,"AS Monaco","AS Saint-Etienne","2-0",2,0,"F1",1,2,2,"H"
"26758",2017-05-20,2016,"Angers SCO","Montpellier HSC","2-0",2,0,"F1",1,2,2,"H"
"26759",2017-05-20,2016,"EA Guingamp","FC Metz","1-0",1,0,"F1",1,1,1,"H"
"26760",2017-05-20,2016,"Lille OSC","FC Nantes","3-0",3,0,"F1",1,3,3,"H"
"26761",2017-05-20,2016,"FC Lorient","Girondins Bordeaux","1-1",1,1,"F1",1,2,0,"D"
"26762",2017-05-20,2016,"Olympique Lyon","OGC Nice","3-3",3,3,"F1",1,6,0,"D"
"26763",2017-05-20,2016,"Olympique Marseille","SC Bastia","1-0",1,0,"F1",1,1,1,"H"
"26764",2017-05-20,2016,"AS Nancy","AS Saint-Etienne","3-1",3,1,"F1",1,4,2,"H"
"26765",2017-05-20,2016,"Paris Saint-Germain","SM Caen","1-1",1,1,"F1",1,2,0,"D"
"26766",2017-05-20,2016,"Stade Rennes","AS Monaco","2-3",2,3,"F1",1,5,-1,"A"
"26767",2017-05-20,2016,"Toulouse FC","Dijon FCO","0-0",0,0,"F1",1,0,0,"D"
