"","Date","Season","home","visitor","FT","hgoal","vgoal","division","tier","totgoal","goaldif","result"
"1",1994-08-13,1994,"Zeytinburnu","Fenerbahce","1-4",1,4,"T1",1,5,-3,"A"
"2",1994-08-14,1994,"Ad. Demirspor","Antalya","1-0",1,0,"T1",1,1,1,"H"
"3",1994-08-14,1994,"Ankaragucu","Gaziantepspor","1-0",1,0,"T1",1,1,1,"H"
"4",1994-08-14,1994,"Bursaspor","P. Ofisi","5-2",5,2,"T1",1,7,3,"H"
"5",1994-08-14,1994,"Denizlispor","Besiktas","1-3",1,3,"T1",1,4,-2,"A"
"6",1994-08-14,1994,"Galatasaray","Genclerbirligi","3-1",3,1,"T1",1,4,2,"H"
"7",1994-08-14,1994,"Kocaelispor","Samsunspor","0-0",0,0,"T1",1,0,0,"D"
"8",1994-08-14,1994,"Trabzonspor","Altay","3-1",3,1,"T1",1,4,2,"H"
"9",1994-08-14,1994,"Vanspor","Kayseri","3-0",3,0,"T1",1,3,3,"H"
"10",1994-08-20,1994,"Fenerbahce","Ankaragucu","2-1",2,1,"T1",1,3,1,"H"
"11",1994-08-20,1994,"P. Ofisi","Galatasaray","0-3",0,3,"T1",1,3,-3,"A"
"12",1994-08-21,1994,"Altay","Bursaspor","1-1",1,1,"T1",1,2,0,"D"
"13",1994-08-21,1994,"Antalya","Trabzonspor","1-3",1,3,"T1",1,4,-2,"A"
"14",1994-08-21,1994,"Besiktas","Kocaelispor","7-1",7,1,"T1",1,8,6,"H"
"15",1994-08-21,1994,"Gaziantepspor","Denizlispor","3-1",3,1,"T1",1,4,2,"H"
"16",1994-08-21,1994,"Genclerbirligi","Zeytinburnu","1-1",1,1,"T1",1,2,0,"D"
"17",1994-08-21,1994,"Kayseri","Ad. Demirspor","4-2",4,2,"T1",1,6,2,"H"
"18",1994-08-21,1994,"Samsunspor","Vanspor","2-1",2,1,"T1",1,3,1,"H"
"19",1994-08-27,1994,"Denizlispor","Fenerbahce","2-3",2,3,"T1",1,5,-1,"A"
"20",1994-08-28,1994,"Ad. Demirspor","Samsunspor","2-0",2,0,"T1",1,2,2,"H"
"21",1994-08-28,1994,"Bursaspor","Antalya","2-1",2,1,"T1",1,3,1,"H"
"22",1994-08-28,1994,"Galatasaray","Altay","3-1",3,1,"T1",1,4,2,"H"
"23",1994-08-28,1994,"Genclerbirligi","P. Ofisi","1-0",1,0,"T1",1,1,1,"H"
"24",1994-08-28,1994,"Kocaelispor","Gaziantepspor","2-1",2,1,"T1",1,3,1,"H"
"25",1994-08-28,1994,"Trabzonspor","Kayseri","5-2",5,2,"T1",1,7,3,"H"
"26",1994-08-28,1994,"Vanspor","Besiktas","0-2",0,2,"T1",1,2,-2,"A"
"27",1994-08-28,1994,"Zeytinburnu","Ankaragucu","2-0",2,0,"T1",1,2,2,"H"
"28",1994-09-10,1994,"Ankaragucu","Denizlispor","2-1",2,1,"T1",1,3,1,"H"
"29",1994-09-10,1994,"Fenerbahce","Kocaelispor","5-1",5,1,"T1",1,6,4,"H"
"30",1994-09-10,1994,"Samsunspor","Trabzonspor","3-1",3,1,"T1",1,4,2,"H"
"31",1994-09-11,1994,"Altay","Genclerbirligi","1-1",1,1,"T1",1,2,0,"D"
"32",1994-09-11,1994,"Antalya","Galatasaray","0-5",0,5,"T1",1,5,-5,"A"
"33",1994-09-11,1994,"Besiktas","Ad. Demirspor","3-0",3,0,"T1",1,3,3,"H"
"34",1994-09-11,1994,"Gaziantepspor","Vanspor","1-0",1,0,"T1",1,1,1,"H"
"35",1994-09-11,1994,"Kayseri","Bursaspor","2-1",2,1,"T1",1,3,1,"H"
"36",1994-09-11,1994,"P. Ofisi","Zeytinburnu","2-0",2,0,"T1",1,2,2,"H"
"37",1994-09-17,1994,"P. Ofisi","Altay","2-2",2,2,"T1",1,4,0,"D"
"38",1994-09-17,1994,"Vanspor","Fenerbahce","1-0",1,0,"T1",1,1,1,"H"
"39",1994-09-18,1994,"Ad. Demirspor","Gaziantepspor","3-2",3,2,"T1",1,5,1,"H"
"40",1994-09-18,1994,"Bursaspor","Samsunspor","1-1",1,1,"T1",1,2,0,"D"
"41",1994-09-18,1994,"Galatasaray","Kayseri","2-1",2,1,"T1",1,3,1,"H"
"42",1994-09-18,1994,"Genclerbirligi","Antalya","3-1",3,1,"T1",1,4,2,"H"
"43",1994-09-18,1994,"Kocaelispor","Ankaragucu","2-0",2,0,"T1",1,2,2,"H"
"44",1994-09-18,1994,"Trabzonspor","Besiktas","0-2",0,2,"T1",1,2,-2,"A"
"45",1994-09-18,1994,"Zeytinburnu","Denizlispor","1-0",1,0,"T1",1,1,1,"H"
"46",1994-09-24,1994,"Fenerbahce","Ad. Demirspor","3-0",3,0,"T1",1,3,3,"H"
"47",1994-09-24,1994,"Gaziantepspor","Trabzonspor","0-2",0,2,"T1",1,2,-2,"A"
"48",1994-09-24,1994,"Samsunspor","Galatasaray","2-2",2,2,"T1",1,4,0,"D"
"49",1994-09-25,1994,"Altay","Zeytinburnu","2-0",2,0,"T1",1,2,2,"H"
"50",1994-09-25,1994,"Ankaragucu","Vanspor","1-0",1,0,"T1",1,1,1,"H"
"51",1994-09-25,1994,"Antalya","P. Ofisi","0-1",0,1,"T1",1,1,-1,"A"
"52",1994-09-25,1994,"Besiktas","Bursaspor","1-2",1,2,"T1",1,3,-1,"A"
"53",1994-09-25,1994,"Denizlispor","Kocaelispor","4-3",4,3,"T1",1,7,1,"H"
"54",1994-09-25,1994,"Kayseri","Genclerbirligi","3-4",3,4,"T1",1,7,-1,"A"
"55",1994-10-01,1994,"Genclerbirligi","Samsunspor","5-1",5,1,"T1",1,6,4,"H"
"56",1994-10-02,1994,"Ad. Demirspor","Ankaragucu","2-3",2,3,"T1",1,5,-1,"A"
"57",1994-10-02,1994,"Altay","Antalya","1-1",1,1,"T1",1,2,0,"D"
"58",1994-10-02,1994,"Bursaspor","Gaziantepspor","3-0",3,0,"T1",1,3,3,"H"
"59",1994-10-02,1994,"Galatasaray","Besiktas","3-1",3,1,"T1",1,4,2,"H"
"60",1994-10-02,1994,"P. Ofisi","Kayseri","0-1",0,1,"T1",1,1,-1,"A"
"61",1994-10-02,1994,"Trabzonspor","Fenerbahce","1-0",1,0,"T1",1,1,1,"H"
"62",1994-10-02,1994,"Vanspor","Denizlispor","2-1",2,1,"T1",1,3,1,"H"
"63",1994-10-02,1994,"Zeytinburnu","Kocaelispor","3-2",3,2,"T1",1,5,1,"H"
"64",1994-10-08,1994,"Ankaragucu","Trabzonspor","1-1",1,1,"T1",1,2,0,"D"
"65",1994-10-08,1994,"Besiktas","Genclerbirligi","2-0",2,0,"T1",1,2,2,"H"
"66",1994-10-08,1994,"Fenerbahce","Bursaspor","1-1",1,1,"T1",1,2,0,"D"
"67",1994-10-08,1994,"Gaziantepspor","Galatasaray","2-2",2,2,"T1",1,4,0,"D"
"68",1994-10-09,1994,"Antalya","Zeytinburnu","4-0",4,0,"T1",1,4,4,"H"
"69",1994-10-09,1994,"Denizlispor","Ad. Demirspor","2-0",2,0,"T1",1,2,2,"H"
"70",1994-10-09,1994,"Kayseri","Altay","1-1",1,1,"T1",1,2,0,"D"
"71",1994-10-09,1994,"Kocaelispor","Vanspor","2-0",2,0,"T1",1,2,2,"H"
"72",1994-10-09,1994,"Samsunspor","P. Ofisi","8-2",8,2,"T1",1,10,6,"H"
"73",1994-10-15,1994,"Galatasaray","Fenerbahce","1-1",1,1,"T1",1,2,0,"D"
"74",1994-10-15,1994,"Genclerbirligi","Gaziantepspor","3-2",3,2,"T1",1,5,1,"H"
"75",1994-10-15,1994,"Trabzonspor","Denizlispor","3-1",3,1,"T1",1,4,2,"H"
"76",1994-10-16,1994,"Ad. Demirspor","Kocaelispor","1-1",1,1,"T1",1,2,0,"D"
"77",1994-10-16,1994,"Altay","Samsunspor","3-2",3,2,"T1",1,5,1,"H"
"78",1994-10-16,1994,"Antalya","Kayseri","2-0",2,0,"T1",1,2,2,"H"
"79",1994-10-16,1994,"Bursaspor","Ankaragucu","1-0",1,0,"T1",1,1,1,"H"
"80",1994-10-16,1994,"P. Ofisi","Besiktas","0-2",0,2,"T1",1,2,-2,"A"
"81",1994-10-16,1994,"Zeytinburnu","Vanspor","0-2",0,2,"T1",1,2,-2,"A"
"82",1994-10-22,1994,"Fenerbahce","Genclerbirligi","2-3",2,3,"T1",1,5,-1,"A"
"83",1994-10-22,1994,"Kocaelispor","Trabzonspor","2-2",2,2,"T1",1,4,0,"D"
"84",1994-10-23,1994,"Ankaragucu","Galatasaray","2-1",2,1,"T1",1,3,1,"H"
"85",1994-10-23,1994,"Besiktas","Altay","1-0",1,0,"T1",1,1,1,"H"
"86",1994-10-23,1994,"Denizlispor","Bursaspor","3-1",3,1,"T1",1,4,2,"H"
"87",1994-10-23,1994,"Gaziantepspor","P. Ofisi","1-0",1,0,"T1",1,1,1,"H"
"88",1994-10-23,1994,"Kayseri","Zeytinburnu","2-1",2,1,"T1",1,3,1,"H"
"89",1994-10-23,1994,"Samsunspor","Antalya","1-0",1,0,"T1",1,1,1,"H"
"90",1994-10-23,1994,"Vanspor","Ad. Demirspor","2-0",2,0,"T1",1,2,2,"H"
"91",1994-10-29,1994,"Galatasaray","Denizlispor","4-0",4,0,"T1",1,4,4,"H"
"92",1994-10-29,1994,"P. Ofisi","Fenerbahce","0-4",0,4,"T1",1,4,-4,"A"
"93",1994-10-29,1994,"Trabzonspor","Vanspor","0-0",0,0,"T1",1,0,0,"D"
"94",1994-10-30,1994,"Altay","Gaziantepspor","5-2",5,2,"T1",1,7,3,"H"
"95",1994-10-30,1994,"Antalya","Besiktas","1-1",1,1,"T1",1,2,0,"D"
"96",1994-10-30,1994,"Bursaspor","Kocaelispor","1-0",1,0,"T1",1,1,1,"H"
"97",1994-10-30,1994,"Genclerbirligi","Ankaragucu","1-0",1,0,"T1",1,1,1,"H"
"98",1994-10-30,1994,"Kayseri","Samsunspor","2-2",2,2,"T1",1,4,0,"D"
"99",1994-10-30,1994,"Zeytinburnu","Ad. Demirspor","4-2",4,2,"T1",1,6,2,"H"
"100",1994-11-05,1994,"Ad. Demirspor","Trabzonspor","0-3",0,3,"T1",1,3,-3,"A"
"101",1994-11-05,1994,"Fenerbahce","Altay","2-1",2,1,"T1",1,3,1,"H"
"102",1994-11-06,1994,"Ankaragucu","P. Ofisi","1-2",1,2,"T1",1,3,-1,"A"
"103",1994-11-06,1994,"Besiktas","Kayseri","4-1",4,1,"T1",1,5,3,"H"
"104",1994-11-06,1994,"Denizlispor","Genclerbirligi","0-0",0,0,"T1",1,0,0,"D"
"105",1994-11-06,1994,"Gaziantepspor","Antalya","2-0",2,0,"T1",1,2,2,"H"
"106",1994-11-06,1994,"Kocaelispor","Galatasaray","0-2",0,2,"T1",1,2,-2,"A"
"107",1994-11-06,1994,"Samsunspor","Zeytinburnu","1-1",1,1,"T1",1,2,0,"D"
"108",1994-11-06,1994,"Vanspor","Bursaspor","2-0",2,0,"T1",1,2,2,"H"
"109",1994-11-12,1994,"Genclerbirligi","Kocaelispor","1-1",1,1,"T1",1,2,0,"D"
"110",1994-11-13,1994,"Altay","Ankaragucu","1-1",1,1,"T1",1,2,0,"D"
"111",1994-11-13,1994,"Antalya","Fenerbahce","2-1",2,1,"T1",1,3,1,"H"
"112",1994-11-13,1994,"Bursaspor","Ad. Demirspor","2-0",2,0,"T1",1,2,2,"H"
"113",1994-11-13,1994,"Galatasaray","Vanspor","4-1",4,1,"T1",1,5,3,"H"
"114",1994-11-13,1994,"Kayseri","Gaziantepspor","1-1",1,1,"T1",1,2,0,"D"
"115",1994-11-13,1994,"P. Ofisi","Denizlispor","1-3",1,3,"T1",1,4,-2,"A"
"116",1994-11-13,1994,"Samsunspor","Besiktas","2-3",2,3,"T1",1,5,-1,"A"
"117",1994-11-13,1994,"Zeytinburnu","Trabzonspor","1-6",1,6,"T1",1,7,-5,"A"
"118",1994-11-19,1994,"Ad. Demirspor","Galatasaray","1-2",1,2,"T1",1,3,-1,"A"
"119",1994-11-19,1994,"Trabzonspor","Bursaspor","1-0",1,0,"T1",1,1,1,"H"
"120",1994-11-20,1994,"Ankaragucu","Antalya","2-2",2,2,"T1",1,4,0,"D"
"121",1994-11-20,1994,"Besiktas","Zeytinburnu","3-1",3,1,"T1",1,4,2,"H"
"122",1994-11-20,1994,"Denizlispor","Altay","1-1",1,1,"T1",1,2,0,"D"
"123",1994-11-20,1994,"Fenerbahce","Kayseri","8-1",8,1,"T1",1,9,7,"H"
"124",1994-11-20,1994,"Gaziantepspor","Samsunspor","1-2",1,2,"T1",1,3,-1,"A"
"125",1994-11-20,1994,"Kocaelispor","P. Ofisi","4-0",4,0,"T1",1,4,4,"H"
"126",1994-11-20,1994,"Vanspor","Genclerbirligi","2-1",2,1,"T1",1,3,1,"H"
"127",1994-11-26,1994,"P. Ofisi","Vanspor","1-0",1,0,"T1",1,1,1,"H"
"128",1994-11-27,1994,"Altay","Kocaelispor","0-2",0,2,"T1",1,2,-2,"A"
"129",1994-11-27,1994,"Antalya","Denizlispor","1-1",1,1,"T1",1,2,0,"D"
"130",1994-11-27,1994,"Bursaspor","Zeytinburnu","3-0",3,0,"T1",1,3,3,"H"
"131",1994-11-27,1994,"Galatasaray","Trabzonspor","2-1",2,1,"T1",1,3,1,"H"
"132",1994-11-27,1994,"Gaziantepspor","Besiktas","0-0",0,0,"T1",1,0,0,"D"
"133",1994-11-27,1994,"Genclerbirligi","Ad. Demirspor","0-0",0,0,"T1",1,0,0,"D"
"134",1994-11-27,1994,"Kayseri","Ankaragucu","4-2",4,2,"T1",1,6,2,"H"
"135",1994-11-27,1994,"Samsunspor","Fenerbahce","1-2",1,2,"T1",1,3,-1,"A"
"136",1994-12-03,1994,"Bursaspor","Galatasaray","2-1",2,1,"T1",1,3,1,"H"
"137",1994-12-04,1994,"Ad. Demirspor","P. Ofisi","1-1",1,1,"T1",1,2,0,"D"
"138",1994-12-04,1994,"Ankaragucu","Samsunspor","1-0",1,0,"T1",1,1,1,"H"
"139",1994-12-04,1994,"Denizlispor","Kayseri","3-0",3,0,"T1",1,3,3,"H"
"140",1994-12-04,1994,"Fenerbahce","Besiktas","1-1",1,1,"T1",1,2,0,"D"
"141",1994-12-04,1994,"Kocaelispor","Antalya","2-1",2,1,"T1",1,3,1,"H"
"142",1994-12-04,1994,"Trabzonspor","Genclerbirligi","4-0",4,0,"T1",1,4,4,"H"
"143",1994-12-04,1994,"Zeytinburnu","Gaziantepspor","1-1",1,1,"T1",1,2,0,"D"
"144",1994-12-17,1994,"Genclerbirligi","Bursaspor","1-0",1,0,"T1",1,1,1,"H"
"145",1994-12-18,1994,"Altay","Ad. Demirspor","3-2",3,2,"T1",1,5,1,"H"
"146",1994-12-18,1994,"Antalya","Vanspor","1-0",1,0,"T1",1,1,1,"H"
"147",1994-12-18,1994,"Besiktas","Ankaragucu","5-1",5,1,"T1",1,6,4,"H"
"148",1994-12-18,1994,"Galatasaray","Zeytinburnu","4-0",4,0,"T1",1,4,4,"H"
"149",1994-12-18,1994,"Gaziantepspor","Fenerbahce","1-1",1,1,"T1",1,2,0,"D"
"150",1994-12-18,1994,"Kayseri","Kocaelispor","4-2",4,2,"T1",1,6,2,"H"
"151",1994-12-18,1994,"P. Ofisi","Trabzonspor","2-5",2,5,"T1",1,7,-3,"A"
"152",1994-12-18,1994,"Samsunspor","Denizlispor","1-1",1,1,"T1",1,2,0,"D"
"153",1995-01-23,1994,"Altay","Trabzonspor","0-1",0,1,"T1",1,1,-1,"A"
"154",1995-01-23,1994,"Antalya","Ad. Demirspor","2-1",2,1,"T1",1,3,1,"H"
"155",1995-01-23,1994,"Besiktas","Denizlispor","2-0",2,0,"T1",1,2,2,"H"
"156",1995-01-23,1994,"Fenerbahce","Zeytinburnu","3-0",3,0,"T1",1,3,3,"H"
"157",1995-01-23,1994,"Gaziantepspor","Ankaragucu","3-2",3,2,"T1",1,5,1,"H"
"158",1995-01-23,1994,"Genclerbirligi","Galatasaray","3-1",3,1,"T1",1,4,2,"H"
"159",1995-01-23,1994,"Kayseri","Vanspor","4-1",4,1,"T1",1,5,3,"H"
"160",1995-01-23,1994,"P. Ofisi","Bursaspor","1-0",1,0,"T1",1,1,1,"H"
"161",1995-01-23,1994,"Samsunspor","Kocaelispor","1-0",1,0,"T1",1,1,1,"H"
"162",1995-01-26,1994,"Vanspor","Altay","1-1",1,1,"T1",1,2,0,"D"
"163",1995-01-29,1994,"Ad. Demirspor","Kayseri","0-2",0,2,"T1",1,2,-2,"A"
"164",1995-01-29,1994,"Ankaragucu","Fenerbahce","2-3",2,3,"T1",1,5,-1,"A"
"165",1995-01-29,1994,"Bursaspor","Altay","1-1",1,1,"T1",1,2,0,"D"
"166",1995-01-29,1994,"Denizlispor","Gaziantepspor","2-1",2,1,"T1",1,3,1,"H"
"167",1995-01-29,1994,"Galatasaray","P. Ofisi","2-0",2,0,"T1",1,2,2,"H"
"168",1995-01-29,1994,"Kocaelispor","Besiktas","1-1",1,1,"T1",1,2,0,"D"
"169",1995-01-29,1994,"Trabzonspor","Antalya","0-0",0,0,"T1",1,0,0,"D"
"170",1995-01-29,1994,"Vanspor","Samsunspor","5-1",5,1,"T1",1,6,4,"H"
"171",1995-01-29,1994,"Zeytinburnu","Genclerbirligi","0-0",0,0,"T1",1,0,0,"D"
"172",1995-02-05,1994,"Altay","Galatasaray","0-3",0,3,"T1",1,3,-3,"A"
"173",1995-02-05,1994,"Ankaragucu","Zeytinburnu","2-2",2,2,"T1",1,4,0,"D"
"174",1995-02-05,1994,"Antalya","Bursaspor","0-1",0,1,"T1",1,1,-1,"A"
"175",1995-02-05,1994,"Besiktas","Vanspor","3-0",3,0,"T1",1,3,3,"H"
"176",1995-02-05,1994,"Fenerbahce","Denizlispor","3-0",3,0,"T1",1,3,3,"H"
"177",1995-02-05,1994,"Gaziantepspor","Kocaelispor","2-0",2,0,"T1",1,2,2,"H"
"178",1995-02-05,1994,"Kayseri","Trabzonspor","0-0",0,0,"T1",1,0,0,"D"
"179",1995-02-05,1994,"P. Ofisi","Genclerbirligi","1-2",1,2,"T1",1,3,-1,"A"
"180",1995-02-05,1994,"Samsunspor","Ad. Demirspor","5-1",5,1,"T1",1,6,4,"H"
"181",1995-02-12,1994,"Ad. Demirspor","Besiktas","0-1",0,1,"T1",1,1,-1,"A"
"182",1995-02-12,1994,"Bursaspor","Kayseri","1-1",1,1,"T1",1,2,0,"D"
"183",1995-02-12,1994,"Denizlispor","Ankaragucu","0-0",0,0,"T1",1,0,0,"D"
"184",1995-02-12,1994,"Genclerbirligi","Altay","2-0",2,0,"T1",1,2,2,"H"
"185",1995-02-12,1994,"Trabzonspor","Samsunspor","5-0",5,0,"T1",1,5,5,"H"
"186",1995-02-12,1994,"Vanspor","Gaziantepspor","2-0",2,0,"T1",1,2,2,"H"
"187",1995-02-12,1994,"Zeytinburnu","P. Ofisi","2-1",2,1,"T1",1,3,1,"H"
"188",1995-02-19,1994,"Altay","P. Ofisi","1-0",1,0,"T1",1,1,1,"H"
"189",1995-02-19,1994,"Ankaragucu","Kocaelispor","2-1",2,1,"T1",1,3,1,"H"
"190",1995-02-19,1994,"Antalya","Genclerbirligi","0-0",0,0,"T1",1,0,0,"D"
"191",1995-02-19,1994,"Besiktas","Trabzonspor","4-0",4,0,"T1",1,4,4,"H"
"192",1995-02-19,1994,"Denizlispor","Zeytinburnu","1-0",1,0,"T1",1,1,1,"H"
"193",1995-02-19,1994,"Fenerbahce","Vanspor","2-1",2,1,"T1",1,3,1,"H"
"194",1995-02-19,1994,"Gaziantepspor","Ad. Demirspor","2-0",2,0,"T1",1,2,2,"H"
"195",1995-02-19,1994,"Kayseri","Galatasaray","0-2",0,2,"T1",1,2,-2,"A"
"196",1995-02-19,1994,"Samsunspor","Bursaspor","1-1",1,1,"T1",1,2,0,"D"
"197",1995-02-26,1994,"Ad. Demirspor","Fenerbahce","0-1",0,1,"T1",1,1,-1,"A"
"198",1995-02-26,1994,"Bursaspor","Besiktas","2-2",2,2,"T1",1,4,0,"D"
"199",1995-02-26,1994,"Galatasaray","Samsunspor","0-1",0,1,"T1",1,1,-1,"A"
"200",1995-02-26,1994,"Genclerbirligi","Kayseri","3-1",3,1,"T1",1,4,2,"H"
"201",1995-02-26,1994,"Kocaelispor","Denizlispor","4-1",4,1,"T1",1,5,3,"H"
"202",1995-02-26,1994,"P. Ofisi","Antalya","2-0",2,0,"T1",1,2,2,"H"
"203",1995-02-26,1994,"Trabzonspor","Gaziantepspor","3-0",3,0,"T1",1,3,3,"H"
"204",1995-02-26,1994,"Vanspor","Ankaragucu","1-1",1,1,"T1",1,2,0,"D"
"205",1995-02-26,1994,"Zeytinburnu","Altay","0-0",0,0,"T1",1,0,0,"D"
"206",1995-03-04,1994,"Fenerbahce","Trabzonspor","1-1",1,1,"T1",1,2,0,"D"
"207",1995-03-05,1994,"Ankaragucu","Ad. Demirspor","3-0",3,0,"T1",1,3,3,"H"
"208",1995-03-05,1994,"Antalya","Altay","0-1",0,1,"T1",1,1,-1,"A"
"209",1995-03-05,1994,"Besiktas","Galatasaray","2-3",2,3,"T1",1,5,-1,"A"
"210",1995-03-05,1994,"Denizlispor","Vanspor","4-0",4,0,"T1",1,4,4,"H"
"211",1995-03-05,1994,"Gaziantepspor","Bursaspor","4-2",4,2,"T1",1,6,2,"H"
"212",1995-03-05,1994,"Kayseri","P. Ofisi","3-1",3,1,"T1",1,4,2,"H"
"213",1995-03-05,1994,"Kocaelispor","Zeytinburnu","4-1",4,1,"T1",1,5,3,"H"
"214",1995-03-05,1994,"Samsunspor","Genclerbirligi","1-3",1,3,"T1",1,4,-2,"A"
"215",1995-03-11,1994,"Genclerbirligi","Besiktas","1-3",1,3,"T1",1,4,-2,"A"
"216",1995-03-12,1994,"Ad. Demirspor","Denizlispor","1-1",1,1,"T1",1,2,0,"D"
"217",1995-03-12,1994,"Altay","Kayseri","2-1",2,1,"T1",1,3,1,"H"
"218",1995-03-12,1994,"Bursaspor","Fenerbahce","1-1",1,1,"T1",1,2,0,"D"
"219",1995-03-12,1994,"Galatasaray","Gaziantepspor","1-2",1,2,"T1",1,3,-1,"A"
"220",1995-03-12,1994,"P. Ofisi","Samsunspor","2-2",2,2,"T1",1,4,0,"D"
"221",1995-03-12,1994,"Trabzonspor","Ankaragucu","4-0",4,0,"T1",1,4,4,"H"
"222",1995-03-12,1994,"Vanspor","Kocaelispor","0-0",0,0,"T1",1,0,0,"D"
"223",1995-03-12,1994,"Zeytinburnu","Antalya","2-2",2,2,"T1",1,4,0,"D"
"224",1995-03-15,1994,"Galatasaray","Antalya","0-3",0,3,"T1",1,3,-3,"A"
"225",1995-03-15,1994,"Kocaelispor","Fenerbahce","3-2",3,2,"T1",1,5,1,"H"
"226",1995-03-19,1994,"Ankaragucu","Bursaspor","0-0",0,0,"T1",1,0,0,"D"
"227",1995-03-19,1994,"Besiktas","P. Ofisi","3-1",3,1,"T1",1,4,2,"H"
"228",1995-03-19,1994,"Denizlispor","Trabzonspor","0-1",0,1,"T1",1,1,-1,"A"
"229",1995-03-19,1994,"Fenerbahce","Galatasaray","3-0",3,0,"T1",1,3,3,"H"
"230",1995-03-19,1994,"Gaziantepspor","Genclerbirligi","3-0",3,0,"T1",1,3,3,"H"
"231",1995-03-19,1994,"Kayseri","Antalya","4-2",4,2,"T1",1,6,2,"H"
"232",1995-03-19,1994,"Kocaelispor","Ad. Demirspor","1-1",1,1,"T1",1,2,0,"D"
"233",1995-03-19,1994,"Samsunspor","Altay","0-1",0,1,"T1",1,1,-1,"A"
"234",1995-03-19,1994,"Vanspor","Zeytinburnu","1-1",1,1,"T1",1,2,0,"D"
"235",1995-03-24,1994,"Altay","Besiktas","2-8",2,8,"T1",1,10,-6,"A"
"236",1995-03-25,1994,"Galatasaray","Ankaragucu","2-1",2,1,"T1",1,3,1,"H"
"237",1995-03-25,1994,"Genclerbirligi","Fenerbahce","2-1",2,1,"T1",1,3,1,"H"
"238",1995-03-25,1994,"Trabzonspor","Kocaelispor","4-0",4,0,"T1",1,4,4,"H"
"239",1995-03-26,1994,"Ad. Demirspor","Vanspor","0-0",0,0,"T1",1,0,0,"D"
"240",1995-03-26,1994,"Antalya","Samsunspor","2-0",2,0,"T1",1,2,2,"H"
"241",1995-03-26,1994,"Bursaspor","Denizlispor","3-2",3,2,"T1",1,5,1,"H"
"242",1995-03-26,1994,"P. Ofisi","Gaziantepspor","2-2",2,2,"T1",1,4,0,"D"
"243",1995-03-26,1994,"Zeytinburnu","Kayseri","1-0",1,0,"T1",1,1,1,"H"
"244",1995-04-02,1994,"Ad. Demirspor","Zeytinburnu","1-2",1,2,"T1",1,3,-1,"A"
"245",1995-04-02,1994,"Ankaragucu","Genclerbirligi","1-2",1,2,"T1",1,3,-1,"A"
"246",1995-04-02,1994,"Besiktas","Antalya","2-1",2,1,"T1",1,3,1,"H"
"247",1995-04-02,1994,"Denizlispor","Galatasaray","0-0",0,0,"T1",1,0,0,"D"
"248",1995-04-02,1994,"Fenerbahce","P. Ofisi","6-2",6,2,"T1",1,8,4,"H"
"249",1995-04-02,1994,"Gaziantepspor","Altay","2-0",2,0,"T1",1,2,2,"H"
"250",1995-04-02,1994,"Kocaelispor","Bursaspor","1-1",1,1,"T1",1,2,0,"D"
"251",1995-04-02,1994,"Samsunspor","Kayseri","2-2",2,2,"T1",1,4,0,"D"
"252",1995-04-02,1994,"Vanspor","Trabzonspor","0-2",0,2,"T1",1,2,-2,"A"
"253",1995-04-07,1994,"Altay","Fenerbahce","2-1",2,1,"T1",1,3,1,"H"
"254",1995-04-07,1994,"P. Ofisi","Ankaragucu","1-2",1,2,"T1",1,3,-1,"A"
"255",1995-04-08,1994,"Antalya","Gaziantepspor","2-3",2,3,"T1",1,5,-1,"A"
"256",1995-04-08,1994,"Bursaspor","Vanspor","1-2",1,2,"T1",1,3,-1,"A"
"257",1995-04-08,1994,"Galatasaray","Kocaelispor","4-1",4,1,"T1",1,5,3,"H"
"258",1995-04-08,1994,"Genclerbirligi","Denizlispor","2-2",2,2,"T1",1,4,0,"D"
"259",1995-04-08,1994,"Kayseri","Besiktas","1-2",1,2,"T1",1,3,-1,"A"
"260",1995-04-08,1994,"Trabzonspor","Ad. Demirspor","7-0",7,0,"T1",1,7,7,"H"
"261",1995-04-08,1994,"Zeytinburnu","Samsunspor","1-2",1,2,"T1",1,3,-1,"A"
"262",1995-04-16,1994,"Ad. Demirspor","Bursaspor","2-3",2,3,"T1",1,5,-1,"A"
"263",1995-04-16,1994,"Ankaragucu","Altay","1-0",1,0,"T1",1,1,1,"H"
"264",1995-04-16,1994,"Besiktas","Samsunspor","1-0",1,0,"T1",1,1,1,"H"
"265",1995-04-16,1994,"Denizlispor","P. Ofisi","1-1",1,1,"T1",1,2,0,"D"
"266",1995-04-16,1994,"Fenerbahce","Antalya","3-0",3,0,"T1",1,3,3,"H"
"267",1995-04-16,1994,"Gaziantepspor","Kayseri","2-0",2,0,"T1",1,2,2,"H"
"268",1995-04-16,1994,"Kocaelispor","Genclerbirligi","3-2",3,2,"T1",1,5,1,"H"
"269",1995-04-16,1994,"Trabzonspor","Zeytinburnu","3-0",3,0,"T1",1,3,3,"H"
"270",1995-04-16,1994,"Vanspor","Galatasaray","1-2",1,2,"T1",1,3,-1,"A"
"271",1995-04-30,1994,"Altay","Denizlispor","1-1",1,1,"T1",1,2,0,"D"
"272",1995-04-30,1994,"Antalya","Ankaragucu","2-0",2,0,"T1",1,2,2,"H"
"273",1995-04-30,1994,"Bursaspor","Trabzonspor","0-1",0,1,"T1",1,1,-1,"A"
"274",1995-04-30,1994,"Galatasaray","Ad. Demirspor","3-0",3,0,"T1",1,3,3,"H"
"275",1995-04-30,1994,"Genclerbirligi","Vanspor","3-1",3,1,"T1",1,4,2,"H"
"276",1995-04-30,1994,"Kayseri","Fenerbahce","1-2",1,2,"T1",1,3,-1,"A"
"277",1995-04-30,1994,"P. Ofisi","Kocaelispor","1-0",1,0,"T1",1,1,1,"H"
"278",1995-04-30,1994,"Samsunspor","Gaziantepspor","2-1",2,1,"T1",1,3,1,"H"
"279",1995-04-30,1994,"Zeytinburnu","Besiktas","0-3",0,3,"T1",1,3,-3,"A"
"280",1995-05-06,1994,"Trabzonspor","Galatasaray","2-2",2,2,"T1",1,4,0,"D"
"281",1995-05-07,1994,"Ad. Demirspor","Genclerbirligi","0-7",0,7,"T1",1,7,-7,"A"
"282",1995-05-07,1994,"Ankaragucu","Kayseri","1-5",1,5,"T1",1,6,-4,"A"
"283",1995-05-07,1994,"Besiktas","Gaziantepspor","2-0",2,0,"T1",1,2,2,"H"
"284",1995-05-07,1994,"Denizlispor","Antalya","0-0",0,0,"T1",1,0,0,"D"
"285",1995-05-07,1994,"Fenerbahce","Samsunspor","4-1",4,1,"T1",1,5,3,"H"
"286",1995-05-07,1994,"Kocaelispor","Altay","7-1",7,1,"T1",1,8,6,"H"
"287",1995-05-07,1994,"Vanspor","P. Ofisi","3-2",3,2,"T1",1,5,1,"H"
"288",1995-05-07,1994,"Zeytinburnu","Bursaspor","2-2",2,2,"T1",1,4,0,"D"
"289",1995-05-13,1994,"Galatasaray","Bursaspor","0-0",0,0,"T1",1,0,0,"D"
"290",1995-05-13,1994,"P. Ofisi","Ad. Demirspor","2-0",2,0,"T1",1,2,2,"H"
"291",1995-05-13,1994,"Samsunspor","Ankaragucu","4-2",4,2,"T1",1,6,2,"H"
"292",1995-05-14,1994,"Altay","Vanspor","3-2",3,2,"T1",1,5,1,"H"
"293",1995-05-14,1994,"Antalya","Kocaelispor","1-0",1,0,"T1",1,1,1,"H"
"294",1995-05-14,1994,"Besiktas","Fenerbahce","0-0",0,0,"T1",1,0,0,"D"
"295",1995-05-14,1994,"Gaziantepspor","Zeytinburnu","3-1",3,1,"T1",1,4,2,"H"
"296",1995-05-14,1994,"Genclerbirligi","Trabzonspor","1-2",1,2,"T1",1,3,-1,"A"
"297",1995-05-14,1994,"Kayseri","Denizlispor","5-1",5,1,"T1",1,6,4,"H"
"298",1995-05-21,1994,"Ad. Demirspor","Altay","1-4",1,4,"T1",1,5,-3,"A"
"299",1995-05-21,1994,"Ankaragucu","Besiktas","0-0",0,0,"T1",1,0,0,"D"
"300",1995-05-21,1994,"Bursaspor","Genclerbirligi","2-1",2,1,"T1",1,3,1,"H"
"301",1995-05-21,1994,"Denizlispor","Samsunspor","1-2",1,2,"T1",1,3,-1,"A"
"302",1995-05-21,1994,"Fenerbahce","Gaziantepspor","2-0",2,0,"T1",1,2,2,"H"
"303",1995-05-21,1994,"Kocaelispor","Kayseri","4-3",4,3,"T1",1,7,1,"H"
"304",1995-05-21,1994,"Trabzonspor","P. Ofisi","3-2",3,2,"T1",1,5,1,"H"
"305",1995-05-21,1994,"Vanspor","Antalya","1-4",1,4,"T1",1,5,-3,"A"
"306",1995-05-21,1994,"Zeytinburnu","Galatasaray","3-7",3,7,"T1",1,10,-4,"A"
"307",1995-08-11,1995,"Istanbulspor","Eskisehirspor","1-3",1,3,"T1",1,4,-2,"A"
"308",1995-08-12,1995,"Fenerbahce","Karsiyaka","4-0",4,0,"T1",1,4,4,"H"
"309",1995-08-12,1995,"Genclerbirligi","Kocaelispor","1-1",1,1,"T1",1,2,0,"D"
"310",1995-08-13,1995,"Altay","Denizlispor","1-2",1,2,"T1",1,3,-1,"A"
"311",1995-08-13,1995,"Antalyaspor","Bursaspor","4-2",4,2,"T1",1,6,2,"H"
"312",1995-08-13,1995,"Kayseri","Besiktas","1-1",1,1,"T1",1,2,0,"D"
"313",1995-08-13,1995,"Samsunspor","Gaziantepspor","1-0",1,0,"T1",1,1,1,"H"
"314",1995-08-13,1995,"Trabzonspor","Ankaragucu","3-1",3,1,"T1",1,4,2,"H"
"315",1995-08-13,1995,"Vanspor","Galatasaray","0-1",0,1,"T1",1,1,-1,"A"
"316",1995-08-18,1995,"Ankaragucu","Istanbulspor","3-1",3,1,"T1",1,4,2,"H"
"317",1995-08-19,1995,"Eskisehirspor","Fenerbahce","1-2",1,2,"T1",1,3,-1,"A"
"318",1995-08-19,1995,"Galatasaray","Altay","3-1",3,1,"T1",1,4,2,"H"
"319",1995-08-20,1995,"Besiktas","Genclerbirligi","2-2",2,2,"T1",1,4,0,"D"
"320",1995-08-20,1995,"Bursaspor","Samsunspor","2-4",2,4,"T1",1,6,-2,"A"
"321",1995-08-20,1995,"Gaziantepspor","Trabzonspor","0-0",0,0,"T1",1,0,0,"D"
"322",1995-08-20,1995,"Karsiyaka","Vanspor","2-1",2,1,"T1",1,3,1,"H"
"323",1995-08-20,1995,"Kayseri","Denizlispor","0-0",0,0,"T1",1,0,0,"D"
"324",1995-08-20,1995,"Kocaelispor","Antalyaspor","2-2",2,2,"T1",1,4,0,"D"
"325",1995-08-25,1995,"Samsunspor","Kocaelispor","0-0",0,0,"T1",1,0,0,"D"
"326",1995-08-26,1995,"Istanbulspor","Gaziantepspor","2-0",2,0,"T1",1,2,2,"H"
"327",1995-08-26,1995,"Trabzonspor","Bursaspor","0-0",0,0,"T1",1,0,0,"D"
"328",1995-08-27,1995,"Antalyaspor","Besiktas","0-3",0,3,"T1",1,3,-3,"A"
"329",1995-08-27,1995,"Fenerbahce","Ankaragucu","2-0",2,0,"T1",1,2,2,"H"
"330",1995-08-27,1995,"Genclerbirligi","Denizlispor","1-1",1,1,"T1",1,2,0,"D"
"331",1995-08-27,1995,"Karsiyaka","Eskisehirspor","3-2",3,2,"T1",1,5,1,"H"
"332",1995-08-27,1995,"Kayseri","Galatasaray","1-2",1,2,"T1",1,3,-1,"A"
"333",1995-08-27,1995,"Vanspor","Altay","2-0",2,0,"T1",1,2,2,"H"
"334",1995-09-08,1995,"Ankaragucu","Karsiyaka","1-0",1,0,"T1",1,1,1,"H"
"335",1995-09-09,1995,"Bursaspor","Istanbulspor","2-1",2,1,"T1",1,3,1,"H"
"336",1995-09-09,1995,"Galatasaray","Genclerbirligi","0-1",0,1,"T1",1,1,-1,"A"
"337",1995-09-09,1995,"Gaziantepspor","Fenerbahce","2-2",2,2,"T1",1,4,0,"D"
"338",1995-09-10,1995,"Altay","Kayseri","2-0",2,0,"T1",1,2,2,"H"
"339",1995-09-10,1995,"Antalyaspor","Denizlispor","1-0",1,0,"T1",1,1,1,"H"
"340",1995-09-10,1995,"Besiktas","Samsunspor","4-2",4,2,"T1",1,6,2,"H"
"341",1995-09-10,1995,"Eskisehirspor","Vanspor","2-1",2,1,"T1",1,3,1,"H"
"342",1995-09-10,1995,"Kocaelispor","Trabzonspor","1-3",1,3,"T1",1,4,-2,"A"
"343",1995-09-15,1995,"Istanbulspor","Kocaelispor","1-2",1,2,"T1",1,3,-1,"A"
"344",1995-09-16,1995,"Fenerbahce","Bursaspor","1-1",1,1,"T1",1,2,0,"D"
"345",1995-09-16,1995,"Samsunspor","Denizlispor","1-3",1,3,"T1",1,4,-2,"A"
"346",1995-09-17,1995,"Antalyaspor","Galatasaray","0-2",0,2,"T1",1,2,-2,"A"
"347",1995-09-17,1995,"Eskisehirspor","Ankaragucu","2-1",2,1,"T1",1,3,1,"H"
"348",1995-09-17,1995,"Genclerbirligi","Altay","1-2",1,2,"T1",1,3,-1,"A"
"349",1995-09-17,1995,"Karsiyaka","Gaziantepspor","2-1",2,1,"T1",1,3,1,"H"
"350",1995-09-17,1995,"Trabzonspor","Besiktas","3-1",3,1,"T1",1,4,2,"H"
"351",1995-09-17,1995,"Vanspor","Kayseri","1-0",1,0,"T1",1,1,1,"H"
"352",1995-09-22,1995,"Galatasaray","Samsunspor","1-0",1,0,"T1",1,1,1,"H"
"353",1995-09-23,1995,"Denizlispor","Trabzonspor","0-3",0,3,"T1",1,3,-3,"A"
"354",1995-09-23,1995,"Kocaelispor","Fenerbahce","0-1",0,1,"T1",1,1,-1,"A"
"355",1995-09-24,1995,"Altay","Antalyaspor","1-2",1,2,"T1",1,3,-1,"A"
"356",1995-09-24,1995,"Ankaragucu","Vanspor","0-0",0,0,"T1",1,0,0,"D"
"357",1995-09-24,1995,"Besiktas","Istanbulspor","5-2",5,2,"T1",1,7,3,"H"
"358",1995-09-24,1995,"Bursaspor","Karsiyaka","3-1",3,1,"T1",1,4,2,"H"
"359",1995-09-24,1995,"Gaziantepspor","Eskisehirspor","3-0",3,0,"T1",1,3,3,"H"
"360",1995-09-24,1995,"Kayseri","Genclerbirligi","2-2",2,2,"T1",1,4,0,"D"
"361",1995-09-29,1995,"Ankaragucu","Gaziantepspor","0-0",0,0,"T1",1,0,0,"D"
"362",1995-09-30,1995,"Fenerbahce","Besiktas","2-0",2,0,"T1",1,2,2,"H"
"363",1995-10-01,1995,"Antalyaspor","Kayseri","3-3",3,3,"T1",1,6,0,"D"
"364",1995-10-01,1995,"Eskisehirspor","Bursaspor","1-3",1,3,"T1",1,4,-2,"A"
"365",1995-10-01,1995,"Istanbulspor","Denizlispor","2-3",2,3,"T1",1,5,-1,"A"
"366",1995-10-01,1995,"Karsiyaka","Kocaelispor","1-2",1,2,"T1",1,3,-1,"A"
"367",1995-10-01,1995,"Samsunspor","Altay","4-0",4,0,"T1",1,4,4,"H"
"368",1995-10-01,1995,"Trabzonspor","Galatasaray","4-1",4,1,"T1",1,5,3,"H"
"369",1995-10-01,1995,"Vanspor","Genclerbirligi","0-1",0,1,"T1",1,1,-1,"A"
"370",1995-10-13,1995,"Bursaspor","Ankaragucu","8-0",8,0,"T1",1,8,8,"H"
"371",1995-10-14,1995,"Denizlispor","Fenerbahce","0-0",0,0,"T1",1,0,0,"D"
"372",1995-10-14,1995,"Galatasaray","Istanbulspor","4-2",4,2,"T1",1,6,2,"H"
"373",1995-10-15,1995,"Altay","Trabzonspor","2-5",2,5,"T1",1,7,-3,"A"
"374",1995-10-15,1995,"Besiktas","Karsiyaka","4-0",4,0,"T1",1,4,4,"H"
"375",1995-10-15,1995,"Gaziantepspor","Vanspor","1-0",1,0,"T1",1,1,1,"H"
"376",1995-10-15,1995,"Genclerbirligi","Antalyaspor","6-3",6,3,"T1",1,9,3,"H"
"377",1995-10-15,1995,"Kayseri","Samsunspor","3-2",3,2,"T1",1,5,1,"H"
"378",1995-10-15,1995,"Kocaelispor","Eskisehirspor","2-1",2,1,"T1",1,3,1,"H"
"379",1995-10-21,1995,"Istanbulspor","Altay","1-1",1,1,"T1",1,2,0,"D"
"380",1995-10-21,1995,"Samsunspor","Genclerbirligi","3-0",3,0,"T1",1,3,3,"H"
"381",1995-10-22,1995,"Ankaragucu","Kocaelispor","4-0",4,0,"T1",1,4,4,"H"
"382",1995-10-22,1995,"Eskisehirspor","Besiktas","2-3",2,3,"T1",1,5,-1,"A"
"383",1995-10-22,1995,"Fenerbahce","Galatasaray","3-1",3,1,"T1",1,4,2,"H"
"384",1995-10-22,1995,"Gaziantepspor","Bursaspor","3-0",3,0,"T1",1,3,3,"H"
"385",1995-10-22,1995,"Karsiyaka","Denizlispor","2-0",2,0,"T1",1,2,2,"H"
"386",1995-10-22,1995,"Trabzonspor","Kayseri","3-1",3,1,"T1",1,4,2,"H"
"387",1995-10-22,1995,"Vanspor","Antalyaspor","1-1",1,1,"T1",1,2,0,"D"
"388",1995-10-29,1995,"Altay","Fenerbahce","0-1",0,1,"T1",1,1,-1,"A"
"389",1995-10-29,1995,"Antalyaspor","Samsunspor","2-1",2,1,"T1",1,3,1,"H"
"390",1995-10-29,1995,"Besiktas","Ankaragucu","2-1",2,1,"T1",1,3,1,"H"
"391",1995-10-29,1995,"Bursaspor","Vanspor","5-0",5,0,"T1",1,5,5,"H"
"392",1995-10-29,1995,"Eskisehirspor","Denizlispor","1-1",1,1,"T1",1,2,0,"D"
"393",1995-10-29,1995,"Galatasaray","Karsiyaka","3-0",3,0,"T1",1,3,3,"H"
"394",1995-10-29,1995,"Genclerbirligi","Trabzonspor","1-3",1,3,"T1",1,4,-2,"A"
"395",1995-10-29,1995,"Kayseri","Istanbulspor","0-1",0,1,"T1",1,1,-1,"A"
"396",1995-10-29,1995,"Kocaelispor","Gaziantepspor","2-2",2,2,"T1",1,4,0,"D"
"397",1995-11-03,1995,"Istanbulspor","Genclerbirligi","1-1",1,1,"T1",1,2,0,"D"
"398",1995-11-04,1995,"Eskisehirspor","Galatasaray","1-2",1,2,"T1",1,3,-1,"A"
"399",1995-11-04,1995,"Fenerbahce","Kayseri","2-1",2,1,"T1",1,3,1,"H"
"400",1995-11-05,1995,"Ankaragucu","Denizlispor","1-1",1,1,"T1",1,2,0,"D"
"401",1995-11-05,1995,"Bursaspor","Kocaelispor","2-2",2,2,"T1",1,4,0,"D"
"402",1995-11-05,1995,"Gaziantepspor","Besiktas","1-1",1,1,"T1",1,2,0,"D"
"403",1995-11-05,1995,"Trabzonspor","Antalyaspor","2-0",2,0,"T1",1,2,2,"H"
"404",1995-11-05,1995,"Vanspor","Samsunspor","0-0",0,0,"T1",1,0,0,"D"
"405",1995-11-12,1995,"Karsiyaka","Altay","1-1",1,1,"T1",1,2,0,"D"
"406",1995-11-18,1995,"Besiktas","Bursaspor","4-1",4,1,"T1",1,5,3,"H"
"407",1995-11-18,1995,"Genclerbirligi","Fenerbahce","3-1",3,1,"T1",1,4,2,"H"
"408",1995-11-19,1995,"Altay","Eskisehirspor","1-0",1,0,"T1",1,1,1,"H"
"409",1995-11-19,1995,"Antalyaspor","Istanbulspor","0-0",0,0,"T1",1,0,0,"D"
"410",1995-11-19,1995,"Denizlispor","Gaziantepspor","2-3",2,3,"T1",1,5,-1,"A"
"411",1995-11-19,1995,"Galatasaray","Ankaragucu","5-0",5,0,"T1",1,5,5,"H"
"412",1995-11-19,1995,"Kayseri","Karsiyaka","1-1",1,1,"T1",1,2,0,"D"
"413",1995-11-19,1995,"Kocaelispor","Vanspor","1-0",1,0,"T1",1,1,1,"H"
"414",1995-11-19,1995,"Samsunspor","Trabzonspor","0-1",0,1,"T1",1,1,-1,"A"
"415",1995-11-25,1995,"Fenerbahce","Antalyaspor","3-1",3,1,"T1",1,4,2,"H"
"416",1995-11-25,1995,"Gaziantepspor","Galatasaray","1-1",1,1,"T1",1,2,0,"D"
"417",1995-11-26,1995,"Ankaragucu","Altay","4-0",4,0,"T1",1,4,4,"H"
"418",1995-11-26,1995,"Bursaspor","Denizlispor","2-2",2,2,"T1",1,4,0,"D"
"419",1995-11-26,1995,"Eskisehirspor","Kayseri","4-0",4,0,"T1",1,4,4,"H"
"420",1995-11-26,1995,"Istanbulspor","Samsunspor","0-2",0,2,"T1",1,2,-2,"A"
"421",1995-11-26,1995,"Karsiyaka","Genclerbirligi","1-1",1,1,"T1",1,2,0,"D"
"422",1995-11-26,1995,"Kocaelispor","Besiktas","1-0",1,0,"T1",1,1,1,"H"
"423",1995-11-29,1995,"Vanspor","Trabzonspor","0-5",0,5,"T1",1,5,-5,"A"
"424",1995-12-01,1995,"Trabzonspor","Istanbulspor","2-1",2,1,"T1",1,3,1,"H"
"425",1995-12-02,1995,"Galatasaray","Bursaspor","3-1",3,1,"T1",1,4,2,"H"
"426",1995-12-03,1995,"Altay","Gaziantepspor","2-1",2,1,"T1",1,3,1,"H"
"427",1995-12-03,1995,"Antalyaspor","Karsiyaka","4-0",4,0,"T1",1,4,4,"H"
"428",1995-12-03,1995,"Besiktas","Vanspor","3-1",3,1,"T1",1,4,2,"H"
"429",1995-12-03,1995,"Denizlispor","Kocaelispor","0-0",0,0,"T1",1,0,0,"D"
"430",1995-12-03,1995,"Genclerbirligi","Eskisehirspor","3-2",3,2,"T1",1,5,1,"H"
"431",1995-12-03,1995,"Kayseri","Ankaragucu","4-1",4,1,"T1",1,5,3,"H"
"432",1995-12-03,1995,"Samsunspor","Fenerbahce","0-3",0,3,"T1",1,3,-3,"A"
"433",1995-12-09,1995,"Denizlispor","Besiktas","0-3",0,3,"T1",1,3,-3,"A"
"434",1995-12-09,1995,"Fenerbahce","Trabzonspor","3-1",3,1,"T1",1,4,2,"H"
"435",1995-12-10,1995,"Ankaragucu","Genclerbirligi","2-0",2,0,"T1",1,2,2,"H"
"436",1995-12-10,1995,"Bursaspor","Altay","0-1",0,1,"T1",1,1,-1,"A"
"437",1995-12-10,1995,"Eskisehirspor","Antalyaspor","0-2",0,2,"T1",1,2,-2,"A"
"438",1995-12-10,1995,"Gaziantepspor","Kayseri","1-0",1,0,"T1",1,1,1,"H"
"439",1995-12-10,1995,"Istanbulspor","Vanspor","1-1",1,1,"T1",1,2,0,"D"
"440",1995-12-10,1995,"Karsiyaka","Samsunspor","1-0",1,0,"T1",1,1,1,"H"
"441",1995-12-10,1995,"Kocaelispor","Galatasaray","1-1",1,1,"T1",1,2,0,"D"
"442",1995-12-16,1995,"Istanbulspor","Fenerbahce","1-2",1,2,"T1",1,3,-1,"A"
"443",1995-12-16,1995,"Trabzonspor","Karsiyaka","3-0",3,0,"T1",1,3,3,"H"
"444",1995-12-17,1995,"Altay","Kocaelispor","3-2",3,2,"T1",1,5,1,"H"
"445",1995-12-17,1995,"Antalyaspor","Ankaragucu","2-1",2,1,"T1",1,3,1,"H"
"446",1995-12-17,1995,"Galatasaray","Besiktas","1-3",1,3,"T1",1,4,-2,"A"
"447",1995-12-17,1995,"Genclerbirligi","Gaziantepspor","1-0",1,0,"T1",1,1,1,"H"
"448",1995-12-17,1995,"Kayseri","Bursaspor","0-0",0,0,"T1",1,0,0,"D"
"449",1995-12-17,1995,"Samsunspor","Eskisehirspor","3-1",3,1,"T1",1,4,2,"H"
"450",1995-12-17,1995,"Vanspor","Denizlispor","3-1",3,1,"T1",1,4,2,"H"
"451",1995-12-22,1995,"Besiktas","Altay","3-0",3,0,"T1",1,3,3,"H"
"452",1995-12-22,1995,"Bursaspor","Genclerbirligi","1-1",1,1,"T1",1,2,0,"D"
"453",1995-12-23,1995,"Ankaragucu","Samsunspor","1-0",1,0,"T1",1,1,1,"H"
"454",1995-12-23,1995,"Denizlispor","Galatasaray","1-3",1,3,"T1",1,4,-2,"A"
"455",1995-12-23,1995,"Eskisehirspor","Trabzonspor","0-2",0,2,"T1",1,2,-2,"A"
"456",1995-12-23,1995,"Fenerbahce","Vanspor","3-0",3,0,"T1",1,3,3,"H"
"457",1995-12-23,1995,"Gaziantepspor","Antalyaspor","2-0",2,0,"T1",1,2,2,"H"
"458",1995-12-23,1995,"Karsiyaka","Istanbulspor","0-3",0,3,"T1",1,3,-3,"A"
"459",1995-12-23,1995,"Kocaelispor","Kayseri","5-0",5,0,"T1",1,5,5,"H"
"460",1996-01-26,1995,"Bursaspor","Antalyaspor","2-1",2,1,"T1",1,3,1,"H"
"461",1996-01-27,1995,"Besiktas","Kayseri","4-1",4,1,"T1",1,5,3,"H"
"462",1996-01-27,1995,"Karsiyaka","Fenerbahce","0-1",0,1,"T1",1,1,-1,"A"
"463",1996-01-28,1995,"Ankaragucu","Trabzonspor","1-3",1,3,"T1",1,4,-2,"A"
"464",1996-01-28,1995,"Denizlispor","Altay","1-0",1,0,"T1",1,1,1,"H"
"465",1996-01-28,1995,"Eskisehirspor","Istanbulspor","1-2",1,2,"T1",1,3,-1,"A"
"466",1996-01-28,1995,"Galatasaray","Vanspor","2-0",2,0,"T1",1,2,2,"H"
"467",1996-01-28,1995,"Gaziantepspor","Samsunspor","3-0",3,0,"T1",1,3,3,"H"
"468",1996-01-28,1995,"Kocaelispor","Genclerbirligi","2-0",2,0,"T1",1,2,2,"H"
"469",1996-02-02,1995,"Genclerbirligi","Besiktas","1-2",1,2,"T1",1,3,-1,"A"
"470",1996-02-03,1995,"Altay","Galatasaray","2-5",2,5,"T1",1,7,-3,"A"
"471",1996-02-03,1995,"Trabzonspor","Gaziantepspor","0-0",0,0,"T1",1,0,0,"D"
"472",1996-02-04,1995,"Antalyaspor","Kocaelispor","1-1",1,1,"T1",1,2,0,"D"
"473",1996-02-04,1995,"Denizlispor","Kayseri","2-2",2,2,"T1",1,4,0,"D"
"474",1996-02-04,1995,"Fenerbahce","Eskisehirspor","6-0",6,0,"T1",1,6,6,"H"
"475",1996-02-04,1995,"Istanbulspor","Ankaragucu","0-0",0,0,"T1",1,0,0,"D"
"476",1996-02-04,1995,"Samsunspor","Bursaspor","1-0",1,0,"T1",1,1,1,"H"
"477",1996-02-04,1995,"Vanspor","Karsiyaka","1-1",1,1,"T1",1,2,0,"D"
"478",1996-02-10,1995,"Ankaragucu","Fenerbahce","0-3",0,3,"T1",1,3,-3,"A"
"479",1996-02-10,1995,"Besiktas","Antalyaspor","3-0",3,0,"T1",1,3,3,"H"
"480",1996-02-11,1995,"Altay","Vanspor","1-1",1,1,"T1",1,2,0,"D"
"481",1996-02-11,1995,"Bursaspor","Trabzonspor","1-2",1,2,"T1",1,3,-1,"A"
"482",1996-02-11,1995,"Denizlispor","Genclerbirligi","3-0",3,0,"T1",1,3,3,"H"
"483",1996-02-11,1995,"Eskisehirspor","Karsiyaka","0-2",0,2,"T1",1,2,-2,"A"
"484",1996-02-11,1995,"Galatasaray","Kayseri","4-0",4,0,"T1",1,4,4,"H"
"485",1996-02-11,1995,"Gaziantepspor","Istanbulspor","1-6",1,6,"T1",1,7,-5,"A"
"486",1996-02-11,1995,"Kocaelispor","Samsunspor","3-1",3,1,"T1",1,4,2,"H"
"487",1996-02-16,1995,"Istanbulspor","Bursaspor","1-1",1,1,"T1",1,2,0,"D"
"488",1996-02-17,1995,"Fenerbahce","Gaziantepspor","1-0",1,0,"T1",1,1,1,"H"
"489",1996-02-17,1995,"Genclerbirligi","Galatasaray","1-2",1,2,"T1",1,3,-1,"A"
"490",1996-02-18,1995,"Denizlispor","Antalyaspor","3-1",3,1,"T1",1,4,2,"H"
"491",1996-02-18,1995,"Karsiyaka","Ankaragucu","0-0",0,0,"T1",1,0,0,"D"
"492",1996-02-18,1995,"Kayseri","Altay","1-1",1,1,"T1",1,2,0,"D"
"493",1996-02-18,1995,"Samsunspor","Besiktas","0-1",0,1,"T1",1,1,-1,"A"
"494",1996-02-18,1995,"Trabzonspor","Kocaelispor","2-0",2,0,"T1",1,2,2,"H"
"495",1996-02-18,1995,"Vanspor","Eskisehirspor","3-0",3,0,"T1",1,3,3,"H"
"496",1996-02-23,1995,"Bursaspor","Fenerbahce","0-0",0,0,"T1",1,0,0,"D"
"497",1996-02-24,1995,"Besiktas","Trabzonspor","2-0",2,0,"T1",1,2,2,"H"
"498",1996-02-25,1995,"Altay","Genclerbirligi","1-3",1,3,"T1",1,4,-2,"A"
"499",1996-02-25,1995,"Ankaragucu","Eskisehirspor","1-2",1,2,"T1",1,3,-1,"A"
"500",1996-02-25,1995,"Denizlispor","Samsunspor","1-2",1,2,"T1",1,3,-1,"A"
"501",1996-02-25,1995,"Galatasaray","Antalyaspor","1-2",1,2,"T1",1,3,-1,"A"
"502",1996-02-25,1995,"Gaziantepspor","Karsiyaka","3-0",3,0,"T1",1,3,3,"H"
"503",1996-02-25,1995,"Kayseri","Vanspor","3-1",3,1,"T1",1,4,2,"H"
"504",1996-02-25,1995,"Kocaelispor","Istanbulspor","0-0",0,0,"T1",1,0,0,"D"
"505",1996-03-02,1995,"Istanbulspor","Besiktas","2-3",2,3,"T1",1,5,-1,"A"
"506",1996-03-02,1995,"Samsunspor","Galatasaray","3-2",3,2,"T1",1,5,1,"H"
"507",1996-03-03,1995,"Antalyaspor","Altay","2-1",2,1,"T1",1,3,1,"H"
"508",1996-03-03,1995,"Eskisehirspor","Gaziantepspor","2-0",2,0,"T1",1,2,2,"H"
"509",1996-03-03,1995,"Fenerbahce","Kocaelispor","4-0",4,0,"T1",1,4,4,"H"
"510",1996-03-03,1995,"Genclerbirligi","Kayseri","1-1",1,1,"T1",1,2,0,"D"
"511",1996-03-03,1995,"Karsiyaka","Bursaspor","0-3",0,3,"T1",1,3,-3,"A"
"512",1996-03-03,1995,"Trabzonspor","Denizlispor","3-0",3,0,"T1",1,3,3,"H"
"513",1996-03-03,1995,"Vanspor","Ankaragucu","4-1",4,1,"T1",1,5,3,"H"
"514",1996-03-08,1995,"Kocaelispor","Karsiyaka","2-0",2,0,"T1",1,2,2,"H"
"515",1996-03-09,1995,"Galatasaray","Trabzonspor","0-0",0,0,"T1",1,0,0,"D"
"516",1996-03-10,1995,"Altay","Samsunspor","0-0",0,0,"T1",1,0,0,"D"
"517",1996-03-10,1995,"Besiktas","Fenerbahce","1-2",1,2,"T1",1,3,-1,"A"
"518",1996-03-10,1995,"Bursaspor","Eskisehirspor","2-2",2,2,"T1",1,4,0,"D"
"519",1996-03-10,1995,"Denizlispor","Istanbulspor","1-2",1,2,"T1",1,3,-1,"A"
"520",1996-03-10,1995,"Gaziantepspor","Ankaragucu","1-0",1,0,"T1",1,1,1,"H"
"521",1996-03-10,1995,"Genclerbirligi","Vanspor","1-1",1,1,"T1",1,2,0,"D"
"522",1996-03-10,1995,"Kayseri","Antalyaspor","4-0",4,0,"T1",1,4,4,"H"
"523",1996-03-16,1995,"Istanbulspor","Galatasaray","1-1",1,1,"T1",1,2,0,"D"
"524",1996-03-16,1995,"Trabzonspor","Altay","2-0",2,0,"T1",1,2,2,"H"
"525",1996-03-17,1995,"Ankaragucu","Bursaspor","1-0",1,0,"T1",1,1,1,"H"
"526",1996-03-17,1995,"Antalyaspor","Genclerbirligi","1-0",1,0,"T1",1,1,1,"H"
"527",1996-03-17,1995,"Eskisehirspor","Kocaelispor","0-3",0,3,"T1",1,3,-3,"A"
"528",1996-03-17,1995,"Fenerbahce","Denizlispor","2-0",2,0,"T1",1,2,2,"H"
"529",1996-03-17,1995,"Karsiyaka","Besiktas","0-2",0,2,"T1",1,2,-2,"A"
"530",1996-03-17,1995,"Samsunspor","Kayseri","0-0",0,0,"T1",1,0,0,"D"
"531",1996-03-17,1995,"Vanspor","Gaziantepspor","2-0",2,0,"T1",1,2,2,"H"
"532",1996-03-22,1995,"Galatasaray","Fenerbahce","2-0",2,0,"T1",1,2,2,"H"
"533",1996-03-23,1995,"Besiktas","Eskisehirspor","2-0",2,0,"T1",1,2,2,"H"
"534",1996-03-23,1995,"Kayseri","Trabzonspor","1-2",1,2,"T1",1,3,-1,"A"
"535",1996-03-24,1995,"Altay","Istanbulspor","0-0",0,0,"T1",1,0,0,"D"
"536",1996-03-24,1995,"Antalyaspor","Vanspor","4-1",4,1,"T1",1,5,3,"H"
"537",1996-03-24,1995,"Bursaspor","Gaziantepspor","3-0",3,0,"T1",1,3,3,"H"
"538",1996-03-24,1995,"Denizlispor","Karsiyaka","1-0",1,0,"T1",1,1,1,"H"
"539",1996-03-24,1995,"Genclerbirligi","Samsunspor","0-0",0,0,"T1",1,0,0,"D"
"540",1996-03-24,1995,"Kocaelispor","Ankaragucu","2-0",2,0,"T1",1,2,2,"H"
"541",1996-03-29,1995,"Istanbulspor","Kayseri","5-2",5,2,"T1",1,7,3,"H"
"542",1996-03-30,1995,"Fenerbahce","Altay","2-2",2,2,"T1",1,4,0,"D"
"543",1996-03-30,1995,"Karsiyaka","Galatasaray","0-3",0,3,"T1",1,3,-3,"A"
"544",1996-03-31,1995,"Ankaragucu","Besiktas","0-1",0,1,"T1",1,1,-1,"A"
"545",1996-03-31,1995,"Denizlispor","Eskisehirspor","1-2",1,2,"T1",1,3,-1,"A"
"546",1996-03-31,1995,"Gaziantepspor","Kocaelispor","2-4",2,4,"T1",1,6,-2,"A"
"547",1996-03-31,1995,"Samsunspor","Antalyaspor","2-2",2,2,"T1",1,4,0,"D"
"548",1996-03-31,1995,"Trabzonspor","Genclerbirligi","3-1",3,1,"T1",1,4,2,"H"
"549",1996-03-31,1995,"Vanspor","Bursaspor","1-1",1,1,"T1",1,2,0,"D"
"550",1996-04-05,1995,"Besiktas","Gaziantepspor","5-3",5,3,"T1",1,8,2,"H"
"551",1996-04-06,1995,"Antalyaspor","Trabzonspor","0-2",0,2,"T1",1,2,-2,"A"
"552",1996-04-06,1995,"Kocaelispor","Bursaspor","4-2",4,2,"T1",1,6,2,"H"
"553",1996-04-07,1995,"Altay","Karsiyaka","0-0",0,0,"T1",1,0,0,"D"
"554",1996-04-07,1995,"Denizlispor","Ankaragucu","2-3",2,3,"T1",1,5,-1,"A"
"555",1996-04-07,1995,"Galatasaray","Eskisehirspor","3-0",3,0,"T1",1,3,3,"H"
"556",1996-04-07,1995,"Genclerbirligi","Istanbulspor","2-0",2,0,"T1",1,2,2,"H"
"557",1996-04-07,1995,"Kayseri","Fenerbahce","1-3",1,3,"T1",1,4,-2,"A"
"558",1996-04-07,1995,"Samsunspor","Vanspor","4-1",4,1,"T1",1,5,3,"H"
"559",1996-04-12,1995,"Istanbulspor","Antalyaspor","1-0",1,0,"T1",1,1,1,"H"
"560",1996-04-13,1995,"Trabzonspor","Samsunspor","1-0",1,0,"T1",1,1,1,"H"
"561",1996-04-14,1995,"Ankaragucu","Galatasaray","2-2",2,2,"T1",1,4,0,"D"
"562",1996-04-14,1995,"Bursaspor","Besiktas","1-2",1,2,"T1",1,3,-1,"A"
"563",1996-04-14,1995,"Eskisehirspor","Altay","1-2",1,2,"T1",1,3,-1,"A"
"564",1996-04-14,1995,"Fenerbahce","Genclerbirligi","0-0",0,0,"T1",1,0,0,"D"
"565",1996-04-14,1995,"Gaziantepspor","Denizlispor","1-0",1,0,"T1",1,1,1,"H"
"566",1996-04-14,1995,"Karsiyaka","Kayseri","1-3",1,3,"T1",1,4,-2,"A"
"567",1996-04-14,1995,"Vanspor","Kocaelispor","2-2",2,2,"T1",1,4,0,"D"
"568",1996-04-19,1995,"Trabzonspor","Vanspor","0-1",0,1,"T1",1,1,-1,"A"
"569",1996-04-20,1995,"Galatasaray","Gaziantepspor","2-0",2,0,"T1",1,2,2,"H"
"570",1996-04-20,1995,"Genclerbirligi","Karsiyaka","2-0",2,0,"T1",1,2,2,"H"
"571",1996-04-21,1995,"Altay","Ankaragucu","1-0",1,0,"T1",1,1,1,"H"
"572",1996-04-21,1995,"Antalyaspor","Fenerbahce","0-1",0,1,"T1",1,1,-1,"A"
"573",1996-04-21,1995,"Besiktas","Kocaelispor","3-5",3,5,"T1",1,8,-2,"A"
"574",1996-04-21,1995,"Denizlispor","Bursaspor","0-0",0,0,"T1",1,0,0,"D"
"575",1996-04-21,1995,"Kayseri","Eskisehirspor","0-1",0,1,"T1",1,1,-1,"A"
"576",1996-04-21,1995,"Samsunspor","Istanbulspor","4-4",4,4,"T1",1,8,0,"D"
"577",1996-04-27,1995,"Bursaspor","Galatasaray","2-0",2,0,"T1",1,2,2,"H"
"578",1996-04-27,1995,"Istanbulspor","Trabzonspor","1-4",1,4,"T1",1,5,-3,"A"
"579",1996-04-28,1995,"Ankaragucu","Kayseri","1-1",1,1,"T1",1,2,0,"D"
"580",1996-04-28,1995,"Eskisehirspor","Genclerbirligi","2-0",2,0,"T1",1,2,2,"H"
"581",1996-04-28,1995,"Fenerbahce","Samsunspor","1-0",1,0,"T1",1,1,1,"H"
"582",1996-04-28,1995,"Gaziantepspor","Altay","2-1",2,1,"T1",1,3,1,"H"
"583",1996-04-28,1995,"Karsiyaka","Antalyaspor","1-2",1,2,"T1",1,3,-1,"A"
"584",1996-04-28,1995,"Kocaelispor","Denizlispor","4-2",4,2,"T1",1,6,2,"H"
"585",1996-04-28,1995,"Vanspor","Besiktas","2-0",2,0,"T1",1,2,2,"H"
"586",1996-05-03,1995,"Altay","Bursaspor","1-3",1,3,"T1",1,4,-2,"A"
"587",1996-05-04,1995,"Galatasaray","Kocaelispor","0-4",0,4,"T1",1,4,-4,"A"
"588",1996-05-05,1995,"Antalyaspor","Eskisehirspor","1-0",1,0,"T1",1,1,1,"H"
"589",1996-05-05,1995,"Besiktas","Denizlispor","0-4",0,4,"T1",1,4,-4,"A"
"590",1996-05-05,1995,"Genclerbirligi","Ankaragucu","1-2",1,2,"T1",1,3,-1,"A"
"591",1996-05-05,1995,"Kayseri","Gaziantepspor","1-2",1,2,"T1",1,3,-1,"A"
"592",1996-05-05,1995,"Samsunspor","Karsiyaka","4-1",4,1,"T1",1,5,3,"H"
"593",1996-05-05,1995,"Trabzonspor","Fenerbahce","1-2",1,2,"T1",1,3,-1,"A"
"594",1996-05-05,1995,"Vanspor","Istanbulspor","0-0",0,0,"T1",1,0,0,"D"
"595",1996-05-11,1995,"Besiktas","Galatasaray","1-2",1,2,"T1",1,3,-1,"A"
"596",1996-05-12,1995,"Ankaragucu","Antalyaspor","2-1",2,1,"T1",1,3,1,"H"
"597",1996-05-12,1995,"Bursaspor","Kayseri","1-2",1,2,"T1",1,3,-1,"A"
"598",1996-05-12,1995,"Denizlispor","Vanspor","0-0",0,0,"T1",1,0,0,"D"
"599",1996-05-12,1995,"Eskisehirspor","Samsunspor","3-0",3,0,"T1",1,3,3,"H"
"600",1996-05-12,1995,"Fenerbahce","Istanbulspor","2-0",2,0,"T1",1,2,2,"H"
"601",1996-05-12,1995,"Gaziantepspor","Genclerbirligi","2-0",2,0,"T1",1,2,2,"H"
"602",1996-05-12,1995,"Karsiyaka","Trabzonspor","1-4",1,4,"T1",1,5,-3,"A"
"603",1996-05-12,1995,"Kocaelispor","Altay","1-1",1,1,"T1",1,2,0,"D"
"604",1996-05-19,1995,"Altay","Besiktas","3-0",3,0,"T1",1,3,3,"H"
"605",1996-05-19,1995,"Antalyaspor","Gaziantepspor","0-1",0,1,"T1",1,1,-1,"A"
"606",1996-05-19,1995,"Galatasaray","Denizlispor","1-0",1,0,"T1",1,1,1,"H"
"607",1996-05-19,1995,"Genclerbirligi","Bursaspor","2-1",2,1,"T1",1,3,1,"H"
"608",1996-05-19,1995,"Istanbulspor","Karsiyaka","0-4",0,4,"T1",1,4,-4,"A"
"609",1996-05-19,1995,"Kayseri","Kocaelispor","1-0",1,0,"T1",1,1,1,"H"
"610",1996-05-19,1995,"Samsunspor","Ankaragucu","2-1",2,1,"T1",1,3,1,"H"
"611",1996-05-19,1995,"Trabzonspor","Eskisehirspor","7-1",7,1,"T1",1,8,6,"H"
"612",1996-05-19,1995,"Vanspor","Fenerbahce","0-3",0,3,"T1",1,3,-3,"A"
"613",1996-08-11,1996,"Ankaragucu","Zeytinburnu","4-1",4,1,"T1",1,5,3,"H"
"614",1996-08-11,1996,"Bursaspor","Besiktas","2-0",2,0,"T1",1,2,2,"H"
"615",1996-08-11,1996,"Fenerbahce","Samsunspor","4-1",4,1,"T1",1,5,3,"H"
"616",1996-08-11,1996,"Genclerbirligi","Dardanelspor","1-1",1,1,"T1",1,2,0,"D"
"617",1996-08-11,1996,"Istanbulspor","Antalyaspor","1-0",1,0,"T1",1,1,1,"H"
"618",1996-08-11,1996,"Kocaelispor","Gaziantepspor","3-1",3,1,"T1",1,4,2,"H"
"619",1996-08-11,1996,"Sariyer","Denizlispor","2-1",2,1,"T1",1,3,1,"H"
"620",1996-08-11,1996,"Trabzonspor","Altay","1-0",1,0,"T1",1,1,1,"H"
"621",1996-08-11,1996,"Vanspor","Galatasaray","1-2",1,2,"T1",1,3,-1,"A"
"622",1996-08-18,1996,"Altay","Kocaelispor","0-0",0,0,"T1",1,0,0,"D"
"623",1996-08-18,1996,"Ankaragucu","Antalyaspor","1-3",1,3,"T1",1,4,-2,"A"
"624",1996-08-18,1996,"Besiktas","Vanspor","7-0",7,0,"T1",1,7,7,"H"
"625",1996-08-18,1996,"Denizlispor","Dardanelspor","0-1",0,1,"T1",1,1,-1,"A"
"626",1996-08-18,1996,"Galatasaray","Trabzonspor","1-0",1,0,"T1",1,1,1,"H"
"627",1996-08-18,1996,"Gaziantepspor","Fenerbahce","2-0",2,0,"T1",1,2,2,"H"
"628",1996-08-18,1996,"Genclerbirligi","Istanbulspor","1-0",1,0,"T1",1,1,1,"H"
"629",1996-08-18,1996,"Samsunspor","Sariyer","2-2",2,2,"T1",1,4,0,"D"
"630",1996-08-18,1996,"Zeytinburnu","Bursaspor","0-1",0,1,"T1",1,1,-1,"A"
"631",1996-08-25,1996,"Bursaspor","Antalyaspor","0-0",0,0,"T1",1,0,0,"D"
"632",1996-08-25,1996,"Fenerbahce","Altay","5-1",5,1,"T1",1,6,4,"H"
"633",1996-08-25,1996,"Genclerbirligi","Denizlispor","3-2",3,2,"T1",1,5,1,"H"
"634",1996-08-25,1996,"Istanbulspor","Ankaragucu","1-2",1,2,"T1",1,3,-1,"A"
"635",1996-08-25,1996,"Kocaelispor","Galatasaray","1-1",1,1,"T1",1,2,0,"D"
"636",1996-08-25,1996,"Samsunspor","Dardanelspor","2-0",2,0,"T1",1,2,2,"H"
"637",1996-08-25,1996,"Sariyer","Gaziantepspor","0-0",0,0,"T1",1,0,0,"D"
"638",1996-08-25,1996,"Trabzonspor","Besiktas","3-3",3,3,"T1",1,6,0,"D"
"639",1996-08-25,1996,"Vanspor","Zeytinburnu","1-1",1,1,"T1",1,2,0,"D"
"640",1996-09-08,1996,"Altay","Sariyer","4-3",4,3,"T1",1,7,1,"H"
"641",1996-09-08,1996,"Ankaragucu","Bursaspor","0-2",0,2,"T1",1,2,-2,"A"
"642",1996-09-08,1996,"Besiktas","Kocaelispor","1-1",1,1,"T1",1,2,0,"D"
"643",1996-09-08,1996,"Denizlispor","Istanbulspor","1-1",1,1,"T1",1,2,0,"D"
"644",1996-09-08,1996,"Galatasaray","Fenerbahce","0-4",0,4,"T1",1,4,-4,"A"
"645",1996-09-08,1996,"Gaziantepspor","Dardanelspor","1-1",1,1,"T1",1,2,0,"D"
"646",1996-09-08,1996,"Samsunspor","Genclerbirligi","1-0",1,0,"T1",1,1,1,"H"
"647",1996-09-08,1996,"Vanspor","Antalyaspor","1-0",1,0,"T1",1,1,1,"H"
"648",1996-09-08,1996,"Zeytinburnu","Trabzonspor","1-5",1,5,"T1",1,6,-4,"A"
"649",1996-09-15,1996,"Altay","Dardanelspor","2-1",2,1,"T1",1,3,1,"H"
"650",1996-09-15,1996,"Denizlispor","Samsunspor","2-2",2,2,"T1",1,4,0,"D"
"651",1996-09-15,1996,"Fenerbahce","Besiktas","0-1",0,1,"T1",1,1,-1,"A"
"652",1996-09-15,1996,"Genclerbirligi","Gaziantepspor","1-1",1,1,"T1",1,2,0,"D"
"653",1996-09-15,1996,"Istanbulspor","Bursaspor","1-1",1,1,"T1",1,2,0,"D"
"654",1996-09-15,1996,"Kocaelispor","Zeytinburnu","2-1",2,1,"T1",1,3,1,"H"
"655",1996-09-15,1996,"Sariyer","Galatasaray","0-4",0,4,"T1",1,4,-4,"A"
"656",1996-09-15,1996,"Trabzonspor","Antalyaspor","2-0",2,0,"T1",1,2,2,"H"
"657",1996-09-15,1996,"Vanspor","Ankaragucu","2-0",2,0,"T1",1,2,2,"H"
"658",1996-09-22,1996,"Altay","Genclerbirligi","1-0",1,0,"T1",1,1,1,"H"
"659",1996-09-22,1996,"Ankaragucu","Trabzonspor","0-1",0,1,"T1",1,1,-1,"A"
"660",1996-09-22,1996,"Besiktas","Sariyer","2-0",2,0,"T1",1,2,2,"H"
"661",1996-09-22,1996,"Bursaspor","Vanspor","2-0",2,0,"T1",1,2,2,"H"
"662",1996-09-22,1996,"Galatasaray","Dardanelspor","1-0",1,0,"T1",1,1,1,"H"
"663",1996-09-22,1996,"Gaziantepspor","Denizlispor","2-0",2,0,"T1",1,2,2,"H"
"664",1996-09-22,1996,"Kocaelispor","Antalyaspor","0-1",0,1,"T1",1,1,-1,"A"
"665",1996-09-22,1996,"Samsunspor","Istanbulspor","1-0",1,0,"T1",1,1,1,"H"
"666",1996-09-22,1996,"Zeytinburnu","Fenerbahce","1-5",1,5,"T1",1,6,-4,"A"
"667",1996-09-29,1996,"Dardanelspor","Besiktas","0-5",0,5,"T1",1,5,-5,"A"
"668",1996-09-29,1996,"Denizlispor","Altay","1-0",1,0,"T1",1,1,1,"H"
"669",1996-09-29,1996,"Fenerbahce","Antalyaspor","4-0",4,0,"T1",1,4,4,"H"
"670",1996-09-29,1996,"Genclerbirligi","Galatasaray","0-2",0,2,"T1",1,2,-2,"A"
"671",1996-09-29,1996,"Istanbulspor","Vanspor","2-1",2,1,"T1",1,3,1,"H"
"672",1996-09-29,1996,"Kocaelispor","Ankaragucu","2-1",2,1,"T1",1,3,1,"H"
"673",1996-09-29,1996,"Samsunspor","Gaziantepspor","2-1",2,1,"T1",1,3,1,"H"
"674",1996-09-29,1996,"Sariyer","Zeytinburnu","1-0",1,0,"T1",1,1,1,"H"
"675",1996-09-29,1996,"Trabzonspor","Bursaspor","3-0",3,0,"T1",1,3,3,"H"
"676",1996-10-06,1996,"Altay","Samsunspor","3-1",3,1,"T1",1,4,2,"H"
"677",1996-10-06,1996,"Ankaragucu","Fenerbahce","0-2",0,2,"T1",1,2,-2,"A"
"678",1996-10-06,1996,"Antalyaspor","Sariyer","1-1",1,1,"T1",1,2,0,"D"
"679",1996-10-06,1996,"Besiktas","Genclerbirligi","2-0",2,0,"T1",1,2,2,"H"
"680",1996-10-06,1996,"Bursaspor","Kocaelispor","1-2",1,2,"T1",1,3,-1,"A"
"681",1996-10-06,1996,"Galatasaray","Denizlispor","2-0",2,0,"T1",1,2,2,"H"
"682",1996-10-06,1996,"Gaziantepspor","Istanbulspor","1-0",1,0,"T1",1,1,1,"H"
"683",1996-10-06,1996,"Vanspor","Trabzonspor","1-2",1,2,"T1",1,3,-1,"A"
"684",1996-10-06,1996,"Zeytinburnu","Dardanelspor","0-2",0,2,"T1",1,2,-2,"A"
"685",1996-10-13,1996,"Dardanelspor","Antalyaspor","3-2",3,2,"T1",1,5,1,"H"
"686",1996-10-13,1996,"Denizlispor","Besiktas","0-4",0,4,"T1",1,4,-4,"A"
"687",1996-10-13,1996,"Fenerbahce","Bursaspor","1-0",1,0,"T1",1,1,1,"H"
"688",1996-10-13,1996,"Gaziantepspor","Altay","2-0",2,0,"T1",1,2,2,"H"
"689",1996-10-13,1996,"Genclerbirligi","Zeytinburnu","3-2",3,2,"T1",1,5,1,"H"
"690",1996-10-13,1996,"Istanbulspor","Trabzonspor","2-2",2,2,"T1",1,4,0,"D"
"691",1996-10-13,1996,"Kocaelispor","Vanspor","4-2",4,2,"T1",1,6,2,"H"
"692",1996-10-13,1996,"Samsunspor","Galatasaray","0-2",0,2,"T1",1,2,-2,"A"
"693",1996-10-13,1996,"Sariyer","Ankaragucu","2-1",2,1,"T1",1,3,1,"H"
"694",1996-10-20,1996,"Altay","Istanbulspor","0-2",0,2,"T1",1,2,-2,"A"
"695",1996-10-20,1996,"Ankaragucu","Dardanelspor","2-1",2,1,"T1",1,3,1,"H"
"696",1996-10-20,1996,"Antalyaspor","Genclerbirligi","1-1",1,1,"T1",1,2,0,"D"
"697",1996-10-20,1996,"Besiktas","Samsunspor","1-0",1,0,"T1",1,1,1,"H"
"698",1996-10-20,1996,"Bursaspor","Sariyer","1-0",1,0,"T1",1,1,1,"H"
"699",1996-10-20,1996,"Galatasaray","Gaziantepspor","6-1",6,1,"T1",1,7,5,"H"
"700",1996-10-20,1996,"Trabzonspor","Kocaelispor","2-1",2,1,"T1",1,3,1,"H"
"701",1996-10-20,1996,"Vanspor","Fenerbahce","2-2",2,2,"T1",1,4,0,"D"
"702",1996-10-20,1996,"Zeytinburnu","Denizlispor","1-2",1,2,"T1",1,3,-1,"A"
"703",1996-10-27,1996,"Altay","Galatasaray","1-8",1,8,"T1",1,9,-7,"A"
"704",1996-10-27,1996,"Dardanelspor","Bursaspor","0-0",0,0,"T1",1,0,0,"D"
"705",1996-10-27,1996,"Denizlispor","Antalyaspor","1-5",1,5,"T1",1,6,-4,"A"
"706",1996-10-27,1996,"Fenerbahce","Trabzonspor","1-0",1,0,"T1",1,1,1,"H"
"707",1996-10-27,1996,"Gaziantepspor","Besiktas","0-0",0,0,"T1",1,0,0,"D"
"708",1996-10-27,1996,"Genclerbirligi","Ankaragucu","0-1",0,1,"T1",1,1,-1,"A"
"709",1996-10-27,1996,"Istanbulspor","Kocaelispor","0-1",0,1,"T1",1,1,-1,"A"
"710",1996-10-27,1996,"Samsunspor","Zeytinburnu","2-0",2,0,"T1",1,2,2,"H"
"711",1996-10-27,1996,"Sariyer","Vanspor","2-0",2,0,"T1",1,2,2,"H"
"712",1996-11-03,1996,"Ankaragucu","Denizlispor","3-2",3,2,"T1",1,5,1,"H"
"713",1996-11-03,1996,"Antalyaspor","Samsunspor","1-1",1,1,"T1",1,2,0,"D"
"714",1996-11-03,1996,"Besiktas","Altay","3-0",3,0,"T1",1,3,3,"H"
"715",1996-11-03,1996,"Bursaspor","Genclerbirligi","2-0",2,0,"T1",1,2,2,"H"
"716",1996-11-03,1996,"Galatasaray","Istanbulspor","6-1",6,1,"T1",1,7,5,"H"
"717",1996-11-03,1996,"Kocaelispor","Fenerbahce","0-1",0,1,"T1",1,1,-1,"A"
"718",1996-11-03,1996,"Trabzonspor","Sariyer","3-2",3,2,"T1",1,5,1,"H"
"719",1996-11-03,1996,"Vanspor","Dardanelspor","1-0",1,0,"T1",1,1,1,"H"
"720",1996-11-03,1996,"Zeytinburnu","Gaziantepspor","0-3",0,3,"T1",1,3,-3,"A"
"721",1996-11-17,1996,"Altay","Zeytinburnu","0-0",0,0,"T1",1,0,0,"D"
"722",1996-11-17,1996,"Dardanelspor","Trabzonspor","0-2",0,2,"T1",1,2,-2,"A"
"723",1996-11-17,1996,"Denizlispor","Bursaspor","2-3",2,3,"T1",1,5,-1,"A"
"724",1996-11-17,1996,"Galatasaray","Besiktas","2-2",2,2,"T1",1,4,0,"D"
"725",1996-11-17,1996,"Gaziantepspor","Antalyaspor","1-0",1,0,"T1",1,1,1,"H"
"726",1996-11-17,1996,"Genclerbirligi","Vanspor","1-0",1,0,"T1",1,1,1,"H"
"727",1996-11-17,1996,"Istanbulspor","Fenerbahce","1-1",1,1,"T1",1,2,0,"D"
"728",1996-11-17,1996,"Samsunspor","Ankaragucu","2-4",2,4,"T1",1,6,-2,"A"
"729",1996-11-17,1996,"Sariyer","Kocaelispor","2-1",2,1,"T1",1,3,1,"H"
"730",1996-11-24,1996,"Ankaragucu","Gaziantepspor","0-0",0,0,"T1",1,0,0,"D"
"731",1996-11-24,1996,"Antalyaspor","Altay","1-1",1,1,"T1",1,2,0,"D"
"732",1996-11-24,1996,"Besiktas","Istanbulspor","3-0",3,0,"T1",1,3,3,"H"
"733",1996-11-24,1996,"Bursaspor","Samsunspor","6-1",6,1,"T1",1,7,5,"H"
"734",1996-11-24,1996,"Fenerbahce","Sariyer","2-0",2,0,"T1",1,2,2,"H"
"735",1996-11-24,1996,"Kocaelispor","Dardanelspor","2-0",2,0,"T1",1,2,2,"H"
"736",1996-11-24,1996,"Trabzonspor","Genclerbirligi","1-0",1,0,"T1",1,1,1,"H"
"737",1996-11-24,1996,"Vanspor","Denizlispor","0-2",0,2,"T1",1,2,-2,"A"
"738",1996-11-24,1996,"Zeytinburnu","Galatasaray","2-5",2,5,"T1",1,7,-3,"A"
"739",1996-12-01,1996,"Altay","Ankaragucu","1-1",1,1,"T1",1,2,0,"D"
"740",1996-12-01,1996,"Dardanelspor","Fenerbahce","1-1",1,1,"T1",1,2,0,"D"
"741",1996-12-01,1996,"Denizlispor","Trabzonspor","2-3",2,3,"T1",1,5,-1,"A"
"742",1996-12-01,1996,"Galatasaray","Antalyaspor","3-1",3,1,"T1",1,4,2,"H"
"743",1996-12-01,1996,"Gaziantepspor","Bursaspor","2-1",2,1,"T1",1,3,1,"H"
"744",1996-12-01,1996,"Genclerbirligi","Kocaelispor","1-0",1,0,"T1",1,1,1,"H"
"745",1996-12-01,1996,"Samsunspor","Vanspor","0-0",0,0,"T1",1,0,0,"D"
"746",1996-12-01,1996,"Sariyer","Istanbulspor","0-1",0,1,"T1",1,1,-1,"A"
"747",1996-12-01,1996,"Zeytinburnu","Besiktas","0-3",0,3,"T1",1,3,-3,"A"
"748",1996-12-08,1996,"Ankaragucu","Galatasaray","0-1",0,1,"T1",1,1,-1,"A"
"749",1996-12-08,1996,"Antalyaspor","Besiktas","3-2",3,2,"T1",1,5,1,"H"
"750",1996-12-08,1996,"Bursaspor","Altay","3-0",3,0,"T1",1,3,3,"H"
"751",1996-12-08,1996,"Fenerbahce","Genclerbirligi","2-0",2,0,"T1",1,2,2,"H"
"752",1996-12-08,1996,"Istanbulspor","Zeytinburnu","5-1",5,1,"T1",1,6,4,"H"
"753",1996-12-08,1996,"Kocaelispor","Denizlispor","1-0",1,0,"T1",1,1,1,"H"
"754",1996-12-08,1996,"Sariyer","Dardanelspor","8-0",8,0,"T1",1,8,8,"H"
"755",1996-12-08,1996,"Trabzonspor","Samsunspor","1-0",1,0,"T1",1,1,1,"H"
"756",1996-12-08,1996,"Vanspor","Gaziantepspor","0-1",0,1,"T1",1,1,-1,"A"
"757",1996-12-22,1996,"Altay","Vanspor","2-1",2,1,"T1",1,3,1,"H"
"758",1996-12-22,1996,"Besiktas","Ankaragucu","4-0",4,0,"T1",1,4,4,"H"
"759",1996-12-22,1996,"Dardanelspor","Istanbulspor","1-3",1,3,"T1",1,4,-2,"A"
"760",1996-12-22,1996,"Denizlispor","Fenerbahce","0-1",0,1,"T1",1,1,-1,"A"
"761",1996-12-22,1996,"Galatasaray","Bursaspor","4-1",4,1,"T1",1,5,3,"H"
"762",1996-12-22,1996,"Gaziantepspor","Trabzonspor","1-0",1,0,"T1",1,1,1,"H"
"763",1996-12-22,1996,"Genclerbirligi","Sariyer","2-1",2,1,"T1",1,3,1,"H"
"764",1996-12-22,1996,"Samsunspor","Kocaelispor","3-0",3,0,"T1",1,3,3,"H"
"765",1996-12-22,1996,"Zeytinburnu","Antalyaspor","2-1",2,1,"T1",1,3,1,"H"
"766",1997-01-19,1996,"Altay","Trabzonspor","2-3",2,3,"T1",1,5,-1,"A"
"767",1997-01-19,1996,"Antalyaspor","Istanbulspor","2-1",2,1,"T1",1,3,1,"H"
"768",1997-01-19,1996,"Besiktas","Bursaspor","2-2",2,2,"T1",1,4,0,"D"
"769",1997-01-19,1996,"Dardanelspor","Genclerbirligi","1-3",1,3,"T1",1,4,-2,"A"
"770",1997-01-19,1996,"Denizlispor","Sariyer","0-1",0,1,"T1",1,1,-1,"A"
"771",1997-01-19,1996,"Galatasaray","Vanspor","1-1",1,1,"T1",1,2,0,"D"
"772",1997-01-19,1996,"Gaziantepspor","Kocaelispor","1-1",1,1,"T1",1,2,0,"D"
"773",1997-01-19,1996,"Samsunspor","Fenerbahce","1-1",1,1,"T1",1,2,0,"D"
"774",1997-01-19,1996,"Zeytinburnu","Ankaragucu","1-1",1,1,"T1",1,2,0,"D"
"775",1997-01-26,1996,"Antalyaspor","Ankaragucu","1-0",1,0,"T1",1,1,1,"H"
"776",1997-01-26,1996,"Bursaspor","Zeytinburnu","1-1",1,1,"T1",1,2,0,"D"
"777",1997-01-26,1996,"Dardanelspor","Denizlispor","3-0",3,0,"T1",1,3,3,"H"
"778",1997-01-26,1996,"Fenerbahce","Gaziantepspor","1-0",1,0,"T1",1,1,1,"H"
"779",1997-01-26,1996,"Istanbulspor","Genclerbirligi","0-3",0,3,"T1",1,3,-3,"A"
"780",1997-01-26,1996,"Kocaelispor","Altay","0-0",0,0,"T1",1,0,0,"D"
"781",1997-01-26,1996,"Sariyer","Samsunspor","4-1",4,1,"T1",1,5,3,"H"
"782",1997-01-26,1996,"Trabzonspor","Galatasaray","0-0",0,0,"T1",1,0,0,"D"
"783",1997-01-26,1996,"Vanspor","Besiktas","0-0",0,0,"T1",1,0,0,"D"
"784",1997-02-02,1996,"Altay","Fenerbahce","0-0",0,0,"T1",1,0,0,"D"
"785",1997-02-02,1996,"Ankaragucu","Istanbulspor","0-0",0,0,"T1",1,0,0,"D"
"786",1997-02-02,1996,"Antalyaspor","Bursaspor","0-1",0,1,"T1",1,1,-1,"A"
"787",1997-02-02,1996,"Besiktas","Trabzonspor","3-0",3,0,"T1",1,3,3,"H"
"788",1997-02-02,1996,"Dardanelspor","Samsunspor","0-0",0,0,"T1",1,0,0,"D"
"789",1997-02-02,1996,"Denizlispor","Genclerbirligi","3-3",3,3,"T1",1,6,0,"D"
"790",1997-02-02,1996,"Galatasaray","Kocaelispor","0-0",0,0,"T1",1,0,0,"D"
"791",1997-02-02,1996,"Gaziantepspor","Sariyer","2-1",2,1,"T1",1,3,1,"H"
"792",1997-02-02,1996,"Zeytinburnu","Vanspor","2-1",2,1,"T1",1,3,1,"H"
"793",1997-02-09,1996,"Antalyaspor","Vanspor","1-0",1,0,"T1",1,1,1,"H"
"794",1997-02-09,1996,"Bursaspor","Ankaragucu","2-1",2,1,"T1",1,3,1,"H"
"795",1997-02-09,1996,"Dardanelspor","Gaziantepspor","1-1",1,1,"T1",1,2,0,"D"
"796",1997-02-09,1996,"Fenerbahce","Galatasaray","3-2",3,2,"T1",1,5,1,"H"
"797",1997-02-09,1996,"Genclerbirligi","Samsunspor","3-1",3,1,"T1",1,4,2,"H"
"798",1997-02-09,1996,"Istanbulspor","Denizlispor","5-0",5,0,"T1",1,5,5,"H"
"799",1997-02-09,1996,"Kocaelispor","Besiktas","0-0",0,0,"T1",1,0,0,"D"
"800",1997-02-09,1996,"Sariyer","Altay","0-0",0,0,"T1",1,0,0,"D"
"801",1997-02-09,1996,"Trabzonspor","Zeytinburnu","6-1",6,1,"T1",1,7,5,"H"
"802",1997-02-16,1996,"Ankaragucu","Vanspor","2-2",2,2,"T1",1,4,0,"D"
"803",1997-02-16,1996,"Antalyaspor","Trabzonspor","0-3",0,3,"T1",1,3,-3,"A"
"804",1997-02-16,1996,"Besiktas","Fenerbahce","1-0",1,0,"T1",1,1,1,"H"
"805",1997-02-16,1996,"Bursaspor","Istanbulspor","0-2",0,2,"T1",1,2,-2,"A"
"806",1997-02-16,1996,"Dardanelspor","Altay","3-1",3,1,"T1",1,4,2,"H"
"807",1997-02-16,1996,"Galatasaray","Sariyer","4-0",4,0,"T1",1,4,4,"H"
"808",1997-02-16,1996,"Gaziantepspor","Genclerbirligi","2-0",2,0,"T1",1,2,2,"H"
"809",1997-02-16,1996,"Samsunspor","Denizlispor","3-0",3,0,"T1",1,3,3,"H"
"810",1997-02-16,1996,"Zeytinburnu","Kocaelispor","0-1",0,1,"T1",1,1,-1,"A"
"811",1997-02-23,1996,"Antalyaspor","Kocaelispor","3-2",3,2,"T1",1,5,1,"H"
"812",1997-02-23,1996,"Dardanelspor","Galatasaray","0-3",0,3,"T1",1,3,-3,"A"
"813",1997-02-23,1996,"Denizlispor","Gaziantepspor","3-1",3,1,"T1",1,4,2,"H"
"814",1997-02-23,1996,"Fenerbahce","Zeytinburnu","4-1",4,1,"T1",1,5,3,"H"
"815",1997-02-23,1996,"Genclerbirligi","Altay","1-2",1,2,"T1",1,3,-1,"A"
"816",1997-02-23,1996,"Istanbulspor","Samsunspor","1-1",1,1,"T1",1,2,0,"D"
"817",1997-02-23,1996,"Sariyer","Besiktas","1-6",1,6,"T1",1,7,-5,"A"
"818",1997-02-23,1996,"Trabzonspor","Ankaragucu","1-1",1,1,"T1",1,2,0,"D"
"819",1997-02-23,1996,"Vanspor","Bursaspor","1-0",1,0,"T1",1,1,1,"H"
"820",1997-03-02,1996,"Altay","Denizlispor","2-1",2,1,"T1",1,3,1,"H"
"821",1997-03-02,1996,"Ankaragucu","Kocaelispor","0-3",0,3,"T1",1,3,-3,"A"
"822",1997-03-02,1996,"Antalyaspor","Fenerbahce","0-5",0,5,"T1",1,5,-5,"A"
"823",1997-03-02,1996,"Besiktas","Dardanelspor","4-0",4,0,"T1",1,4,4,"H"
"824",1997-03-02,1996,"Bursaspor","Trabzonspor","3-2",3,2,"T1",1,5,1,"H"
"825",1997-03-02,1996,"Galatasaray","Genclerbirligi","1-1",1,1,"T1",1,2,0,"D"
"826",1997-03-02,1996,"Gaziantepspor","Samsunspor","0-2",0,2,"T1",1,2,-2,"A"
"827",1997-03-02,1996,"Vanspor","Istanbulspor","0-1",0,1,"T1",1,1,-1,"A"
"828",1997-03-02,1996,"Zeytinburnu","Sariyer","1-1",1,1,"T1",1,2,0,"D"
"829",1997-03-09,1996,"Dardanelspor","Zeytinburnu","4-0",4,0,"T1",1,4,4,"H"
"830",1997-03-09,1996,"Denizlispor","Galatasaray","2-3",2,3,"T1",1,5,-1,"A"
"831",1997-03-09,1996,"Fenerbahce","Ankaragucu","1-1",1,1,"T1",1,2,0,"D"
"832",1997-03-09,1996,"Genclerbirligi","Besiktas","0-3",0,3,"T1",1,3,-3,"A"
"833",1997-03-09,1996,"Istanbulspor","Gaziantepspor","3-0",3,0,"T1",1,3,3,"H"
"834",1997-03-09,1996,"Kocaelispor","Bursaspor","0-0",0,0,"T1",1,0,0,"D"
"835",1997-03-09,1996,"Samsunspor","Altay","0-0",0,0,"T1",1,0,0,"D"
"836",1997-03-09,1996,"Sariyer","Antalyaspor","1-1",1,1,"T1",1,2,0,"D"
"837",1997-03-09,1996,"Trabzonspor","Vanspor","4-0",4,0,"T1",1,4,4,"H"
"838",1997-03-16,1996,"Altay","Gaziantepspor","2-2",2,2,"T1",1,4,0,"D"
"839",1997-03-16,1996,"Ankaragucu","Sariyer","1-0",1,0,"T1",1,1,1,"H"
"840",1997-03-16,1996,"Antalyaspor","Dardanelspor","1-0",1,0,"T1",1,1,1,"H"
"841",1997-03-16,1996,"Besiktas","Denizlispor","2-1",2,1,"T1",1,3,1,"H"
"842",1997-03-16,1996,"Bursaspor","Fenerbahce","0-1",0,1,"T1",1,1,-1,"A"
"843",1997-03-16,1996,"Galatasaray","Samsunspor","3-1",3,1,"T1",1,4,2,"H"
"844",1997-03-16,1996,"Trabzonspor","Istanbulspor","1-2",1,2,"T1",1,3,-1,"A"
"845",1997-03-16,1996,"Vanspor","Kocaelispor","0-0",0,0,"T1",1,0,0,"D"
"846",1997-03-16,1996,"Zeytinburnu","Genclerbirligi","0-1",0,1,"T1",1,1,-1,"A"
"847",1997-03-23,1996,"Dardanelspor","Ankaragucu","2-1",2,1,"T1",1,3,1,"H"
"848",1997-03-23,1996,"Denizlispor","Zeytinburnu","3-2",3,2,"T1",1,5,1,"H"
"849",1997-03-23,1996,"Fenerbahce","Vanspor","5-0",5,0,"T1",1,5,5,"H"
"850",1997-03-23,1996,"Gaziantepspor","Galatasaray","0-3",0,3,"T1",1,3,-3,"A"
"851",1997-03-23,1996,"Genclerbirligi","Antalyaspor","0-1",0,1,"T1",1,1,-1,"A"
"852",1997-03-23,1996,"Istanbulspor","Altay","5-0",5,0,"T1",1,5,5,"H"
"853",1997-03-23,1996,"Kocaelispor","Trabzonspor","0-2",0,2,"T1",1,2,-2,"A"
"854",1997-03-23,1996,"Samsunspor","Besiktas","4-1",4,1,"T1",1,5,3,"H"
"855",1997-03-23,1996,"Sariyer","Bursaspor","1-2",1,2,"T1",1,3,-1,"A"
"856",1997-04-06,1996,"Ankaragucu","Genclerbirligi","1-0",1,0,"T1",1,1,1,"H"
"857",1997-04-06,1996,"Antalyaspor","Denizlispor","3-0",3,0,"T1",1,3,3,"H"
"858",1997-04-06,1996,"Besiktas","Gaziantepspor","5-1",5,1,"T1",1,6,4,"H"
"859",1997-04-06,1996,"Bursaspor","Dardanelspor","3-1",3,1,"T1",1,4,2,"H"
"860",1997-04-06,1996,"Galatasaray","Altay","2-1",2,1,"T1",1,3,1,"H"
"861",1997-04-06,1996,"Kocaelispor","Istanbulspor","1-1",1,1,"T1",1,2,0,"D"
"862",1997-04-06,1996,"Trabzonspor","Fenerbahce","4-3",4,3,"T1",1,7,1,"H"
"863",1997-04-06,1996,"Vanspor","Sariyer","1-0",1,0,"T1",1,1,1,"H"
"864",1997-04-06,1996,"Zeytinburnu","Samsunspor","1-3",1,3,"T1",1,4,-2,"A"
"865",1997-04-13,1996,"Altay","Besiktas","0-4",0,4,"T1",1,4,-4,"A"
"866",1997-04-13,1996,"Dardanelspor","Vanspor","2-1",2,1,"T1",1,3,1,"H"
"867",1997-04-13,1996,"Denizlispor","Ankaragucu","2-6",2,6,"T1",1,8,-4,"A"
"868",1997-04-13,1996,"Fenerbahce","Kocaelispor","0-0",0,0,"T1",1,0,0,"D"
"869",1997-04-13,1996,"Gaziantepspor","Zeytinburnu","3-1",3,1,"T1",1,4,2,"H"
"870",1997-04-13,1996,"Genclerbirligi","Bursaspor","0-4",0,4,"T1",1,4,-4,"A"
"871",1997-04-13,1996,"Istanbulspor","Galatasaray","2-3",2,3,"T1",1,5,-1,"A"
"872",1997-04-13,1996,"Samsunspor","Antalyaspor","2-1",2,1,"T1",1,3,1,"H"
"873",1997-04-13,1996,"Sariyer","Trabzonspor","1-1",1,1,"T1",1,2,0,"D"
"874",1997-04-20,1996,"Ankaragucu","Samsunspor","0-0",0,0,"T1",1,0,0,"D"
"875",1997-04-20,1996,"Antalyaspor","Gaziantepspor","2-1",2,1,"T1",1,3,1,"H"
"876",1997-04-20,1996,"Besiktas","Galatasaray","1-1",1,1,"T1",1,2,0,"D"
"877",1997-04-20,1996,"Bursaspor","Denizlispor","2-2",2,2,"T1",1,4,0,"D"
"878",1997-04-20,1996,"Fenerbahce","Istanbulspor","3-0",3,0,"T1",1,3,3,"H"
"879",1997-04-20,1996,"Kocaelispor","Sariyer","1-0",1,0,"T1",1,1,1,"H"
"880",1997-04-20,1996,"Trabzonspor","Dardanelspor","4-0",4,0,"T1",1,4,4,"H"
"881",1997-04-20,1996,"Vanspor","Genclerbirligi","3-0",3,0,"T1",1,3,3,"H"
"882",1997-04-20,1996,"Zeytinburnu","Altay","0-1",0,1,"T1",1,1,-1,"A"
"883",1997-05-04,1996,"Altay","Antalyaspor","2-1",2,1,"T1",1,3,1,"H"
"884",1997-05-04,1996,"Dardanelspor","Kocaelispor","3-2",3,2,"T1",1,5,1,"H"
"885",1997-05-04,1996,"Denizlispor","Vanspor","0-1",0,1,"T1",1,1,-1,"A"
"886",1997-05-04,1996,"Galatasaray","Zeytinburnu","4-0",4,0,"T1",1,4,4,"H"
"887",1997-05-04,1996,"Gaziantepspor","Ankaragucu","3-2",3,2,"T1",1,5,1,"H"
"888",1997-05-04,1996,"Genclerbirligi","Trabzonspor","1-1",1,1,"T1",1,2,0,"D"
"889",1997-05-04,1996,"Istanbulspor","Besiktas","4-3",4,3,"T1",1,7,1,"H"
"890",1997-05-04,1996,"Samsunspor","Bursaspor","2-3",2,3,"T1",1,5,-1,"A"
"891",1997-05-04,1996,"Sariyer","Fenerbahce","1-4",1,4,"T1",1,5,-3,"A"
"892",1997-05-11,1996,"Ankaragucu","Altay","1-0",1,0,"T1",1,1,1,"H"
"893",1997-05-11,1996,"Antalyaspor","Galatasaray","0-2",0,2,"T1",1,2,-2,"A"
"894",1997-05-11,1996,"Besiktas","Zeytinburnu","4-1",4,1,"T1",1,5,3,"H"
"895",1997-05-11,1996,"Bursaspor","Gaziantepspor","3-1",3,1,"T1",1,4,2,"H"
"896",1997-05-11,1996,"Fenerbahce","Dardanelspor","4-0",4,0,"T1",1,4,4,"H"
"897",1997-05-11,1996,"Istanbulspor","Sariyer","2-1",2,1,"T1",1,3,1,"H"
"898",1997-05-11,1996,"Kocaelispor","Genclerbirligi","3-1",3,1,"T1",1,4,2,"H"
"899",1997-05-11,1996,"Trabzonspor","Denizlispor","2-1",2,1,"T1",1,3,1,"H"
"900",1997-05-11,1996,"Vanspor","Samsunspor","3-2",3,2,"T1",1,5,1,"H"
"901",1997-05-18,1996,"Altay","Bursaspor","1-1",1,1,"T1",1,2,0,"D"
"902",1997-05-18,1996,"Besiktas","Antalyaspor","4-0",4,0,"T1",1,4,4,"H"
"903",1997-05-18,1996,"Dardanelspor","Sariyer","1-0",1,0,"T1",1,1,1,"H"
"904",1997-05-18,1996,"Denizlispor","Kocaelispor","0-0",0,0,"T1",1,0,0,"D"
"905",1997-05-18,1996,"Galatasaray","Ankaragucu","5-1",5,1,"T1",1,6,4,"H"
"906",1997-05-18,1996,"Gaziantepspor","Vanspor","0-1",0,1,"T1",1,1,-1,"A"
"907",1997-05-18,1996,"Genclerbirligi","Fenerbahce","4-1",4,1,"T1",1,5,3,"H"
"908",1997-05-18,1996,"Samsunspor","Trabzonspor","0-2",0,2,"T1",1,2,-2,"A"
"909",1997-05-18,1996,"Zeytinburnu","Istanbulspor","0-2",0,2,"T1",1,2,-2,"A"
"910",1997-05-25,1996,"Ankaragucu","Besiktas","0-2",0,2,"T1",1,2,-2,"A"
"911",1997-05-25,1996,"Antalyaspor","Zeytinburnu","1-0",1,0,"T1",1,1,1,"H"
"912",1997-05-25,1996,"Bursaspor","Galatasaray","2-3",2,3,"T1",1,5,-1,"A"
"913",1997-05-25,1996,"Fenerbahce","Denizlispor","7-0",7,0,"T1",1,7,7,"H"
"914",1997-05-25,1996,"Istanbulspor","Dardanelspor","4-2",4,2,"T1",1,6,2,"H"
"915",1997-05-25,1996,"Kocaelispor","Samsunspor","2-5",2,5,"T1",1,7,-3,"A"
"916",1997-05-25,1996,"Sariyer","Genclerbirligi","2-1",2,1,"T1",1,3,1,"H"
"917",1997-05-25,1996,"Trabzonspor","Gaziantepspor","5-0",5,0,"T1",1,5,5,"H"
"918",1997-05-25,1996,"Vanspor","Altay","3-0",3,0,"T1",1,3,3,"H"
"919",1997-08-03,1997,"Ankaragucu","Galatasaray","0-0",0,0,"T1",1,0,0,"D"
"920",1997-08-03,1997,"Besiktas","Sekerspor","2-1",2,1,"T1",1,3,1,"H"
"921",1997-08-03,1997,"Bursaspor","Altay","1-0",1,0,"T1",1,1,1,"H"
"922",1997-08-03,1997,"Dardanelspor","Istanbulspor","1-1",1,1,"T1",1,2,0,"D"
"923",1997-08-03,1997,"Fenerbahce","Gaziantepspor","1-0",1,0,"T1",1,1,1,"H"
"924",1997-08-03,1997,"Genclerbirligi","Antalyaspor","0-0",0,0,"T1",1,0,0,"D"
"925",1997-08-03,1997,"Karabukspor","Kayseri","3-0",3,0,"T1",1,3,3,"H"
"926",1997-08-03,1997,"Kocaelispor","Trabzonspor","1-3",1,3,"T1",1,4,-2,"A"
"927",1997-08-03,1997,"Samsunspor","Vanspor","2-0",2,0,"T1",1,2,2,"H"
"928",1997-08-10,1997,"Altay","Kocaelispor","1-0",1,0,"T1",1,1,1,"H"
"929",1997-08-10,1997,"Galatasaray","Bursaspor","4-0",4,0,"T1",1,4,4,"H"
"930",1997-08-10,1997,"Gaziantepspor","Antalyaspor","1-3",1,3,"T1",1,4,-2,"A"
"931",1997-08-10,1997,"Genclerbirligi","Besiktas","2-2",2,2,"T1",1,4,0,"D"
"932",1997-08-10,1997,"Istanbulspor","Karabukspor","2-1",2,1,"T1",1,3,1,"H"
"933",1997-08-10,1997,"Kayseri","Ankaragucu","1-1",1,1,"T1",1,2,0,"D"
"934",1997-08-10,1997,"Samsunspor","Fenerbahce","0-2",0,2,"T1",1,2,-2,"A"
"935",1997-08-10,1997,"Sekerspor","Dardanelspor","1-4",1,4,"T1",1,5,-3,"A"
"936",1997-08-10,1997,"Trabzonspor","Vanspor","2-0",2,0,"T1",1,2,2,"H"
"937",1997-08-24,1997,"Altay","Vanspor","3-2",3,2,"T1",1,5,1,"H"
"938",1997-08-24,1997,"Ankaragucu","Istanbulspor","0-5",0,5,"T1",1,5,-5,"A"
"939",1997-08-24,1997,"Besiktas","Gaziantepspor","2-1",2,1,"T1",1,3,1,"H"
"940",1997-08-24,1997,"Bursaspor","Kayseri","1-0",1,0,"T1",1,1,1,"H"
"941",1997-08-24,1997,"Dardanelspor","Karabukspor","1-1",1,1,"T1",1,2,0,"D"
"942",1997-08-24,1997,"Fenerbahce","Trabzonspor","1-3",1,3,"T1",1,4,-2,"A"
"943",1997-08-24,1997,"Kocaelispor","Galatasaray","1-1",1,1,"T1",1,2,0,"D"
"944",1997-08-24,1997,"Samsunspor","Antalyaspor","2-2",2,2,"T1",1,4,0,"D"
"945",1997-08-24,1997,"Sekerspor","Genclerbirligi","0-0",0,0,"T1",1,0,0,"D"
"946",1997-08-31,1997,"Altay","Fenerbahce","0-2",0,2,"T1",1,2,-2,"A"
"947",1997-08-31,1997,"Galatasaray","Vanspor","6-2",6,2,"T1",1,8,4,"H"
"948",1997-08-31,1997,"Gaziantepspor","Sekerspor","1-1",1,1,"T1",1,2,0,"D"
"949",1997-08-31,1997,"Genclerbirligi","Dardanelspor","3-0",3,0,"T1",1,3,3,"H"
"950",1997-08-31,1997,"Istanbulspor","Bursaspor","1-1",1,1,"T1",1,2,0,"D"
"951",1997-08-31,1997,"Karabukspor","Ankaragucu","1-0",1,0,"T1",1,1,1,"H"
"952",1997-08-31,1997,"Kayseri","Kocaelispor","2-1",2,1,"T1",1,3,1,"H"
"953",1997-08-31,1997,"Samsunspor","Besiktas","0-0",0,0,"T1",1,0,0,"D"
"954",1997-08-31,1997,"Trabzonspor","Antalyaspor","2-2",2,2,"T1",1,4,0,"D"
"955",1997-09-07,1997,"Altay","Antalyaspor","0-3",0,3,"T1",1,3,-3,"A"
"956",1997-09-07,1997,"Besiktas","Trabzonspor","3-0",3,0,"T1",1,3,3,"H"
"957",1997-09-07,1997,"Bursaspor","Karabukspor","4-0",4,0,"T1",1,4,4,"H"
"958",1997-09-07,1997,"Dardanelspor","Ankaragucu","1-1",1,1,"T1",1,2,0,"D"
"959",1997-09-07,1997,"Fenerbahce","Galatasaray","3-1",3,1,"T1",1,4,2,"H"
"960",1997-09-07,1997,"Genclerbirligi","Gaziantepspor","0-1",0,1,"T1",1,1,-1,"A"
"961",1997-09-07,1997,"Kayseri","Vanspor","1-1",1,1,"T1",1,2,0,"D"
"962",1997-09-07,1997,"Kocaelispor","Istanbulspor","3-0",3,0,"T1",1,3,3,"H"
"963",1997-09-07,1997,"Sekerspor","Samsunspor","2-1",2,1,"T1",1,3,1,"H"
"964",1997-09-14,1997,"Altay","Besiktas","1-2",1,2,"T1",1,3,-1,"A"
"965",1997-09-14,1997,"Ankaragucu","Bursaspor","1-2",1,2,"T1",1,3,-1,"A"
"966",1997-09-14,1997,"Galatasaray","Antalyaspor","2-1",2,1,"T1",1,3,1,"H"
"967",1997-09-14,1997,"Gaziantepspor","Dardanelspor","2-2",2,2,"T1",1,4,0,"D"
"968",1997-09-14,1997,"Istanbulspor","Vanspor","6-3",6,3,"T1",1,9,3,"H"
"969",1997-09-14,1997,"Karabukspor","Kocaelispor","1-0",1,0,"T1",1,1,1,"H"
"970",1997-09-14,1997,"Kayseri","Fenerbahce","0-3",0,3,"T1",1,3,-3,"A"
"971",1997-09-14,1997,"Samsunspor","Genclerbirligi","3-1",3,1,"T1",1,4,2,"H"
"972",1997-09-14,1997,"Trabzonspor","Sekerspor","6-3",6,3,"T1",1,9,3,"H"
"973",1997-09-21,1997,"Fenerbahce","Istanbulspor","3-0",3,0,"T1",1,3,3,"H"
"974",1997-09-21,1997,"Genclerbirligi","Trabzonspor","0-1",0,1,"T1",1,1,-1,"A"
"975",1997-09-21,1997,"Sekerspor","Altay","0-0",0,0,"T1",1,0,0,"D"
"976",1997-09-22,1997,"Besiktas","Galatasaray","2-1",2,1,"T1",1,3,1,"H"
"977",1997-09-22,1997,"Dardanelspor","Bursaspor","0-0",0,0,"T1",1,0,0,"D"
"978",1997-09-22,1997,"Gaziantepspor","Samsunspor","2-0",2,0,"T1",1,2,2,"H"
"979",1997-09-22,1997,"Kayseri","Antalyaspor","3-1",3,1,"T1",1,4,2,"H"
"980",1997-09-22,1997,"Kocaelispor","Ankaragucu","2-0",2,0,"T1",1,2,2,"H"
"981",1997-09-22,1997,"Vanspor","Karabukspor","0-1",0,1,"T1",1,1,-1,"A"
"982",1997-09-28,1997,"Altay","Genclerbirligi","0-0",0,0,"T1",1,0,0,"D"
"983",1997-09-28,1997,"Ankaragucu","Vanspor","2-0",2,0,"T1",1,2,2,"H"
"984",1997-09-28,1997,"Bursaspor","Kocaelispor","1-2",1,2,"T1",1,3,-1,"A"
"985",1997-09-28,1997,"Galatasaray","Sekerspor","4-1",4,1,"T1",1,5,3,"H"
"986",1997-09-28,1997,"Istanbulspor","Antalyaspor","5-2",5,2,"T1",1,7,3,"H"
"987",1997-09-28,1997,"Karabukspor","Fenerbahce","1-2",1,2,"T1",1,3,-1,"A"
"988",1997-09-28,1997,"Kayseri","Besiktas","1-0",1,0,"T1",1,1,1,"H"
"989",1997-09-28,1997,"Samsunspor","Dardanelspor","3-0",3,0,"T1",1,3,3,"H"
"990",1997-09-28,1997,"Trabzonspor","Gaziantepspor","1-0",1,0,"T1",1,1,1,"H"
"991",1997-10-05,1997,"Besiktas","Istanbulspor","0-0",0,0,"T1",1,0,0,"D"
"992",1997-10-05,1997,"Dardanelspor","Kocaelispor","2-0",2,0,"T1",1,2,2,"H"
"993",1997-10-05,1997,"Fenerbahce","Ankaragucu","0-0",0,0,"T1",1,0,0,"D"
"994",1997-10-05,1997,"Gaziantepspor","Altay","3-0",3,0,"T1",1,3,3,"H"
"995",1997-10-05,1997,"Genclerbirligi","Galatasaray","3-2",3,2,"T1",1,5,1,"H"
"996",1997-10-05,1997,"Karabukspor","Antalyaspor","3-0",3,0,"T1",1,3,3,"H"
"997",1997-10-05,1997,"Samsunspor","Trabzonspor","2-1",2,1,"T1",1,3,1,"H"
"998",1997-10-05,1997,"Sekerspor","Kayseri","0-1",0,1,"T1",1,1,-1,"A"
"999",1997-10-05,1997,"Vanspor","Bursaspor","1-1",1,1,"T1",1,2,0,"D"
"1000",1997-10-19,1997,"Altay","Samsunspor","2-5",2,5,"T1",1,7,-3,"A"
"1001",1997-10-19,1997,"Ankaragucu","Antalyaspor","2-0",2,0,"T1",1,2,2,"H"
"1002",1997-10-19,1997,"Bursaspor","Fenerbahce","1-1",1,1,"T1",1,2,0,"D"
"1003",1997-10-19,1997,"Galatasaray","Gaziantepspor","1-0",1,0,"T1",1,1,1,"H"
"1004",1997-10-19,1997,"Istanbulspor","Sekerspor","4-1",4,1,"T1",1,5,3,"H"
"1005",1997-10-19,1997,"Karabukspor","Besiktas","0-5",0,5,"T1",1,5,-5,"A"
"1006",1997-10-19,1997,"Kayseri","Genclerbirligi","2-0",2,0,"T1",1,2,2,"H"
"1007",1997-10-19,1997,"Kocaelispor","Vanspor","4-2",4,2,"T1",1,6,2,"H"
"1008",1997-10-19,1997,"Trabzonspor","Dardanelspor","0-2",0,2,"T1",1,2,-2,"A"
"1009",1997-11-02,1997,"Besiktas","Ankaragucu","1-0",1,0,"T1",1,1,1,"H"
"1010",1997-11-02,1997,"Bursaspor","Antalyaspor","4-1",4,1,"T1",1,5,3,"H"
"1011",1997-11-02,1997,"Dardanelspor","Vanspor","2-0",2,0,"T1",1,2,2,"H"
"1012",1997-11-02,1997,"Fenerbahce","Kocaelispor","2-0",2,0,"T1",1,2,2,"H"
"1013",1997-11-02,1997,"Gaziantepspor","Kayseri","3-2",3,2,"T1",1,5,1,"H"
"1014",1997-11-02,1997,"Genclerbirligi","Istanbulspor","1-0",1,0,"T1",1,1,1,"H"
"1015",1997-11-02,1997,"Samsunspor","Galatasaray","0-2",0,2,"T1",1,2,-2,"A"
"1016",1997-11-02,1997,"Sekerspor","Karabukspor","1-0",1,0,"T1",1,1,1,"H"
"1017",1997-11-02,1997,"Trabzonspor","Altay","3-0",3,0,"T1",1,3,3,"H"
"1018",1997-11-09,1997,"Altay","Dardanelspor","1-0",1,0,"T1",1,1,1,"H"
"1019",1997-11-09,1997,"Ankaragucu","Sekerspor","1-1",1,1,"T1",1,2,0,"D"
"1020",1997-11-09,1997,"Bursaspor","Besiktas","2-1",2,1,"T1",1,3,1,"H"
"1021",1997-11-09,1997,"Galatasaray","Trabzonspor","2-2",2,2,"T1",1,4,0,"D"
"1022",1997-11-09,1997,"Istanbulspor","Gaziantepspor","4-1",4,1,"T1",1,5,3,"H"
"1023",1997-11-09,1997,"Karabukspor","Genclerbirligi","1-0",1,0,"T1",1,1,1,"H"
"1024",1997-11-09,1997,"Kayseri","Samsunspor","0-1",0,1,"T1",1,1,-1,"A"
"1025",1997-11-09,1997,"Kocaelispor","Antalyaspor","2-1",2,1,"T1",1,3,1,"H"
"1026",1997-11-09,1997,"Vanspor","Fenerbahce","0-1",0,1,"T1",1,1,-1,"A"
"1027",1997-11-16,1997,"Altay","Galatasaray","4-5",4,5,"T1",1,9,-1,"A"
"1028",1997-11-16,1997,"Besiktas","Kocaelispor","1-1",1,1,"T1",1,2,0,"D"
"1029",1997-11-16,1997,"Dardanelspor","Fenerbahce","0-1",0,1,"T1",1,1,-1,"A"
"1030",1997-11-16,1997,"Gaziantepspor","Karabukspor","2-2",2,2,"T1",1,4,0,"D"
"1031",1997-11-16,1997,"Genclerbirligi","Ankaragucu","1-2",1,2,"T1",1,3,-1,"A"
"1032",1997-11-16,1997,"Samsunspor","Istanbulspor","0-0",0,0,"T1",1,0,0,"D"
"1033",1997-11-16,1997,"Sekerspor","Bursaspor","3-1",3,1,"T1",1,4,2,"H"
"1034",1997-11-16,1997,"Trabzonspor","Kayseri","2-0",2,0,"T1",1,2,2,"H"
"1035",1997-11-16,1997,"Vanspor","Antalyaspor","0-3",0,3,"T1",1,3,-3,"A"
"1036",1997-11-23,1997,"Ankaragucu","Gaziantepspor","2-0",2,0,"T1",1,2,2,"H"
"1037",1997-11-23,1997,"Bursaspor","Genclerbirligi","2-1",2,1,"T1",1,3,1,"H"
"1038",1997-11-23,1997,"Fenerbahce","Antalyaspor","2-1",2,1,"T1",1,3,1,"H"
"1039",1997-11-23,1997,"Galatasaray","Dardanelspor","1-0",1,0,"T1",1,1,1,"H"
"1040",1997-11-23,1997,"Istanbulspor","Trabzonspor","0-0",0,0,"T1",1,0,0,"D"
"1041",1997-11-23,1997,"Karabukspor","Samsunspor","2-1",2,1,"T1",1,3,1,"H"
"1042",1997-11-23,1997,"Kayseri","Altay","1-1",1,1,"T1",1,2,0,"D"
"1043",1997-11-23,1997,"Kocaelispor","Sekerspor","3-0",3,0,"T1",1,3,3,"H"
"1044",1997-11-23,1997,"Vanspor","Besiktas","1-7",1,7,"T1",1,8,-6,"A"
"1045",1997-12-07,1997,"Altay","Istanbulspor","1-3",1,3,"T1",1,4,-2,"A"
"1046",1997-12-07,1997,"Antalyaspor","Dardanelspor","0-0",0,0,"T1",1,0,0,"D"
"1047",1997-12-07,1997,"Besiktas","Fenerbahce","2-2",2,2,"T1",1,4,0,"D"
"1048",1997-12-07,1997,"Gaziantepspor","Bursaspor","1-2",1,2,"T1",1,3,-1,"A"
"1049",1997-12-07,1997,"Genclerbirligi","Kocaelispor","0-0",0,0,"T1",1,0,0,"D"
"1050",1997-12-07,1997,"Kayseri","Galatasaray","1-2",1,2,"T1",1,3,-1,"A"
"1051",1997-12-07,1997,"Samsunspor","Ankaragucu","0-2",0,2,"T1",1,2,-2,"A"
"1052",1997-12-07,1997,"Sekerspor","Vanspor","1-1",1,1,"T1",1,2,0,"D"
"1053",1997-12-07,1997,"Trabzonspor","Karabukspor","2-0",2,0,"T1",1,2,2,"H"
"1054",1997-12-14,1997,"Ankaragucu","Trabzonspor","1-3",1,3,"T1",1,4,-2,"A"
"1055",1997-12-14,1997,"Antalyaspor","Besiktas","3-3",3,3,"T1",1,6,0,"D"
"1056",1997-12-14,1997,"Bursaspor","Samsunspor","2-3",2,3,"T1",1,5,-1,"A"
"1057",1997-12-14,1997,"Dardanelspor","Kayseri","3-0",3,0,"T1",1,3,3,"H"
"1058",1997-12-14,1997,"Fenerbahce","Sekerspor","7-0",7,0,"T1",1,7,7,"H"
"1059",1997-12-14,1997,"Istanbulspor","Galatasaray","2-1",2,1,"T1",1,3,1,"H"
"1060",1997-12-14,1997,"Karabukspor","Altay","1-1",1,1,"T1",1,2,0,"D"
"1061",1997-12-14,1997,"Kocaelispor","Gaziantepspor","1-1",1,1,"T1",1,2,0,"D"
"1062",1997-12-14,1997,"Vanspor","Genclerbirligi","0-0",0,0,"T1",1,0,0,"D"
"1063",1997-12-21,1997,"Altay","Ankaragucu","3-0",3,0,"T1",1,3,3,"H"
"1064",1997-12-21,1997,"Besiktas","Dardanelspor","1-2",1,2,"T1",1,3,-1,"A"
"1065",1997-12-21,1997,"Galatasaray","Karabukspor","3-0",3,0,"T1",1,3,3,"H"
"1066",1997-12-21,1997,"Gaziantepspor","Vanspor","0-0",0,0,"T1",1,0,0,"D"
"1067",1997-12-21,1997,"Genclerbirligi","Fenerbahce","3-0",3,0,"T1",1,3,3,"H"
"1068",1997-12-21,1997,"Kayseri","Istanbulspor","0-0",0,0,"T1",1,0,0,"D"
"1069",1997-12-21,1997,"Samsunspor","Kocaelispor","1-1",1,1,"T1",1,2,0,"D"
"1070",1997-12-21,1997,"Sekerspor","Antalyaspor","2-1",2,1,"T1",1,3,1,"H"
"1071",1997-12-21,1997,"Trabzonspor","Bursaspor","1-0",1,0,"T1",1,1,1,"H"
"1072",1998-01-18,1997,"Altay","Bursaspor","2-1",2,1,"T1",1,3,1,"H"
"1073",1998-01-18,1997,"Antalyaspor","Genclerbirligi","2-1",2,1,"T1",1,3,1,"H"
"1074",1998-01-18,1997,"Galatasaray","Ankaragucu","2-1",2,1,"T1",1,3,1,"H"
"1075",1998-01-18,1997,"Gaziantepspor","Fenerbahce","2-0",2,0,"T1",1,2,2,"H"
"1076",1998-01-18,1997,"Istanbulspor","Dardanelspor","3-1",3,1,"T1",1,4,2,"H"
"1077",1998-01-18,1997,"Kayseri","Karabukspor","0-1",0,1,"T1",1,1,-1,"A"
"1078",1998-01-18,1997,"Sekerspor","Besiktas","2-0",2,0,"T1",1,2,2,"H"
"1079",1998-01-18,1997,"Trabzonspor","Kocaelispor","2-2",2,2,"T1",1,4,0,"D"
"1080",1998-01-18,1997,"Vanspor","Samsunspor","1-0",1,0,"T1",1,1,1,"H"
"1081",1998-01-25,1997,"Ankaragucu","Kayseri","6-3",6,3,"T1",1,9,3,"H"
"1082",1998-01-25,1997,"Antalyaspor","Gaziantepspor","2-1",2,1,"T1",1,3,1,"H"
"1083",1998-01-25,1997,"Besiktas","Genclerbirligi","3-1",3,1,"T1",1,4,2,"H"
"1084",1998-01-25,1997,"Bursaspor","Galatasaray","3-2",3,2,"T1",1,5,1,"H"
"1085",1998-01-25,1997,"Dardanelspor","Sekerspor","4-1",4,1,"T1",1,5,3,"H"
"1086",1998-01-25,1997,"Fenerbahce","Samsunspor","0-0",0,0,"T1",1,0,0,"D"
"1087",1998-01-25,1997,"Karabukspor","Istanbulspor","0-1",0,1,"T1",1,1,-1,"A"
"1088",1998-01-25,1997,"Kocaelispor","Altay","0-1",0,1,"T1",1,1,-1,"A"
"1089",1998-01-25,1997,"Vanspor","Trabzonspor","0-2",0,2,"T1",1,2,-2,"A"
"1090",1998-02-01,1997,"Antalyaspor","Samsunspor","1-2",1,2,"T1",1,3,-1,"A"
"1091",1998-02-01,1997,"Galatasaray","Kocaelispor","2-0",2,0,"T1",1,2,2,"H"
"1092",1998-02-01,1997,"Gaziantepspor","Besiktas","1-1",1,1,"T1",1,2,0,"D"
"1093",1998-02-01,1997,"Genclerbirligi","Sekerspor","3-0",3,0,"T1",1,3,3,"H"
"1094",1998-02-01,1997,"Istanbulspor","Ankaragucu","1-1",1,1,"T1",1,2,0,"D"
"1095",1998-02-01,1997,"Karabukspor","Dardanelspor","0-0",0,0,"T1",1,0,0,"D"
"1096",1998-02-01,1997,"Kayseri","Bursaspor","2-1",2,1,"T1",1,3,1,"H"
"1097",1998-02-01,1997,"Trabzonspor","Fenerbahce","0-0",0,0,"T1",1,0,0,"D"
"1098",1998-02-01,1997,"Vanspor","Altay","0-0",0,0,"T1",1,0,0,"D"
"1099",1998-02-08,1997,"Ankaragucu","Karabukspor","3-2",3,2,"T1",1,5,1,"H"
"1100",1998-02-08,1997,"Antalyaspor","Trabzonspor","1-1",1,1,"T1",1,2,0,"D"
"1101",1998-02-08,1997,"Besiktas","Samsunspor","0-1",0,1,"T1",1,1,-1,"A"
"1102",1998-02-08,1997,"Bursaspor","Istanbulspor","1-1",1,1,"T1",1,2,0,"D"
"1103",1998-02-08,1997,"Dardanelspor","Genclerbirligi","1-2",1,2,"T1",1,3,-1,"A"
"1104",1998-02-08,1997,"Fenerbahce","Altay","2-0",2,0,"T1",1,2,2,"H"
"1105",1998-02-08,1997,"Kocaelispor","Kayseri","3-1",3,1,"T1",1,4,2,"H"
"1106",1998-02-08,1997,"Sekerspor","Gaziantepspor","4-3",4,3,"T1",1,7,1,"H"
"1107",1998-02-08,1997,"Vanspor","Galatasaray","0-3",0,3,"T1",1,3,-3,"A"
"1108",1998-02-15,1997,"Ankaragucu","Dardanelspor","1-0",1,0,"T1",1,1,1,"H"
"1109",1998-02-15,1997,"Antalyaspor","Altay","0-0",0,0,"T1",1,0,0,"D"
"1110",1998-02-15,1997,"Galatasaray","Fenerbahce","2-2",2,2,"T1",1,4,0,"D"
"1111",1998-02-15,1997,"Gaziantepspor","Genclerbirligi","1-1",1,1,"T1",1,2,0,"D"
"1112",1998-02-15,1997,"Istanbulspor","Kocaelispor","0-1",0,1,"T1",1,1,-1,"A"
"1113",1998-02-15,1997,"Karabukspor","Bursaspor","2-0",2,0,"T1",1,2,2,"H"
"1114",1998-02-15,1997,"Samsunspor","Sekerspor","3-0",3,0,"T1",1,3,3,"H"
"1115",1998-02-15,1997,"Trabzonspor","Besiktas","3-1",3,1,"T1",1,4,2,"H"
"1116",1998-02-15,1997,"Vanspor","Kayseri","1-2",1,2,"T1",1,3,-1,"A"
"1117",1998-02-22,1997,"Antalyaspor","Galatasaray","1-3",1,3,"T1",1,4,-2,"A"
"1118",1998-02-22,1997,"Besiktas","Altay","0-1",0,1,"T1",1,1,-1,"A"
"1119",1998-02-22,1997,"Bursaspor","Ankaragucu","1-0",1,0,"T1",1,1,1,"H"
"1120",1998-02-22,1997,"Dardanelspor","Gaziantepspor","1-0",1,0,"T1",1,1,1,"H"
"1121",1998-02-22,1997,"Fenerbahce","Kayseri","1-2",1,2,"T1",1,3,-1,"A"
"1122",1998-02-22,1997,"Genclerbirligi","Samsunspor","1-1",1,1,"T1",1,2,0,"D"
"1123",1998-02-22,1997,"Kocaelispor","Karabukspor","2-3",2,3,"T1",1,5,-1,"A"
"1124",1998-02-22,1997,"Sekerspor","Trabzonspor","0-2",0,2,"T1",1,2,-2,"A"
"1125",1998-02-22,1997,"Vanspor","Istanbulspor","1-1",1,1,"T1",1,2,0,"D"
"1126",1998-03-01,1997,"Altay","Sekerspor","2-0",2,0,"T1",1,2,2,"H"
"1127",1998-03-01,1997,"Ankaragucu","Kocaelispor","2-0",2,0,"T1",1,2,2,"H"
"1128",1998-03-01,1997,"Antalyaspor","Kayseri","2-1",2,1,"T1",1,3,1,"H"
"1129",1998-03-01,1997,"Bursaspor","Dardanelspor","0-0",0,0,"T1",1,0,0,"D"
"1130",1998-03-01,1997,"Galatasaray","Besiktas","3-2",3,2,"T1",1,5,1,"H"
"1131",1998-03-01,1997,"Istanbulspor","Fenerbahce","0-1",0,1,"T1",1,1,-1,"A"
"1132",1998-03-01,1997,"Karabukspor","Vanspor","2-1",2,1,"T1",1,3,1,"H"
"1133",1998-03-01,1997,"Samsunspor","Gaziantepspor","1-0",1,0,"T1",1,1,1,"H"
"1134",1998-03-01,1997,"Trabzonspor","Genclerbirligi","4-5",4,5,"T1",1,9,-1,"A"
"1135",1998-03-08,1997,"Antalyaspor","Istanbulspor","1-3",1,3,"T1",1,4,-2,"A"
"1136",1998-03-08,1997,"Besiktas","Kayseri","4-1",4,1,"T1",1,5,3,"H"
"1137",1998-03-08,1997,"Dardanelspor","Samsunspor","0-0",0,0,"T1",1,0,0,"D"
"1138",1998-03-08,1997,"Fenerbahce","Karabukspor","2-0",2,0,"T1",1,2,2,"H"
"1139",1998-03-08,1997,"Gaziantepspor","Trabzonspor","1-3",1,3,"T1",1,4,-2,"A"
"1140",1998-03-08,1997,"Genclerbirligi","Altay","1-3",1,3,"T1",1,4,-2,"A"
"1141",1998-03-08,1997,"Kocaelispor","Bursaspor","1-2",1,2,"T1",1,3,-1,"A"
"1142",1998-03-08,1997,"Sekerspor","Galatasaray","2-4",2,4,"T1",1,6,-2,"A"
"1143",1998-03-08,1997,"Vanspor","Ankaragucu","1-0",1,0,"T1",1,1,1,"H"
"1144",1998-03-15,1997,"Altay","Gaziantepspor","0-0",0,0,"T1",1,0,0,"D"
"1145",1998-03-15,1997,"Ankaragucu","Fenerbahce","0-2",0,2,"T1",1,2,-2,"A"
"1146",1998-03-15,1997,"Antalyaspor","Karabukspor","4-0",4,0,"T1",1,4,4,"H"
"1147",1998-03-15,1997,"Bursaspor","Vanspor","6-0",6,0,"T1",1,6,6,"H"
"1148",1998-03-15,1997,"Galatasaray","Genclerbirligi","3-1",3,1,"T1",1,4,2,"H"
"1149",1998-03-15,1997,"Istanbulspor","Besiktas","1-2",1,2,"T1",1,3,-1,"A"
"1150",1998-03-15,1997,"Kayseri","Sekerspor","0-1",0,1,"T1",1,1,-1,"A"
"1151",1998-03-15,1997,"Kocaelispor","Dardanelspor","3-1",3,1,"T1",1,4,2,"H"
"1152",1998-03-15,1997,"Trabzonspor","Samsunspor","4-0",4,0,"T1",1,4,4,"H"
"1153",1998-03-22,1997,"Antalyaspor","Ankaragucu","1-1",1,1,"T1",1,2,0,"D"
"1154",1998-03-22,1997,"Besiktas","Karabukspor","1-0",1,0,"T1",1,1,1,"H"
"1155",1998-03-22,1997,"Dardanelspor","Trabzonspor","2-1",2,1,"T1",1,3,1,"H"
"1156",1998-03-22,1997,"Fenerbahce","Bursaspor","3-0",3,0,"T1",1,3,3,"H"
"1157",1998-03-22,1997,"Gaziantepspor","Galatasaray","1-1",1,1,"T1",1,2,0,"D"
"1158",1998-03-22,1997,"Genclerbirligi","Kayseri","2-1",2,1,"T1",1,3,1,"H"
"1159",1998-03-22,1997,"Samsunspor","Altay","2-3",2,3,"T1",1,5,-1,"A"
"1160",1998-03-22,1997,"Sekerspor","Istanbulspor","0-2",0,2,"T1",1,2,-2,"A"
"1161",1998-03-22,1997,"Vanspor","Kocaelispor","2-1",2,1,"T1",1,3,1,"H"
"1162",1998-03-27,1997,"Kocaelispor","Fenerbahce","2-1",2,1,"T1",1,3,1,"H"
"1163",1998-03-28,1997,"Altay","Trabzonspor","1-1",1,1,"T1",1,2,0,"D"
"1164",1998-03-28,1997,"Istanbulspor","Genclerbirligi","3-3",3,3,"T1",1,6,0,"D"
"1165",1998-03-29,1997,"Ankaragucu","Besiktas","2-1",2,1,"T1",1,3,1,"H"
"1166",1998-03-29,1997,"Antalyaspor","Bursaspor","2-2",2,2,"T1",1,4,0,"D"
"1167",1998-03-29,1997,"Galatasaray","Samsunspor","2-1",2,1,"T1",1,3,1,"H"
"1168",1998-03-29,1997,"Karabukspor","Sekerspor","1-0",1,0,"T1",1,1,1,"H"
"1169",1998-03-29,1997,"Kayseri","Gaziantepspor","1-0",1,0,"T1",1,1,1,"H"
"1170",1998-03-29,1997,"Vanspor","Dardanelspor","3-0",3,0,"T1",1,3,3,"H"
"1171",1998-04-03,1997,"Antalyaspor","Kocaelispor","2-0",2,0,"T1",1,2,2,"H"
"1172",1998-04-04,1997,"Besiktas","Bursaspor","1-1",1,1,"T1",1,2,0,"D"
"1173",1998-04-04,1997,"Genclerbirligi","Karabukspor","2-0",2,0,"T1",1,2,2,"H"
"1174",1998-04-04,1997,"Trabzonspor","Galatasaray","1-1",1,1,"T1",1,2,0,"D"
"1175",1998-04-05,1997,"Dardanelspor","Altay","2-2",2,2,"T1",1,4,0,"D"
"1176",1998-04-05,1997,"Fenerbahce","Vanspor","4-1",4,1,"T1",1,5,3,"H"
"1177",1998-04-05,1997,"Gaziantepspor","Istanbulspor","0-0",0,0,"T1",1,0,0,"D"
"1178",1998-04-05,1997,"Samsunspor","Kayseri","2-0",2,0,"T1",1,2,2,"H"
"1179",1998-04-05,1997,"Sekerspor","Ankaragucu","1-1",1,1,"T1",1,2,0,"D"
"1180",1998-04-10,1997,"Istanbulspor","Samsunspor","4-2",4,2,"T1",1,6,2,"H"
"1181",1998-04-11,1997,"Fenerbahce","Dardanelspor","2-1",2,1,"T1",1,3,1,"H"
"1182",1998-04-11,1997,"Kocaelispor","Besiktas","3-2",3,2,"T1",1,5,1,"H"
"1183",1998-04-12,1997,"Ankaragucu","Genclerbirligi","2-0",2,0,"T1",1,2,2,"H"
"1184",1998-04-12,1997,"Antalyaspor","Vanspor","2-0",2,0,"T1",1,2,2,"H"
"1185",1998-04-12,1997,"Bursaspor","Sekerspor","0-6",0,6,"T1",1,6,-6,"A"
"1186",1998-04-12,1997,"Galatasaray","Altay","6-1",6,1,"T1",1,7,5,"H"
"1187",1998-04-12,1997,"Karabukspor","Gaziantepspor","0-1",0,1,"T1",1,1,-1,"A"
"1188",1998-04-12,1997,"Kayseri","Trabzonspor","5-6",5,6,"T1",1,11,-1,"A"
"1189",1998-04-17,1997,"Genclerbirligi","Bursaspor","1-1",1,1,"T1",1,2,0,"D"
"1190",1998-04-18,1997,"Altay","Kayseri","1-1",1,1,"T1",1,2,0,"D"
"1191",1998-04-18,1997,"Dardanelspor","Galatasaray","1-2",1,2,"T1",1,3,-1,"A"
"1192",1998-04-18,1997,"Gaziantepspor","Ankaragucu","4-2",4,2,"T1",1,6,2,"H"
"1193",1998-04-18,1997,"Samsunspor","Karabukspor","0-1",0,1,"T1",1,1,-1,"A"
"1194",1998-04-18,1997,"Sekerspor","Kocaelispor","2-1",2,1,"T1",1,3,1,"H"
"1195",1998-04-18,1997,"Trabzonspor","Istanbulspor","0-3",0,3,"T1",1,3,-3,"A"
"1196",1998-04-19,1997,"Antalyaspor","Fenerbahce","1-1",1,1,"T1",1,2,0,"D"
"1197",1998-04-19,1997,"Besiktas","Vanspor","4-0",4,0,"T1",1,4,4,"H"
"1198",1998-04-25,1997,"Ankaragucu","Samsunspor","0-1",0,1,"T1",1,1,-1,"A"
"1199",1998-04-25,1997,"Bursaspor","Gaziantepspor","1-2",1,2,"T1",1,3,-1,"A"
"1200",1998-04-25,1997,"Dardanelspor","Antalyaspor","3-1",3,1,"T1",1,4,2,"H"
"1201",1998-04-25,1997,"Fenerbahce","Besiktas","2-0",2,0,"T1",1,2,2,"H"
"1202",1998-04-25,1997,"Galatasaray","Kayseri","5-1",5,1,"T1",1,6,4,"H"
"1203",1998-04-25,1997,"Istanbulspor","Altay","2-2",2,2,"T1",1,4,0,"D"
"1204",1998-04-25,1997,"Karabukspor","Trabzonspor","1-1",1,1,"T1",1,2,0,"D"
"1205",1998-04-25,1997,"Kocaelispor","Genclerbirligi","1-1",1,1,"T1",1,2,0,"D"
"1206",1998-04-25,1997,"Vanspor","Sekerspor","0-0",0,0,"T1",1,0,0,"D"
"1207",1998-05-01,1997,"Samsunspor","Bursaspor","2-0",2,0,"T1",1,2,2,"H"
"1208",1998-05-02,1997,"Genclerbirligi","Vanspor","1-2",1,2,"T1",1,3,-1,"A"
"1209",1998-05-02,1997,"Trabzonspor","Ankaragucu","3-1",3,1,"T1",1,4,2,"H"
"1210",1998-05-03,1997,"Altay","Karabukspor","5-1",5,1,"T1",1,6,4,"H"
"1211",1998-05-03,1997,"Besiktas","Antalyaspor","0-1",0,1,"T1",1,1,-1,"A"
"1212",1998-05-03,1997,"Galatasaray","Istanbulspor","4-1",4,1,"T1",1,5,3,"H"
"1213",1998-05-03,1997,"Gaziantepspor","Kocaelispor","3-0",3,0,"T1",1,3,3,"H"
"1214",1998-05-03,1997,"Kayseri","Dardanelspor","3-0",3,0,"T1",1,3,3,"H"
"1215",1998-05-03,1997,"Sekerspor","Fenerbahce","1-1",1,1,"T1",1,2,0,"D"
"1216",1998-05-08,1997,"Ankaragucu","Altay","2-3",2,3,"T1",1,5,-1,"A"
"1217",1998-05-09,1997,"Karabukspor","Galatasaray","2-3",2,3,"T1",1,5,-1,"A"
"1218",1998-05-09,1997,"Kocaelispor","Samsunspor","4-0",4,0,"T1",1,4,4,"H"
"1219",1998-05-10,1997,"Antalyaspor","Sekerspor","3-3",3,3,"T1",1,6,0,"D"
"1220",1998-05-10,1997,"Bursaspor","Trabzonspor","1-2",1,2,"T1",1,3,-1,"A"
"1221",1998-05-10,1997,"Dardanelspor","Besiktas","0-0",0,0,"T1",1,0,0,"D"
"1222",1998-05-10,1997,"Fenerbahce","Genclerbirligi","2-1",2,1,"T1",1,3,1,"H"
"1223",1998-05-10,1997,"Istanbulspor","Kayseri","1-3",1,3,"T1",1,4,-2,"A"
"1224",1998-05-10,1997,"Vanspor","Gaziantepspor","0-0",0,0,"T1",1,0,0,"D"
"1225",1998-08-07,1998,"Dardanelspor","Fenerbahce","0-0",0,0,"T1",1,0,0,"D"
"1226",1998-08-08,1998,"Adanaspor","Istanbulspor","0-1",0,1,"T1",1,1,-1,"A"
"1227",1998-08-08,1998,"Galatasaray","Altay","3-1",3,1,"T1",1,4,2,"H"
"1228",1998-08-08,1998,"Samsunspor","Kocaelispor","0-1",0,1,"T1",1,1,-1,"A"
"1229",1998-08-08,1998,"Trabzonspor","Gaziantepspor","0-1",0,1,"T1",1,1,-1,"A"
"1230",1998-08-09,1998,"Besiktas","Ankaragucu","4-1",4,1,"T1",1,5,3,"H"
"1231",1998-08-09,1998,"Bursaspor","Karabukspor","1-2",1,2,"T1",1,3,-1,"A"
"1232",1998-08-09,1998,"Genclerbirligi","Erzurum","5-1",5,1,"T1",1,6,4,"H"
"1233",1998-08-09,1998,"Sakaryaspor","Antalyaspor","0-0",0,0,"T1",1,0,0,"D"
"1234",1998-08-14,1998,"Antalyaspor","Besiktas","0-3",0,3,"T1",1,3,-3,"A"
"1235",1998-08-15,1998,"Fenerbahce","Genclerbirligi","3-0",3,0,"T1",1,3,3,"H"
"1236",1998-08-16,1998,"Altay","Trabzonspor","2-5",2,5,"T1",1,7,-3,"A"
"1237",1998-08-16,1998,"Ankaragucu","Dardanelspor","3-0",3,0,"T1",1,3,3,"H"
"1238",1998-08-16,1998,"Bursaspor","Galatasaray","0-5",0,5,"T1",1,5,-5,"A"
"1239",1998-08-16,1998,"Erzurum","Adanaspor","1-0",1,0,"T1",1,1,1,"H"
"1240",1998-08-16,1998,"Gaziantepspor","Sakaryaspor","2-0",2,0,"T1",1,2,2,"H"
"1241",1998-08-16,1998,"Istanbulspor","Samsunspor","2-1",2,1,"T1",1,3,1,"H"
"1242",1998-08-16,1998,"Kocaelispor","Karabukspor","2-0",2,0,"T1",1,2,2,"H"
"1243",1998-08-21,1998,"Adanaspor","Fenerbahce","0-3",0,3,"T1",1,3,-3,"A"
"1244",1998-08-22,1998,"Besiktas","Gaziantepspor","1-1",1,1,"T1",1,2,0,"D"
"1245",1998-08-22,1998,"Galatasaray","Kocaelispor","3-1",3,1,"T1",1,4,2,"H"
"1246",1998-08-22,1998,"Istanbulspor","Karabukspor","3-0",3,0,"T1",1,3,3,"H"
"1247",1998-08-22,1998,"Samsunspor","Erzurum","2-4",2,4,"T1",1,6,-2,"A"
"1248",1998-08-22,1998,"Trabzonspor","Bursaspor","2-0",2,0,"T1",1,2,2,"H"
"1249",1998-08-23,1998,"Ankaragucu","Antalyaspor","0-0",0,0,"T1",1,0,0,"D"
"1250",1998-08-23,1998,"Dardanelspor","Genclerbirligi","1-2",1,2,"T1",1,3,-1,"A"
"1251",1998-08-23,1998,"Sakaryaspor","Altay","1-2",1,2,"T1",1,3,-1,"A"
"1252",1998-08-28,1998,"Altay","Besiktas","0-1",0,1,"T1",1,1,-1,"A"
"1253",1998-08-29,1998,"Antalyaspor","Dardanelspor","2-0",2,0,"T1",1,2,2,"H"
"1254",1998-08-29,1998,"Bursaspor","Sakaryaspor","2-1",2,1,"T1",1,3,1,"H"
"1255",1998-08-29,1998,"Erzurum","Karabukspor","2-1",2,1,"T1",1,3,1,"H"
"1256",1998-08-29,1998,"Fenerbahce","Samsunspor","6-2",6,2,"T1",1,8,4,"H"
"1257",1998-08-29,1998,"Gaziantepspor","Ankaragucu","1-0",1,0,"T1",1,1,1,"H"
"1258",1998-08-29,1998,"Genclerbirligi","Adanaspor","2-1",2,1,"T1",1,3,1,"H"
"1259",1998-08-29,1998,"Istanbulspor","Galatasaray","1-4",1,4,"T1",1,5,-3,"A"
"1260",1998-08-29,1998,"Kocaelispor","Trabzonspor","1-1",1,1,"T1",1,2,0,"D"
"1261",1998-09-11,1998,"Trabzonspor","Istanbulspor","0-0",0,0,"T1",1,0,0,"D"
"1262",1998-09-12,1998,"Fenerbahce","Karabukspor","4-1",4,1,"T1",1,5,3,"H"
"1263",1998-09-12,1998,"Galatasaray","Erzurum","5-0",5,0,"T1",1,5,5,"H"
"1264",1998-09-12,1998,"Samsunspor","Genclerbirligi","2-4",2,4,"T1",1,6,-2,"A"
"1265",1998-09-13,1998,"Ankaragucu","Altay","2-1",2,1,"T1",1,3,1,"H"
"1266",1998-09-13,1998,"Antalyaspor","Gaziantepspor","3-1",3,1,"T1",1,4,2,"H"
"1267",1998-09-13,1998,"Besiktas","Bursaspor","3-3",3,3,"T1",1,6,0,"D"
"1268",1998-09-13,1998,"Dardanelspor","Adanaspor","0-1",0,1,"T1",1,1,-1,"A"
"1269",1998-09-13,1998,"Sakaryaspor","Kocaelispor","2-2",2,2,"T1",1,4,0,"D"
"1270",1998-09-18,1998,"Bursaspor","Ankaragucu","4-0",4,0,"T1",1,4,4,"H"
"1271",1998-09-19,1998,"Genclerbirligi","Karabukspor","2-1",2,1,"T1",1,3,1,"H"
"1272",1998-09-19,1998,"Istanbulspor","Sakaryaspor","4-0",4,0,"T1",1,4,4,"H"
"1273",1998-09-20,1998,"Adanaspor","Samsunspor","0-0",0,0,"T1",1,0,0,"D"
"1274",1998-09-20,1998,"Altay","Antalyaspor","2-4",2,4,"T1",1,6,-2,"A"
"1275",1998-09-20,1998,"Erzurum","Trabzonspor","2-2",2,2,"T1",1,4,0,"D"
"1276",1998-09-20,1998,"Fenerbahce","Galatasaray","2-2",2,2,"T1",1,4,0,"D"
"1277",1998-09-20,1998,"Gaziantepspor","Dardanelspor","1-0",1,0,"T1",1,1,1,"H"
"1278",1998-09-20,1998,"Kocaelispor","Besiktas","0-2",0,2,"T1",1,2,-2,"A"
"1279",1998-09-25,1998,"Ankaragucu","Kocaelispor","0-2",0,2,"T1",1,2,-2,"A"
"1280",1998-09-25,1998,"Antalyaspor","Bursaspor","0-0",0,0,"T1",1,0,0,"D"
"1281",1998-09-25,1998,"Besiktas","Istanbulspor","2-1",2,1,"T1",1,3,1,"H"
"1282",1998-09-25,1998,"Dardanelspor","Samsunspor","0-0",0,0,"T1",1,0,0,"D"
"1283",1998-09-25,1998,"Galatasaray","Genclerbirligi","0-2",0,2,"T1",1,2,-2,"A"
"1284",1998-09-25,1998,"Gaziantepspor","Altay","1-1",1,1,"T1",1,2,0,"D"
"1285",1998-09-25,1998,"Karabukspor","Adanaspor","2-0",2,0,"T1",1,2,2,"H"
"1286",1998-09-25,1998,"Sakaryaspor","Erzurum","1-1",1,1,"T1",1,2,0,"D"
"1287",1998-09-25,1998,"Trabzonspor","Fenerbahce","1-0",1,0,"T1",1,1,1,"H"
"1288",1998-10-18,1998,"Adanaspor","Galatasaray","2-2",2,2,"T1",1,4,0,"D"
"1289",1998-10-18,1998,"Altay","Dardanelspor","1-1",1,1,"T1",1,2,0,"D"
"1290",1998-10-18,1998,"Bursaspor","Gaziantepspor","2-1",2,1,"T1",1,3,1,"H"
"1291",1998-10-18,1998,"Erzurum","Besiktas","2-2",2,2,"T1",1,4,0,"D"
"1292",1998-10-18,1998,"Fenerbahce","Sakaryaspor","3-0",3,0,"T1",1,3,3,"H"
"1293",1998-10-18,1998,"Genclerbirligi","Trabzonspor","0-1",0,1,"T1",1,1,-1,"A"
"1294",1998-10-18,1998,"Istanbulspor","Ankaragucu","1-4",1,4,"T1",1,5,-3,"A"
"1295",1998-10-18,1998,"Kocaelispor","Antalyaspor","2-1",2,1,"T1",1,3,1,"H"
"1296",1998-10-18,1998,"Samsunspor","Karabukspor","2-1",2,1,"T1",1,3,1,"H"
"1297",1998-10-23,1998,"Trabzonspor","Adanaspor","2-0",2,0,"T1",1,2,2,"H"
"1298",1998-10-24,1998,"Antalyaspor","Istanbulspor","2-3",2,3,"T1",1,5,-1,"A"
"1299",1998-10-24,1998,"Galatasaray","Samsunspor","3-1",3,1,"T1",1,4,2,"H"
"1300",1998-10-25,1998,"Altay","Bursaspor","4-1",4,1,"T1",1,5,3,"H"
"1301",1998-10-25,1998,"Ankaragucu","Erzurum","3-0",3,0,"T1",1,3,3,"H"
"1302",1998-10-25,1998,"Besiktas","Fenerbahce","3-2",3,2,"T1",1,5,1,"H"
"1303",1998-10-25,1998,"Dardanelspor","Karabukspor","0-0",0,0,"T1",1,0,0,"D"
"1304",1998-10-25,1998,"Gaziantepspor","Kocaelispor","1-2",1,2,"T1",1,3,-1,"A"
"1305",1998-10-25,1998,"Sakaryaspor","Genclerbirligi","3-1",3,1,"T1",1,4,2,"H"
"1306",1998-10-30,1998,"Samsunspor","Trabzonspor","2-1",2,1,"T1",1,3,1,"H"
"1307",1998-10-31,1998,"Fenerbahce","Ankaragucu","2-1",2,1,"T1",1,3,1,"H"
"1308",1998-10-31,1998,"Istanbulspor","Gaziantepspor","0-0",0,0,"T1",1,0,0,"D"
"1309",1998-10-31,1998,"Karabukspor","Galatasaray","0-3",0,3,"T1",1,3,-3,"A"
"1310",1998-11-01,1998,"Adanaspor","Sakaryaspor","2-1",2,1,"T1",1,3,1,"H"
"1311",1998-11-01,1998,"Bursaspor","Dardanelspor","2-0",2,0,"T1",1,2,2,"H"
"1312",1998-11-01,1998,"Erzurum","Antalyaspor","0-1",0,1,"T1",1,1,-1,"A"
"1313",1998-11-01,1998,"Genclerbirligi","Besiktas","0-1",0,1,"T1",1,1,-1,"A"
"1314",1998-11-01,1998,"Kocaelispor","Altay","2-1",2,1,"T1",1,3,1,"H"
"1315",1998-11-06,1998,"Antalyaspor","Fenerbahce","1-0",1,0,"T1",1,1,1,"H"
"1316",1998-11-07,1998,"Trabzonspor","Karabukspor","1-0",1,0,"T1",1,1,1,"H"
"1317",1998-11-08,1998,"Altay","Istanbulspor","2-1",2,1,"T1",1,3,1,"H"
"1318",1998-11-08,1998,"Ankaragucu","Genclerbirligi","0-1",0,1,"T1",1,1,-1,"A"
"1319",1998-11-08,1998,"Besiktas","Adanaspor","2-0",2,0,"T1",1,2,2,"H"
"1320",1998-11-08,1998,"Bursaspor","Kocaelispor","2-1",2,1,"T1",1,3,1,"H"
"1321",1998-11-08,1998,"Dardanelspor","Galatasaray","0-5",0,5,"T1",1,5,-5,"A"
"1322",1998-11-08,1998,"Gaziantepspor","Erzurum","3-0",3,0,"T1",1,3,3,"H"
"1323",1998-11-08,1998,"Sakaryaspor","Samsunspor","0-1",0,1,"T1",1,1,-1,"A"
"1324",1998-11-13,1998,"Kocaelispor","Dardanelspor","2-0",2,0,"T1",1,2,2,"H"
"1325",1998-11-14,1998,"Erzurum","Altay","2-1",2,1,"T1",1,3,1,"H"
"1326",1998-11-14,1998,"Fenerbahce","Gaziantepspor","4-0",4,0,"T1",1,4,4,"H"
"1327",1998-11-14,1998,"Karabukspor","Sakaryaspor","1-2",1,2,"T1",1,3,-1,"A"
"1328",1998-11-15,1998,"Adanaspor","Ankaragucu","1-0",1,0,"T1",1,1,1,"H"
"1329",1998-11-15,1998,"Galatasaray","Trabzonspor","3-5",3,5,"T1",1,8,-2,"A"
"1330",1998-11-15,1998,"Genclerbirligi","Antalyaspor","1-2",1,2,"T1",1,3,-1,"A"
"1331",1998-11-15,1998,"Istanbulspor","Bursaspor","2-3",2,3,"T1",1,5,-1,"A"
"1332",1998-11-15,1998,"Samsunspor","Besiktas","0-3",0,3,"T1",1,3,-3,"A"
"1333",1998-11-20,1998,"Altay","Fenerbahce","0-4",0,4,"T1",1,4,-4,"A"
"1334",1998-11-21,1998,"Dardanelspor","Trabzonspor","2-3",2,3,"T1",1,5,-1,"A"
"1335",1998-11-21,1998,"Kocaelispor","Istanbulspor","0-1",0,1,"T1",1,1,-1,"A"
"1336",1998-11-21,1998,"Sakaryaspor","Galatasaray","0-0",0,0,"T1",1,0,0,"D"
"1337",1998-11-22,1998,"Ankaragucu","Samsunspor","3-4",3,4,"T1",1,7,-1,"A"
"1338",1998-11-22,1998,"Antalyaspor","Adanaspor","2-0",2,0,"T1",1,2,2,"H"
"1339",1998-11-22,1998,"Besiktas","Karabukspor","1-1",1,1,"T1",1,2,0,"D"
"1340",1998-11-22,1998,"Bursaspor","Erzurum","6-1",6,1,"T1",1,7,5,"H"
"1341",1998-11-22,1998,"Gaziantepspor","Genclerbirligi","2-2",2,2,"T1",1,4,0,"D"
"1342",1998-11-27,1998,"Adanaspor","Gaziantepspor","3-1",3,1,"T1",1,4,2,"H"
"1343",1998-11-28,1998,"Erzurum","Kocaelispor","0-0",0,0,"T1",1,0,0,"D"
"1344",1998-11-28,1998,"Istanbulspor","Dardanelspor","1-1",1,1,"T1",1,2,0,"D"
"1345",1998-11-28,1998,"Karabukspor","Ankaragucu","0-1",0,1,"T1",1,1,-1,"A"
"1346",1998-11-28,1998,"Trabzonspor","Sakaryaspor","2-1",2,1,"T1",1,3,1,"H"
"1347",1998-11-29,1998,"Fenerbahce","Bursaspor","4-1",4,1,"T1",1,5,3,"H"
"1348",1998-11-29,1998,"Genclerbirligi","Altay","1-1",1,1,"T1",1,2,0,"D"
"1349",1998-11-29,1998,"Samsunspor","Antalyaspor","0-1",0,1,"T1",1,1,-1,"A"
"1350",1998-12-04,1998,"Kocaelispor","Fenerbahce","0-3",0,3,"T1",1,3,-3,"A"
"1351",1998-12-05,1998,"Erzurum","Istanbulspor","2-4",2,4,"T1",1,6,-2,"A"
"1352",1998-12-06,1998,"Altay","Adanaspor","3-2",3,2,"T1",1,5,1,"H"
"1353",1998-12-06,1998,"Antalyaspor","Karabukspor","3-1",3,1,"T1",1,4,2,"H"
"1354",1998-12-06,1998,"Besiktas","Trabzonspor","2-0",2,0,"T1",1,2,2,"H"
"1355",1998-12-06,1998,"Bursaspor","Genclerbirligi","1-1",1,1,"T1",1,2,0,"D"
"1356",1998-12-06,1998,"Gaziantepspor","Samsunspor","1-1",1,1,"T1",1,2,0,"D"
"1357",1998-12-06,1998,"Sakaryaspor","Dardanelspor","1-3",1,3,"T1",1,4,-2,"A"
"1358",1998-12-11,1998,"Genclerbirligi","Kocaelispor","1-1",1,1,"T1",1,2,0,"D"
"1359",1998-12-12,1998,"Galatasaray","Antalyaspor","3-1",3,1,"T1",1,4,2,"H"
"1360",1998-12-12,1998,"Sakaryaspor","Besiktas","0-2",0,2,"T1",1,2,-2,"A"
"1361",1998-12-13,1998,"Adanaspor","Bursaspor","4-1",4,1,"T1",1,5,3,"H"
"1362",1998-12-13,1998,"Dardanelspor","Erzurum","0-0",0,0,"T1",1,0,0,"D"
"1363",1998-12-13,1998,"Fenerbahce","Istanbulspor","2-0",2,0,"T1",1,2,2,"H"
"1364",1998-12-13,1998,"Karabukspor","Gaziantepspor","2-6",2,6,"T1",1,8,-4,"A"
"1365",1998-12-13,1998,"Samsunspor","Altay","1-0",1,0,"T1",1,1,1,"H"
"1366",1998-12-13,1998,"Trabzonspor","Ankaragucu","1-0",1,0,"T1",1,1,1,"H"
"1367",1998-12-16,1998,"Galatasaray","Besiktas","2-0",2,0,"T1",1,2,2,"H"
"1368",1998-12-18,1998,"Bursaspor","Samsunspor","2-3",2,3,"T1",1,5,-1,"A"
"1369",1998-12-19,1998,"Antalyaspor","Trabzonspor","0-1",0,1,"T1",1,1,-1,"A"
"1370",1998-12-20,1998,"Altay","Karabukspor","1-0",1,0,"T1",1,1,1,"H"
"1371",1998-12-20,1998,"Ankaragucu","Sakaryaspor","1-0",1,0,"T1",1,1,1,"H"
"1372",1998-12-20,1998,"Besiktas","Dardanelspor","0-0",0,0,"T1",1,0,0,"D"
"1373",1998-12-20,1998,"Erzurum","Fenerbahce","0-2",0,2,"T1",1,2,-2,"A"
"1374",1998-12-20,1998,"Gaziantepspor","Galatasaray","1-2",1,2,"T1",1,3,-1,"A"
"1375",1998-12-20,1998,"Istanbulspor","Genclerbirligi","0-0",0,0,"T1",1,0,0,"D"
"1376",1998-12-20,1998,"Kocaelispor","Adanaspor","2-1",2,1,"T1",1,3,1,"H"
"1377",1999-01-23,1998,"Ankaragucu","Galatasaray","2-2",2,2,"T1",1,4,0,"D"
"1378",1999-01-29,1998,"Ankaragucu","Besiktas","0-1",0,1,"T1",1,1,-1,"A"
"1379",1999-01-30,1998,"Fenerbahce","Dardanelspor","3-1",3,1,"T1",1,4,2,"H"
"1380",1999-01-30,1998,"Kocaelispor","Samsunspor","1-0",1,0,"T1",1,1,1,"H"
"1381",1999-01-31,1998,"Altay","Galatasaray","0-2",0,2,"T1",1,2,-2,"A"
"1382",1999-01-31,1998,"Antalyaspor","Sakaryaspor","2-2",2,2,"T1",1,4,0,"D"
"1383",1999-01-31,1998,"Erzurum","Genclerbirligi","2-2",2,2,"T1",1,4,0,"D"
"1384",1999-01-31,1998,"Gaziantepspor","Trabzonspor","1-1",1,1,"T1",1,2,0,"D"
"1385",1999-01-31,1998,"Istanbulspor","Adanaspor","6-0",6,0,"T1",1,6,6,"H"
"1386",1999-01-31,1998,"Karabukspor","Bursaspor","1-0",1,0,"T1",1,1,1,"H"
"1387",1999-02-05,1998,"Besiktas","Antalyaspor","2-1",2,1,"T1",1,3,1,"H"
"1388",1999-02-06,1998,"Genclerbirligi","Fenerbahce","0-3",0,3,"T1",1,3,-3,"A"
"1389",1999-02-07,1998,"Adanaspor","Erzurum","2-0",2,0,"T1",1,2,2,"H"
"1390",1999-02-07,1998,"Dardanelspor","Ankaragucu","3-0",3,0,"T1",1,3,3,"H"
"1391",1999-02-07,1998,"Galatasaray","Bursaspor","5-0",5,0,"T1",1,5,5,"H"
"1392",1999-02-07,1998,"Karabukspor","Kocaelispor","0-1",0,1,"T1",1,1,-1,"A"
"1393",1999-02-07,1998,"Sakaryaspor","Gaziantepspor","6-2",6,2,"T1",1,8,4,"H"
"1394",1999-02-07,1998,"Samsunspor","Istanbulspor","0-1",0,1,"T1",1,1,-1,"A"
"1395",1999-02-07,1998,"Trabzonspor","Altay","0-3",0,3,"T1",1,3,-3,"A"
"1396",1999-02-12,1998,"Kocaelispor","Galatasaray","1-2",1,2,"T1",1,3,-1,"A"
"1397",1999-02-13,1998,"Altay","Sakaryaspor","2-0",2,0,"T1",1,2,2,"H"
"1398",1999-02-13,1998,"Antalyaspor","Ankaragucu","1-4",1,4,"T1",1,5,-3,"A"
"1399",1999-02-13,1998,"Erzurum","Samsunspor","1-0",1,0,"T1",1,1,1,"H"
"1400",1999-02-13,1998,"Gaziantepspor","Besiktas","2-0",2,0,"T1",1,2,2,"H"
"1401",1999-02-13,1998,"Karabukspor","Istanbulspor","2-2",2,2,"T1",1,4,0,"D"
"1402",1999-02-14,1998,"Bursaspor","Trabzonspor","0-1",0,1,"T1",1,1,-1,"A"
"1403",1999-02-14,1998,"Fenerbahce","Adanaspor","6-0",6,0,"T1",1,6,6,"H"
"1404",1999-02-14,1998,"Genclerbirligi","Dardanelspor","0-0",0,0,"T1",1,0,0,"D"
"1405",1999-02-19,1998,"Samsunspor","Fenerbahce","1-1",1,1,"T1",1,2,0,"D"
"1406",1999-02-20,1998,"Besiktas","Altay","1-1",1,1,"T1",1,2,0,"D"
"1407",1999-02-21,1998,"Adanaspor","Genclerbirligi","1-1",1,1,"T1",1,2,0,"D"
"1408",1999-02-21,1998,"Ankaragucu","Gaziantepspor","1-1",1,1,"T1",1,2,0,"D"
"1409",1999-02-21,1998,"Dardanelspor","Antalyaspor","2-0",2,0,"T1",1,2,2,"H"
"1410",1999-02-21,1998,"Galatasaray","Istanbulspor","3-3",3,3,"T1",1,6,0,"D"
"1411",1999-02-21,1998,"Karabukspor","Erzurum","1-1",1,1,"T1",1,2,0,"D"
"1412",1999-02-21,1998,"Sakaryaspor","Bursaspor","4-1",4,1,"T1",1,5,3,"H"
"1413",1999-02-21,1998,"Trabzonspor","Kocaelispor","0-3",0,3,"T1",1,3,-3,"A"
"1414",1999-02-26,1998,"Kocaelispor","Sakaryaspor","0-1",0,1,"T1",1,1,-1,"A"
"1415",1999-02-27,1998,"Bursaspor","Besiktas","1-2",1,2,"T1",1,3,-1,"A"
"1416",1999-02-27,1998,"Istanbulspor","Trabzonspor","0-0",0,0,"T1",1,0,0,"D"
"1417",1999-02-28,1998,"Adanaspor","Dardanelspor","3-0",3,0,"T1",1,3,3,"H"
"1418",1999-02-28,1998,"Altay","Ankaragucu","5-1",5,1,"T1",1,6,4,"H"
"1419",1999-02-28,1998,"Erzurum","Galatasaray","0-1",0,1,"T1",1,1,-1,"A"
"1420",1999-02-28,1998,"Gaziantepspor","Antalyaspor","1-1",1,1,"T1",1,2,0,"D"
"1421",1999-02-28,1998,"Genclerbirligi","Samsunspor","3-0",3,0,"T1",1,3,3,"H"
"1422",1999-02-28,1998,"Karabukspor","Fenerbahce","0-0",0,0,"T1",1,0,0,"D"
"1423",1999-03-05,1998,"Trabzonspor","Erzurum","3-1",3,1,"T1",1,4,2,"H"
"1424",1999-03-06,1998,"Ankaragucu","Bursaspor","2-2",2,2,"T1",1,4,0,"D"
"1425",1999-03-06,1998,"Besiktas","Kocaelispor","0-3",0,3,"T1",1,3,-3,"A"
"1426",1999-03-06,1998,"Dardanelspor","Gaziantepspor","0-1",0,1,"T1",1,1,-1,"A"
"1427",1999-03-06,1998,"Sakaryaspor","Istanbulspor","3-0",3,0,"T1",1,3,3,"H"
"1428",1999-03-07,1998,"Antalyaspor","Altay","4-2",4,2,"T1",1,6,2,"H"
"1429",1999-03-07,1998,"Galatasaray","Fenerbahce","2-0",2,0,"T1",1,2,2,"H"
"1430",1999-03-07,1998,"Karabukspor","Genclerbirligi","1-6",1,6,"T1",1,7,-5,"A"
"1431",1999-03-07,1998,"Samsunspor","Adanaspor","2-0",2,0,"T1",1,2,2,"H"
"1432",1999-03-12,1998,"Bursaspor","Antalyaspor","1-0",1,0,"T1",1,1,1,"H"
"1433",1999-03-13,1998,"Fenerbahce","Trabzonspor","1-0",1,0,"T1",1,1,1,"H"
"1434",1999-03-14,1998,"Adanaspor","Karabukspor","2-0",2,0,"T1",1,2,2,"H"
"1435",1999-03-14,1998,"Altay","Gaziantepspor","0-0",0,0,"T1",1,0,0,"D"
"1436",1999-03-14,1998,"Erzurum","Sakaryaspor","4-2",4,2,"T1",1,6,2,"H"
"1437",1999-03-14,1998,"Genclerbirligi","Galatasaray","1-2",1,2,"T1",1,3,-1,"A"
"1438",1999-03-14,1998,"Istanbulspor","Besiktas","0-2",0,2,"T1",1,2,-2,"A"
"1439",1999-03-14,1998,"Kocaelispor","Ankaragucu","0-1",0,1,"T1",1,1,-1,"A"
"1440",1999-03-14,1998,"Samsunspor","Dardanelspor","2-1",2,1,"T1",1,3,1,"H"
"1441",1999-03-19,1998,"Galatasaray","Adanaspor","1-1",1,1,"T1",1,2,0,"D"
"1442",1999-03-20,1998,"Ankaragucu","Istanbulspor","5-0",5,0,"T1",1,5,5,"H"
"1443",1999-03-20,1998,"Gaziantepspor","Bursaspor","5-2",5,2,"T1",1,7,3,"H"
"1444",1999-03-20,1998,"Karabukspor","Samsunspor","0-3",0,3,"T1",1,3,-3,"A"
"1445",1999-03-20,1998,"Sakaryaspor","Fenerbahce","2-1",2,1,"T1",1,3,1,"H"
"1446",1999-03-20,1998,"Trabzonspor","Genclerbirligi","4-0",4,0,"T1",1,4,4,"H"
"1447",1999-03-21,1998,"Antalyaspor","Kocaelispor","2-1",2,1,"T1",1,3,1,"H"
"1448",1999-03-21,1998,"Besiktas","Erzurum","2-1",2,1,"T1",1,3,1,"H"
"1449",1999-03-21,1998,"Dardanelspor","Altay","4-1",4,1,"T1",1,5,3,"H"
"1450",1999-04-02,1998,"Adanaspor","Trabzonspor","0-2",0,2,"T1",1,2,-2,"A"
"1451",1999-04-03,1998,"Istanbulspor","Antalyaspor","0-1",0,1,"T1",1,1,-1,"A"
"1452",1999-04-03,1998,"Samsunspor","Galatasaray","0-3",0,3,"T1",1,3,-3,"A"
"1453",1999-04-04,1998,"Bursaspor","Altay","2-0",2,0,"T1",1,2,2,"H"
"1454",1999-04-04,1998,"Erzurum","Ankaragucu","2-2",2,2,"T1",1,4,0,"D"
"1455",1999-04-04,1998,"Fenerbahce","Besiktas","1-2",1,2,"T1",1,3,-1,"A"
"1456",1999-04-04,1998,"Genclerbirligi","Sakaryaspor","1-0",1,0,"T1",1,1,1,"H"
"1457",1999-04-04,1998,"Karabukspor","Dardanelspor","1-0",1,0,"T1",1,1,1,"H"
"1458",1999-04-04,1998,"Kocaelispor","Gaziantepspor","1-1",1,1,"T1",1,2,0,"D"
"1459",1999-04-09,1998,"Besiktas","Genclerbirligi","2-0",2,0,"T1",1,2,2,"H"
"1460",1999-04-10,1998,"Galatasaray","Karabukspor","2-0",2,0,"T1",1,2,2,"H"
"1461",1999-04-11,1998,"Altay","Kocaelispor","3-1",3,1,"T1",1,4,2,"H"
"1462",1999-04-11,1998,"Ankaragucu","Fenerbahce","2-4",2,4,"T1",1,6,-2,"A"
"1463",1999-04-11,1998,"Antalyaspor","Erzurum","1-0",1,0,"T1",1,1,1,"H"
"1464",1999-04-11,1998,"Dardanelspor","Bursaspor","3-1",3,1,"T1",1,4,2,"H"
"1465",1999-04-11,1998,"Gaziantepspor","Istanbulspor","2-1",2,1,"T1",1,3,1,"H"
"1466",1999-04-11,1998,"Sakaryaspor","Adanaspor","0-0",0,0,"T1",1,0,0,"D"
"1467",1999-04-11,1998,"Trabzonspor","Samsunspor","3-1",3,1,"T1",1,4,2,"H"
"1468",1999-04-15,1998,"Karabukspor","Trabzonspor","0-0",0,0,"T1",1,0,0,"D"
"1469",1999-04-16,1998,"Fenerbahce","Antalyaspor","3-1",3,1,"T1",1,4,2,"H"
"1470",1999-04-17,1998,"Adanaspor","Besiktas","0-1",0,1,"T1",1,1,-1,"A"
"1471",1999-04-17,1998,"Erzurum","Gaziantepspor","2-1",2,1,"T1",1,3,1,"H"
"1472",1999-04-17,1998,"Galatasaray","Dardanelspor","5-2",5,2,"T1",1,7,3,"H"
"1473",1999-04-17,1998,"Genclerbirligi","Ankaragucu","3-1",3,1,"T1",1,4,2,"H"
"1474",1999-04-17,1998,"Istanbulspor","Altay","3-0",3,0,"T1",1,3,3,"H"
"1475",1999-04-17,1998,"Kocaelispor","Bursaspor","4-0",4,0,"T1",1,4,4,"H"
"1476",1999-04-17,1998,"Samsunspor","Sakaryaspor","2-2",2,2,"T1",1,4,0,"D"
"1477",1999-04-23,1998,"Besiktas","Samsunspor","0-0",0,0,"T1",1,0,0,"D"
"1478",1999-04-24,1998,"Gaziantepspor","Fenerbahce","2-2",2,2,"T1",1,4,0,"D"
"1479",1999-04-25,1998,"Altay","Erzurum","3-1",3,1,"T1",1,4,2,"H"
"1480",1999-04-25,1998,"Ankaragucu","Adanaspor","2-2",2,2,"T1",1,4,0,"D"
"1481",1999-04-25,1998,"Antalyaspor","Genclerbirligi","1-1",1,1,"T1",1,2,0,"D"
"1482",1999-04-25,1998,"Bursaspor","Istanbulspor","2-0",2,0,"T1",1,2,2,"H"
"1483",1999-04-25,1998,"Dardanelspor","Kocaelispor","3-1",3,1,"T1",1,4,2,"H"
"1484",1999-04-25,1998,"Sakaryaspor","Karabukspor","4-0",4,0,"T1",1,4,4,"H"
"1485",1999-04-25,1998,"Trabzonspor","Galatasaray","0-3",0,3,"T1",1,3,-3,"A"
"1486",1999-04-30,1998,"Galatasaray","Sakaryaspor","3-0",3,0,"T1",1,3,3,"H"
"1487",1999-05-01,1998,"Karabukspor","Besiktas","1-2",1,2,"T1",1,3,-1,"A"
"1488",1999-05-02,1998,"Adanaspor","Antalyaspor","4-2",4,2,"T1",1,6,2,"H"
"1489",1999-05-02,1998,"Erzurum","Bursaspor","2-1",2,1,"T1",1,3,1,"H"
"1490",1999-05-02,1998,"Fenerbahce","Altay","5-0",5,0,"T1",1,5,5,"H"
"1491",1999-05-02,1998,"Genclerbirligi","Gaziantepspor","3-0",3,0,"T1",1,3,3,"H"
"1492",1999-05-02,1998,"Istanbulspor","Kocaelispor","2-1",2,1,"T1",1,3,1,"H"
"1493",1999-05-02,1998,"Samsunspor","Ankaragucu","0-0",0,0,"T1",1,0,0,"D"
"1494",1999-05-02,1998,"Trabzonspor","Dardanelspor","2-1",2,1,"T1",1,3,1,"H"
"1495",1999-05-07,1998,"Antalyaspor","Samsunspor","1-2",1,2,"T1",1,3,-1,"A"
"1496",1999-05-08,1998,"Bursaspor","Fenerbahce","1-3",1,3,"T1",1,4,-2,"A"
"1497",1999-05-09,1998,"Altay","Genclerbirligi","0-0",0,0,"T1",1,0,0,"D"
"1498",1999-05-09,1998,"Ankaragucu","Karabukspor","1-1",1,1,"T1",1,2,0,"D"
"1499",1999-05-09,1998,"Besiktas","Galatasaray","1-1",1,1,"T1",1,2,0,"D"
"1500",1999-05-09,1998,"Dardanelspor","Istanbulspor","5-1",5,1,"T1",1,6,4,"H"
"1501",1999-05-09,1998,"Gaziantepspor","Adanaspor","3-1",3,1,"T1",1,4,2,"H"
"1502",1999-05-09,1998,"Kocaelispor","Erzurum","1-1",1,1,"T1",1,2,0,"D"
"1503",1999-05-09,1998,"Sakaryaspor","Trabzonspor","1-1",1,1,"T1",1,2,0,"D"
"1504",1999-05-14,1998,"Galatasaray","Ankaragucu","2-1",2,1,"T1",1,3,1,"H"
"1505",1999-05-15,1998,"Fenerbahce","Kocaelispor","1-1",1,1,"T1",1,2,0,"D"
"1506",1999-05-16,1998,"Adanaspor","Altay","2-0",2,0,"T1",1,2,2,"H"
"1507",1999-05-16,1998,"Dardanelspor","Sakaryaspor","1-0",1,0,"T1",1,1,1,"H"
"1508",1999-05-16,1998,"Genclerbirligi","Bursaspor","1-4",1,4,"T1",1,5,-3,"A"
"1509",1999-05-16,1998,"Istanbulspor","Erzurum","0-2",0,2,"T1",1,2,-2,"A"
"1510",1999-05-16,1998,"Karabukspor","Antalyaspor","2-1",2,1,"T1",1,3,1,"H"
"1511",1999-05-16,1998,"Samsunspor","Gaziantepspor","2-1",2,1,"T1",1,3,1,"H"
"1512",1999-05-16,1998,"Trabzonspor","Besiktas","1-2",1,2,"T1",1,3,-1,"A"
"1513",1999-05-21,1998,"Kocaelispor","Genclerbirligi","2-0",2,0,"T1",1,2,2,"H"
"1514",1999-05-22,1998,"Gaziantepspor","Karabukspor","4-2",4,2,"T1",1,6,2,"H"
"1515",1999-05-23,1998,"Altay","Samsunspor","2-0",2,0,"T1",1,2,2,"H"
"1516",1999-05-23,1998,"Ankaragucu","Trabzonspor","1-0",1,0,"T1",1,1,1,"H"
"1517",1999-05-23,1998,"Antalyaspor","Galatasaray","1-1",1,1,"T1",1,2,0,"D"
"1518",1999-05-23,1998,"Besiktas","Sakaryaspor","3-0",3,0,"T1",1,3,3,"H"
"1519",1999-05-23,1998,"Bursaspor","Adanaspor","1-1",1,1,"T1",1,2,0,"D"
"1520",1999-05-23,1998,"Erzurum","Dardanelspor","1-0",1,0,"T1",1,1,1,"H"
"1521",1999-05-23,1998,"Istanbulspor","Fenerbahce","1-2",1,2,"T1",1,3,-1,"A"
"1522",1999-05-28,1998,"Dardanelspor","Besiktas","1-3",1,3,"T1",1,4,-2,"A"
"1523",1999-05-29,1998,"Adanaspor","Kocaelispor","1-1",1,1,"T1",1,2,0,"D"
"1524",1999-05-29,1998,"Fenerbahce","Erzurum","4-1",4,1,"T1",1,5,3,"H"
"1525",1999-05-29,1998,"Genclerbirligi","Istanbulspor","2-3",2,3,"T1",1,5,-1,"A"
"1526",1999-05-29,1998,"Karabukspor","Altay","1-1",1,1,"T1",1,2,0,"D"
"1527",1999-05-29,1998,"Sakaryaspor","Ankaragucu","4-0",4,0,"T1",1,4,4,"H"
"1528",1999-05-29,1998,"Samsunspor","Bursaspor","1-1",1,1,"T1",1,2,0,"D"
"1529",1999-05-30,1998,"Galatasaray","Gaziantepspor","0-0",0,0,"T1",1,0,0,"D"
"1530",1999-05-30,1998,"Trabzonspor","Antalyaspor","2-3",2,3,"T1",1,5,-1,"A"
"1531",1999-08-06,1999,"Galatasaray","Gaziantepspor","1-2",1,2,"T1",1,3,-1,"A"
"1532",1999-08-07,1999,"Genclerbirligi","Besiktas","1-0",1,0,"T1",1,1,1,"H"
"1533",1999-08-07,1999,"Samsunspor","Ankaragucu","2-0",2,0,"T1",1,2,2,"H"
"1534",1999-08-08,1999,"Adanaspor","Trabzonspor","1-2",1,2,"T1",1,3,-1,"A"
"1535",1999-08-08,1999,"Antalyaspor","Istanbulspor","0-3",0,3,"T1",1,3,-3,"A"
"1536",1999-08-08,1999,"Bursaspor","Altay","1-4",1,4,"T1",1,5,-3,"A"
"1537",1999-08-08,1999,"Erzurumspor","Denizlispor","0-1",0,1,"T1",1,1,-1,"A"
"1538",1999-08-08,1999,"Fenerbahce","Vanspor","3-0",3,0,"T1",1,3,3,"H"
"1539",1999-08-08,1999,"Goztep","Kocaelispor","0-0",0,0,"T1",1,0,0,"D"
"1540",1999-08-13,1999,"Altay","Goztep","0-0",0,0,"T1",1,0,0,"D"
"1541",1999-08-14,1999,"Fenerbahce","Kocaelispor","1-1",1,1,"T1",1,2,0,"D"
"1542",1999-08-14,1999,"Istanbulspor","Bursaspor","1-0",1,0,"T1",1,1,1,"H"
"1543",1999-08-15,1999,"Ankaragucu","Adanaspor","0-0",0,0,"T1",1,0,0,"D"
"1544",1999-08-15,1999,"Besiktas","Samsunspor","4-0",4,0,"T1",1,4,4,"H"
"1545",1999-08-15,1999,"Denizlispor","Genclerbirligi","1-3",1,3,"T1",1,4,-2,"A"
"1546",1999-08-15,1999,"Gaziantepspor","Antalyaspor","1-2",1,2,"T1",1,3,-1,"A"
"1547",1999-08-15,1999,"Trabzonspor","Galatasaray","1-2",1,2,"T1",1,3,-1,"A"
"1548",1999-08-15,1999,"Vanspor","Erzurumspor","0-2",0,2,"T1",1,2,-2,"A"
"1549",1999-09-10,1999,"Antalyaspor","Trabzonspor","0-2",0,2,"T1",1,2,-2,"A"
"1550",1999-09-11,1999,"Galatasaray","Ankaragucu","5-0",5,0,"T1",1,5,5,"H"
"1551",1999-09-12,1999,"Besiktas","Denizlispor","1-1",1,1,"T1",1,2,0,"D"
"1552",1999-09-12,1999,"Bursaspor","Gaziantepspor","0-1",0,1,"T1",1,1,-1,"A"
"1553",1999-09-12,1999,"Erzurumspor","Kocaelispor","3-3",3,3,"T1",1,6,0,"D"
"1554",1999-09-12,1999,"Fenerbahce","Altay","3-1",3,1,"T1",1,4,2,"H"
"1555",1999-09-12,1999,"Genclerbirligi","Vanspor","1-1",1,1,"T1",1,2,0,"D"
"1556",1999-09-12,1999,"Goztep","Istanbulspor","2-0",2,0,"T1",1,2,2,"H"
"1557",1999-09-12,1999,"Samsunspor","Adanaspor","2-1",2,1,"T1",1,3,1,"H"
"1558",1999-09-17,1999,"Adanaspor","Galatasaray","3-4",3,4,"T1",1,7,-1,"A"
"1559",1999-09-18,1999,"Genclerbirligi","Kocaelispor","0-4",0,4,"T1",1,4,-4,"A"
"1560",1999-09-18,1999,"Trabzonspor","Bursaspor","2-0",2,0,"T1",1,2,2,"H"
"1561",1999-09-19,1999,"Altay","Erzurumspor","3-0",3,0,"T1",1,3,3,"H"
"1562",1999-09-19,1999,"Ankaragucu","Antalyaspor","1-3",1,3,"T1",1,4,-2,"A"
"1563",1999-09-19,1999,"Denizlispor","Samsunspor","4-1",4,1,"T1",1,5,3,"H"
"1564",1999-09-19,1999,"Gaziantepspor","Goztep","2-1",2,1,"T1",1,3,1,"H"
"1565",1999-09-19,1999,"Istanbulspor","Fenerbahce","1-4",1,4,"T1",1,5,-3,"A"
"1566",1999-09-19,1999,"Vanspor","Besiktas","0-6",0,6,"T1",1,6,-6,"A"
"1567",1999-09-24,1999,"Samsunspor","Galatasaray","0-1",0,1,"T1",1,1,-1,"A"
"1568",1999-09-25,1999,"Besiktas","Kocaelispor","1-0",1,0,"T1",1,1,1,"H"
"1569",1999-09-26,1999,"Antalyaspor","Adanaspor","2-2",2,2,"T1",1,4,0,"D"
"1570",1999-09-26,1999,"Bursaspor","Ankaragucu","3-1",3,1,"T1",1,4,2,"H"
"1571",1999-09-26,1999,"Denizlispor","Vanspor","1-0",1,0,"T1",1,1,1,"H"
"1572",1999-09-26,1999,"Erzurumspor","Istanbulspor","0-0",0,0,"T1",1,0,0,"D"
"1573",1999-09-26,1999,"Fenerbahce","Gaziantepspor","0-0",0,0,"T1",1,0,0,"D"
"1574",1999-09-26,1999,"Genclerbirligi","Altay","0-0",0,0,"T1",1,0,0,"D"
"1575",1999-09-26,1999,"Goztep","Trabzonspor","1-1",1,1,"T1",1,2,0,"D"
"1576",1999-10-15,1999,"Galatasaray","Antalyaspor","2-0",2,0,"T1",1,2,2,"H"
"1577",1999-10-16,1999,"Ankaragucu","Goztep","1-2",1,2,"T1",1,3,-1,"A"
"1578",1999-10-16,1999,"Trabzonspor","Fenerbahce","2-0",2,0,"T1",1,2,2,"H"
"1579",1999-10-17,1999,"Adanaspor","Bursaspor","1-1",1,1,"T1",1,2,0,"D"
"1580",1999-10-17,1999,"Altay","Besiktas","2-2",2,2,"T1",1,4,0,"D"
"1581",1999-10-17,1999,"Denizlispor","Kocaelispor","3-1",3,1,"T1",1,4,2,"H"
"1582",1999-10-17,1999,"Gaziantepspor","Erzurumspor","6-0",6,0,"T1",1,6,6,"H"
"1583",1999-10-17,1999,"Istanbulspor","Genclerbirligi","3-1",3,1,"T1",1,4,2,"H"
"1584",1999-10-17,1999,"Vanspor","Samsunspor","0-0",0,0,"T1",1,0,0,"D"
"1585",1999-10-22,1999,"Bursaspor","Galatasaray","0-0",0,0,"T1",1,0,0,"D"
"1586",1999-10-23,1999,"Besiktas","Istanbulspor","3-0",3,0,"T1",1,3,3,"H"
"1587",1999-10-24,1999,"Denizlispor","Altay","2-1",2,1,"T1",1,3,1,"H"
"1588",1999-10-24,1999,"Erzurumspor","Trabzonspor","2-1",2,1,"T1",1,3,1,"H"
"1589",1999-10-24,1999,"Fenerbahce","Ankaragucu","1-1",1,1,"T1",1,2,0,"D"
"1590",1999-10-24,1999,"Genclerbirligi","Gaziantepspor","0-1",0,1,"T1",1,1,-1,"A"
"1591",1999-10-24,1999,"Goztep","Adanaspor","0-1",0,1,"T1",1,1,-1,"A"
"1592",1999-10-24,1999,"Samsunspor","Antalyaspor","0-1",0,1,"T1",1,1,-1,"A"
"1593",1999-10-24,1999,"Vanspor","Kocaelispor","5-0",5,0,"T1",1,5,5,"H"
"1594",1999-10-29,1999,"Galatasaray","Goztep","2-0",2,0,"T1",1,2,2,"H"
"1595",1999-10-30,1999,"Adanaspor","Fenerbahce","1-3",1,3,"T1",1,4,-2,"A"
"1596",1999-10-30,1999,"Ankaragucu","Erzurumspor","1-0",1,0,"T1",1,1,1,"H"
"1597",1999-10-31,1999,"Altay","Vanspor","2-0",2,0,"T1",1,2,2,"H"
"1598",1999-10-31,1999,"Antalyaspor","Bursaspor","1-1",1,1,"T1",1,2,0,"D"
"1599",1999-10-31,1999,"Gaziantepspor","Besiktas","0-0",0,0,"T1",1,0,0,"D"
"1600",1999-10-31,1999,"Istanbulspor","Denizlispor","1-1",1,1,"T1",1,2,0,"D"
"1601",1999-10-31,1999,"Samsunspor","Kocaelispor","5-1",5,1,"T1",1,6,4,"H"
"1602",1999-10-31,1999,"Trabzonspor","Genclerbirligi","1-2",1,2,"T1",1,3,-1,"A"
"1603",1999-11-19,1999,"Denizlispor","Gaziantepspor","1-0",1,0,"T1",1,1,1,"H"
"1604",1999-11-20,1999,"Goztep","Antalyaspor","1-2",1,2,"T1",1,3,-1,"A"
"1605",1999-11-21,1999,"Altay","Kocaelispor","0-1",0,1,"T1",1,1,-1,"A"
"1606",1999-11-21,1999,"Besiktas","Trabzonspor","1-1",1,1,"T1",1,2,0,"D"
"1607",1999-11-21,1999,"Erzurumspor","Adanaspor","4-1",4,1,"T1",1,5,3,"H"
"1608",1999-11-21,1999,"Genclerbirligi","Ankaragucu","1-2",1,2,"T1",1,3,-1,"A"
"1609",1999-11-21,1999,"Samsunspor","Bursaspor","1-0",1,0,"T1",1,1,1,"H"
"1610",1999-11-21,1999,"Vanspor","Istanbulspor","1-1",1,1,"T1",1,2,0,"D"
"1611",1999-11-26,1999,"Ankaragucu","Besiktas","2-3",2,3,"T1",1,5,-1,"A"
"1612",1999-11-27,1999,"Adanaspor","Genclerbirligi","1-2",1,2,"T1",1,3,-1,"A"
"1613",1999-11-27,1999,"Antalyaspor","Fenerbahce","2-3",2,3,"T1",1,5,-1,"A"
"1614",1999-11-28,1999,"Altay","Samsunspor","2-1",2,1,"T1",1,3,1,"H"
"1615",1999-11-28,1999,"Bursaspor","Goztep","1-2",1,2,"T1",1,3,-1,"A"
"1616",1999-11-28,1999,"Galatasaray","Erzurumspor","4-1",4,1,"T1",1,5,3,"H"
"1617",1999-11-28,1999,"Gaziantepspor","Vanspor","1-3",1,3,"T1",1,4,-2,"A"
"1618",1999-11-28,1999,"Istanbulspor","Kocaelispor","4-1",4,1,"T1",1,5,3,"H"
"1619",1999-11-28,1999,"Trabzonspor","Denizlispor","1-1",1,1,"T1",1,2,0,"D"
"1620",1999-12-03,1999,"Genclerbirligi","Galatasaray","1-1",1,1,"T1",1,2,0,"D"
"1621",1999-12-04,1999,"Besiktas","Adanaspor","0-1",0,1,"T1",1,1,-1,"A"
"1622",1999-12-05,1999,"Altay","Istanbulspor","0-0",0,0,"T1",1,0,0,"D"
"1623",1999-12-05,1999,"Denizlispor","Ankaragucu","1-1",1,1,"T1",1,2,0,"D"
"1624",1999-12-05,1999,"Erzurumspor","Antalyaspor","4-0",4,0,"T1",1,4,4,"H"
"1625",1999-12-05,1999,"Fenerbahce","Bursaspor","2-2",2,2,"T1",1,4,0,"D"
"1626",1999-12-05,1999,"Gaziantepspor","Kocaelispor","1-0",1,0,"T1",1,1,1,"H"
"1627",1999-12-05,1999,"Samsunspor","Goztep","4-0",4,0,"T1",1,4,4,"H"
"1628",1999-12-05,1999,"Vanspor","Trabzonspor","2-2",2,2,"T1",1,4,0,"D"
"1629",1999-12-10,1999,"Adanaspor","Denizlispor","3-2",3,2,"T1",1,5,1,"H"
"1630",1999-12-11,1999,"Goztep","Fenerbahce","0-0",0,0,"T1",1,0,0,"D"
"1631",1999-12-11,1999,"Istanbulspor","Samsunspor","0-1",0,1,"T1",1,1,-1,"A"
"1632",1999-12-12,1999,"Ankaragucu","Vanspor","1-0",1,0,"T1",1,1,1,"H"
"1633",1999-12-12,1999,"Antalyaspor","Genclerbirligi","2-1",2,1,"T1",1,3,1,"H"
"1634",1999-12-12,1999,"Bursaspor","Erzurumspor","4-2",4,2,"T1",1,6,2,"H"
"1635",1999-12-12,1999,"Galatasaray","Besiktas","1-0",1,0,"T1",1,1,1,"H"
"1636",1999-12-12,1999,"Gaziantepspor","Altay","1-0",1,0,"T1",1,1,1,"H"
"1637",1999-12-12,1999,"Trabzonspor","Kocaelispor","1-0",1,0,"T1",1,1,1,"H"
"1638",1999-12-17,1999,"Samsunspor","Fenerbahce","1-1",1,1,"T1",1,2,0,"D"
"1639",1999-12-18,1999,"Ankaragucu","Kocaelispor","3-2",3,2,"T1",1,5,1,"H"
"1640",1999-12-18,1999,"Denizlispor","Galatasaray","2-4",2,4,"T1",1,6,-2,"A"
"1641",1999-12-19,1999,"Altay","Trabzonspor","3-1",3,1,"T1",1,4,2,"H"
"1642",1999-12-19,1999,"Besiktas","Antalyaspor","4-0",4,0,"T1",1,4,4,"H"
"1643",1999-12-19,1999,"Erzurumspor","Goztep","0-0",0,0,"T1",1,0,0,"D"
"1644",1999-12-19,1999,"Genclerbirligi","Bursaspor","1-0",1,0,"T1",1,1,1,"H"
"1645",1999-12-19,1999,"Istanbulspor","Gaziantepspor","1-1",1,1,"T1",1,2,0,"D"
"1646",1999-12-19,1999,"Vanspor","Adanaspor","0-2",0,2,"T1",1,2,-2,"A"
"1647",1999-12-22,1999,"Fenerbahce","Galatasaray","1-2",1,2,"T1",1,3,-1,"A"
"1648",1999-12-24,1999,"Bursaspor","Besiktas","0-1",0,1,"T1",1,1,-1,"A"
"1649",1999-12-25,1999,"Adanaspor","Kocaelispor","3-0",3,0,"T1",1,3,3,"H"
"1650",1999-12-25,1999,"Ankaragucu","Altay","3-0",3,0,"T1",1,3,3,"H"
"1651",1999-12-25,1999,"Antalyaspor","Denizlispor","2-2",2,2,"T1",1,4,0,"D"
"1652",1999-12-25,1999,"Fenerbahce","Erzurumspor","2-0",2,0,"T1",1,2,2,"H"
"1653",1999-12-26,1999,"Galatasaray","Vanspor","2-1",2,1,"T1",1,3,1,"H"
"1654",1999-12-26,1999,"Gaziantepspor","Samsunspor","5-2",5,2,"T1",1,7,3,"H"
"1655",1999-12-26,1999,"Goztep","Genclerbirligi","3-2",3,2,"T1",1,5,1,"H"
"1656",1999-12-26,1999,"Trabzonspor","Istanbulspor","1-1",1,1,"T1",1,2,0,"D"
"1657",2000-01-07,1999,"Besiktas","Goztep","2-1",2,1,"T1",1,3,1,"H"
"1658",2000-01-08,1999,"Altay","Adanaspor","2-1",2,1,"T1",1,3,1,"H"
"1659",2000-01-08,1999,"Denizlispor","Bursaspor","1-3",1,3,"T1",1,4,-2,"A"
"1660",2000-01-08,1999,"Erzurumspor","Samsunspor","1-0",1,0,"T1",1,1,1,"H"
"1661",2000-01-08,1999,"Genclerbirligi","Fenerbahce","2-2",2,2,"T1",1,4,0,"D"
"1662",2000-01-09,1999,"Istanbulspor","Ankaragucu","2-6",2,6,"T1",1,8,-4,"A"
"1663",2000-01-09,1999,"Kocaelispor","Galatasaray","1-2",1,2,"T1",1,3,-1,"A"
"1664",2000-01-09,1999,"Trabzonspor","Gaziantepspor","0-0",0,0,"T1",1,0,0,"D"
"1665",2000-01-09,1999,"Vanspor","Antalyaspor","2-4",2,4,"T1",1,6,-2,"A"
"1666",2000-01-14,1999,"Samsunspor","Trabzonspor","0-0",0,0,"T1",1,0,0,"D"
"1667",2000-01-15,1999,"Ankaragucu","Gaziantepspor","1-1",1,1,"T1",1,2,0,"D"
"1668",2000-01-15,1999,"Antalyaspor","Kocaelispor","3-0",3,0,"T1",1,3,3,"H"
"1669",2000-01-15,1999,"Bursaspor","Vanspor","3-2",3,2,"T1",1,5,1,"H"
"1670",2000-01-15,1999,"Galatasaray","Altay","3-1",3,1,"T1",1,4,2,"H"
"1671",2000-01-16,1999,"Adanaspor","Istanbulspor","2-1",2,1,"T1",1,3,1,"H"
"1672",2000-01-16,1999,"Erzurumspor","Genclerbirligi","1-1",1,1,"T1",1,2,0,"D"
"1673",2000-01-16,1999,"Fenerbahce","Besiktas","2-1",2,1,"T1",1,3,1,"H"
"1674",2000-01-16,1999,"Goztep","Denizlispor","2-4",2,4,"T1",1,6,-2,"A"
"1675",2000-01-21,1999,"Denizlispor","Fenerbahce","1-1",1,1,"T1",1,2,0,"D"
"1676",2000-01-22,1999,"Gaziantepspor","Adanaspor","1-1",1,1,"T1",1,2,0,"D"
"1677",2000-01-23,1999,"Altay","Antalyaspor","2-0",2,0,"T1",1,2,2,"H"
"1678",2000-01-23,1999,"Besiktas","Erzurumspor","2-0",2,0,"T1",1,2,2,"H"
"1679",2000-01-23,1999,"Genclerbirligi","Samsunspor","1-0",1,0,"T1",1,1,1,"H"
"1680",2000-01-23,1999,"Istanbulspor","Galatasaray","0-0",0,0,"T1",1,0,0,"D"
"1681",2000-01-23,1999,"Kocaelispor","Bursaspor","3-2",3,2,"T1",1,5,1,"H"
"1682",2000-01-23,1999,"Trabzonspor","Ankaragucu","3-1",3,1,"T1",1,4,2,"H"
"1683",2000-01-28,1999,"Trabzonspor","Adanaspor","0-1",0,1,"T1",1,1,-1,"A"
"1684",2000-01-28,1999,"Vanspor","Fenerbahce","1-2",1,2,"T1",1,3,-1,"A"
"1685",2000-01-29,1999,"Ankaragucu","Samsunspor","1-2",1,2,"T1",1,3,-1,"A"
"1686",2000-01-29,1999,"Besiktas","Genclerbirligi","4-0",4,0,"T1",1,4,4,"H"
"1687",2000-01-29,1999,"Istanbulspor","Antalyaspor","0-0",0,0,"T1",1,0,0,"D"
"1688",2000-01-29,1999,"Kocaelispor","Goztep","2-0",2,0,"T1",1,2,2,"H"
"1689",2000-01-30,1999,"Altay","Bursaspor","1-2",1,2,"T1",1,3,-1,"A"
"1690",2000-01-30,1999,"Denizlispor","Erzurumspor","2-1",2,1,"T1",1,3,1,"H"
"1691",2000-01-30,1999,"Gaziantepspor","Galatasaray","0-1",0,1,"T1",1,1,-1,"A"
"1692",2000-02-02,1999,"Vanspor","Goztep","1-0",1,0,"T1",1,1,1,"H"
"1693",2000-02-04,1999,"Samsunspor","Besiktas","0-2",0,2,"T1",1,2,-2,"A"
"1694",2000-02-05,1999,"Bursaspor","Istanbulspor","1-0",1,0,"T1",1,1,1,"H"
"1695",2000-02-05,1999,"Genclerbirligi","Denizlispor","3-1",3,1,"T1",1,4,2,"H"
"1696",2000-02-05,1999,"Kocaelispor","Fenerbahce","1-1",1,1,"T1",1,2,0,"D"
"1697",2000-02-06,1999,"Adanaspor","Ankaragucu","2-2",2,2,"T1",1,4,0,"D"
"1698",2000-02-06,1999,"Antalyaspor","Gaziantepspor","0-0",0,0,"T1",1,0,0,"D"
"1699",2000-02-06,1999,"Erzurumspor","Vanspor","2-0",2,0,"T1",1,2,2,"H"
"1700",2000-02-06,1999,"Galatasaray","Trabzonspor","2-0",2,0,"T1",1,2,2,"H"
"1701",2000-02-06,1999,"Goztep","Altay","0-1",0,1,"T1",1,1,-1,"A"
"1702",2000-02-11,1999,"Denizlispor","Besiktas","0-2",0,2,"T1",1,2,-2,"A"
"1703",2000-02-12,1999,"Adanaspor","Samsunspor","0-1",0,1,"T1",1,1,-1,"A"
"1704",2000-02-12,1999,"Altay","Fenerbahce","2-3",2,3,"T1",1,5,-1,"A"
"1705",2000-02-12,1999,"Gaziantepspor","Bursaspor","1-1",1,1,"T1",1,2,0,"D"
"1706",2000-02-12,1999,"Kocaelispor","Erzurumspor","4-0",4,0,"T1",1,4,4,"H"
"1707",2000-02-12,1999,"Trabzonspor","Antalyaspor","2-0",2,0,"T1",1,2,2,"H"
"1708",2000-02-12,1999,"Vanspor","Genclerbirligi","2-5",2,5,"T1",1,7,-3,"A"
"1709",2000-02-13,1999,"Ankaragucu","Galatasaray","0-2",0,2,"T1",1,2,-2,"A"
"1710",2000-02-13,1999,"Istanbulspor","Goztep","3-0",3,0,"T1",1,3,3,"H"
"1711",2000-02-18,1999,"Besiktas","Vanspor","2-1",2,1,"T1",1,3,1,"H"
"1712",2000-02-19,1999,"Fenerbahce","Istanbulspor","1-0",1,0,"T1",1,1,1,"H"
"1713",2000-02-19,1999,"Goztep","Gaziantepspor","0-1",0,1,"T1",1,1,-1,"A"
"1714",2000-02-19,1999,"Kocaelispor","Genclerbirligi","0-0",0,0,"T1",1,0,0,"D"
"1715",2000-02-19,1999,"Samsunspor","Denizlispor","6-2",6,2,"T1",1,8,4,"H"
"1716",2000-02-20,1999,"Antalyaspor","Ankaragucu","0-0",0,0,"T1",1,0,0,"D"
"1717",2000-02-20,1999,"Bursaspor","Trabzonspor","2-3",2,3,"T1",1,5,-1,"A"
"1718",2000-02-20,1999,"Erzurumspor","Altay","0-0",0,0,"T1",1,0,0,"D"
"1719",2000-02-20,1999,"Galatasaray","Adanaspor","4-0",4,0,"T1",1,4,4,"H"
"1720",2000-02-25,1999,"Galatasaray","Samsunspor","3-1",3,1,"T1",1,4,2,"H"
"1721",2000-02-26,1999,"Adanaspor","Antalyaspor","1-2",1,2,"T1",1,3,-1,"A"
"1722",2000-02-26,1999,"Ankaragucu","Bursaspor","2-1",2,1,"T1",1,3,1,"H"
"1723",2000-02-26,1999,"Kocaelispor","Besiktas","1-2",1,2,"T1",1,3,-1,"A"
"1724",2000-02-26,1999,"Trabzonspor","Goztep","2-0",2,0,"T1",1,2,2,"H"
"1725",2000-02-27,1999,"Altay","Genclerbirligi","0-2",0,2,"T1",1,2,-2,"A"
"1726",2000-02-27,1999,"Gaziantepspor","Fenerbahce","5-1",5,1,"T1",1,6,4,"H"
"1727",2000-02-27,1999,"Istanbulspor","Erzurumspor","1-1",1,1,"T1",1,2,0,"D"
"1728",2000-02-27,1999,"Vanspor","Denizlispor","2-3",2,3,"T1",1,5,-1,"A"
"1729",2000-03-03,1999,"Besiktas","Altay","3-0",3,0,"T1",1,3,3,"H"
"1730",2000-03-04,1999,"Erzurumspor","Gaziantepspor","1-1",1,1,"T1",1,2,0,"D"
"1731",2000-03-04,1999,"Fenerbahce","Trabzonspor","2-1",2,1,"T1",1,3,1,"H"
"1732",2000-03-04,1999,"Genclerbirligi","Istanbulspor","1-1",1,1,"T1",1,2,0,"D"
"1733",2000-03-04,1999,"Kocaelispor","Denizlispor","1-0",1,0,"T1",1,1,1,"H"
"1734",2000-03-05,1999,"Antalyaspor","Galatasaray","1-3",1,3,"T1",1,4,-2,"A"
"1735",2000-03-05,1999,"Bursaspor","Adanaspor","3-1",3,1,"T1",1,4,2,"H"
"1736",2000-03-05,1999,"Goztep","Ankaragucu","2-0",2,0,"T1",1,2,2,"H"
"1737",2000-03-05,1999,"Samsunspor","Vanspor","5-1",5,1,"T1",1,6,4,"H"
"1738",2000-03-10,1999,"Trabzonspor","Erzurumspor","2-0",2,0,"T1",1,2,2,"H"
"1739",2000-03-11,1999,"Altay","Denizlispor","1-0",1,0,"T1",1,1,1,"H"
"1740",2000-03-11,1999,"Ankaragucu","Fenerbahce","1-1",1,1,"T1",1,2,0,"D"
"1741",2000-03-11,1999,"Gaziantepspor","Genclerbirligi","2-1",2,1,"T1",1,3,1,"H"
"1742",2000-03-11,1999,"Kocaelispor","Vanspor","6-1",6,1,"T1",1,7,5,"H"
"1743",2000-03-12,1999,"Adanaspor","Goztep","2-0",2,0,"T1",1,2,2,"H"
"1744",2000-03-12,1999,"Antalyaspor","Samsunspor","0-1",0,1,"T1",1,1,-1,"A"
"1745",2000-03-12,1999,"Galatasaray","Bursaspor","6-0",6,0,"T1",1,6,6,"H"
"1746",2000-03-12,1999,"Istanbulspor","Besiktas","0-2",0,2,"T1",1,2,-2,"A"
"1747",2000-03-17,1999,"Fenerbahce","Adanaspor","2-4",2,4,"T1",1,6,-2,"A"
"1748",2000-03-18,1999,"Besiktas","Gaziantepspor","1-0",1,0,"T1",1,1,1,"H"
"1749",2000-03-18,1999,"Bursaspor","Antalyaspor","4-2",4,2,"T1",1,6,2,"H"
"1750",2000-03-18,1999,"Erzurumspor","Ankaragucu","2-1",2,1,"T1",1,3,1,"H"
"1751",2000-03-18,1999,"Kocaelispor","Samsunspor","0-4",0,4,"T1",1,4,-4,"A"
"1752",2000-03-19,1999,"Denizlispor","Istanbulspor","3-1",3,1,"T1",1,4,2,"H"
"1753",2000-03-19,1999,"Genclerbirligi","Trabzonspor","0-1",0,1,"T1",1,1,-1,"A"
"1754",2000-03-19,1999,"Goztep","Galatasaray","0-2",0,2,"T1",1,2,-2,"A"
"1755",2000-03-19,1999,"Vanspor","Altay","1-1",1,1,"T1",1,2,0,"D"
"1756",2000-03-24,1999,"Gaziantepspor","Denizlispor","0-0",0,0,"T1",1,0,0,"D"
"1757",2000-03-25,1999,"Adanaspor","Erzurumspor","2-0",2,0,"T1",1,2,2,"H"
"1758",2000-03-25,1999,"Bursaspor","Samsunspor","2-2",2,2,"T1",1,4,0,"D"
"1759",2000-03-25,1999,"Istanbulspor","Vanspor","0-0",0,0,"T1",1,0,0,"D"
"1760",2000-03-25,1999,"Trabzonspor","Besiktas","1-2",1,2,"T1",1,3,-1,"A"
"1761",2000-03-26,1999,"Ankaragucu","Genclerbirligi","0-0",0,0,"T1",1,0,0,"D"
"1762",2000-03-26,1999,"Antalyaspor","Goztep","1-0",1,0,"T1",1,1,1,"H"
"1763",2000-03-26,1999,"Galatasaray","Fenerbahce","0-1",0,1,"T1",1,1,-1,"A"
"1764",2000-03-26,1999,"Kocaelispor","Altay","2-1",2,1,"T1",1,3,1,"H"
"1765",2000-03-31,1999,"Denizlispor","Trabzonspor","0-2",0,2,"T1",1,2,-2,"A"
"1766",2000-04-01,1999,"Erzurumspor","Galatasaray","0-0",0,0,"T1",1,0,0,"D"
"1767",2000-04-01,1999,"Fenerbahce","Antalyaspor","1-0",1,0,"T1",1,1,1,"H"
"1768",2000-04-01,1999,"Genclerbirligi","Adanaspor","5-2",5,2,"T1",1,7,3,"H"
"1769",2000-04-01,1999,"Goztep","Bursaspor","0-1",0,1,"T1",1,1,-1,"A"
"1770",2000-04-01,1999,"Vanspor","Gaziantepspor","1-2",1,2,"T1",1,3,-1,"A"
"1771",2000-04-02,1999,"Besiktas","Ankaragucu","3-1",3,1,"T1",1,4,2,"H"
"1772",2000-04-02,1999,"Kocaelispor","Istanbulspor","2-1",2,1,"T1",1,3,1,"H"
"1773",2000-04-02,1999,"Samsunspor","Altay","1-0",1,0,"T1",1,1,1,"H"
"1774",2000-04-07,1999,"Bursaspor","Fenerbahce","2-1",2,1,"T1",1,3,1,"H"
"1775",2000-04-08,1999,"Adanaspor","Besiktas","1-3",1,3,"T1",1,4,-2,"A"
"1776",2000-04-08,1999,"Goztep","Samsunspor","1-2",1,2,"T1",1,3,-1,"A"
"1777",2000-04-08,1999,"Istanbulspor","Altay","1-0",1,0,"T1",1,1,1,"H"
"1778",2000-04-08,1999,"Kocaelispor","Gaziantepspor","1-2",1,2,"T1",1,3,-1,"A"
"1779",2000-04-09,1999,"Ankaragucu","Denizlispor","3-1",3,1,"T1",1,4,2,"H"
"1780",2000-04-09,1999,"Antalyaspor","Erzurumspor","1-2",1,2,"T1",1,3,-1,"A"
"1781",2000-04-09,1999,"Galatasaray","Genclerbirligi","6-0",6,0,"T1",1,6,6,"H"
"1782",2000-04-09,1999,"Trabzonspor","Vanspor","4-2",4,2,"T1",1,6,2,"H"
"1783",2000-04-14,1999,"Besiktas","Galatasaray","1-1",1,1,"T1",1,2,0,"D"
"1784",2000-04-15,1999,"Altay","Gaziantepspor","1-3",1,3,"T1",1,4,-2,"A"
"1785",2000-04-15,1999,"Denizlispor","Adanaspor","4-2",4,2,"T1",1,6,2,"H"
"1786",2000-04-15,1999,"Genclerbirligi","Antalyaspor","4-1",4,1,"T1",1,5,3,"H"
"1787",2000-04-15,1999,"Kocaelispor","Trabzonspor","1-0",1,0,"T1",1,1,1,"H"
"1788",2000-04-16,1999,"Erzurumspor","Bursaspor","4-1",4,1,"T1",1,5,3,"H"
"1789",2000-04-16,1999,"Fenerbahce","Goztep","2-3",2,3,"T1",1,5,-1,"A"
"1790",2000-04-16,1999,"Samsunspor","Istanbulspor","1-0",1,0,"T1",1,1,1,"H"
"1791",2000-04-16,1999,"Vanspor","Ankaragucu","2-3",2,3,"T1",1,5,-1,"A"
"1792",2000-04-21,1999,"Fenerbahce","Samsunspor","1-0",1,0,"T1",1,1,1,"H"
"1793",2000-04-22,1999,"Adanaspor","Vanspor","2-0",2,0,"T1",1,2,2,"H"
"1794",2000-04-22,1999,"Antalyaspor","Besiktas","2-2",2,2,"T1",1,4,0,"D"
"1795",2000-04-22,1999,"Bursaspor","Genclerbirligi","2-5",2,5,"T1",1,7,-3,"A"
"1796",2000-04-22,1999,"Trabzonspor","Altay","2-1",2,1,"T1",1,3,1,"H"
"1797",2000-04-23,1999,"Galatasaray","Denizlispor","2-2",2,2,"T1",1,4,0,"D"
"1798",2000-04-23,1999,"Gaziantepspor","Istanbulspor","1-0",1,0,"T1",1,1,1,"H"
"1799",2000-04-23,1999,"Goztep","Erzurumspor","1-4",1,4,"T1",1,5,-3,"A"
"1800",2000-04-23,1999,"Kocaelispor","Ankaragucu","4-1",4,1,"T1",1,5,3,"H"
"1801",2000-04-28,1999,"Besiktas","Bursaspor","5-1",5,1,"T1",1,6,4,"H"
"1802",2000-04-29,1999,"Altay","Ankaragucu","0-0",0,0,"T1",1,0,0,"D"
"1803",2000-04-29,1999,"Denizlispor","Antalyaspor","4-0",4,0,"T1",1,4,4,"H"
"1804",2000-04-29,1999,"Istanbulspor","Trabzonspor","5-1",5,1,"T1",1,6,4,"H"
"1805",2000-04-29,1999,"Kocaelispor","Adanaspor","0-0",0,0,"T1",1,0,0,"D"
"1806",2000-04-29,1999,"Vanspor","Galatasaray","1-3",1,3,"T1",1,4,-2,"A"
"1807",2000-04-30,1999,"Erzurumspor","Fenerbahce","1-5",1,5,"T1",1,6,-4,"A"
"1808",2000-04-30,1999,"Genclerbirligi","Goztep","1-0",1,0,"T1",1,1,1,"H"
"1809",2000-04-30,1999,"Samsunspor","Gaziantepspor","0-2",0,2,"T1",1,2,-2,"A"
"1810",2000-05-05,1999,"Fenerbahce","Genclerbirligi","1-3",1,3,"T1",1,4,-2,"A"
"1811",2000-05-06,1999,"Bursaspor","Denizlispor","4-1",4,1,"T1",1,5,3,"H"
"1812",2000-05-06,1999,"Gaziantepspor","Trabzonspor","3-0",3,0,"T1",1,3,3,"H"
"1813",2000-05-06,1999,"Goztep","Besiktas","2-4",2,4,"T1",1,6,-2,"A"
"1814",2000-05-07,1999,"Adanaspor","Altay","1-0",1,0,"T1",1,1,1,"H"
"1815",2000-05-07,1999,"Ankaragucu","Istanbulspor","2-2",2,2,"T1",1,4,0,"D"
"1816",2000-05-07,1999,"Antalyaspor","Vanspor","4-1",4,1,"T1",1,5,3,"H"
"1817",2000-05-07,1999,"Galatasaray","Kocaelispor","5-0",5,0,"T1",1,5,5,"H"
"1818",2000-05-07,1999,"Samsunspor","Erzurumspor","2-1",2,1,"T1",1,3,1,"H"
"1819",2000-05-12,1999,"Altay","Galatasaray","1-0",1,0,"T1",1,1,1,"H"
"1820",2000-05-12,1999,"Gaziantepspor","Ankaragucu","2-2",2,2,"T1",1,4,0,"D"
"1821",2000-05-12,1999,"Genclerbirligi","Erzurumspor","5-0",5,0,"T1",1,5,5,"H"
"1822",2000-05-12,1999,"Istanbulspor","Adanaspor","3-2",3,2,"T1",1,5,1,"H"
"1823",2000-05-12,1999,"Kocaelispor","Antalyaspor","1-1",1,1,"T1",1,2,0,"D"
"1824",2000-05-12,1999,"Vanspor","Bursaspor","3-1",3,1,"T1",1,4,2,"H"
"1825",2000-05-13,1999,"Denizlispor","Goztep","2-0",2,0,"T1",1,2,2,"H"
"1826",2000-05-13,1999,"Trabzonspor","Samsunspor","3-2",3,2,"T1",1,5,1,"H"
"1827",2000-05-14,1999,"Besiktas","Fenerbahce","1-3",1,3,"T1",1,4,-2,"A"
"1828",2000-05-19,1999,"Samsunspor","Genclerbirligi","1-2",1,2,"T1",1,3,-1,"A"
"1829",2000-05-20,1999,"Adanaspor","Gaziantepspor","3-0",3,0,"T1",1,3,3,"H"
"1830",2000-05-20,1999,"Fenerbahce","Denizlispor","2-1",2,1,"T1",1,3,1,"H"
"1831",2000-05-20,1999,"Goztep","Vanspor","2-1",2,1,"T1",1,3,1,"H"
"1832",2000-05-21,1999,"Ankaragucu","Trabzonspor","1-1",1,1,"T1",1,2,0,"D"
"1833",2000-05-21,1999,"Antalyaspor","Altay","3-1",3,1,"T1",1,4,2,"H"
"1834",2000-05-21,1999,"Bursaspor","Kocaelispor","2-0",2,0,"T1",1,2,2,"H"
"1835",2000-05-21,1999,"Erzurumspor","Besiktas","1-4",1,4,"T1",1,5,-3,"A"
"1836",2000-05-21,1999,"Galatasaray","Istanbulspor","1-1",1,1,"T1",1,2,0,"D"
"1837",2000-08-11,2000,"Kocaelispor","Fenerbahce","0-4",0,4,"T1",1,4,-4,"A"
"1838",2000-08-12,2000,"Besiktas","Yozgatspor","3-0",3,0,"T1",1,3,3,"H"
"1839",2000-08-12,2000,"Bursaspor","Gaziantepspor","3-3",3,3,"T1",1,6,0,"D"
"1840",2000-08-12,2000,"Erzurumspor","Trabzonspor","1-3",1,3,"T1",1,4,-2,"A"
"1841",2000-08-12,2000,"Genclerbirligi","Rizespor","0-0",0,0,"T1",1,0,0,"D"
"1842",2000-08-13,2000,"Denizlispor","Galatasaray","0-1",0,1,"T1",1,1,-1,"A"
"1843",2000-08-13,2000,"Istanbulspor","Adanaspor","1-6",1,6,"T1",1,7,-5,"A"
"1844",2000-08-13,2000,"Samsunspor","Ankaragucu","3-0",3,0,"T1",1,3,3,"H"
"1845",2000-08-13,2000,"Siirt Jet-PA","Antalyaspor","1-2",1,2,"T1",1,3,-1,"A"
"1846",2000-08-18,2000,"Antalyaspor","Besiktas","1-2",1,2,"T1",1,3,-1,"A"
"1847",2000-08-19,2000,"Ankaragucu","Kocaelispor","1-0",1,0,"T1",1,1,1,"H"
"1848",2000-08-19,2000,"Galatasaray","Erzurumspor","7-0",7,0,"T1",1,7,7,"H"
"1849",2000-08-19,2000,"Siirt Jet-PA","Rizespor","2-3",2,3,"T1",1,5,-1,"A"
"1850",2000-08-19,2000,"Yozgatspor","Denizlispor","2-0",2,0,"T1",1,2,2,"H"
"1851",2000-08-20,2000,"Fenerbahce","Istanbulspor","2-0",2,0,"T1",1,2,2,"H"
"1852",2000-08-20,2000,"Gaziantepspor","Samsunspor","4-0",4,0,"T1",1,4,4,"H"
"1853",2000-08-20,2000,"Genclerbirligi","Adanaspor","1-0",1,0,"T1",1,1,1,"H"
"1854",2000-08-20,2000,"Trabzonspor","Bursaspor","2-1",2,1,"T1",1,3,1,"H"
"1855",2000-08-25,2000,"Samsunspor","Trabzonspor","1-1",1,1,"T1",1,2,0,"D"
"1856",2000-08-26,2000,"Denizlispor","Erzurumspor","3-1",3,1,"T1",1,4,2,"H"
"1857",2000-08-26,2000,"Genclerbirligi","Fenerbahce","3-1",3,1,"T1",1,4,2,"H"
"1858",2000-08-26,2000,"Siirt Jet-PA","Adanaspor","2-2",2,2,"T1",1,4,0,"D"
"1859",2000-08-27,2000,"Besiktas","Rizespor","2-1",2,1,"T1",1,3,1,"H"
"1860",2000-08-27,2000,"Istanbulspor","Ankaragucu","0-2",0,2,"T1",1,2,-2,"A"
"1861",2000-08-27,2000,"Kocaelispor","Gaziantepspor","1-2",1,2,"T1",1,3,-1,"A"
"1862",2000-08-27,2000,"Yozgatspor","Antalyaspor","0-0",0,0,"T1",1,0,0,"D"
"1863",2000-09-06,2000,"Bursaspor","Galatasaray","0-2",0,2,"T1",1,2,-2,"A"
"1864",2000-09-08,2000,"Adanaspor","Besiktas","1-1",1,1,"T1",1,2,0,"D"
"1865",2000-09-09,2000,"Ankaragucu","Genclerbirligi","2-3",2,3,"T1",1,5,-1,"A"
"1866",2000-09-09,2000,"Antalyaspor","Denizlispor","4-1",4,1,"T1",1,5,3,"H"
"1867",2000-09-09,2000,"Galatasaray","Samsunspor","1-2",1,2,"T1",1,3,-1,"A"
"1868",2000-09-09,2000,"Trabzonspor","Kocaelispor","2-1",2,1,"T1",1,3,1,"H"
"1869",2000-09-10,2000,"Erzurumspor","Bursaspor","5-0",5,0,"T1",1,5,5,"H"
"1870",2000-09-10,2000,"Fenerbahce","Siirt Jet-PA","4-2",4,2,"T1",1,6,2,"H"
"1871",2000-09-10,2000,"Gaziantepspor","Istanbulspor","0-0",0,0,"T1",1,0,0,"D"
"1872",2000-09-10,2000,"Yozgatspor","Rizespor","0-0",0,0,"T1",1,0,0,"D"
"1873",2000-09-15,2000,"Kocaelispor","Galatasaray","1-4",1,4,"T1",1,5,-3,"A"
"1874",2000-09-16,2000,"Besiktas","Fenerbahce","3-0",3,0,"T1",1,3,3,"H"
"1875",2000-09-16,2000,"Denizlispor","Bursaspor","1-1",1,1,"T1",1,2,0,"D"
"1876",2000-09-16,2000,"Samsunspor","Erzurumspor","2-2",2,2,"T1",1,4,0,"D"
"1877",2000-09-17,2000,"Antalyaspor","Rizespor","2-1",2,1,"T1",1,3,1,"H"
"1878",2000-09-17,2000,"Genclerbirligi","Gaziantepspor","2-0",2,0,"T1",1,2,2,"H"
"1879",2000-09-17,2000,"Istanbulspor","Trabzonspor","1-0",1,0,"T1",1,1,1,"H"
"1880",2000-09-17,2000,"Siirt Jet-PA","Ankaragucu","1-1",1,1,"T1",1,2,0,"D"
"1881",2000-09-17,2000,"Yozgatspor","Adanaspor","4-1",4,1,"T1",1,5,3,"H"
"1882",2000-09-22,2000,"Ankaragucu","Besiktas","1-5",1,5,"T1",1,6,-4,"A"
"1883",2000-09-23,2000,"Adanaspor","Antalyaspor","1-1",1,1,"T1",1,2,0,"D"
"1884",2000-09-23,2000,"Bursaspor","Samsunspor","0-2",0,2,"T1",1,2,-2,"A"
"1885",2000-09-23,2000,"Gaziantepspor","Siirt Jet-PA","4-0",4,0,"T1",1,4,4,"H"
"1886",2000-09-23,2000,"Galatasaray","Istanbulspor","1-1",1,1,"T1",1,2,0,"D"
"1887",2000-09-24,2000,"Denizlispor","Rizespor","0-0",0,0,"T1",1,0,0,"D"
"1888",2000-09-24,2000,"Erzurumspor","Kocaelispor","1-0",1,0,"T1",1,1,1,"H"
"1889",2000-09-24,2000,"Fenerbahce","Yozgatspor","3-1",3,1,"T1",1,4,2,"H"
"1890",2000-09-24,2000,"Trabzonspor","Genclerbirligi","2-0",2,0,"T1",1,2,2,"H"
"1891",2000-09-29,2000,"Denizlispor","Samsunspor","3-1",3,1,"T1",1,4,2,"H"
"1892",2000-09-30,2000,"Genclerbirligi","Galatasaray","1-4",1,4,"T1",1,5,-3,"A"
"1893",2000-09-30,2000,"Istanbulspor","Erzurumspor","1-0",1,0,"T1",1,1,1,"H"
"1894",2000-09-30,2000,"Kocaelispor","Bursaspor","0-0",0,0,"T1",1,0,0,"D"
"1895",2000-10-01,2000,"Adanaspor","Rizespor","1-0",1,0,"T1",1,1,1,"H"
"1896",2000-10-01,2000,"Antalyaspor","Fenerbahce","0-1",0,1,"T1",1,1,-1,"A"
"1897",2000-10-01,2000,"Besiktas","Gaziantepspor","2-4",2,4,"T1",1,6,-2,"A"
"1898",2000-10-01,2000,"Siirt Jet-PA","Trabzonspor","1-4",1,4,"T1",1,5,-3,"A"
"1899",2000-10-01,2000,"Yozgatspor","Ankaragucu","0-1",0,1,"T1",1,1,-1,"A"
"1900",2000-10-13,2000,"Adanaspor","Denizlispor","2-3",2,3,"T1",1,5,-1,"A"
"1901",2000-10-14,2000,"Bursaspor","Istanbulspor","2-5",2,5,"T1",1,7,-3,"A"
"1902",2000-10-14,2000,"Gaziantepspor","Yozgatspor","3-1",3,1,"T1",1,4,2,"H"
"1903",2000-10-14,2000,"Galatasaray","Siirt Jet-PA","4-1",4,1,"T1",1,5,3,"H"
"1904",2000-10-14,2000,"Trabzonspor","Besiktas","2-0",2,0,"T1",1,2,2,"H"
"1905",2000-10-15,2000,"Ankaragucu","Antalyaspor","1-1",1,1,"T1",1,2,0,"D"
"1906",2000-10-15,2000,"Erzurumspor","Genclerbirligi","1-2",1,2,"T1",1,3,-1,"A"
"1907",2000-10-15,2000,"Fenerbahce","Rizespor","1-0",1,0,"T1",1,1,1,"H"
"1908",2000-10-15,2000,"Samsunspor","Kocaelispor","0-1",0,1,"T1",1,1,-1,"A"
"1909",2000-10-19,2000,"Antalyaspor","Gaziantepspor","2-2",2,2,"T1",1,4,0,"D"
"1910",2000-10-20,2000,"Adanaspor","Fenerbahce","1-1",1,1,"T1",1,2,0,"D"
"1911",2000-10-21,2000,"Besiktas","Galatasaray","3-1",3,1,"T1",1,4,2,"H"
"1912",2000-10-21,2000,"Denizlispor","Kocaelispor","2-1",2,1,"T1",1,3,1,"H"
"1913",2000-10-21,2000,"Genclerbirligi","Bursaspor","0-1",0,1,"T1",1,1,-1,"A"
"1914",2000-10-21,2000,"Istanbulspor","Samsunspor","0-0",0,0,"T1",1,0,0,"D"
"1915",2000-10-21,2000,"Rizespor","Ankaragucu","1-1",1,1,"T1",1,2,0,"D"
"1916",2000-10-21,2000,"Siirt Jet-PA","Erzurumspor","1-1",1,1,"T1",1,2,0,"D"
"1917",2000-10-21,2000,"Yozgatspor","Trabzonspor","1-1",1,1,"T1",1,2,0,"D"
"1918",2000-10-27,2000,"Fenerbahce","Denizlispor","5-2",5,2,"T1",1,7,3,"H"
"1919",2000-10-28,2000,"Ankaragucu","Adanaspor","4-0",4,0,"T1",1,4,4,"H"
"1920",2000-10-28,2000,"Bursaspor","Siirt Jet-PA","3-2",3,2,"T1",1,5,1,"H"
"1921",2000-10-28,2000,"Erzurumspor","Besiktas","1-3",1,3,"T1",1,4,-2,"A"
"1922",2000-10-28,2000,"Trabzonspor","Antalyaspor","4-0",4,0,"T1",1,4,4,"H"
"1923",2000-10-29,2000,"Gaziantepspor","Rizespor","2-1",2,1,"T1",1,3,1,"H"
"1924",2000-10-29,2000,"Galatasaray","Yozgatspor","3-0",3,0,"T1",1,3,3,"H"
"1925",2000-10-29,2000,"Kocaelispor","Istanbulspor","1-1",1,1,"T1",1,2,0,"D"
"1926",2000-10-29,2000,"Samsunspor","Genclerbirligi","1-2",1,2,"T1",1,3,-1,"A"
"1927",2000-11-03,2000,"Rizespor","Trabzonspor","2-1",2,1,"T1",1,3,1,"H"
"1928",2000-11-04,2000,"Besiktas","Bursaspor","2-1",2,1,"T1",1,3,1,"H"
"1929",2000-11-04,2000,"Denizlispor","Istanbulspor","0-4",0,4,"T1",1,4,-4,"A"
"1930",2000-11-04,2000,"Genclerbirligi","Kocaelispor","0-0",0,0,"T1",1,0,0,"D"
"1931",2000-11-05,2000,"Adanaspor","Gaziantepspor","0-1",0,1,"T1",1,1,-1,"A"
"1932",2000-11-05,2000,"Fenerbahce","Ankaragucu","5-1",5,1,"T1",1,6,4,"H"
"1933",2000-11-05,2000,"Siirt Jet-PA","Samsunspor","1-2",1,2,"T1",1,3,-1,"A"
"1934",2000-11-05,2000,"Yozgatspor","Erzurumspor","4-0",4,0,"T1",1,4,4,"H"
"1935",2000-11-10,2000,"Gaziantepspor","Fenerbahce","2-1",2,1,"T1",1,3,1,"H"
"1936",2000-11-11,2000,"Bursaspor","Yozgatspor","1-4",1,4,"T1",1,5,-3,"A"
"1937",2000-11-11,2000,"Erzurumspor","Antalyaspor","0-1",0,1,"T1",1,1,-1,"A"
"1938",2000-11-11,2000,"Galatasaray","Rizespor","2-0",2,0,"T1",1,2,2,"H"
"1939",2000-11-11,2000,"Istanbulspor","Genclerbirligi","2-1",2,1,"T1",1,3,1,"H"
"1940",2000-11-12,2000,"Ankaragucu","Denizlispor","3-1",3,1,"T1",1,4,2,"H"
"1941",2000-11-12,2000,"Kocaelispor","Siirt Jet-PA","1-1",1,1,"T1",1,2,0,"D"
"1942",2000-11-12,2000,"Samsunspor","Besiktas","2-3",2,3,"T1",1,5,-1,"A"
"1943",2000-11-12,2000,"Trabzonspor","Adanaspor","3-3",3,3,"T1",1,6,0,"D"
"1944",2000-11-17,2000,"Besiktas","Kocaelispor","3-2",3,2,"T1",1,5,1,"H"
"1945",2000-11-18,2000,"Adanaspor","Galatasaray","1-2",1,2,"T1",1,3,-1,"A"
"1946",2000-11-18,2000,"Ankaragucu","Gaziantepspor","1-1",1,1,"T1",1,2,0,"D"
"1947",2000-11-18,2000,"Rizespor","Erzurumspor","4-1",4,1,"T1",1,5,3,"H"
"1948",2000-11-18,2000,"Siirt Jet-PA","Istanbulspor","0-2",0,2,"T1",1,2,-2,"A"
"1949",2000-11-19,2000,"Antalyaspor","Bursaspor","2-1",2,1,"T1",1,3,1,"H"
"1950",2000-11-19,2000,"Denizlispor","Genclerbirligi","0-0",0,0,"T1",1,0,0,"D"
"1951",2000-11-19,2000,"Fenerbahce","Trabzonspor","5-2",5,2,"T1",1,7,3,"H"
"1952",2000-11-19,2000,"Yozgatspor","Samsunspor","0-0",0,0,"T1",1,0,0,"D"
"1953",2000-11-24,2000,"Trabzonspor","Ankaragucu","2-2",2,2,"T1",1,4,0,"D"
"1954",2000-11-25,2000,"Erzurumspor","Adanaspor","2-0",2,0,"T1",1,2,2,"H"
"1955",2000-11-25,2000,"Istanbulspor","Besiktas","2-3",2,3,"T1",1,5,-1,"A"
"1956",2000-11-25,2000,"Samsunspor","Antalyaspor","4-2",4,2,"T1",1,6,2,"H"
"1957",2000-11-26,2000,"Bursaspor","Rizespor","2-1",2,1,"T1",1,3,1,"H"
"1958",2000-11-26,2000,"Gaziantepspor","Denizlispor","1-1",1,1,"T1",1,2,0,"D"
"1959",2000-11-26,2000,"Genclerbirligi","Siirt Jet-PA","2-0",2,0,"T1",1,2,2,"H"
"1960",2000-11-26,2000,"Galatasaray","Fenerbahce","0-0",0,0,"T1",1,0,0,"D"
"1961",2000-11-26,2000,"Kocaelispor","Yozgatspor","2-2",2,2,"T1",1,4,0,"D"
"1962",2000-12-01,2000,"Ankaragucu","Galatasaray","1-3",1,3,"T1",1,4,-2,"A"
"1963",2000-12-02,2000,"Antalyaspor","Kocaelispor","2-2",2,2,"T1",1,4,0,"D"
"1964",2000-12-02,2000,"Besiktas","Genclerbirligi","0-3",0,3,"T1",1,3,-3,"A"
"1965",2000-12-02,2000,"Trabzonspor","Gaziantepspor","3-1",3,1,"T1",1,4,2,"H"
"1966",2000-12-02,2000,"Yozgatspor","Istanbulspor","3-0",3,0,"T1",1,3,3,"H"
"1967",2000-12-03,2000,"Adanaspor","Bursaspor","1-1",1,1,"T1",1,2,0,"D"
"1968",2000-12-03,2000,"Fenerbahce","Erzurumspor","4-2",4,2,"T1",1,6,2,"H"
"1969",2000-12-03,2000,"Rizespor","Samsunspor","0-1",0,1,"T1",1,1,-1,"A"
"1970",2000-12-03,2000,"Siirt Jet-PA","Denizlispor","1-1",1,1,"T1",1,2,0,"D"
"1971",2000-12-08,2000,"Denizlispor","Trabzonspor","2-0",2,0,"T1",1,2,2,"H"
"1972",2000-12-09,2000,"Bursaspor","Fenerbahce","2-2",2,2,"T1",1,4,0,"D"
"1973",2000-12-09,2000,"Istanbulspor","Antalyaspor","2-0",2,0,"T1",1,2,2,"H"
"1974",2000-12-09,2000,"Kocaelispor","Rizespor","2-1",2,1,"T1",1,3,1,"H"
"1975",2000-12-09,2000,"Samsunspor","Adanaspor","3-1",3,1,"T1",1,4,2,"H"
"1976",2000-12-10,2000,"Erzurumspor","Ankaragucu","1-1",1,1,"T1",1,2,0,"D"
"1977",2000-12-10,2000,"Genclerbirligi","Yozgatspor","2-1",2,1,"T1",1,3,1,"H"
"1978",2000-12-10,2000,"Galatasaray","Gaziantepspor","2-0",2,0,"T1",1,2,2,"H"
"1979",2000-12-10,2000,"Siirt Jet-PA","Besiktas","1-1",1,1,"T1",1,2,0,"D"
"1980",2000-12-15,2000,"Fenerbahce","Samsunspor","2-1",2,1,"T1",1,3,1,"H"
"1981",2000-12-16,2000,"Besiktas","Denizlispor","1-1",1,1,"T1",1,2,0,"D"
"1982",2000-12-16,2000,"Gaziantepspor","Erzurumspor","6-1",6,1,"T1",1,7,5,"H"
"1983",2000-12-16,2000,"Rizespor","Istanbulspor","2-1",2,1,"T1",1,3,1,"H"
"1984",2000-12-16,2000,"Yozgatspor","Siirt Jet-PA","2-1",2,1,"T1",1,3,1,"H"
"1985",2000-12-17,2000,"Adanaspor","Kocaelispor","4-4",4,4,"T1",1,8,0,"D"
"1986",2000-12-17,2000,"Ankaragucu","Bursaspor","1-1",1,1,"T1",1,2,0,"D"
"1987",2000-12-17,2000,"Antalyaspor","Genclerbirligi","4-2",4,2,"T1",1,6,2,"H"
"1988",2000-12-17,2000,"Trabzonspor","Galatasaray","1-1",1,1,"T1",1,2,0,"D"
"1989",2000-12-20,2000,"Antalyaspor","Galatasaray","0-1",0,1,"T1",1,1,-1,"A"
"1990",2000-12-21,2000,"Trabzonspor","Erzurumspor","3-0",3,0,"T1",1,3,3,"H"
"1991",2000-12-22,2000,"Adanaspor","Istanbulspor","2-2",2,2,"T1",1,4,0,"D"
"1992",2000-12-22,2000,"Ankaragucu","Samsunspor","2-0",2,0,"T1",1,2,2,"H"
"1993",2000-12-22,2000,"Fenerbahce","Kocaelispor","4-0",4,0,"T1",1,4,4,"H"
"1994",2000-12-22,2000,"Rizespor","Genclerbirligi","2-0",2,0,"T1",1,2,2,"H"
"1995",2000-12-23,2000,"Antalyaspor","Siirt Jet-PA","1-3",1,3,"T1",1,4,-2,"A"
"1996",2000-12-23,2000,"Gaziantepspor","Bursaspor","2-1",2,1,"T1",1,3,1,"H"
"1997",2000-12-23,2000,"Galatasaray","Denizlispor","1-2",1,2,"T1",1,3,-1,"A"
"1998",2000-12-23,2000,"Yozgatspor","Besiktas","1-1",1,1,"T1",1,2,0,"D"
"1999",2001-02-02,2000,"Samsunspor","Gaziantepspor","3-3",3,3,"T1",1,6,0,"D"
"2000",2001-02-03,2000,"Besiktas","Antalyaspor","4-2",4,2,"T1",1,6,2,"H"
"2001",2001-02-03,2000,"Denizlispor","Yozgatspor","2-0",2,0,"T1",1,2,2,"H"
"2002",2001-02-03,2000,"Erzurumspor","Galatasaray","1-2",1,2,"T1",1,3,-1,"A"
"2003",2001-02-03,2000,"Rizespor","Siirt Jet-PA","3-0",3,0,"T1",1,3,3,"H"
"2004",2001-02-04,2000,"Adanaspor","Genclerbirligi","2-3",2,3,"T1",1,5,-1,"A"
"2005",2001-02-04,2000,"Bursaspor","Trabzonspor","4-2",4,2,"T1",1,6,2,"H"
"2006",2001-02-04,2000,"Istanbulspor","Fenerbahce","1-2",1,2,"T1",1,3,-1,"A"
"2007",2001-02-04,2000,"Kocaelispor","Ankaragucu","4-0",4,0,"T1",1,4,4,"H"
"2008",2001-02-09,2000,"Trabzonspor","Samsunspor","3-2",3,2,"T1",1,5,1,"H"
"2009",2001-02-10,2000,"Adanaspor","Siirt Jet-PA","0-2",0,2,"T1",1,2,-2,"A"
"2010",2001-02-10,2000,"Ankaragucu","Istanbulspor","1-1",1,1,"T1",1,2,0,"D"
"2011",2001-02-10,2000,"Galatasaray","Bursaspor","2-1",2,1,"T1",1,3,1,"H"
"2012",2001-02-11,2000,"Antalyaspor","Yozgatspor","1-1",1,1,"T1",1,2,0,"D"
"2013",2001-02-11,2000,"Erzurumspor","Denizlispor","2-2",2,2,"T1",1,4,0,"D"
"2014",2001-02-11,2000,"Fenerbahce","Genclerbirligi","3-0",3,0,"T1",1,3,3,"H"
"2015",2001-02-11,2000,"Gaziantepspor","Kocaelispor","0-0",0,0,"T1",1,0,0,"D"
"2016",2001-02-11,2000,"Rizespor","Besiktas","5-1",5,1,"T1",1,6,4,"H"
"2017",2001-02-16,2000,"Istanbulspor","Gaziantepspor","0-1",0,1,"T1",1,1,-1,"A"
"2018",2001-02-17,2000,"Denizlispor","Antalyaspor","1-1",1,1,"T1",1,2,0,"D"
"2019",2001-02-17,2000,"Samsunspor","Galatasaray","1-1",1,1,"T1",1,2,0,"D"
"2020",2001-02-17,2000,"Siirt Jet-PA","Fenerbahce","0-4",0,4,"T1",1,4,-4,"A"
"2021",2001-02-18,2000,"Besiktas","Adanaspor","2-1",2,1,"T1",1,3,1,"H"
"2022",2001-02-18,2000,"Bursaspor","Erzurumspor","6-0",6,0,"T1",1,6,6,"H"
"2023",2001-02-18,2000,"Genclerbirligi","Ankaragucu","3-4",3,4,"T1",1,7,-1,"A"
"2024",2001-02-18,2000,"Kocaelispor","Trabzonspor","3-2",3,2,"T1",1,5,1,"H"
"2025",2001-02-18,2000,"Rizespor","Yozgatspor","1-0",1,0,"T1",1,1,1,"H"
"2026",2001-02-23,2000,"Gaziantepspor","Genclerbirligi","1-0",1,0,"T1",1,1,1,"H"
"2027",2001-02-24,2000,"Ankaragucu","Siirt Jet-PA","4-1",4,1,"T1",1,5,3,"H"
"2028",2001-02-24,2000,"Fenerbahce","Besiktas","3-1",3,1,"T1",1,4,2,"H"
"2029",2001-02-24,2000,"Rizespor","Antalyaspor","0-2",0,2,"T1",1,2,-2,"A"
"2030",2001-02-25,2000,"Adanaspor","Yozgatspor","3-3",3,3,"T1",1,6,0,"D"
"2031",2001-02-25,2000,"Bursaspor","Denizlispor","2-1",2,1,"T1",1,3,1,"H"
"2032",2001-02-25,2000,"Erzurumspor","Samsunspor","1-2",1,2,"T1",1,3,-1,"A"
"2033",2001-02-25,2000,"Galatasaray","Kocaelispor","2-3",2,3,"T1",1,5,-1,"A"
"2034",2001-02-25,2000,"Trabzonspor","Istanbulspor","1-2",1,2,"T1",1,3,-1,"A"
"2035",2001-03-02,2000,"Genclerbirligi","Trabzonspor","0-2",0,2,"T1",1,2,-2,"A"
"2036",2001-03-03,2000,"Antalyaspor","Adanaspor","2-1",2,1,"T1",1,3,1,"H"
"2037",2001-03-03,2000,"Samsunspor","Bursaspor","2-0",2,0,"T1",1,2,2,"H"
"2038",2001-03-03,2000,"Siirt Jet-PA","Gaziantepspor","1-2",1,2,"T1",1,3,-1,"A"
"2039",2001-03-03,2000,"Yozgatspor","Fenerbahce","2-3",2,3,"T1",1,5,-1,"A"
"2040",2001-03-04,2000,"Besiktas","Ankaragucu","4-0",4,0,"T1",1,4,4,"H"
"2041",2001-03-04,2000,"Kocaelispor","Erzurumspor","1-0",1,0,"T1",1,1,1,"H"
"2042",2001-03-04,2000,"Rizespor","Denizlispor","2-1",2,1,"T1",1,3,1,"H"
"2043",2001-03-09,2000,"Gaziantepspor","Besiktas","3-1",3,1,"T1",1,4,2,"H"
"2044",2001-03-10,2000,"Bursaspor","Kocaelispor","1-1",1,1,"T1",1,2,0,"D"
"2045",2001-03-10,2000,"Erzurumspor","Istanbulspor","1-3",1,3,"T1",1,4,-2,"A"
"2046",2001-03-10,2000,"Galatasaray","Genclerbirligi","2-1",2,1,"T1",1,3,1,"H"
"2047",2001-03-10,2000,"Samsunspor","Denizlispor","2-1",2,1,"T1",1,3,1,"H"
"2048",2001-03-11,2000,"Ankaragucu","Yozgatspor","4-0",4,0,"T1",1,4,4,"H"
"2049",2001-03-11,2000,"Fenerbahce","Antalyaspor","2-1",2,1,"T1",1,3,1,"H"
"2050",2001-03-11,2000,"Rizespor","Adanaspor","4-2",4,2,"T1",1,6,2,"H"
"2051",2001-03-11,2000,"Trabzonspor","Siirt Jet-PA","2-4",2,4,"T1",1,6,-2,"A"
"2052",2001-03-16,2000,"Kocaelispor","Samsunspor","1-0",1,0,"T1",1,1,1,"H"
"2053",2001-03-17,2000,"Antalyaspor","Ankaragucu","3-4",3,4,"T1",1,7,-1,"A"
"2054",2001-03-17,2000,"Genclerbirligi","Erzurumspor","1-2",1,2,"T1",1,3,-1,"A"
"2055",2001-03-17,2000,"Istanbulspor","Bursaspor","2-4",2,4,"T1",1,6,-2,"A"
"2056",2001-03-17,2000,"Rizespor","Fenerbahce","1-1",1,1,"T1",1,2,0,"D"
"2057",2001-03-18,2000,"Besiktas","Trabzonspor","3-1",3,1,"T1",1,4,2,"H"
"2058",2001-03-18,2000,"Denizlispor","Adanaspor","4-2",4,2,"T1",1,6,2,"H"
"2059",2001-03-18,2000,"Siirt Jet-PA","Galatasaray","0-1",0,1,"T1",1,1,-1,"A"
"2060",2001-03-18,2000,"Yozgatspor","Gaziantepspor","1-2",1,2,"T1",1,3,-1,"A"
"2061",2001-03-30,2000,"Kocaelispor","Denizlispor","4-2",4,2,"T1",1,6,2,"H"
"2062",2001-03-31,2000,"Ankaragucu","Rizespor","4-0",4,0,"T1",1,4,4,"H"
"2063",2001-03-31,2000,"Bursaspor","Genclerbirligi","2-0",2,0,"T1",1,2,2,"H"
"2064",2001-03-31,2000,"Erzurumspor","Siirt Jet-PA","2-1",2,1,"T1",1,3,1,"H"
"2065",2001-03-31,2000,"Galatasaray","Besiktas","2-0",2,0,"T1",1,2,2,"H"
"2066",2001-04-01,2000,"Fenerbahce","Adanaspor","4-0",4,0,"T1",1,4,4,"H"
"2067",2001-04-01,2000,"Gaziantepspor","Antalyaspor","2-0",2,0,"T1",1,2,2,"H"
"2068",2001-04-01,2000,"Samsunspor","Istanbulspor","2-3",2,3,"T1",1,5,-1,"A"
"2069",2001-04-01,2000,"Trabzonspor","Yozgatspor","1-1",1,1,"T1",1,2,0,"D"
"2070",2001-04-06,2000,"Rizespor","Gaziantepspor","2-1",2,1,"T1",1,3,1,"H"
"2071",2001-04-07,2000,"Adanaspor","Ankaragucu","1-3",1,3,"T1",1,4,-2,"A"
"2072",2001-04-07,2000,"Antalyaspor","Trabzonspor","2-3",2,3,"T1",1,5,-1,"A"
"2073",2001-04-07,2000,"Denizlispor","Fenerbahce","2-1",2,1,"T1",1,3,1,"H"
"2074",2001-04-07,2000,"Genclerbirligi","Samsunspor","1-0",1,0,"T1",1,1,1,"H"
"2075",2001-04-08,2000,"Besiktas","Erzurumspor","2-0",2,0,"T1",1,2,2,"H"
"2076",2001-04-08,2000,"Istanbulspor","Kocaelispor","1-1",1,1,"T1",1,2,0,"D"
"2077",2001-04-08,2000,"Siirt Jet-PA","Bursaspor","2-5",2,5,"T1",1,7,-3,"A"
"2078",2001-04-08,2000,"Yozgatspor","Galatasaray","4-2",4,2,"T1",1,6,2,"H"
"2079",2001-04-11,2000,"Istanbulspor","Galatasaray","3-5",3,5,"T1",1,8,-2,"A"
"2080",2001-04-13,2000,"Bursaspor","Besiktas","0-1",0,1,"T1",1,1,-1,"A"
"2081",2001-04-14,2000,"Galatasaray","Antalyaspor","2-0",2,0,"T1",1,2,2,"H"
"2082",2001-04-14,2000,"Istanbulspor","Denizlispor","1-3",1,3,"T1",1,4,-2,"A"
"2083",2001-04-14,2000,"Samsunspor","Siirt Jet-PA","4-3",4,3,"T1",1,7,1,"H"
"2084",2001-04-15,2000,"Ankaragucu","Fenerbahce","2-1",2,1,"T1",1,3,1,"H"
"2085",2001-04-15,2000,"Erzurumspor","Yozgatspor","1-2",1,2,"T1",1,3,-1,"A"
"2086",2001-04-15,2000,"Gaziantepspor","Adanaspor","3-0",3,0,"T1",1,3,3,"H"
"2087",2001-04-15,2000,"Kocaelispor","Genclerbirligi","4-1",4,1,"T1",1,5,3,"H"
"2088",2001-04-15,2000,"Trabzonspor","Rizespor","2-0",2,0,"T1",1,2,2,"H"
"2089",2001-04-20,2000,"Besiktas","Samsunspor","0-0",0,0,"T1",1,0,0,"D"
"2090",2001-04-21,2000,"Adanaspor","Trabzonspor","1-7",1,7,"T1",1,8,-6,"A"
"2091",2001-04-21,2000,"Denizlispor","Ankaragucu","2-0",2,0,"T1",1,2,2,"H"
"2092",2001-04-21,2000,"Fenerbahce","Gaziantepspor","4-3",4,3,"T1",1,7,1,"H"
"2093",2001-04-22,2000,"Antalyaspor","Erzurumspor","1-0",1,0,"T1",1,1,1,"H"
"2094",2001-04-22,2000,"Genclerbirligi","Istanbulspor","3-0",3,0,"T1",1,3,3,"H"
"2095",2001-04-22,2000,"Rizespor","Galatasaray","2-4",2,4,"T1",1,6,-2,"A"
"2096",2001-04-22,2000,"Siirt Jet-PA","Kocaelispor","4-3",4,3,"T1",1,7,1,"H"
"2097",2001-04-22,2000,"Yozgatspor","Bursaspor","1-0",1,0,"T1",1,1,1,"H"
"2098",2001-04-27,2000,"Gaziantepspor","Ankaragucu","2-1",2,1,"T1",1,3,1,"H"
"2099",2001-04-28,2000,"Erzurumspor","Rizespor","0-0",0,0,"T1",1,0,0,"D"
"2100",2001-04-28,2000,"Galatasaray","Adanaspor","4-1",4,1,"T1",1,5,3,"H"
"2101",2001-04-28,2000,"Istanbulspor","Siirt Jet-PA","2-1",2,1,"T1",1,3,1,"H"
"2102",2001-04-28,2000,"Kocaelispor","Besiktas","1-1",1,1,"T1",1,2,0,"D"
"2103",2001-04-29,2000,"Bursaspor","Antalyaspor","4-0",4,0,"T1",1,4,4,"H"
"2104",2001-04-29,2000,"Genclerbirligi","Denizlispor","2-4",2,4,"T1",1,6,-2,"A"
"2105",2001-04-29,2000,"Samsunspor","Yozgatspor","0-2",0,2,"T1",1,2,-2,"A"
"2106",2001-04-29,2000,"Trabzonspor","Fenerbahce","1-0",1,0,"T1",1,1,1,"H"
"2107",2001-05-04,2000,"Ankaragucu","Trabzonspor","2-4",2,4,"T1",1,6,-2,"A"
"2108",2001-05-05,2000,"Adanaspor","Erzurumspor","3-3",3,3,"T1",1,6,0,"D"
"2109",2001-05-05,2000,"Antalyaspor","Samsunspor","2-2",2,2,"T1",1,4,0,"D"
"2110",2001-05-05,2000,"Besiktas","Istanbulspor","2-0",2,0,"T1",1,2,2,"H"
"2111",2001-05-05,2000,"Yozgatspor","Kocaelispor","4-2",4,2,"T1",1,6,2,"H"
"2112",2001-05-06,2000,"Denizlispor","Gaziantepspor","2-3",2,3,"T1",1,5,-1,"A"
"2113",2001-05-06,2000,"Fenerbahce","Galatasaray","2-1",2,1,"T1",1,3,1,"H"
"2114",2001-05-06,2000,"Rizespor","Bursaspor","3-1",3,1,"T1",1,4,2,"H"
"2115",2001-05-06,2000,"Siirt Jet-PA","Genclerbirligi","3-0",3,0,"T1",1,3,3,"H"
"2116",2001-05-12,2000,"Bursaspor","Adanaspor","2-1",2,1,"T1",1,3,1,"H"
"2117",2001-05-12,2000,"Denizlispor","Siirt Jet-PA","1-2",1,2,"T1",1,3,-1,"A"
"2118",2001-05-12,2000,"Istanbulspor","Yozgatspor","0-4",0,4,"T1",1,4,-4,"A"
"2119",2001-05-12,2000,"Kocaelispor","Antalyaspor","5-0",5,0,"T1",1,5,5,"H"
"2120",2001-05-12,2000,"Samsunspor","Rizespor","1-1",1,1,"T1",1,2,0,"D"
"2121",2001-05-13,2000,"Erzurumspor","Fenerbahce","1-2",1,2,"T1",1,3,-1,"A"
"2122",2001-05-13,2000,"Gaziantepspor","Trabzonspor","1-1",1,1,"T1",1,2,0,"D"
"2123",2001-05-13,2000,"Genclerbirligi","Besiktas","2-1",2,1,"T1",1,3,1,"H"
"2124",2001-05-13,2000,"Galatasaray","Ankaragucu","1-2",1,2,"T1",1,3,-1,"A"
"2125",2001-05-19,2000,"Adanaspor","Samsunspor","3-5",3,5,"T1",1,8,-2,"A"
"2126",2001-05-19,2000,"Ankaragucu","Erzurumspor","5-2",5,2,"T1",1,7,3,"H"
"2127",2001-05-19,2000,"Antalyaspor","Istanbulspor","2-2",2,2,"T1",1,4,0,"D"
"2128",2001-05-19,2000,"Besiktas","Siirt Jet-PA","5-1",5,1,"T1",1,6,4,"H"
"2129",2001-05-19,2000,"Rizespor","Kocaelispor","2-1",2,1,"T1",1,3,1,"H"
"2130",2001-05-19,2000,"Yozgatspor","Genclerbirligi","1-1",1,1,"T1",1,2,0,"D"
"2131",2001-05-20,2000,"Fenerbahce","Bursaspor","2-0",2,0,"T1",1,2,2,"H"
"2132",2001-05-20,2000,"Gaziantepspor","Galatasaray","0-2",0,2,"T1",1,2,-2,"A"
"2133",2001-05-20,2000,"Trabzonspor","Denizlispor","1-0",1,0,"T1",1,1,1,"H"
"2134",2001-05-25,2000,"Bursaspor","Ankaragucu","2-3",2,3,"T1",1,5,-1,"A"
"2135",2001-05-25,2000,"Denizlispor","Besiktas","2-2",2,2,"T1",1,4,0,"D"
"2136",2001-05-25,2000,"Erzurumspor","Gaziantepspor","0-2",0,2,"T1",1,2,-2,"A"
"2137",2001-05-25,2000,"Istanbulspor","Rizespor","1-0",1,0,"T1",1,1,1,"H"
"2138",2001-05-26,2000,"Genclerbirligi","Antalyaspor","2-1",2,1,"T1",1,3,1,"H"
"2139",2001-05-26,2000,"Galatasaray","Trabzonspor","4-0",4,0,"T1",1,4,4,"H"
"2140",2001-05-26,2000,"Kocaelispor","Adanaspor","4-3",4,3,"T1",1,7,1,"H"
"2141",2001-05-26,2000,"Samsunspor","Fenerbahce","1-3",1,3,"T1",1,4,-2,"A"
"2142",2001-05-26,2000,"Siirt Jet-PA","Yozgatspor","1-3",1,3,"T1",1,4,-2,"A"
"2143",2001-08-10,2001,"Besiktas","Trabzonspor","1-2",1,2,"T1",1,3,-1,"A"
"2144",2001-08-11,2001,"Fenerbahce","Samsunspor","3-0",3,0,"T1",1,3,3,"H"
"2145",2001-08-11,2001,"Genclerbirligi","Diyarbakirspor","4-4",4,4,"T1",1,8,0,"D"
"2146",2001-08-11,2001,"Goztep","Bursaspor","2-0",2,0,"T1",1,2,2,"H"
"2147",2001-08-11,2001,"Rizespor","Kocaelispor","0-0",0,0,"T1",1,0,0,"D"
"2148",2001-08-12,2001,"Antalyaspor","Ankaragucu","1-8",1,8,"T1",1,9,-7,"A"
"2149",2001-08-12,2001,"Denizlispor","Yozgatspor","5-0",5,0,"T1",1,5,5,"H"
"2150",2001-08-12,2001,"Gaziantepspor","Galatasaray","1-1",1,1,"T1",1,2,0,"D"
"2151",2001-08-12,2001,"Istanbulspor","Malatyaspor","1-0",1,0,"T1",1,1,1,"H"
"2152",2001-08-17,2001,"Bursaspor","Besiktas","2-2",2,2,"T1",1,4,0,"D"
"2153",2001-08-18,2001,"Diyarbakirspor","Goztep","1-2",1,2,"T1",1,3,-1,"A"
"2154",2001-08-18,2001,"Galatasaray","Denizlispor","1-0",1,0,"T1",1,1,1,"H"
"2155",2001-08-18,2001,"Kocaelispor","Antalyaspor","3-1",3,1,"T1",1,4,2,"H"
"2156",2001-08-18,2001,"Samsunspor","Genclerbirligi","2-2",2,2,"T1",1,4,0,"D"
"2157",2001-08-19,2001,"Ankaragucu","Malatyaspor","6-0",6,0,"T1",1,6,6,"H"
"2158",2001-08-19,2001,"Istanbulspor","Fenerbahce","1-0",1,0,"T1",1,1,1,"H"
"2159",2001-08-19,2001,"Trabzonspor","Gaziantepspor","2-1",2,1,"T1",1,3,1,"H"
"2160",2001-08-19,2001,"Yozgatspor","Rizespor","2-1",2,1,"T1",1,3,1,"H"
"2161",2001-08-24,2001,"Trabzonspor","Bursaspor","5-0",5,0,"T1",1,5,5,"H"
"2162",2001-08-25,2001,"Antalyaspor","Yozgatspor","3-3",3,3,"T1",1,6,0,"D"
"2163",2001-08-25,2001,"Besiktas","Diyarbakirspor","4-0",4,0,"T1",1,4,4,"H"
"2164",2001-08-25,2001,"Genclerbirligi","Istanbulspor","0-1",0,1,"T1",1,1,-1,"A"
"2165",2001-08-25,2001,"Goztep","Samsunspor","2-1",2,1,"T1",1,3,1,"H"
"2166",2001-08-26,2001,"Fenerbahce","Ankaragucu","4-1",4,1,"T1",1,5,3,"H"
"2167",2001-08-26,2001,"Gaziantepspor","Denizlispor","0-0",0,0,"T1",1,0,0,"D"
"2168",2001-08-26,2001,"Kocaelispor","Malatyaspor","2-0",2,0,"T1",1,2,2,"H"
"2169",2001-08-26,2001,"Rizespor","Galatasaray","3-6",3,6,"T1",1,9,-3,"A"
"2170",2001-09-07,2001,"Ankaragucu","Genclerbirligi","2-5",2,5,"T1",1,7,-3,"A"
"2171",2001-09-08,2001,"Bursaspor","Gaziantepspor","0-2",0,2,"T1",1,2,-2,"A"
"2172",2001-09-08,2001,"Diyarbakirspor","Trabzonspor","3-1",3,1,"T1",1,4,2,"H"
"2173",2001-09-08,2001,"Galatasaray","Antalyaspor","2-1",2,1,"T1",1,3,1,"H"
"2174",2001-09-08,2001,"Kocaelispor","Fenerbahce","3-3",3,3,"T1",1,6,0,"D"
"2175",2001-09-09,2001,"Denizlispor","Rizespor","1-2",1,2,"T1",1,3,-1,"A"
"2176",2001-09-09,2001,"Istanbulspor","Goztep","0-0",0,0,"T1",1,0,0,"D"
"2177",2001-09-09,2001,"Yozgatspor","Malatyaspor","3-0",3,0,"T1",1,3,3,"H"
"2178",2001-09-14,2001,"Besiktas","Istanbulspor","0-1",0,1,"T1",1,1,-1,"A"
"2179",2001-09-15,2001,"Antalyaspor","Denizlispor","1-0",1,0,"T1",1,1,1,"H"
"2180",2001-09-15,2001,"Bursaspor","Diyarbakirspor","2-1",2,1,"T1",1,3,1,"H"
"2181",2001-09-15,2001,"Fenerbahce","Yozgatspor","1-0",1,0,"T1",1,1,1,"H"
"2182",2001-09-15,2001,"Malatyaspor","Galatasaray","0-2",0,2,"T1",1,2,-2,"A"
"2183",2001-09-16,2001,"Gaziantepspor","Rizespor","0-2",0,2,"T1",1,2,-2,"A"
"2184",2001-09-16,2001,"Genclerbirligi","Kocaelispor","2-2",2,2,"T1",1,4,0,"D"
"2185",2001-09-16,2001,"Goztep","Ankaragucu","2-1",2,1,"T1",1,3,1,"H"
"2186",2001-09-16,2001,"Trabzonspor","Samsunspor","1-2",1,2,"T1",1,3,-1,"A"
"2187",2001-09-21,2001,"Kocaelispor","Goztep","2-0",2,0,"T1",1,2,2,"H"
"2188",2001-09-22,2001,"Bursaspor","Samsunspor","2-1",2,1,"T1",1,3,1,"H"
"2189",2001-09-22,2001,"Denizlispor","Malatyaspor","4-1",4,1,"T1",1,5,3,"H"
"2190",2001-09-22,2001,"Galatasaray","Fenerbahce","2-0",2,0,"T1",1,2,2,"H"
"2191",2001-09-23,2001,"Ankaragucu","Besiktas","3-4",3,4,"T1",1,7,-1,"A"
"2192",2001-09-23,2001,"Istanbulspor","Trabzonspor","2-1",2,1,"T1",1,3,1,"H"
"2193",2001-09-23,2001,"Rizespor","Antalyaspor","1-1",1,1,"T1",1,2,0,"D"
"2194",2001-09-23,2001,"Yozgatspor","Genclerbirligi","0-2",0,2,"T1",1,2,-2,"A"
"2195",2001-09-28,2001,"Trabzonspor","Ankaragucu","2-2",2,2,"T1",1,4,0,"D"
"2196",2001-09-29,2001,"Diyarbakirspor","Samsunspor","1-1",1,1,"T1",1,2,0,"D"
"2197",2001-09-29,2001,"Fenerbahce","Denizlispor","2-1",2,1,"T1",1,3,1,"H"
"2198",2001-09-29,2001,"Malatyaspor","Rizespor","2-1",2,1,"T1",1,3,1,"H"
"2199",2001-09-30,2001,"Besiktas","Kocaelispor","4-2",4,2,"T1",1,6,2,"H"
"2200",2001-09-30,2001,"Bursaspor","Istanbulspor","1-2",1,2,"T1",1,3,-1,"A"
"2201",2001-09-30,2001,"Gaziantepspor","Antalyaspor","2-3",2,3,"T1",1,5,-1,"A"
"2202",2001-09-30,2001,"Genclerbirligi","Galatasaray","1-3",1,3,"T1",1,4,-2,"A"
"2203",2001-09-30,2001,"Goztep","Yozgatspor","0-0",0,0,"T1",1,0,0,"D"
"2204",2001-10-10,2001,"Diyarbakirspor","Gaziantepspor","2-3",2,3,"T1",1,5,-1,"A"
"2205",2001-10-10,2001,"Samsunspor","Besiktas","2-1",2,1,"T1",1,3,1,"H"
"2206",2001-10-12,2001,"Galatasaray","Goztep","4-1",4,1,"T1",1,5,3,"H"
"2207",2001-10-13,2001,"Ankaragucu","Bursaspor","0-1",0,1,"T1",1,1,-1,"A"
"2208",2001-10-13,2001,"Antalyaspor","Malatyaspor","2-1",2,1,"T1",1,3,1,"H"
"2209",2001-10-13,2001,"Denizlispor","Genclerbirligi","4-1",4,1,"T1",1,5,3,"H"
"2210",2001-10-13,2001,"Kocaelispor","Trabzonspor","1-0",1,0,"T1",1,1,1,"H"
"2211",2001-10-14,2001,"Gaziantepspor","Samsunspor","1-0",1,0,"T1",1,1,1,"H"
"2212",2001-10-14,2001,"Istanbulspor","Diyarbakirspor","1-0",1,0,"T1",1,1,1,"H"
"2213",2001-10-14,2001,"Rizespor","Fenerbahce","1-2",1,2,"T1",1,3,-1,"A"
"2214",2001-10-14,2001,"Yozgatspor","Besiktas","1-3",1,3,"T1",1,4,-2,"A"
"2215",2001-10-19,2001,"Diyarbakirspor","Ankaragucu","2-1",2,1,"T1",1,3,1,"H"
"2216",2001-10-20,2001,"Fenerbahce","Antalyaspor","3-2",3,2,"T1",1,5,1,"H"
"2217",2001-10-20,2001,"Gaziantepspor","Malatyaspor","1-0",1,0,"T1",1,1,1,"H"
"2218",2001-10-20,2001,"Istanbulspor","Samsunspor","0-1",0,1,"T1",1,1,-1,"A"
"2219",2001-10-20,2001,"Trabzonspor","Yozgatspor","2-0",2,0,"T1",1,2,2,"H"
"2220",2001-10-21,2001,"Besiktas","Galatasaray","2-2",2,2,"T1",1,4,0,"D"
"2221",2001-10-21,2001,"Bursaspor","Kocaelispor","2-1",2,1,"T1",1,3,1,"H"
"2222",2001-10-21,2001,"Genclerbirligi","Rizespor","2-2",2,2,"T1",1,4,0,"D"
"2223",2001-10-21,2001,"Goztep","Denizlispor","1-1",1,1,"T1",1,2,0,"D"
"2224",2001-10-26,2001,"Kocaelispor","Diyarbakirspor","3-1",3,1,"T1",1,4,2,"H"
"2225",2001-10-27,2001,"Galatasaray","Trabzonspor","3-1",3,1,"T1",1,4,2,"H"
"2226",2001-10-27,2001,"Malatyaspor","Fenerbahce","1-3",1,3,"T1",1,4,-2,"A"
"2227",2001-10-27,2001,"Rizespor","Goztep","0-0",0,0,"T1",1,0,0,"D"
"2228",2001-10-27,2001,"Yozgatspor","Bursaspor","3-4",3,4,"T1",1,7,-1,"A"
"2229",2001-10-28,2001,"Ankaragucu","Samsunspor","2-0",2,0,"T1",1,2,2,"H"
"2230",2001-10-28,2001,"Antalyaspor","Genclerbirligi","2-2",2,2,"T1",1,4,0,"D"
"2231",2001-10-28,2001,"Denizlispor","Besiktas","3-3",3,3,"T1",1,6,0,"D"
"2232",2001-10-28,2001,"Istanbulspor","Gaziantepspor","0-1",0,1,"T1",1,1,-1,"A"
"2233",2001-11-02,2001,"Bursaspor","Galatasaray","5-0",5,0,"T1",1,5,5,"H"
"2234",2001-11-03,2001,"Besiktas","Rizespor","2-1",2,1,"T1",1,3,1,"H"
"2235",2001-11-03,2001,"Genclerbirligi","Malatyaspor","1-2",1,2,"T1",1,3,-1,"A"
"2236",2001-11-03,2001,"Istanbulspor","Ankaragucu","1-2",1,2,"T1",1,3,-1,"A"
"2237",2001-11-03,2001,"Kocaelispor","Samsunspor","0-1",0,1,"T1",1,1,-1,"A"
"2238",2001-11-04,2001,"Diyarbakirspor","Yozgatspor","1-1",1,1,"T1",1,2,0,"D"
"2239",2001-11-04,2001,"Gaziantepspor","Fenerbahce","0-2",0,2,"T1",1,2,-2,"A"
"2240",2001-11-04,2001,"Goztep","Antalyaspor","0-0",0,0,"T1",1,0,0,"D"
"2241",2001-11-04,2001,"Trabzonspor","Denizlispor","2-2",2,2,"T1",1,4,0,"D"
"2242",2001-11-16,2001,"Antalyaspor","Besiktas","1-4",1,4,"T1",1,5,-3,"A"
"2243",2001-11-17,2001,"Ankaragucu","Gaziantepspor","1-1",1,1,"T1",1,2,0,"D"
"2244",2001-11-17,2001,"Galatasaray","Diyarbakirspor","5-1",5,1,"T1",1,6,4,"H"
"2245",2001-11-17,2001,"Rizespor","Trabzonspor","1-1",1,1,"T1",1,2,0,"D"
"2246",2001-11-17,2001,"Yozgatspor","Samsunspor","2-0",2,0,"T1",1,2,2,"H"
"2247",2001-11-18,2001,"Denizlispor","Bursaspor","0-0",0,0,"T1",1,0,0,"D"
"2248",2001-11-18,2001,"Fenerbahce","Genclerbirligi","2-0",2,0,"T1",1,2,2,"H"
"2249",2001-11-18,2001,"Kocaelispor","Istanbulspor","2-0",2,0,"T1",1,2,2,"H"
"2250",2001-11-18,2001,"Malatyaspor","Goztep","3-1",3,1,"T1",1,4,2,"H"
"2251",2001-11-23,2001,"Goztep","Fenerbahce","0-5",0,5,"T1",1,5,-5,"A"
"2252",2001-11-24,2001,"Diyarbakirspor","Denizlispor","3-0",3,0,"T1",1,3,3,"H"
"2253",2001-11-24,2001,"Galatasaray","Samsunspor","2-0",2,0,"T1",1,2,2,"H"
"2254",2001-11-24,2001,"Istanbulspor","Yozgatspor","2-0",2,0,"T1",1,2,2,"H"
"2255",2001-11-24,2001,"Trabzonspor","Antalyaspor","2-0",2,0,"T1",1,2,2,"H"
"2256",2001-11-25,2001,"Ankaragucu","Kocaelispor","2-0",2,0,"T1",1,2,2,"H"
"2257",2001-11-25,2001,"Besiktas","Malatyaspor","3-1",3,1,"T1",1,4,2,"H"
"2258",2001-11-25,2001,"Bursaspor","Rizespor","1-0",1,0,"T1",1,1,1,"H"
"2259",2001-11-25,2001,"Gaziantepspor","Genclerbirligi","5-0",5,0,"T1",1,5,5,"H"
"2260",2001-11-30,2001,"Galatasaray","Istanbulspor","4-1",4,1,"T1",1,5,3,"H"
"2261",2001-12-01,2001,"Denizlispor","Samsunspor","4-1",4,1,"T1",1,5,3,"H"
"2262",2001-12-01,2001,"Kocaelispor","Gaziantepspor","0-0",0,0,"T1",1,0,0,"D"
"2263",2001-12-01,2001,"Rizespor","Diyarbakirspor","2-0",2,0,"T1",1,2,2,"H"
"2264",2001-12-01,2001,"Yozgatspor","Ankaragucu","0-2",0,2,"T1",1,2,-2,"A"
"2265",2001-12-02,2001,"Antalyaspor","Bursaspor","3-0",3,0,"T1",1,3,3,"H"
"2266",2001-12-02,2001,"Fenerbahce","Besiktas","1-2",1,2,"T1",1,3,-1,"A"
"2267",2001-12-02,2001,"Genclerbirligi","Goztep","0-1",0,1,"T1",1,1,-1,"A"
"2268",2001-12-02,2001,"Malatyaspor","Trabzonspor","1-0",1,0,"T1",1,1,1,"H"
"2269",2001-12-07,2001,"Besiktas","Genclerbirligi","1-0",1,0,"T1",1,1,1,"H"
"2270",2001-12-08,2001,"Bursaspor","Malatyaspor","1-0",1,0,"T1",1,1,1,"H"
"2271",2001-12-08,2001,"Goztep","Gaziantepspor","1-3",1,3,"T1",1,4,-2,"A"
"2272",2001-12-08,2001,"Istanbulspor","Denizlispor","1-1",1,1,"T1",1,2,0,"D"
"2273",2001-12-08,2001,"Trabzonspor","Fenerbahce","2-1",2,1,"T1",1,3,1,"H"
"2274",2001-12-09,2001,"Ankaragucu","Galatasaray","2-1",2,1,"T1",1,3,1,"H"
"2275",2001-12-09,2001,"Diyarbakirspor","Antalyaspor","3-1",3,1,"T1",1,4,2,"H"
"2276",2001-12-09,2001,"Rizespor","Samsunspor","1-0",1,0,"T1",1,1,1,"H"
"2277",2001-12-09,2001,"Yozgatspor","Kocaelispor","4-0",4,0,"T1",1,4,4,"H"
"2278",2001-12-14,2001,"Fenerbahce","Bursaspor","3-1",3,1,"T1",1,4,2,"H"
"2279",2001-12-15,2001,"Antalyaspor","Samsunspor","1-1",1,1,"T1",1,2,0,"D"
"2280",2001-12-15,2001,"Denizlispor","Ankaragucu","3-4",3,4,"T1",1,7,-1,"A"
"2281",2001-12-15,2001,"Gaziantepspor","Yozgatspor","3-2",3,2,"T1",1,5,1,"H"
"2282",2001-12-15,2001,"Goztep","Besiktas","0-6",0,6,"T1",1,6,-6,"A"
"2283",2001-12-16,2001,"Genclerbirligi","Trabzonspor","1-1",1,1,"T1",1,2,0,"D"
"2284",2001-12-16,2001,"Malatyaspor","Diyarbakirspor","1-3",1,3,"T1",1,4,-2,"A"
"2285",2001-12-16,2001,"Rizespor","Istanbulspor","1-1",1,1,"T1",1,2,0,"D"
"2286",2001-12-21,2001,"Diyarbakirspor","Fenerbahce","2-1",2,1,"T1",1,3,1,"H"
"2287",2001-12-22,2001,"Ankaragucu","Rizespor","1-1",1,1,"T1",1,2,0,"D"
"2288",2001-12-22,2001,"Besiktas","Gaziantepspor","3-1",3,1,"T1",1,4,2,"H"
"2289",2001-12-22,2001,"Bursaspor","Genclerbirligi","0-1",0,1,"T1",1,1,-1,"A"
"2290",2001-12-22,2001,"Istanbulspor","Antalyaspor","4-1",4,1,"T1",1,5,3,"H"
"2291",2001-12-22,2001,"Kocaelispor","Denizlispor","2-1",2,1,"T1",1,3,1,"H"
"2292",2001-12-22,2001,"Malatyaspor","Samsunspor","1-3",1,3,"T1",1,4,-2,"A"
"2293",2001-12-22,2001,"Trabzonspor","Goztep","3-0",3,0,"T1",1,3,3,"H"
"2294",2001-12-23,2001,"Yozgatspor","Galatasaray","3-3",3,3,"T1",1,6,0,"D"
"2295",2002-01-15,2001,"Galatasaray","Kocaelispor","5-1",5,1,"T1",1,6,4,"H"
"2296",2002-01-18,2001,"Samsunspor","Fenerbahce","1-0",1,0,"T1",1,1,1,"H"
"2297",2002-01-19,2001,"Ankaragucu","Antalyaspor","2-0",2,0,"T1",1,2,2,"H"
"2298",2002-01-19,2001,"Diyarbakirspor","Genclerbirligi","1-2",1,2,"T1",1,3,-1,"A"
"2299",2002-01-19,2001,"Galatasaray","Gaziantepspor","2-0",2,0,"T1",1,2,2,"H"
"2300",2002-01-19,2001,"Malatyaspor","Istanbulspor","2-0",2,0,"T1",1,2,2,"H"
"2301",2002-01-20,2001,"Bursaspor","Goztep","0-0",0,0,"T1",1,0,0,"D"
"2302",2002-01-20,2001,"Kocaelispor","Rizespor","2-1",2,1,"T1",1,3,1,"H"
"2303",2002-01-20,2001,"Trabzonspor","Besiktas","0-5",0,5,"T1",1,5,-5,"A"
"2304",2002-01-20,2001,"Yozgatspor","Denizlispor","0-1",0,1,"T1",1,1,-1,"A"
"2305",2002-01-22,2001,"Fenerbahce","Istanbulspor","2-0",2,0,"T1",1,2,2,"H"
"2306",2002-01-22,2001,"Malatyaspor","Ankaragucu","4-1",4,1,"T1",1,5,3,"H"
"2307",2002-01-23,2001,"Antalyaspor","Kocaelispor","2-0",2,0,"T1",1,2,2,"H"
"2308",2002-01-23,2001,"Denizlispor","Galatasaray","1-1",1,1,"T1",1,2,0,"D"
"2309",2002-01-23,2001,"Gaziantepspor","Trabzonspor","5-2",5,2,"T1",1,7,3,"H"
"2310",2002-01-23,2001,"Goztep","Diyarbakirspor","3-1",3,1,"T1",1,4,2,"H"
"2311",2002-01-23,2001,"Rizespor","Yozgatspor","1-1",1,1,"T1",1,2,0,"D"
"2312",2002-01-23,2001,"Genclerbirligi","Samsunspor","2-0",2,0,"T1",1,2,2,"H"
"2313",2002-01-24,2001,"Besiktas","Bursaspor","2-1",2,1,"T1",1,3,1,"H"
"2314",2002-01-26,2001,"Ankaragucu","Fenerbahce","3-2",3,2,"T1",1,5,1,"H"
"2315",2002-01-27,2001,"Bursaspor","Trabzonspor","2-2",2,2,"T1",1,4,0,"D"
"2316",2002-01-27,2001,"Denizlispor","Gaziantepspor","5-2",5,2,"T1",1,7,3,"H"
"2317",2002-01-27,2001,"Diyarbakirspor","Besiktas","0-0",0,0,"T1",1,0,0,"D"
"2318",2002-01-27,2001,"Galatasaray","Rizespor","4-1",4,1,"T1",1,5,3,"H"
"2319",2002-01-27,2001,"Istanbulspor","Genclerbirligi","0-0",0,0,"T1",1,0,0,"D"
"2320",2002-01-27,2001,"Malatyaspor","Kocaelispor","2-1",2,1,"T1",1,3,1,"H"
"2321",2002-01-27,2001,"Samsunspor","Goztep","1-2",1,2,"T1",1,3,-1,"A"
"2322",2002-01-27,2001,"Yozgatspor","Antalyaspor","3-2",3,2,"T1",1,5,1,"H"
"2323",2002-02-01,2001,"Fenerbahce","Kocaelispor","3-0",3,0,"T1",1,3,3,"H"
"2324",2002-02-02,2001,"Besiktas","Samsunspor","0-0",0,0,"T1",1,0,0,"D"
"2325",2002-02-02,2001,"Gaziantepspor","Bursaspor","5-2",5,2,"T1",1,7,3,"H"
"2326",2002-02-02,2001,"Rizespor","Denizlispor","3-1",3,1,"T1",1,4,2,"H"
"2327",2002-02-02,2001,"Trabzonspor","Diyarbakirspor","0-2",0,2,"T1",1,2,-2,"A"
"2328",2002-02-03,2001,"Antalyaspor","Galatasaray","1-1",1,1,"T1",1,2,0,"D"
"2329",2002-02-03,2001,"Genclerbirligi","Ankaragucu","0-1",0,1,"T1",1,1,-1,"A"
"2330",2002-02-03,2001,"Goztep","Istanbulspor","0-0",0,0,"T1",1,0,0,"D"
"2331",2002-02-03,2001,"Malatyaspor","Yozgatspor","2-1",2,1,"T1",1,3,1,"H"
"2332",2002-02-08,2001,"Galatasaray","Malatyaspor","1-0",1,0,"T1",1,1,1,"H"
"2333",2002-02-09,2001,"Ankaragucu","Goztep","4-2",4,2,"T1",1,6,2,"H"
"2334",2002-02-09,2001,"Denizlispor","Antalyaspor","3-2",3,2,"T1",1,5,1,"H"
"2335",2002-02-09,2001,"Diyarbakirspor","Bursaspor","2-3",2,3,"T1",1,5,-1,"A"
"2336",2002-02-09,2001,"Yozgatspor","Fenerbahce","1-2",1,2,"T1",1,3,-1,"A"
"2337",2002-02-10,2001,"Istanbulspor","Besiktas","1-2",1,2,"T1",1,3,-1,"A"
"2338",2002-02-10,2001,"Kocaelispor","Genclerbirligi","0-1",0,1,"T1",1,1,-1,"A"
"2339",2002-02-10,2001,"Rizespor","Gaziantepspor","1-0",1,0,"T1",1,1,1,"H"
"2340",2002-02-10,2001,"Samsunspor","Trabzonspor","1-2",1,2,"T1",1,3,-1,"A"
"2341",2002-02-15,2001,"Gaziantepspor","Diyarbakirspor","0-1",0,1,"T1",1,1,-1,"A"
"2342",2002-02-16,2001,"Fenerbahce","Galatasaray","1-0",1,0,"T1",1,1,1,"H"
"2343",2002-02-16,2001,"Genclerbirligi","Yozgatspor","3-2",3,2,"T1",1,5,1,"H"
"2344",2002-02-16,2001,"Malatyaspor","Denizlispor","0-0",0,0,"T1",1,0,0,"D"
"2345",2002-02-16,2001,"Samsunspor","Bursaspor","2-3",2,3,"T1",1,5,-1,"A"
"2346",2002-02-17,2001,"Antalyaspor","Rizespor","2-2",2,2,"T1",1,4,0,"D"
"2347",2002-02-17,2001,"Besiktas","Ankaragucu","1-2",1,2,"T1",1,3,-1,"A"
"2348",2002-02-17,2001,"Goztep","Kocaelispor","3-0",3,0,"T1",1,3,3,"H"
"2349",2002-02-17,2001,"Trabzonspor","Istanbulspor","2-0",2,0,"T1",1,2,2,"H"
"2350",2002-02-22,2001,"Kocaelispor","Besiktas","0-2",0,2,"T1",1,2,-2,"A"
"2351",2002-02-23,2001,"Antalyaspor","Gaziantepspor","3-3",3,3,"T1",1,6,0,"D"
"2352",2002-02-23,2001,"Galatasaray","Genclerbirligi","3-1",3,1,"T1",1,4,2,"H"
"2353",2002-02-23,2001,"Istanbulspor","Bursaspor","3-0",3,0,"T1",1,3,3,"H"
"2354",2002-02-23,2001,"Samsunspor","Diyarbakirspor","0-0",0,0,"T1",1,0,0,"D"
"2355",2002-02-24,2001,"Ankaragucu","Trabzonspor","4-2",4,2,"T1",1,6,2,"H"
"2356",2002-02-24,2001,"Denizlispor","Fenerbahce","1-2",1,2,"T1",1,3,-1,"A"
"2357",2002-02-24,2001,"Rizespor","Malatyaspor","0-0",0,0,"T1",1,0,0,"D"
"2358",2002-02-24,2001,"Yozgatspor","Goztep","1-1",1,1,"T1",1,2,0,"D"
"2359",2002-03-01,2001,"Fenerbahce","Rizespor","2-1",2,1,"T1",1,3,1,"H"
"2360",2002-03-02,2001,"Besiktas","Yozgatspor","4-2",4,2,"T1",1,6,2,"H"
"2361",2002-03-02,2001,"Genclerbirligi","Denizlispor","4-2",4,2,"T1",1,6,2,"H"
"2362",2002-03-02,2001,"Samsunspor","Gaziantepspor","2-1",2,1,"T1",1,3,1,"H"
"2363",2002-03-02,2001,"Trabzonspor","Kocaelispor","1-2",1,2,"T1",1,3,-1,"A"
"2364",2002-03-03,2001,"Bursaspor","Ankaragucu","2-1",2,1,"T1",1,3,1,"H"
"2365",2002-03-03,2001,"Diyarbakirspor","Istanbulspor","1-0",1,0,"T1",1,1,1,"H"
"2366",2002-03-03,2001,"Goztep","Galatasaray","2-0",2,0,"T1",1,2,2,"H"
"2367",2002-03-03,2001,"Malatyaspor","Antalyaspor","2-1",2,1,"T1",1,3,1,"H"
"2368",2002-03-08,2001,"Ankaragucu","Diyarbakirspor","1-1",1,1,"T1",1,2,0,"D"
"2369",2002-03-09,2001,"Galatasaray","Besiktas","1-0",1,0,"T1",1,1,1,"H"
"2370",2002-03-09,2001,"Rizespor","Genclerbirligi","1-2",1,2,"T1",1,3,-1,"A"
"2371",2002-03-09,2001,"Samsunspor","Istanbulspor","0-1",0,1,"T1",1,1,-1,"A"
"2372",2002-03-09,2001,"Yozgatspor","Trabzonspor","2-3",2,3,"T1",1,5,-1,"A"
"2373",2002-03-10,2001,"Antalyaspor","Fenerbahce","0-1",0,1,"T1",1,1,-1,"A"
"2374",2002-03-10,2001,"Denizlispor","Goztep","2-1",2,1,"T1",1,3,1,"H"
"2375",2002-03-10,2001,"Kocaelispor","Bursaspor","1-2",1,2,"T1",1,3,-1,"A"
"2376",2002-03-10,2001,"Malatyaspor","Gaziantepspor","1-1",1,1,"T1",1,2,0,"D"
"2377",2002-03-15,2001,"Besiktas","Denizlispor","2-2",2,2,"T1",1,4,0,"D"
"2378",2002-03-16,2001,"Bursaspor","Yozgatspor","3-1",3,1,"T1",1,4,2,"H"
"2379",2002-03-16,2001,"Gaziantepspor","Istanbulspor","2-2",2,2,"T1",1,4,0,"D"
"2380",2002-03-16,2001,"Goztep","Rizespor","2-3",2,3,"T1",1,5,-1,"A"
"2381",2002-03-17,2001,"Diyarbakirspor","Kocaelispor","1-1",1,1,"T1",1,2,0,"D"
"2382",2002-03-17,2001,"Fenerbahce","Malatyaspor","2-2",2,2,"T1",1,4,0,"D"
"2383",2002-03-17,2001,"Genclerbirligi","Antalyaspor","1-0",1,0,"T1",1,1,1,"H"
"2384",2002-03-17,2001,"Samsunspor","Ankaragucu","2-0",2,0,"T1",1,2,2,"H"
"2385",2002-03-22,2001,"Fenerbahce","Gaziantepspor","4-1",4,1,"T1",1,5,3,"H"
"2386",2002-03-23,2001,"Denizlispor","Trabzonspor","2-1",2,1,"T1",1,3,1,"H"
"2387",2002-03-23,2001,"Galatasaray","Bursaspor","2-1",2,1,"T1",1,3,1,"H"
"2388",2002-03-23,2001,"Samsunspor","Kocaelispor","0-0",0,0,"T1",1,0,0,"D"
"2389",2002-03-23,2001,"Yozgatspor","Diyarbakirspor","2-0",2,0,"T1",1,2,2,"H"
"2390",2002-03-24,2001,"Ankaragucu","Istanbulspor","4-2",4,2,"T1",1,6,2,"H"
"2391",2002-03-24,2001,"Antalyaspor","Goztep","2-0",2,0,"T1",1,2,2,"H"
"2392",2002-03-24,2001,"Malatyaspor","Genclerbirligi","1-0",1,0,"T1",1,1,1,"H"
"2393",2002-03-24,2001,"Rizespor","Besiktas","1-3",1,3,"T1",1,4,-2,"A"
"2394",2002-03-29,2001,"Besiktas","Antalyaspor","0-0",0,0,"T1",1,0,0,"D"
"2395",2002-03-30,2001,"Diyarbakirspor","Galatasaray","0-0",0,0,"T1",1,0,0,"D"
"2396",2002-03-30,2001,"Gaziantepspor","Ankaragucu","1-1",1,1,"T1",1,2,0,"D"
"2397",2002-03-30,2001,"Istanbulspor","Kocaelispor","0-1",0,1,"T1",1,1,-1,"A"
"2398",2002-03-30,2001,"Trabzonspor","Rizespor","2-1",2,1,"T1",1,3,1,"H"
"2399",2002-03-31,2001,"Bursaspor","Denizlispor","3-3",3,3,"T1",1,6,0,"D"
"2400",2002-03-31,2001,"Genclerbirligi","Fenerbahce","1-1",1,1,"T1",1,2,0,"D"
"2401",2002-03-31,2001,"Goztep","Malatyaspor","2-1",2,1,"T1",1,3,1,"H"
"2402",2002-03-31,2001,"Samsunspor","Yozgatspor","0-0",0,0,"T1",1,0,0,"D"
"2403",2002-04-03,2001,"Trabzonspor","Galatasaray","0-2",0,2,"T1",1,2,-2,"A"
"2404",2002-04-05,2001,"Fenerbahce","Goztep","3-0",3,0,"T1",1,3,3,"H"
"2405",2002-04-06,2001,"Denizlispor","Diyarbakirspor","2-1",2,1,"T1",1,3,1,"H"
"2406",2002-04-06,2001,"Genclerbirligi","Gaziantepspor","1-1",1,1,"T1",1,2,0,"D"
"2407",2002-04-06,2001,"Rizespor","Bursaspor","3-1",3,1,"T1",1,4,2,"H"
"2408",2002-04-07,2001,"Antalyaspor","Trabzonspor","4-2",4,2,"T1",1,6,2,"H"
"2409",2002-04-07,2001,"Kocaelispor","Ankaragucu","4-4",4,4,"T1",1,8,0,"D"
"2410",2002-04-07,2001,"Malatyaspor","Besiktas","0-1",0,1,"T1",1,1,-1,"A"
"2411",2002-04-07,2001,"Samsunspor","Galatasaray","0-1",0,1,"T1",1,1,-1,"A"
"2412",2002-04-07,2001,"Yozgatspor","Istanbulspor","1-1",1,1,"T1",1,2,0,"D"
"2413",2002-04-12,2001,"Trabzonspor","Malatyaspor","0-0",0,0,"T1",1,0,0,"D"
"2414",2002-04-13,2001,"Ankaragucu","Yozgatspor","1-1",1,1,"T1",1,2,0,"D"
"2415",2002-04-13,2001,"Goztep","Genclerbirligi","1-1",1,1,"T1",1,2,0,"D"
"2416",2002-04-13,2001,"Istanbulspor","Galatasaray","0-2",0,2,"T1",1,2,-2,"A"
"2417",2002-04-13,2001,"Samsunspor","Denizlispor","3-4",3,4,"T1",1,7,-1,"A"
"2418",2002-04-14,2001,"Besiktas","Fenerbahce","0-2",0,2,"T1",1,2,-2,"A"
"2419",2002-04-14,2001,"Bursaspor","Antalyaspor","0-1",0,1,"T1",1,1,-1,"A"
"2420",2002-04-14,2001,"Diyarbakirspor","Rizespor","1-0",1,0,"T1",1,1,1,"H"
"2421",2002-04-14,2001,"Gaziantepspor","Kocaelispor","3-5",3,5,"T1",1,8,-2,"A"
"2422",2002-04-20,2001,"Genclerbirligi","Besiktas","1-1",1,1,"T1",1,2,0,"D"
"2423",2002-04-21,2001,"Antalyaspor","Diyarbakirspor","0-0",0,0,"T1",1,0,0,"D"
"2424",2002-04-21,2001,"Denizlispor","Istanbulspor","1-1",1,1,"T1",1,2,0,"D"
"2425",2002-04-21,2001,"Fenerbahce","Trabzonspor","3-0",3,0,"T1",1,3,3,"H"
"2426",2002-04-21,2001,"Gaziantepspor","Goztep","4-0",4,0,"T1",1,4,4,"H"
"2427",2002-04-21,2001,"Galatasaray","Ankaragucu","2-0",2,0,"T1",1,2,2,"H"
"2428",2002-04-21,2001,"Kocaelispor","Yozgatspor","4-3",4,3,"T1",1,7,1,"H"
"2429",2002-04-21,2001,"Malatyaspor","Bursaspor","2-1",2,1,"T1",1,3,1,"H"
"2430",2002-04-21,2001,"Samsunspor","Rizespor","1-0",1,0,"T1",1,1,1,"H"
"2431",2002-04-27,2001,"Ankaragucu","Denizlispor","1-1",1,1,"T1",1,2,0,"D"
"2432",2002-04-27,2001,"Besiktas","Goztep","1-2",1,2,"T1",1,3,-1,"A"
"2433",2002-04-27,2001,"Diyarbakirspor","Malatyaspor","0-0",0,0,"T1",1,0,0,"D"
"2434",2002-04-27,2001,"Istanbulspor","Rizespor","3-1",3,1,"T1",1,4,2,"H"
"2435",2002-04-27,2001,"Samsunspor","Antalyaspor","2-0",2,0,"T1",1,2,2,"H"
"2436",2002-04-27,2001,"Trabzonspor","Genclerbirligi","0-0",0,0,"T1",1,0,0,"D"
"2437",2002-04-27,2001,"Yozgatspor","Gaziantepspor","1-2",1,2,"T1",1,3,-1,"A"
"2438",2002-04-28,2001,"Bursaspor","Fenerbahce","0-1",0,1,"T1",1,1,-1,"A"
"2439",2002-04-28,2001,"Kocaelispor","Galatasaray","0-2",0,2,"T1",1,2,-2,"A"
"2440",2002-05-03,2001,"Goztep","Trabzonspor","4-2",4,2,"T1",1,6,2,"H"
"2441",2002-05-04,2001,"Antalyaspor","Istanbulspor","2-0",2,0,"T1",1,2,2,"H"
"2442",2002-05-04,2001,"Denizlispor","Kocaelispor","4-0",4,0,"T1",1,4,4,"H"
"2443",2002-05-04,2001,"Fenerbahce","Diyarbakirspor","3-1",3,1,"T1",1,4,2,"H"
"2444",2002-05-04,2001,"Gaziantepspor","Besiktas","1-0",1,0,"T1",1,1,1,"H"
"2445",2002-05-04,2001,"Genclerbirligi","Bursaspor","3-2",3,2,"T1",1,5,1,"H"
"2446",2002-05-04,2001,"Galatasaray","Yozgatspor","5-0",5,0,"T1",1,5,5,"H"
"2447",2002-05-04,2001,"Rizespor","Ankaragucu","3-2",3,2,"T1",1,5,1,"H"
"2448",2002-05-04,2001,"Samsunspor","Malatyaspor","1-1",1,1,"T1",1,2,0,"D"
"2449",2002-08-09,2002,"Trabzonspor","Fenerbahce","0-0",0,0,"T1",1,0,0,"D"
"2450",2002-08-10,2002,"Ankaragucu","Malatyaspor","1-1",1,1,"T1",1,2,0,"D"
"2451",2002-08-10,2002,"Bursaspor","Besiktas","2-2",2,2,"T1",1,4,0,"D"
"2452",2002-08-10,2002,"Diyarbakirspor","Altay","1-1",1,1,"T1",1,2,0,"D"
"2453",2002-08-10,2002,"Istanbulspor","Adanaspor","2-2",2,2,"T1",1,4,0,"D"
"2454",2002-08-11,2002,"Galatasaray","Samsunspor","4-1",4,1,"T1",1,5,3,"H"
"2455",2002-08-11,2002,"Gaziantepspor","Denizlispor","1-1",1,1,"T1",1,2,0,"D"
"2456",2002-08-11,2002,"Goztep","Elazigspor","2-1",2,1,"T1",1,3,1,"H"
"2457",2002-08-11,2002,"Kocaelispor","Genclerbirligi","1-3",1,3,"T1",1,4,-2,"A"
"2458",2002-08-16,2002,"Denizlispor","Galatasaray","1-3",1,3,"T1",1,4,-2,"A"
"2459",2002-08-17,2002,"Besiktas","Kocaelispor","2-1",2,1,"T1",1,3,1,"H"
"2460",2002-08-17,2002,"Elazigspor","Trabzonspor","2-0",2,0,"T1",1,2,2,"H"
"2461",2002-08-17,2002,"Genclerbirligi","Istanbulspor","4-1",4,1,"T1",1,5,3,"H"
"2462",2002-08-17,2002,"Malatyaspor","Gaziantepspor","1-1",1,1,"T1",1,2,0,"D"
"2463",2002-08-17,2002,"Samsunspor","Bursaspor","1-0",1,0,"T1",1,1,1,"H"
"2464",2002-08-18,2002,"Adanaspor","Diyarbakirspor","2-1",2,1,"T1",1,3,1,"H"
"2465",2002-08-18,2002,"Altay","Goztep","4-2",4,2,"T1",1,6,2,"H"
"2466",2002-08-18,2002,"Fenerbahce","Ankaragucu","1-0",1,0,"T1",1,1,1,"H"
"2467",2002-08-24,2002,"Goztep","Adanaspor","1-4",1,4,"T1",1,5,-3,"A"
"2468",2002-08-24,2002,"Istanbulspor","Besiktas","1-2",1,2,"T1",1,3,-1,"A"
"2469",2002-08-24,2002,"Kocaelispor","Samsunspor","1-2",1,2,"T1",1,3,-1,"A"
"2470",2002-08-24,2002,"Trabzonspor","Altay","0-0",0,0,"T1",1,0,0,"D"
"2471",2002-08-25,2002,"Ankaragucu","Elazigspor","3-1",3,1,"T1",1,4,2,"H"
"2472",2002-08-25,2002,"Denizlispor","Malatyaspor","1-0",1,0,"T1",1,1,1,"H"
"2473",2002-08-25,2002,"Diyarbakirspor","Genclerbirligi","1-4",1,4,"T1",1,5,-3,"A"
"2474",2002-08-25,2002,"Galatasaray","Bursaspor","2-0",2,0,"T1",1,2,2,"H"
"2475",2002-08-30,2002,"Besiktas","Diyarbakirspor","2-0",2,0,"T1",1,2,2,"H"
"2476",2002-08-31,2002,"Adanaspor","Trabzonspor","0-1",0,1,"T1",1,1,-1,"A"
"2477",2002-08-31,2002,"Altay","Ankaragucu","2-3",2,3,"T1",1,5,-1,"A"
"2478",2002-08-31,2002,"Bursaspor","Kocaelispor","4-2",4,2,"T1",1,6,2,"H"
"2479",2002-08-31,2002,"Malatyaspor","Galatasaray","2-2",2,2,"T1",1,4,0,"D"
"2480",2002-09-01,2002,"Elazigspor","Gaziantepspor","1-3",1,3,"T1",1,4,-2,"A"
"2481",2002-09-01,2002,"Fenerbahce","Denizlispor","3-2",3,2,"T1",1,5,1,"H"
"2482",2002-09-01,2002,"Genclerbirligi","Goztep","3-1",3,1,"T1",1,4,2,"H"
"2483",2002-09-01,2002,"Samsunspor","Istanbulspor","1-2",1,2,"T1",1,3,-1,"A"
"2484",2002-09-11,2002,"Gaziantepspor","Fenerbahce","3-3",3,3,"T1",1,6,0,"D"
"2485",2002-09-13,2002,"Galatasaray","Kocaelispor","2-0",2,0,"T1",1,2,2,"H"
"2486",2002-09-14,2002,"Ankaragucu","Adanaspor","1-1",1,1,"T1",1,2,0,"D"
"2487",2002-09-14,2002,"Denizlispor","Elazigspor","3-1",3,1,"T1",1,4,2,"H"
"2488",2002-09-14,2002,"Malatyaspor","Fenerbahce","2-0",2,0,"T1",1,2,2,"H"
"2489",2002-09-14,2002,"Trabzonspor","Genclerbirligi","1-1",1,1,"T1",1,2,0,"D"
"2490",2002-09-15,2002,"Diyarbakirspor","Samsunspor","1-1",1,1,"T1",1,2,0,"D"
"2491",2002-09-15,2002,"Gaziantepspor","Altay","2-1",2,1,"T1",1,3,1,"H"
"2492",2002-09-15,2002,"Goztep","Besiktas","2-2",2,2,"T1",1,4,0,"D"
"2493",2002-09-15,2002,"Istanbulspor","Bursaspor","1-1",1,1,"T1",1,2,0,"D"
"2494",2002-09-21,2002,"Adanaspor","Gaziantepspor","0-2",0,2,"T1",1,2,-2,"A"
"2495",2002-09-21,2002,"Bursaspor","Diyarbakirspor","4-1",4,1,"T1",1,5,3,"H"
"2496",2002-09-21,2002,"Elazigspor","Malatyaspor","2-1",2,1,"T1",1,3,1,"H"
"2497",2002-09-21,2002,"Samsunspor","Goztep","0-0",0,0,"T1",1,0,0,"D"
"2498",2002-09-22,2002,"Altay","Denizlispor","3-1",3,1,"T1",1,4,2,"H"
"2499",2002-09-22,2002,"Besiktas","Trabzonspor","0-0",0,0,"T1",1,0,0,"D"
"2500",2002-09-22,2002,"Genclerbirligi","Ankaragucu","0-1",0,1,"T1",1,1,-1,"A"
"2501",2002-09-22,2002,"Kocaelispor","Istanbulspor","0-1",0,1,"T1",1,1,-1,"A"
"2502",2002-09-27,2002,"Galatasaray","Istanbulspor","2-0",2,0,"T1",1,2,2,"H"
"2503",2002-09-28,2002,"Ankaragucu","Besiktas","0-1",0,1,"T1",1,1,-1,"A"
"2504",2002-09-28,2002,"Denizlispor","Adanaspor","2-0",2,0,"T1",1,2,2,"H"
"2505",2002-09-28,2002,"Diyarbakirspor","Kocaelispor","1-1",1,1,"T1",1,2,0,"D"
"2506",2002-09-28,2002,"Trabzonspor","Samsunspor","0-1",0,1,"T1",1,1,-1,"A"
"2507",2002-09-29,2002,"Fenerbahce","Elazigspor","4-2",4,2,"T1",1,6,2,"H"
"2508",2002-09-29,2002,"Gaziantepspor","Genclerbirligi","2-0",2,0,"T1",1,2,2,"H"
"2509",2002-09-29,2002,"Goztep","Bursaspor","1-1",1,1,"T1",1,2,0,"D"
"2510",2002-09-29,2002,"Malatyaspor","Altay","6-0",6,0,"T1",1,6,6,"H"
"2511",2002-10-05,2002,"Adanaspor","Malatyaspor","1-1",1,1,"T1",1,2,0,"D"
"2512",2002-10-05,2002,"Bursaspor","Trabzonspor","1-2",1,2,"T1",1,3,-1,"A"
"2513",2002-10-05,2002,"Elazigspor","Galatasaray","0-0",0,0,"T1",1,0,0,"D"
"2514",2002-10-05,2002,"Istanbulspor","Diyarbakirspor","1-0",1,0,"T1",1,1,1,"H"
"2515",2002-10-06,2002,"Altay","Fenerbahce","1-3",1,3,"T1",1,4,-2,"A"
"2516",2002-10-06,2002,"Besiktas","Gaziantepspor","0-0",0,0,"T1",1,0,0,"D"
"2517",2002-10-06,2002,"Genclerbirligi","Denizlispor","0-0",0,0,"T1",1,0,0,"D"
"2518",2002-10-06,2002,"Kocaelispor","Goztep","1-3",1,3,"T1",1,4,-2,"A"
"2519",2002-10-06,2002,"Samsunspor","Ankaragucu","1-0",1,0,"T1",1,1,1,"H"
"2520",2002-10-18,2002,"Fenerbahce","Adanaspor","1-1",1,1,"T1",1,2,0,"D"
"2521",2002-10-19,2002,"Galatasaray","Diyarbakirspor","1-0",1,0,"T1",1,1,1,"H"
"2522",2002-10-19,2002,"Gaziantepspor","Samsunspor","4-2",4,2,"T1",1,6,2,"H"
"2523",2002-10-19,2002,"Goztep","Istanbulspor","1-1",1,1,"T1",1,2,0,"D"
"2524",2002-10-19,2002,"Malatyaspor","Genclerbirligi","5-4",5,4,"T1",1,9,1,"H"
"2525",2002-10-20,2002,"Ankaragucu","Bursaspor","4-0",4,0,"T1",1,4,4,"H"
"2526",2002-10-20,2002,"Denizlispor","Besiktas","1-2",1,2,"T1",1,3,-1,"A"
"2527",2002-10-20,2002,"Elazigspor","Altay","2-0",2,0,"T1",1,2,2,"H"
"2528",2002-10-20,2002,"Trabzonspor","Kocaelispor","2-0",2,0,"T1",1,2,2,"H"
"2529",2002-10-25,2002,"Besiktas","Malatyaspor","3-0",3,0,"T1",1,3,3,"H"
"2530",2002-10-26,2002,"Altay","Galatasaray","1-2",1,2,"T1",1,3,-1,"A"
"2531",2002-10-26,2002,"Istanbulspor","Trabzonspor","1-2",1,2,"T1",1,3,-1,"A"
"2532",2002-10-26,2002,"Kocaelispor","Ankaragucu","3-0",3,0,"T1",1,3,3,"H"
"2533",2002-10-26,2002,"Samsunspor","Denizlispor","0-0",0,0,"T1",1,0,0,"D"
"2534",2002-10-27,2002,"Adanaspor","Elazigspor","0-0",0,0,"T1",1,0,0,"D"
"2535",2002-10-27,2002,"Bursaspor","Gaziantepspor","1-1",1,1,"T1",1,2,0,"D"
"2536",2002-10-27,2002,"Diyarbakirspor","Goztep","1-0",1,0,"T1",1,1,1,"H"
"2537",2002-10-27,2002,"Genclerbirligi","Fenerbahce","1-1",1,1,"T1",1,2,0,"D"
"2538",2002-11-01,2002,"Trabzonspor","Diyarbakirspor","3-0",3,0,"T1",1,3,3,"H"
"2539",2002-11-02,2002,"Altay","Adanaspor","0-4",0,4,"T1",1,4,-4,"A"
"2540",2002-11-02,2002,"Ankaragucu","Istanbulspor","1-0",1,0,"T1",1,1,1,"H"
"2541",2002-11-02,2002,"Elazigspor","Genclerbirligi","0-3",0,3,"T1",1,3,-3,"A"
"2542",2002-11-02,2002,"Galatasaray","Goztep","3-1",3,1,"T1",1,4,2,"H"
"2543",2002-11-02,2002,"Gaziantepspor","Kocaelispor","2-1",2,1,"T1",1,3,1,"H"
"2544",2002-11-02,2002,"Malatyaspor","Samsunspor","2-1",2,1,"T1",1,3,1,"H"
"2545",2002-11-06,2002,"Denizlispor","Bursaspor","2-2",2,2,"T1",1,4,0,"D"
"2546",2002-11-06,2002,"Fenerbahce","Galatasaray","6-0",6,0,"T1",1,6,6,"H"
"2547",2002-11-08,2002,"Besiktas","Elazigspor","3-1",3,1,"T1",1,4,2,"H"
"2548",2002-11-09,2002,"Adanaspor","Galatasaray","0-0",0,0,"T1",1,0,0,"D"
"2549",2002-11-09,2002,"Diyarbakirspor","Ankaragucu","3-0",3,0,"T1",1,3,3,"H"
"2550",2002-11-09,2002,"Goztep","Trabzonspor","1-2",1,2,"T1",1,3,-1,"A"
"2551",2002-11-09,2002,"Istanbulspor","Gaziantepspor","1-3",1,3,"T1",1,4,-2,"A"
"2552",2002-11-10,2002,"Bursaspor","Malatyaspor","1-1",1,1,"T1",1,2,0,"D"
"2553",2002-11-10,2002,"Genclerbirligi","Altay","1-0",1,0,"T1",1,1,1,"H"
"2554",2002-11-10,2002,"Kocaelispor","Denizlispor","2-1",2,1,"T1",1,3,1,"H"
"2555",2002-11-10,2002,"Samsunspor","Fenerbahce","1-3",1,3,"T1",1,4,-2,"A"
"2556",2002-11-16,2002,"Adanaspor","Genclerbirligi","2-7",2,7,"T1",1,9,-5,"A"
"2557",2002-11-16,2002,"Ankaragucu","Goztep","1-0",1,0,"T1",1,1,1,"H"
"2558",2002-11-16,2002,"Galatasaray","Trabzonspor","2-1",2,1,"T1",1,3,1,"H"
"2559",2002-11-16,2002,"Gaziantepspor","Diyarbakirspor","2-0",2,0,"T1",1,2,2,"H"
"2560",2002-11-17,2002,"Altay","Besiktas","0-1",0,1,"T1",1,1,-1,"A"
"2561",2002-11-17,2002,"Denizlispor","Istanbulspor","2-1",2,1,"T1",1,3,1,"H"
"2562",2002-11-17,2002,"Elazigspor","Samsunspor","3-1",3,1,"T1",1,4,2,"H"
"2563",2002-11-17,2002,"Fenerbahce","Bursaspor","7-1",7,1,"T1",1,8,6,"H"
"2564",2002-11-17,2002,"Malatyaspor","Kocaelispor","2-1",2,1,"T1",1,3,1,"H"
"2565",2002-11-23,2002,"Besiktas","Adanaspor","3-0",3,0,"T1",1,3,3,"H"
"2566",2002-11-23,2002,"Diyarbakirspor","Denizlispor","0-0",0,0,"T1",1,0,0,"D"
"2567",2002-11-23,2002,"Istanbulspor","Malatyaspor","0-0",0,0,"T1",1,0,0,"D"
"2568",2002-11-23,2002,"Kocaelispor","Fenerbahce","1-2",1,2,"T1",1,3,-1,"A"
"2569",2002-11-23,2002,"Trabzonspor","Ankaragucu","3-0",3,0,"T1",1,3,3,"H"
"2570",2002-11-24,2002,"Bursaspor","Elazigspor","1-1",1,1,"T1",1,2,0,"D"
"2571",2002-11-24,2002,"Genclerbirligi","Galatasaray","1-0",1,0,"T1",1,1,1,"H"
"2572",2002-11-24,2002,"Goztep","Gaziantepspor","2-1",2,1,"T1",1,3,1,"H"
"2573",2002-11-24,2002,"Samsunspor","Altay","2-4",2,4,"T1",1,6,-2,"A"
"2574",2002-11-29,2002,"Fenerbahce","Istanbulspor","2-0",2,0,"T1",1,2,2,"H"
"2575",2002-11-30,2002,"Altay","Bursaspor","2-1",2,1,"T1",1,3,1,"H"
"2576",2002-11-30,2002,"Ankaragucu","Galatasaray","1-2",1,2,"T1",1,3,-1,"A"
"2577",2002-11-30,2002,"Elazigspor","Kocaelispor","0-1",0,1,"T1",1,1,-1,"A"
"2578",2002-11-30,2002,"Gaziantepspor","Trabzonspor","0-0",0,0,"T1",1,0,0,"D"
"2579",2002-12-01,2002,"Adanaspor","Samsunspor","1-1",1,1,"T1",1,2,0,"D"
"2580",2002-12-01,2002,"Besiktas","Genclerbirligi","1-1",1,1,"T1",1,2,0,"D"
"2581",2002-12-01,2002,"Denizlispor","Goztep","0-0",0,0,"T1",1,0,0,"D"
"2582",2002-12-01,2002,"Malatyaspor","Diyarbakirspor","0-1",0,1,"T1",1,1,-1,"A"
"2583",2002-12-07,2002,"Diyarbakirspor","Fenerbahce","3-0",3,0,"T1",1,3,3,"H"
"2584",2002-12-07,2002,"Istanbulspor","Elazigspor","2-1",2,1,"T1",1,3,1,"H"
"2585",2002-12-07,2002,"Kocaelispor","Altay","3-0",3,0,"T1",1,3,3,"H"
"2586",2002-12-07,2002,"Trabzonspor","Denizlispor","1-0",1,0,"T1",1,1,1,"H"
"2587",2002-12-08,2002,"Ankaragucu","Gaziantepspor","5-3",5,3,"T1",1,8,2,"H"
"2588",2002-12-08,2002,"Bursaspor","Adanaspor","3-0",3,0,"T1",1,3,3,"H"
"2589",2002-12-08,2002,"Galatasaray","Besiktas","0-1",0,1,"T1",1,1,-1,"A"
"2590",2002-12-08,2002,"Goztep","Malatyaspor","0-3",0,3,"T1",1,3,-3,"A"
"2591",2002-12-08,2002,"Samsunspor","Genclerbirligi","2-7",2,7,"T1",1,9,-5,"A"
"2592",2002-12-13,2002,"Gaziantepspor","Galatasaray","1-2",1,2,"T1",1,3,-1,"A"
"2593",2002-12-14,2002,"Adanaspor","Kocaelispor","1-0",1,0,"T1",1,1,1,"H"
"2594",2002-12-14,2002,"Altay","Istanbulspor","4-3",4,3,"T1",1,7,1,"H"
"2595",2002-12-14,2002,"Fenerbahce","Goztep","0-0",0,0,"T1",1,0,0,"D"
"2596",2002-12-14,2002,"Malatyaspor","Trabzonspor","2-2",2,2,"T1",1,4,0,"D"
"2597",2002-12-15,2002,"Besiktas","Samsunspor","2-0",2,0,"T1",1,2,2,"H"
"2598",2002-12-15,2002,"Elazigspor","Diyarbakirspor","0-1",0,1,"T1",1,1,-1,"A"
"2599",2002-12-15,2002,"Genclerbirligi","Bursaspor","2-0",2,0,"T1",1,2,2,"H"
"2600",2002-12-21,2002,"Adanaspor","Istanbulspor","0-3",0,3,"T1",1,3,-3,"A"
"2601",2002-12-21,2002,"Besiktas","Bursaspor","1-0",1,0,"T1",1,1,1,"H"
"2602",2002-12-22,2002,"Altay","Diyarbakirspor","2-2",2,2,"T1",1,4,0,"D"
"2603",2002-12-22,2002,"Fenerbahce","Trabzonspor","3-2",3,2,"T1",1,5,1,"H"
"2604",2002-12-22,2002,"Genclerbirligi","Kocaelispor","5-1",5,1,"T1",1,6,4,"H"
"2605",2002-12-22,2002,"Samsunspor","Galatasaray","0-1",0,1,"T1",1,1,-1,"A"
"2606",2003-01-28,2002,"Denizlispor","Ankaragucu","2-1",2,1,"T1",1,3,1,"H"
"2607",2003-02-02,2002,"Denizlispor","Gaziantepspor","1-0",1,0,"T1",1,1,1,"H"
"2608",2003-02-02,2002,"Elazigspor","Goztep","0-0",0,0,"T1",1,0,0,"D"
"2609",2003-02-02,2002,"Fenerbahce","Besiktas","0-1",0,1,"T1",1,1,-1,"A"
"2610",2003-02-02,2002,"Malatyaspor","Ankaragucu","3-1",3,1,"T1",1,4,2,"H"
"2611",2003-02-08,2002,"Bursaspor","Samsunspor","2-1",2,1,"T1",1,3,1,"H"
"2612",2003-02-08,2002,"Gaziantepspor","Malatyaspor","3-0",3,0,"T1",1,3,3,"H"
"2613",2003-02-08,2002,"Goztep","Altay","0-2",0,2,"T1",1,2,-2,"A"
"2614",2003-02-08,2002,"Kocaelispor","Besiktas","0-5",0,5,"T1",1,5,-5,"A"
"2615",2003-02-09,2002,"Ankaragucu","Fenerbahce","0-0",0,0,"T1",1,0,0,"D"
"2616",2003-02-09,2002,"Diyarbakirspor","Adanaspor","2-0",2,0,"T1",1,2,2,"H"
"2617",2003-02-09,2002,"Istanbulspor","Genclerbirligi","1-3",1,3,"T1",1,4,-2,"A"
"2618",2003-02-09,2002,"Trabzonspor","Elazigspor","1-1",1,1,"T1",1,2,0,"D"
"2619",2003-02-15,2002,"Fenerbahce","Gaziantepspor","2-0",2,0,"T1",1,2,2,"H"
"2620",2003-02-15,2002,"Malatyaspor","Denizlispor","2-1",2,1,"T1",1,3,1,"H"
"2621",2003-02-15,2002,"Samsunspor","Kocaelispor","1-0",1,0,"T1",1,1,1,"H"
"2622",2003-02-16,2002,"Adanaspor","Goztep","1-2",1,2,"T1",1,3,-1,"A"
"2623",2003-02-16,2002,"Altay","Trabzonspor","1-4",1,4,"T1",1,5,-3,"A"
"2624",2003-02-16,2002,"Besiktas","Istanbulspor","2-1",2,1,"T1",1,3,1,"H"
"2625",2003-02-16,2002,"Bursaspor","Galatasaray","0-4",0,4,"T1",1,4,-4,"A"
"2626",2003-02-16,2002,"Elazigspor","Ankaragucu","1-0",1,0,"T1",1,1,1,"H"
"2627",2003-02-16,2002,"Genclerbirligi","Diyarbakirspor","3-1",3,1,"T1",1,4,2,"H"
"2628",2003-02-22,2002,"Goztep","Genclerbirligi","0-0",0,0,"T1",1,0,0,"D"
"2629",2003-02-22,2002,"Trabzonspor","Adanaspor","3-1",3,1,"T1",1,4,2,"H"
"2630",2003-02-23,2002,"Ankaragucu","Altay","3-0",3,0,"T1",1,3,3,"H"
"2631",2003-02-23,2002,"Galatasaray","Malatyaspor","2-1",2,1,"T1",1,3,1,"H"
"2632",2003-02-23,2002,"Istanbulspor","Samsunspor","0-1",0,1,"T1",1,1,-1,"A"
"2633",2003-02-28,2002,"Fenerbahce","Malatyaspor","2-0",2,0,"T1",1,2,2,"H"
"2634",2003-03-01,2002,"Altay","Gaziantepspor","0-0",0,0,"T1",1,0,0,"D"
"2635",2003-03-01,2002,"Bursaspor","Istanbulspor","1-2",1,2,"T1",1,3,-1,"A"
"2636",2003-03-01,2002,"Genclerbirligi","Trabzonspor","2-1",2,1,"T1",1,3,1,"H"
"2637",2003-03-01,2002,"Kocaelispor","Galatasaray","0-1",0,1,"T1",1,1,-1,"A"
"2638",2003-03-02,2002,"Adanaspor","Ankaragucu","0-2",0,2,"T1",1,2,-2,"A"
"2639",2003-03-02,2002,"Besiktas","Goztep","7-3",7,3,"T1",1,10,4,"H"
"2640",2003-03-02,2002,"Elazigspor","Denizlispor","0-2",0,2,"T1",1,2,-2,"A"
"2641",2003-03-02,2002,"Samsunspor","Diyarbakirspor","3-1",3,1,"T1",1,4,2,"H"
"2642",2003-03-07,2002,"Gaziantepspor","Adanaspor","1-1",1,1,"T1",1,2,0,"D"
"2643",2003-03-08,2002,"Denizlispor","Altay","1-1",1,1,"T1",1,2,0,"D"
"2644",2003-03-08,2002,"Galatasaray","Fenerbahce","2-0",2,0,"T1",1,2,2,"H"
"2645",2003-03-08,2002,"Goztep","Samsunspor","0-0",0,0,"T1",1,0,0,"D"
"2646",2003-03-08,2002,"Malatyaspor","Elazigspor","1-1",1,1,"T1",1,2,0,"D"
"2647",2003-03-09,2002,"Ankaragucu","Genclerbirligi","0-1",0,1,"T1",1,1,-1,"A"
"2648",2003-03-09,2002,"Diyarbakirspor","Bursaspor","4-0",4,0,"T1",1,4,4,"H"
"2649",2003-03-09,2002,"Istanbulspor","Kocaelispor","2-1",2,1,"T1",1,3,1,"H"
"2650",2003-03-09,2002,"Trabzonspor","Besiktas","1-1",1,1,"T1",1,2,0,"D"
"2651",2003-03-14,2002,"Genclerbirligi","Gaziantepspor","2-1",2,1,"T1",1,3,1,"H"
"2652",2003-03-15,2002,"Adanaspor","Denizlispor","2-1",2,1,"T1",1,3,1,"H"
"2653",2003-03-15,2002,"Elazigspor","Fenerbahce","3-3",3,3,"T1",1,6,0,"D"
"2654",2003-03-15,2002,"Istanbulspor","Galatasaray","1-2",1,2,"T1",1,3,-1,"A"
"2655",2003-03-15,2002,"Samsunspor","Trabzonspor","1-3",1,3,"T1",1,4,-2,"A"
"2656",2003-03-16,2002,"Altay","Malatyaspor","0-2",0,2,"T1",1,2,-2,"A"
"2657",2003-03-16,2002,"Besiktas","Ankaragucu","1-0",1,0,"T1",1,1,1,"H"
"2658",2003-03-16,2002,"Bursaspor","Goztep","1-0",1,0,"T1",1,1,1,"H"
"2659",2003-03-16,2002,"Kocaelispor","Diyarbakirspor","1-1",1,1,"T1",1,2,0,"D"
"2660",2003-03-19,2002,"Galatasaray","Denizlispor","0-1",0,1,"T1",1,1,-1,"A"
"2661",2003-03-19,2002,"Gaziantepspor","Elazigspor","4-0",4,0,"T1",1,4,4,"H"
"2662",2003-03-19,2002,"Kocaelispor","Bursaspor","0-0",0,0,"T1",1,0,0,"D"
"2663",2003-03-22,2002,"Ankaragucu","Samsunspor","3-2",3,2,"T1",1,5,1,"H"
"2664",2003-03-22,2002,"Diyarbakirspor","Istanbulspor","1-1",1,1,"T1",1,2,0,"D"
"2665",2003-03-22,2002,"Fenerbahce","Altay","0-1",0,1,"T1",1,1,-1,"A"
"2666",2003-03-22,2002,"Malatyaspor","Adanaspor","1-0",1,0,"T1",1,1,1,"H"
"2667",2003-03-23,2002,"Denizlispor","Genclerbirligi","1-3",1,3,"T1",1,4,-2,"A"
"2668",2003-03-23,2002,"Galatasaray","Elazigspor","3-0",3,0,"T1",1,3,3,"H"
"2669",2003-03-23,2002,"Gaziantepspor","Besiktas","1-1",1,1,"T1",1,2,0,"D"
"2670",2003-03-23,2002,"Goztep","Kocaelispor","1-2",1,2,"T1",1,3,-1,"A"
"2671",2003-03-23,2002,"Trabzonspor","Bursaspor","3-0",3,0,"T1",1,3,3,"H"
"2672",2003-04-05,2002,"Besiktas","Denizlispor","2-0",2,0,"T1",1,2,2,"H"
"2673",2003-04-05,2002,"Genclerbirligi","Malatyaspor","3-0",3,0,"T1",1,3,3,"H"
"2674",2003-04-05,2002,"Kocaelispor","Trabzonspor","2-2",2,2,"T1",1,4,0,"D"
"2675",2003-04-05,2002,"Samsunspor","Gaziantepspor","2-1",2,1,"T1",1,3,1,"H"
"2676",2003-04-06,2002,"Adanaspor","Fenerbahce","3-1",3,1,"T1",1,4,2,"H"
"2677",2003-04-06,2002,"Altay","Elazigspor","5-1",5,1,"T1",1,6,4,"H"
"2678",2003-04-06,2002,"Bursaspor","Ankaragucu","0-2",0,2,"T1",1,2,-2,"A"
"2679",2003-04-06,2002,"Diyarbakirspor","Galatasaray","1-3",1,3,"T1",1,4,-2,"A"
"2680",2003-04-06,2002,"Istanbulspor","Goztep","3-1",3,1,"T1",1,4,2,"H"
"2681",2003-04-11,2002,"Galatasaray","Altay","5-0",5,0,"T1",1,5,5,"H"
"2682",2003-04-12,2002,"Denizlispor","Samsunspor","0-1",0,1,"T1",1,1,-1,"A"
"2683",2003-04-12,2002,"Goztep","Diyarbakirspor","3-0",3,0,"T1",1,3,3,"H"
"2684",2003-04-12,2002,"Malatyaspor","Besiktas","1-2",1,2,"T1",1,3,-1,"A"
"2685",2003-04-13,2002,"Ankaragucu","Kocaelispor","2-0",2,0,"T1",1,2,2,"H"
"2686",2003-04-13,2002,"Elazigspor","Adanaspor","4-2",4,2,"T1",1,6,2,"H"
"2687",2003-04-13,2002,"Fenerbahce","Genclerbirligi","3-3",3,3,"T1",1,6,0,"D"
"2688",2003-04-13,2002,"Gaziantepspor","Bursaspor","2-1",2,1,"T1",1,3,1,"H"
"2689",2003-04-13,2002,"Trabzonspor","Istanbulspor","0-0",0,0,"T1",1,0,0,"D"
"2690",2003-04-16,2002,"Denizlispor","Fenerbahce","1-1",1,1,"T1",1,2,0,"D"
"2691",2003-04-16,2002,"Diyarbakirspor","Besiktas","1-0",1,0,"T1",1,1,1,"H"
"2692",2003-04-18,2002,"Goztep","Galatasaray","0-1",0,1,"T1",1,1,-1,"A"
"2693",2003-04-19,2002,"Diyarbakirspor","Trabzonspor","2-0",2,0,"T1",1,2,2,"H"
"2694",2003-04-19,2002,"Genclerbirligi","Elazigspor","2-0",2,0,"T1",1,2,2,"H"
"2695",2003-04-19,2002,"Istanbulspor","Ankaragucu","1-0",1,0,"T1",1,1,1,"H"
"2696",2003-04-19,2002,"Samsunspor","Malatyaspor","1-1",1,1,"T1",1,2,0,"D"
"2697",2003-04-20,2002,"Adanaspor","Altay","5-2",5,2,"T1",1,7,3,"H"
"2698",2003-04-20,2002,"Besiktas","Fenerbahce","2-0",2,0,"T1",1,2,2,"H"
"2699",2003-04-20,2002,"Bursaspor","Denizlispor","2-0",2,0,"T1",1,2,2,"H"
"2700",2003-04-20,2002,"Kocaelispor","Gaziantepspor","0-3",0,3,"T1",1,3,-3,"A"
"2701",2003-04-26,2002,"Ankaragucu","Diyarbakirspor","3-1",3,1,"T1",1,4,2,"H"
"2702",2003-04-26,2002,"Denizlispor","Kocaelispor","1-2",1,2,"T1",1,3,-1,"A"
"2703",2003-04-26,2002,"Elazigspor","Besiktas","0-1",0,1,"T1",1,1,-1,"A"
"2704",2003-04-26,2002,"Fenerbahce","Samsunspor","1-1",1,1,"T1",1,2,0,"D"
"2705",2003-04-27,2002,"Altay","Genclerbirligi","3-3",3,3,"T1",1,6,0,"D"
"2706",2003-04-27,2002,"Galatasaray","Adanaspor","2-2",2,2,"T1",1,4,0,"D"
"2707",2003-04-27,2002,"Gaziantepspor","Istanbulspor","4-3",4,3,"T1",1,7,1,"H"
"2708",2003-04-27,2002,"Malatyaspor","Bursaspor","4-2",4,2,"T1",1,6,2,"H"
"2709",2003-04-27,2002,"Trabzonspor","Goztep","0-0",0,0,"T1",1,0,0,"D"
"2710",2003-05-03,2002,"Besiktas","Altay","2-0",2,0,"T1",1,2,2,"H"
"2711",2003-05-03,2002,"Bursaspor","Fenerbahce","2-1",2,1,"T1",1,3,1,"H"
"2712",2003-05-03,2002,"Genclerbirligi","Adanaspor","0-2",0,2,"T1",1,2,-2,"A"
"2713",2003-05-03,2002,"Istanbulspor","Denizlispor","2-1",2,1,"T1",1,3,1,"H"
"2714",2003-05-03,2002,"Samsunspor","Elazigspor","4-3",4,3,"T1",1,7,1,"H"
"2715",2003-05-04,2002,"Diyarbakirspor","Gaziantepspor","0-1",0,1,"T1",1,1,-1,"A"
"2716",2003-05-04,2002,"Goztep","Ankaragucu","0-1",0,1,"T1",1,1,-1,"A"
"2717",2003-05-04,2002,"Kocaelispor","Malatyaspor","2-3",2,3,"T1",1,5,-1,"A"
"2718",2003-05-04,2002,"Trabzonspor","Galatasaray","1-2",1,2,"T1",1,3,-1,"A"
"2719",2003-05-09,2002,"Fenerbahce","Kocaelispor","1-0",1,0,"T1",1,1,1,"H"
"2720",2003-05-10,2002,"Adanaspor","Besiktas","0-1",0,1,"T1",1,1,-1,"A"
"2721",2003-05-11,2002,"Altay","Samsunspor","2-2",2,2,"T1",1,4,0,"D"
"2722",2003-05-11,2002,"Ankaragucu","Trabzonspor","2-0",2,0,"T1",1,2,2,"H"
"2723",2003-05-11,2002,"Denizlispor","Diyarbakirspor","2-0",2,0,"T1",1,2,2,"H"
"2724",2003-05-11,2002,"Elazigspor","Bursaspor","2-1",2,1,"T1",1,3,1,"H"
"2725",2003-05-11,2002,"Galatasaray","Genclerbirligi","1-1",1,1,"T1",1,2,0,"D"
"2726",2003-05-11,2002,"Gaziantepspor","Goztep","3-1",3,1,"T1",1,4,2,"H"
"2727",2003-05-11,2002,"Malatyaspor","Istanbulspor","1-2",1,2,"T1",1,3,-1,"A"
"2728",2003-05-16,2002,"Trabzonspor","Gaziantepspor","2-1",2,1,"T1",1,3,1,"H"
"2729",2003-05-17,2002,"Bursaspor","Altay","2-1",2,1,"T1",1,3,1,"H"
"2730",2003-05-17,2002,"Diyarbakirspor","Malatyaspor","1-1",1,1,"T1",1,2,0,"D"
"2731",2003-05-17,2002,"Galatasaray","Ankaragucu","3-0",3,0,"T1",1,3,3,"H"
"2732",2003-05-17,2002,"Genclerbirligi","Besiktas","1-2",1,2,"T1",1,3,-1,"A"
"2733",2003-05-17,2002,"Goztep","Denizlispor","2-3",2,3,"T1",1,5,-1,"A"
"2734",2003-05-17,2002,"Istanbulspor","Fenerbahce","2-0",2,0,"T1",1,2,2,"H"
"2735",2003-05-17,2002,"Kocaelispor","Elazigspor","1-3",1,3,"T1",1,4,-2,"A"
"2736",2003-05-17,2002,"Samsunspor","Adanaspor","0-2",0,2,"T1",1,2,-2,"A"
"2737",2003-05-25,2002,"Adanaspor","Bursaspor","2-2",2,2,"T1",1,4,0,"D"
"2738",2003-05-25,2002,"Altay","Kocaelispor","5-0",5,0,"T1",1,5,5,"H"
"2739",2003-05-25,2002,"Besiktas","Galatasaray","1-0",1,0,"T1",1,1,1,"H"
"2740",2003-05-25,2002,"Denizlispor","Trabzonspor","1-1",1,1,"T1",1,2,0,"D"
"2741",2003-05-25,2002,"Elazigspor","Istanbulspor","1-0",1,0,"T1",1,1,1,"H"
"2742",2003-05-25,2002,"Fenerbahce","Diyarbakirspor","0-0",0,0,"T1",1,0,0,"D"
"2743",2003-05-25,2002,"Gaziantepspor","Ankaragucu","4-2",4,2,"T1",1,6,2,"H"
"2744",2003-05-25,2002,"Genclerbirligi","Samsunspor","1-1",1,1,"T1",1,2,0,"D"
"2745",2003-05-25,2002,"Malatyaspor","Goztep","4-1",4,1,"T1",1,5,3,"H"
"2746",2003-05-30,2002,"Galatasaray","Gaziantepspor","2-1",2,1,"T1",1,3,1,"H"
"2747",2003-05-31,2002,"Ankaragucu","Denizlispor","1-1",1,1,"T1",1,2,0,"D"
"2748",2003-05-31,2002,"Bursaspor","Genclerbirligi","3-1",3,1,"T1",1,4,2,"H"
"2749",2003-05-31,2002,"Diyarbakirspor","Elazigspor","1-2",1,2,"T1",1,3,-1,"A"
"2750",2003-05-31,2002,"Goztep","Fenerbahce","1-1",1,1,"T1",1,2,0,"D"
"2751",2003-05-31,2002,"Istanbulspor","Altay","0-0",0,0,"T1",1,0,0,"D"
"2752",2003-05-31,2002,"Kocaelispor","Adanaspor","1-2",1,2,"T1",1,3,-1,"A"
"2753",2003-05-31,2002,"Samsunspor","Besiktas","3-4",3,4,"T1",1,7,-1,"A"
"2754",2003-05-31,2002,"Trabzonspor","Malatyaspor","0-2",0,2,"T1",1,2,-2,"A"
"2755",2003-08-08,2003,"Samsunspor","Besiktas","1-3",1,3,"T1",1,4,-2,"A"
"2756",2003-08-09,2003,"Bursaspor","Gaziantepspor","0-0",0,0,"T1",1,0,0,"D"
"2757",2003-08-09,2003,"Galatasaray","Diyarbakirspor","2-1",2,1,"T1",1,3,1,"H"
"2758",2003-08-09,2003,"Genclerbirligi","Elazigspor","2-3",2,3,"T1",1,5,-1,"A"
"2759",2003-08-09,2003,"Konyaspor","Trabzonspor","3-3",3,3,"T1",1,6,0,"D"
"2760",2003-08-10,2003,"A. Sebatspor","Denizlispor","0-2",0,2,"T1",1,2,-2,"A"
"2761",2003-08-10,2003,"Adanaspor","Malatyaspor","0-1",0,1,"T1",1,1,-1,"A"
"2762",2003-08-10,2003,"Fenerbahce","Istanbulspor","0-3",0,3,"T1",1,3,-3,"A"
"2763",2003-08-10,2003,"Rizespor","Ankaragucu","2-1",2,1,"T1",1,3,1,"H"
"2764",2003-08-15,2003,"Trabzonspor","Fenerbahce","0-1",0,1,"T1",1,1,-1,"A"
"2765",2003-08-16,2003,"Ankaragucu","Samsunspor","4-2",4,2,"T1",1,6,2,"H"
"2766",2003-08-16,2003,"Besiktas","Bursaspor","1-0",1,0,"T1",1,1,1,"H"
"2767",2003-08-16,2003,"Denizlispor","Rizespor","1-1",1,1,"T1",1,2,0,"D"
"2768",2003-08-16,2003,"Istanbulspor","Adanaspor","1-0",1,0,"T1",1,1,1,"H"
"2769",2003-08-17,2003,"Diyarbakirspor","Genclerbirligi","3-2",3,2,"T1",1,5,1,"H"
"2770",2003-08-17,2003,"Elazigspor","Konyaspor","0-0",0,0,"T1",1,0,0,"D"
"2771",2003-08-17,2003,"Gaziantepspor","Galatasaray","1-2",1,2,"T1",1,3,-1,"A"
"2772",2003-08-17,2003,"Malatyaspor","A. Sebatspor","3-1",3,1,"T1",1,4,2,"H"
"2773",2003-08-23,2003,"A. Sebatspor","Istanbulspor","1-3",1,3,"T1",1,4,-2,"A"
"2774",2003-08-23,2003,"Adanaspor","Trabzonspor","0-1",0,1,"T1",1,1,-1,"A"
"2775",2003-08-23,2003,"Bursaspor","Galatasaray","2-2",2,2,"T1",1,4,0,"D"
"2776",2003-08-23,2003,"Fenerbahce","Elazigspor","7-1",7,1,"T1",1,8,6,"H"
"2777",2003-08-23,2003,"Rizespor","Malatyaspor","2-1",2,1,"T1",1,3,1,"H"
"2778",2003-08-24,2003,"Besiktas","Ankaragucu","3-0",3,0,"T1",1,3,3,"H"
"2779",2003-08-24,2003,"Genclerbirligi","Gaziantepspor","1-0",1,0,"T1",1,1,1,"H"
"2780",2003-08-24,2003,"Konyaspor","Diyarbakirspor","3-1",3,1,"T1",1,4,2,"H"
"2781",2003-08-24,2003,"Samsunspor","Denizlispor","2-1",2,1,"T1",1,3,1,"H"
"2782",2003-08-29,2003,"Denizlispor","Besiktas","2-3",2,3,"T1",1,5,-1,"A"
"2783",2003-08-30,2003,"Diyarbakirspor","Fenerbahce","1-2",1,2,"T1",1,3,-1,"A"
"2784",2003-08-30,2003,"Elazigspor","Adanaspor","3-4",3,4,"T1",1,7,-1,"A"
"2785",2003-08-30,2003,"Gaziantepspor","Konyaspor","3-1",3,1,"T1",1,4,2,"H"
"2786",2003-08-30,2003,"Malatyaspor","Samsunspor","5-0",5,0,"T1",1,5,5,"H"
"2787",2003-08-31,2003,"Ankaragucu","Bursaspor","2-0",2,0,"T1",1,2,2,"H"
"2788",2003-08-31,2003,"Galatasaray","Genclerbirligi","2-1",2,1,"T1",1,3,1,"H"
"2789",2003-08-31,2003,"Istanbulspor","Rizespor","3-0",3,0,"T1",1,3,3,"H"
"2790",2003-08-31,2003,"Trabzonspor","A. Sebatspor","2-1",2,1,"T1",1,3,1,"H"
"2791",2003-09-12,2003,"Besiktas","Malatyaspor","3-1",3,1,"T1",1,4,2,"H"
"2792",2003-09-13,2003,"Adanaspor","Diyarbakirspor","2-1",2,1,"T1",1,3,1,"H"
"2793",2003-09-13,2003,"Konyaspor","Galatasaray","1-0",1,0,"T1",1,1,1,"H"
"2794",2003-09-13,2003,"Rizespor","Trabzonspor","1-0",1,0,"T1",1,1,1,"H"
"2795",2003-09-13,2003,"Samsunspor","Istanbulspor","3-3",3,3,"T1",1,6,0,"D"
"2796",2003-09-14,2003,"A. Sebatspor","Elazigspor","3-1",3,1,"T1",1,4,2,"H"
"2797",2003-09-14,2003,"Ankaragucu","Denizlispor","1-1",1,1,"T1",1,2,0,"D"
"2798",2003-09-14,2003,"Bursaspor","Genclerbirligi","0-0",0,0,"T1",1,0,0,"D"
"2799",2003-09-14,2003,"Fenerbahce","Gaziantepspor","3-1",3,1,"T1",1,4,2,"H"
"2800",2003-09-19,2003,"Trabzonspor","Samsunspor","2-1",2,1,"T1",1,3,1,"H"
"2801",2003-09-20,2003,"Gaziantepspor","Adanaspor","1-0",1,0,"T1",1,1,1,"H"
"2802",2003-09-20,2003,"Genclerbirligi","Konyaspor","4-0",4,0,"T1",1,4,4,"H"
"2803",2003-09-20,2003,"Istanbulspor","Besiktas","1-1",1,1,"T1",1,2,0,"D"
"2804",2003-09-20,2003,"Malatyaspor","Ankaragucu","1-0",1,0,"T1",1,1,1,"H"
"2805",2003-09-21,2003,"Denizlispor","Bursaspor","4-0",4,0,"T1",1,4,4,"H"
"2806",2003-09-21,2003,"Diyarbakirspor","A. Sebatspor","1-0",1,0,"T1",1,1,1,"H"
"2807",2003-09-21,2003,"Elazigspor","Rizespor","1-1",1,1,"T1",1,2,0,"D"
"2808",2003-09-21,2003,"Galatasaray","Fenerbahce","2-2",2,2,"T1",1,4,0,"D"
"2809",2003-09-26,2003,"Adanaspor","Galatasaray","0-2",0,2,"T1",1,2,-2,"A"
"2810",2003-09-27,2003,"Ankaragucu","Istanbulspor","2-1",2,1,"T1",1,3,1,"H"
"2811",2003-09-27,2003,"Bursaspor","Konyaspor","2-1",2,1,"T1",1,3,1,"H"
"2812",2003-09-27,2003,"Fenerbahce","Genclerbirligi","1-0",1,0,"T1",1,1,1,"H"
"2813",2003-09-27,2003,"Samsunspor","Elazigspor","2-0",2,0,"T1",1,2,2,"H"
"2814",2003-09-28,2003,"A. Sebatspor","Gaziantepspor","1-2",1,2,"T1",1,3,-1,"A"
"2815",2003-09-28,2003,"Besiktas","Trabzonspor","5-0",5,0,"T1",1,5,5,"H"
"2816",2003-09-28,2003,"Denizlispor","Malatyaspor","1-0",1,0,"T1",1,1,1,"H"
"2817",2003-09-28,2003,"Rizespor","Diyarbakirspor","2-1",2,1,"T1",1,3,1,"H"
"2818",2003-10-03,2003,"Konyaspor","Fenerbahce","2-4",2,4,"T1",1,6,-2,"A"
"2819",2003-10-04,2003,"Galatasaray","A. Sebatspor","4-3",4,3,"T1",1,7,1,"H"
"2820",2003-10-04,2003,"Genclerbirligi","Adanaspor","6-0",6,0,"T1",1,6,6,"H"
"2821",2003-10-04,2003,"Istanbulspor","Denizlispor","0-3",0,3,"T1",1,3,-3,"A"
"2822",2003-10-04,2003,"Malatyaspor","Bursaspor","2-1",2,1,"T1",1,3,1,"H"
"2823",2003-10-05,2003,"Diyarbakirspor","Samsunspor","2-2",2,2,"T1",1,4,0,"D"
"2824",2003-10-05,2003,"Elazigspor","Besiktas","1-5",1,5,"T1",1,6,-4,"A"
"2825",2003-10-05,2003,"Gaziantepspor","Rizespor","2-0",2,0,"T1",1,2,2,"H"
"2826",2003-10-05,2003,"Trabzonspor","Ankaragucu","3-0",3,0,"T1",1,3,3,"H"
"2827",2003-10-17,2003,"Rizespor","Galatasaray","0-1",0,1,"T1",1,1,-1,"A"
"2828",2003-10-18,2003,"Adanaspor","Konyaspor","1-1",1,1,"T1",1,2,0,"D"
"2829",2003-10-18,2003,"Ankaragucu","Elazigspor","1-0",1,0,"T1",1,1,1,"H"
"2830",2003-10-18,2003,"Besiktas","Diyarbakirspor","1-0",1,0,"T1",1,1,1,"H"
"2831",2003-10-19,2003,"A. Sebatspor","Genclerbirligi","0-3",0,3,"T1",1,3,-3,"A"
"2832",2003-10-19,2003,"Bursaspor","Fenerbahce","2-2",2,2,"T1",1,4,0,"D"
"2833",2003-10-19,2003,"Denizlispor","Trabzonspor","0-1",0,1,"T1",1,1,-1,"A"
"2834",2003-10-19,2003,"Malatyaspor","Istanbulspor","2-1",2,1,"T1",1,3,1,"H"
"2835",2003-10-19,2003,"Samsunspor","Gaziantepspor","1-2",1,2,"T1",1,3,-1,"A"
"2836",2003-10-24,2003,"Fenerbahce","Adanaspor","3-0",3,0,"T1",1,3,3,"H"
"2837",2003-10-25,2003,"Diyarbakirspor","Ankaragucu","1-1",1,1,"T1",1,2,0,"D"
"2838",2003-10-25,2003,"Elazigspor","Denizlispor","2-4",2,4,"T1",1,6,-2,"A"
"2839",2003-10-25,2003,"Galatasaray","Samsunspor","1-0",1,0,"T1",1,1,1,"H"
"2840",2003-10-25,2003,"Trabzonspor","Malatyaspor","0-0",0,0,"T1",1,0,0,"D"
"2841",2003-10-26,2003,"Gaziantepspor","Besiktas","0-3",0,3,"T1",1,3,-3,"A"
"2842",2003-10-26,2003,"Genclerbirligi","Rizespor","1-0",1,0,"T1",1,1,1,"H"
"2843",2003-10-26,2003,"Istanbulspor","Bursaspor","3-0",3,0,"T1",1,3,3,"H"
"2844",2003-10-26,2003,"Konyaspor","A. Sebatspor","0-0",0,0,"T1",1,0,0,"D"
"2845",2003-10-31,2003,"Besiktas","Galatasaray","0-0",0,0,"T1",1,0,0,"D"
"2846",2003-11-01,2003,"Ankaragucu","Gaziantepspor","1-4",1,4,"T1",1,5,-3,"A"
"2847",2003-11-01,2003,"Denizlispor","Diyarbakirspor","1-2",1,2,"T1",1,3,-1,"A"
"2848",2003-11-01,2003,"Istanbulspor","Trabzonspor","0-2",0,2,"T1",1,2,-2,"A"
"2849",2003-11-01,2003,"Samsunspor","Genclerbirligi","2-1",2,1,"T1",1,3,1,"H"
"2850",2003-11-02,2003,"A. Sebatspor","Fenerbahce","1-1",1,1,"T1",1,2,0,"D"
"2851",2003-11-02,2003,"Bursaspor","Adanaspor","6-0",6,0,"T1",1,6,6,"H"
"2852",2003-11-02,2003,"Malatyaspor","Elazigspor","3-0",3,0,"T1",1,3,3,"H"
"2853",2003-11-02,2003,"Rizespor","Konyaspor","1-1",1,1,"T1",1,2,0,"D"
"2854",2003-11-07,2003,"Trabzonspor","Bursaspor","2-0",2,0,"T1",1,2,2,"H"
"2855",2003-11-08,2003,"Adanaspor","A. Sebatspor","1-2",1,2,"T1",1,3,-1,"A"
"2856",2003-11-08,2003,"Konyaspor","Samsunspor","0-0",0,0,"T1",1,0,0,"D"
"2857",2003-11-09,2003,"Diyarbakirspor","Malatyaspor","2-0",2,0,"T1",1,2,2,"H"
"2858",2003-11-09,2003,"Elazigspor","Istanbulspor","1-1",1,1,"T1",1,2,0,"D"
"2859",2003-11-09,2003,"Galatasaray","Ankaragucu","2-1",2,1,"T1",1,3,1,"H"
"2860",2003-11-09,2003,"Gaziantepspor","Denizlispor","1-2",1,2,"T1",1,3,-1,"A"
"2861",2003-11-09,2003,"Genclerbirligi","Besiktas","1-2",1,2,"T1",1,3,-1,"A"
"2862",2003-11-22,2003,"Ankaragucu","Genclerbirligi","2-3",2,3,"T1",1,5,-1,"A"
"2863",2003-11-22,2003,"Besiktas","Konyaspor","1-1",1,1,"T1",1,2,0,"D"
"2864",2003-11-22,2003,"Denizlispor","Galatasaray","2-1",2,1,"T1",1,3,1,"H"
"2865",2003-11-22,2003,"Malatyaspor","Gaziantepspor","0-0",0,0,"T1",1,0,0,"D"
"2866",2003-11-23,2003,"Bursaspor","A. Sebatspor","1-1",1,1,"T1",1,2,0,"D"
"2867",2003-11-23,2003,"Istanbulspor","Diyarbakirspor","1-3",1,3,"T1",1,4,-2,"A"
"2868",2003-11-23,2003,"Rizespor","Adanaspor","0-2",0,2,"T1",1,2,-2,"A"
"2869",2003-11-23,2003,"Samsunspor","Fenerbahce","3-0",3,0,"T1",1,3,3,"H"
"2870",2003-11-23,2003,"Trabzonspor","Elazigspor","2-2",2,2,"T1",1,4,0,"D"
"2871",2003-11-28,2003,"Galatasaray","Malatyaspor","2-2",2,2,"T1",1,4,0,"D"
"2872",2003-11-29,2003,"A. Sebatspor","Rizespor","1-0",1,0,"T1",1,1,1,"H"
"2873",2003-11-29,2003,"Diyarbakirspor","Trabzonspor","2-2",2,2,"T1",1,4,0,"D"
"2874",2003-11-29,2003,"Elazigspor","Bursaspor","1-0",1,0,"T1",1,1,1,"H"
"2875",2003-11-29,2003,"Konyaspor","Ankaragucu","1-1",1,1,"T1",1,2,0,"D"
"2876",2003-11-30,2003,"Adanaspor","Samsunspor","2-3",2,3,"T1",1,5,-1,"A"
"2877",2003-11-30,2003,"Fenerbahce","Besiktas","2-2",2,2,"T1",1,4,0,"D"
"2878",2003-11-30,2003,"Gaziantepspor","Istanbulspor","2-1",2,1,"T1",1,3,1,"H"
"2879",2003-11-30,2003,"Genclerbirligi","Denizlispor","1-3",1,3,"T1",1,4,-2,"A"
"2880",2003-12-05,2003,"Besiktas","Adanaspor","2-1",2,1,"T1",1,3,1,"H"
"2881",2003-12-06,2003,"Diyarbakirspor","Elazigspor","2-0",2,0,"T1",1,2,2,"H"
"2882",2003-12-06,2003,"Istanbulspor","Galatasaray","3-1",3,1,"T1",1,4,2,"H"
"2883",2003-12-06,2003,"Samsunspor","A. Sebatspor","1-1",1,1,"T1",1,2,0,"D"
"2884",2003-12-06,2003,"Trabzonspor","Gaziantepspor","3-0",3,0,"T1",1,3,3,"H"
"2885",2003-12-07,2003,"Ankaragucu","Fenerbahce","1-4",1,4,"T1",1,5,-3,"A"
"2886",2003-12-07,2003,"Denizlispor","Konyaspor","3-2",3,2,"T1",1,5,1,"H"
"2887",2003-12-07,2003,"Malatyaspor","Genclerbirligi","1-1",1,1,"T1",1,2,0,"D"
"2888",2003-12-07,2003,"Rizespor","Bursaspor","1-0",1,0,"T1",1,1,1,"H"
"2889",2003-12-13,2003,"A. Sebatspor","Besiktas","1-2",1,2,"T1",1,3,-1,"A"
"2890",2003-12-13,2003,"Fenerbahce","Denizlispor","2-0",2,0,"T1",1,2,2,"H"
"2891",2003-12-13,2003,"Gaziantepspor","Elazigspor","3-1",3,1,"T1",1,4,2,"H"
"2892",2003-12-13,2003,"Genclerbirligi","Istanbulspor","1-0",1,0,"T1",1,1,1,"H"
"2893",2003-12-14,2003,"Adanaspor","Ankaragucu","1-3",1,3,"T1",1,4,-2,"A"
"2894",2003-12-14,2003,"Bursaspor","Diyarbakirspor","0-0",0,0,"T1",1,0,0,"D"
"2895",2003-12-14,2003,"Galatasaray","Trabzonspor","1-2",1,2,"T1",1,3,-1,"A"
"2896",2003-12-14,2003,"Konyaspor","Malatyaspor","3-3",3,3,"T1",1,6,0,"D"
"2897",2003-12-14,2003,"Rizespor","Samsunspor","1-2",1,2,"T1",1,3,-1,"A"
"2898",2003-12-20,2003,"Besiktas","Rizespor","5-3",5,3,"T1",1,8,2,"H"
"2899",2003-12-20,2003,"Elazigspor","Galatasaray","2-2",2,2,"T1",1,4,0,"D"
"2900",2003-12-20,2003,"Trabzonspor","Genclerbirligi","1-3",1,3,"T1",1,4,-2,"A"
"2901",2003-12-21,2003,"Ankaragucu","A. Sebatspor","1-1",1,1,"T1",1,2,0,"D"
"2902",2003-12-21,2003,"Denizlispor","Adanaspor","1-1",1,1,"T1",1,2,0,"D"
"2903",2003-12-21,2003,"Diyarbakirspor","Gaziantepspor","2-1",2,1,"T1",1,3,1,"H"
"2904",2003-12-21,2003,"Istanbulspor","Konyaspor","2-3",2,3,"T1",1,5,-1,"A"
"2905",2003-12-21,2003,"Malatyaspor","Fenerbahce","2-2",2,2,"T1",1,4,0,"D"
"2906",2003-12-21,2003,"Samsunspor","Bursaspor","0-0",0,0,"T1",1,0,0,"D"
"2907",2004-01-18,2003,"Fenerbahce","Rizespor","4-1",4,1,"T1",1,5,3,"H"
"2908",2004-01-23,2003,"Diyarbakirspor","Galatasaray","0-0",0,0,"T1",1,0,0,"D"
"2909",2004-01-24,2003,"Denizlispor","A. Sebatspor","1-2",1,2,"T1",1,3,-1,"A"
"2910",2004-01-25,2003,"Ankaragucu","Rizespor","4-1",4,1,"T1",1,5,3,"H"
"2911",2004-01-25,2003,"Besiktas","Samsunspor","1-4",1,4,"T1",1,5,-3,"A"
"2912",2004-01-25,2003,"Elazigspor","Genclerbirligi","1-1",1,1,"T1",1,2,0,"D"
"2913",2004-01-25,2003,"Gaziantepspor","Bursaspor","3-2",3,2,"T1",1,5,1,"H"
"2914",2004-01-25,2003,"Istanbulspor","Fenerbahce","0-1",0,1,"T1",1,1,-1,"A"
"2915",2004-01-25,2003,"Malatyaspor","Adanaspor","2-0",2,0,"T1",1,2,2,"H"
"2916",2004-01-25,2003,"Trabzonspor","Konyaspor","0-3",0,3,"T1",1,3,-3,"A"
"2917",2004-01-31,2003,"Galatasaray","Gaziantepspor","3-0",3,0,"T1",1,3,3,"H"
"2918",2004-02-01,2003,"A. Sebatspor","Malatyaspor","2-2",2,2,"T1",1,4,0,"D"
"2919",2004-02-01,2003,"Adanaspor","Istanbulspor","1-1",1,1,"T1",1,2,0,"D"
"2920",2004-02-01,2003,"Bursaspor","Besiktas","0-1",0,1,"T1",1,1,-1,"A"
"2921",2004-02-01,2003,"Fenerbahce","Trabzonspor","3-1",3,1,"T1",1,4,2,"H"
"2922",2004-02-01,2003,"Genclerbirligi","Diyarbakirspor","3-4",3,4,"T1",1,7,-1,"A"
"2923",2004-02-01,2003,"Konyaspor","Elazigspor","2-0",2,0,"T1",1,2,2,"H"
"2924",2004-02-01,2003,"Rizespor","Denizlispor","1-2",1,2,"T1",1,3,-1,"A"
"2925",2004-02-01,2003,"Samsunspor","Ankaragucu","3-2",3,2,"T1",1,5,1,"H"
"2926",2004-02-06,2003,"Ankaragucu","Besiktas","1-1",1,1,"T1",1,2,0,"D"
"2927",2004-02-07,2003,"Denizlispor","Samsunspor","1-0",1,0,"T1",1,1,1,"H"
"2928",2004-02-07,2003,"Diyarbakirspor","Konyaspor","1-1",1,1,"T1",1,2,0,"D"
"2929",2004-02-07,2003,"Elazigspor","Fenerbahce","0-1",0,1,"T1",1,1,-1,"A"
"2930",2004-02-07,2003,"Gaziantepspor","Genclerbirligi","2-0",2,0,"T1",1,2,2,"H"
"2931",2004-02-07,2003,"Malatyaspor","Rizespor","0-1",0,1,"T1",1,1,-1,"A"
"2932",2004-02-08,2003,"Galatasaray","Bursaspor","0-0",0,0,"T1",1,0,0,"D"
"2933",2004-02-08,2003,"Istanbulspor","A. Sebatspor","1-3",1,3,"T1",1,4,-2,"A"
"2934",2004-02-08,2003,"Trabzonspor","Adanaspor","2-1",2,1,"T1",1,3,1,"H"
"2935",2004-02-14,2003,"Adanaspor","Elazigspor","1-2",1,2,"T1",1,3,-1,"A"
"2936",2004-02-14,2003,"Samsunspor","Malatyaspor","1-0",1,0,"T1",1,1,1,"H"
"2937",2004-02-15,2003,"A. Sebatspor","Trabzonspor","0-0",0,0,"T1",1,0,0,"D"
"2938",2004-02-15,2003,"Besiktas","Denizlispor","3-1",3,1,"T1",1,4,2,"H"
"2939",2004-02-15,2003,"Bursaspor","Ankaragucu","1-0",1,0,"T1",1,1,1,"H"
"2940",2004-02-15,2003,"Fenerbahce","Diyarbakirspor","2-2",2,2,"T1",1,4,0,"D"
"2941",2004-02-15,2003,"Genclerbirligi","Galatasaray","2-2",2,2,"T1",1,4,0,"D"
"2942",2004-02-15,2003,"Konyaspor","Gaziantepspor","0-3",0,3,"T1",1,3,-3,"A"
"2943",2004-02-16,2003,"Rizespor","Istanbulspor","1-0",1,0,"T1",1,1,1,"H"
"2944",2004-02-21,2003,"Galatasaray","Konyaspor","2-1",2,1,"T1",1,3,1,"H"
"2945",2004-02-21,2003,"Genclerbirligi","Bursaspor","2-0",2,0,"T1",1,2,2,"H"
"2946",2004-02-21,2003,"Malatyaspor","Besiktas","0-0",0,0,"T1",1,0,0,"D"
"2947",2004-02-22,2003,"Denizlispor","Ankaragucu","0-1",0,1,"T1",1,1,-1,"A"
"2948",2004-02-22,2003,"Diyarbakirspor","Adanaspor","3-1",3,1,"T1",1,4,2,"H"
"2949",2004-02-22,2003,"Gaziantepspor","Fenerbahce","1-5",1,5,"T1",1,6,-4,"A"
"2950",2004-02-22,2003,"Istanbulspor","Samsunspor","0-0",0,0,"T1",1,0,0,"D"
"2951",2004-02-22,2003,"Trabzonspor","Rizespor","1-0",1,0,"T1",1,1,1,"H"
"2952",2004-02-23,2003,"Elazigspor","A. Sebatspor","3-1",3,1,"T1",1,4,2,"H"
"2953",2004-02-28,2003,"Rizespor","Elazigspor","5-4",5,4,"T1",1,9,1,"H"
"2954",2004-02-28,2003,"Samsunspor","Trabzonspor","1-3",1,3,"T1",1,4,-2,"A"
"2955",2004-02-29,2003,"A. Sebatspor","Diyarbakirspor","0-1",0,1,"T1",1,1,-1,"A"
"2956",2004-02-29,2003,"Adanaspor","Gaziantepspor","2-3",2,3,"T1",1,5,-1,"A"
"2957",2004-02-29,2003,"Ankaragucu","Malatyaspor","0-0",0,0,"T1",1,0,0,"D"
"2958",2004-02-29,2003,"Besiktas","Istanbulspor","1-2",1,2,"T1",1,3,-1,"A"
"2959",2004-02-29,2003,"Bursaspor","Denizlispor","0-1",0,1,"T1",1,1,-1,"A"
"2960",2004-02-29,2003,"Fenerbahce","Galatasaray","2-1",2,1,"T1",1,3,1,"H"
"2961",2004-02-29,2003,"Konyaspor","Genclerbirligi","4-1",4,1,"T1",1,5,3,"H"
"2962",2004-03-06,2003,"Diyarbakirspor","Rizespor","0-1",0,1,"T1",1,1,-1,"A"
"2963",2004-03-06,2003,"Elazigspor","Samsunspor","1-0",1,0,"T1",1,1,1,"H"
"2964",2004-03-06,2003,"Genclerbirligi","Fenerbahce","0-1",0,1,"T1",1,1,-1,"A"
"2965",2004-03-06,2003,"Konyaspor","Bursaspor","1-1",1,1,"T1",1,2,0,"D"
"2966",2004-03-07,2003,"Galatasaray","Adanaspor","3-2",3,2,"T1",1,5,1,"H"
"2967",2004-03-07,2003,"Gaziantepspor","A. Sebatspor","2-2",2,2,"T1",1,4,0,"D"
"2968",2004-03-07,2003,"Istanbulspor","Ankaragucu","2-3",2,3,"T1",1,5,-1,"A"
"2969",2004-03-07,2003,"Malatyaspor","Denizlispor","0-1",0,1,"T1",1,1,-1,"A"
"2970",2004-03-07,2003,"Trabzonspor","Besiktas","3-0",3,0,"T1",1,3,3,"H"
"2971",2004-03-12,2003,"Ankaragucu","Trabzonspor","1-2",1,2,"T1",1,3,-1,"A"
"2972",2004-03-13,2003,"A. Sebatspor","Galatasaray","2-1",2,1,"T1",1,3,1,"H"
"2973",2004-03-13,2003,"Bursaspor","Malatyaspor","3-2",3,2,"T1",1,5,1,"H"
"2974",2004-03-13,2003,"Denizlispor","Istanbulspor","2-0",2,0,"T1",1,2,2,"H"
"2975",2004-03-13,2003,"Fenerbahce","Konyaspor","5-2",5,2,"T1",1,7,3,"H"
"2976",2004-03-14,2003,"Besiktas","Elazigspor","5-3",5,3,"T1",1,8,2,"H"
"2977",2004-03-14,2003,"Rizespor","Gaziantepspor","1-2",1,2,"T1",1,3,-1,"A"
"2978",2004-03-14,2003,"Samsunspor","Diyarbakirspor","3-1",3,1,"T1",1,4,2,"H"
"2979",2004-03-19,2003,"Diyarbakirspor","Besiktas","3-1",3,1,"T1",1,4,2,"H"
"2980",2004-03-20,2003,"Galatasaray","Rizespor","1-2",1,2,"T1",1,3,-1,"A"
"2981",2004-03-20,2003,"Gaziantepspor","Samsunspor","1-0",1,0,"T1",1,1,1,"H"
"2982",2004-03-20,2003,"Konyaspor","Adanaspor","4-1",4,1,"T1",1,5,3,"H"
"2983",2004-03-21,2003,"Elazigspor","Ankaragucu","1-2",1,2,"T1",1,3,-1,"A"
"2984",2004-03-21,2003,"Fenerbahce","Bursaspor","3-1",3,1,"T1",1,4,2,"H"
"2985",2004-03-21,2003,"Genclerbirligi","A. Sebatspor","3-1",3,1,"T1",1,4,2,"H"
"2986",2004-03-21,2003,"Istanbulspor","Malatyaspor","0-0",0,0,"T1",1,0,0,"D"
"2987",2004-03-21,2003,"Trabzonspor","Denizlispor","1-0",1,0,"T1",1,1,1,"H"
"2988",2004-03-26,2003,"Samsunspor","Galatasaray","1-0",1,0,"T1",1,1,1,"H"
"2989",2004-03-27,2003,"A. Sebatspor","Konyaspor","1-1",1,1,"T1",1,2,0,"D"
"2990",2004-03-27,2003,"Adanaspor","Fenerbahce","1-2",1,2,"T1",1,3,-1,"A"
"2991",2004-03-27,2003,"Ankaragucu","Diyarbakirspor","3-1",3,1,"T1",1,4,2,"H"
"2992",2004-03-27,2003,"Besiktas","Gaziantepspor","4-1",4,1,"T1",1,5,3,"H"
"2993",2004-03-27,2003,"Bursaspor","Istanbulspor","1-1",1,1,"T1",1,2,0,"D"
"2994",2004-03-27,2003,"Denizlispor","Elazigspor","3-0",3,0,"T1",1,3,3,"H"
"2995",2004-03-27,2003,"Malatyaspor","Trabzonspor","2-3",2,3,"T1",1,5,-1,"A"
"2996",2004-03-27,2003,"Rizespor","Genclerbirligi","2-0",2,0,"T1",1,2,2,"H"
"2997",2004-03-31,2003,"Adanaspor","Genclerbirligi","2-2",2,2,"T1",1,4,0,"D"
"2998",2004-04-03,2003,"Diyarbakirspor","Denizlispor","0-1",0,1,"T1",1,1,-1,"A"
"2999",2004-04-03,2003,"Fenerbahce","A. Sebatspor","4-2",4,2,"T1",1,6,2,"H"
"3000",2004-04-03,2003,"Gaziantepspor","Ankaragucu","2-1",2,1,"T1",1,3,1,"H"
"3001",2004-04-03,2003,"Trabzonspor","Istanbulspor","2-0",2,0,"T1",1,2,2,"H"
"3002",2004-04-04,2003,"Adanaspor","Bursaspor","0-3",0,3,"T1",1,3,-3,"A"
"3003",2004-04-04,2003,"Elazigspor","Malatyaspor","0-0",0,0,"T1",1,0,0,"D"
"3004",2004-04-04,2003,"Galatasaray","Besiktas","1-2",1,2,"T1",1,3,-1,"A"
"3005",2004-04-04,2003,"Genclerbirligi","Samsunspor","2-1",2,1,"T1",1,3,1,"H"
"3006",2004-04-04,2003,"Konyaspor","Rizespor","2-1",2,1,"T1",1,3,1,"H"
"3007",2004-04-09,2003,"Rizespor","Fenerbahce","1-0",1,0,"T1",1,1,1,"H"
"3008",2004-04-10,2003,"A. Sebatspor","Adanaspor","4-3",4,3,"T1",1,7,1,"H"
"3009",2004-04-10,2003,"Ankaragucu","Galatasaray","1-0",1,0,"T1",1,1,1,"H"
"3010",2004-04-10,2003,"Bursaspor","Trabzonspor","1-2",1,2,"T1",1,3,-1,"A"
"3011",2004-04-10,2003,"Istanbulspor","Elazigspor","3-1",3,1,"T1",1,4,2,"H"
"3012",2004-04-11,2003,"Besiktas","Genclerbirligi","2-2",2,2,"T1",1,4,0,"D"
"3013",2004-04-11,2003,"Denizlispor","Gaziantepspor","2-0",2,0,"T1",1,2,2,"H"
"3014",2004-04-11,2003,"Malatyaspor","Diyarbakirspor","5-0",5,0,"T1",1,5,5,"H"
"3015",2004-04-16,2003,"Galatasaray","Denizlispor","4-3",4,3,"T1",1,7,1,"H"
"3016",2004-04-17,2003,"Elazigspor","Trabzonspor","0-3",0,3,"T1",1,3,-3,"A"
"3017",2004-04-17,2003,"Gaziantepspor","Malatyaspor","1-3",1,3,"T1",1,4,-2,"A"
"3018",2004-04-17,2003,"Genclerbirligi","Ankaragucu","1-2",1,2,"T1",1,3,-1,"A"
"3019",2004-04-17,2003,"Konyaspor","Besiktas","2-2",2,2,"T1",1,4,0,"D"
"3020",2004-04-18,2003,"A. Sebatspor","Bursaspor","0-1",0,1,"T1",1,1,-1,"A"
"3021",2004-04-18,2003,"Adanaspor","Rizespor","0-1",0,1,"T1",1,1,-1,"A"
"3022",2004-04-18,2003,"Diyarbakirspor","Istanbulspor","1-2",1,2,"T1",1,3,-1,"A"
"3023",2004-04-18,2003,"Fenerbahce","Samsunspor","1-1",1,1,"T1",1,2,0,"D"
"3024",2004-04-21,2003,"Samsunspor","Konyaspor","2-3",2,3,"T1",1,5,-1,"A"
"3025",2004-04-23,2003,"Malatyaspor","Galatasaray","1-2",1,2,"T1",1,3,-1,"A"
"3026",2004-04-24,2003,"Bursaspor","Elazigspor","4-0",4,0,"T1",1,4,4,"H"
"3027",2004-04-24,2003,"Istanbulspor","Gaziantepspor","0-1",0,1,"T1",1,1,-1,"A"
"3028",2004-04-24,2003,"Rizespor","A. Sebatspor","0-1",0,1,"T1",1,1,-1,"A"
"3029",2004-04-24,2003,"Trabzonspor","Diyarbakirspor","2-0",2,0,"T1",1,2,2,"H"
"3030",2004-04-25,2003,"Ankaragucu","Konyaspor","1-0",1,0,"T1",1,1,1,"H"
"3031",2004-04-25,2003,"Besiktas","Fenerbahce","1-3",1,3,"T1",1,4,-2,"A"
"3032",2004-04-25,2003,"Denizlispor","Genclerbirligi","1-2",1,2,"T1",1,3,-1,"A"
"3033",2004-04-25,2003,"Samsunspor","Adanaspor","2-1",2,1,"T1",1,3,1,"H"
"3034",2004-04-30,2003,"Adanaspor","Besiktas","1-0",1,0,"T1",1,1,1,"H"
"3035",2004-05-01,2003,"Fenerbahce","Ankaragucu","3-1",3,1,"T1",1,4,2,"H"
"3036",2004-05-01,2003,"Gaziantepspor","Trabzonspor","1-2",1,2,"T1",1,3,-1,"A"
"3037",2004-05-01,2003,"Genclerbirligi","Malatyaspor","2-2",2,2,"T1",1,4,0,"D"
"3038",2004-05-01,2003,"Konyaspor","Denizlispor","1-1",1,1,"T1",1,2,0,"D"
"3039",2004-05-02,2003,"A. Sebatspor","Samsunspor","1-0",1,0,"T1",1,1,1,"H"
"3040",2004-05-02,2003,"Bursaspor","Rizespor","4-2",4,2,"T1",1,6,2,"H"
"3041",2004-05-02,2003,"Elazigspor","Diyarbakirspor","0-1",0,1,"T1",1,1,-1,"A"
"3042",2004-05-02,2003,"Galatasaray","Istanbulspor","2-2",2,2,"T1",1,4,0,"D"
"3043",2004-05-08,2003,"Ankaragucu","Adanaspor","1-2",1,2,"T1",1,3,-1,"A"
"3044",2004-05-08,2003,"Elazigspor","Gaziantepspor","1-2",1,2,"T1",1,3,-1,"A"
"3045",2004-05-08,2003,"Malatyaspor","Konyaspor","1-3",1,3,"T1",1,4,-2,"A"
"3046",2004-05-09,2003,"Besiktas","A. Sebatspor","0-2",0,2,"T1",1,2,-2,"A"
"3047",2004-05-09,2003,"Denizlispor","Fenerbahce","0-4",0,4,"T1",1,4,-4,"A"
"3048",2004-05-09,2003,"Diyarbakirspor","Bursaspor","0-3",0,3,"T1",1,3,-3,"A"
"3049",2004-05-09,2003,"Istanbulspor","Genclerbirligi","3-0",3,0,"T1",1,3,3,"H"
"3050",2004-05-09,2003,"Samsunspor","Rizespor","2-1",2,1,"T1",1,3,1,"H"
"3051",2004-05-09,2003,"Trabzonspor","Galatasaray","2-4",2,4,"T1",1,6,-2,"A"
"3052",2004-05-14,2003,"Fenerbahce","Malatyaspor","2-4",2,4,"T1",1,6,-2,"A"
"3053",2004-05-15,2003,"A. Sebatspor","Ankaragucu","3-2",3,2,"T1",1,5,1,"H"
"3054",2004-05-15,2003,"Adanaspor","Denizlispor","4-1",4,1,"T1",1,5,3,"H"
"3055",2004-05-15,2003,"Bursaspor","Samsunspor","1-0",1,0,"T1",1,1,1,"H"
"3056",2004-05-15,2003,"Galatasaray","Elazigspor","3-1",3,1,"T1",1,4,2,"H"
"3057",2004-05-15,2003,"Gaziantepspor","Diyarbakirspor","4-1",4,1,"T1",1,5,3,"H"
"3058",2004-05-15,2003,"Genclerbirligi","Trabzonspor","2-2",2,2,"T1",1,4,0,"D"
"3059",2004-05-15,2003,"Konyaspor","Istanbulspor","0-2",0,2,"T1",1,2,-2,"A"
"3060",2004-05-15,2003,"Rizespor","Besiktas","1-0",1,0,"T1",1,1,1,"H"
"3061",2004-08-06,2004,"Rizespor","Fenerbahce","2-2",2,2,"T1",1,4,0,"D"
"3062",2004-08-07,2004,"Denizlispor","Gaziantepspor","2-1",2,1,"T1",1,3,1,"H"
"3063",2004-08-07,2004,"Genclerbirligi","Sakaryaspor","1-0",1,0,"T1",1,1,1,"H"
"3064",2004-08-07,2004,"Kayserispor","Trabzonspor","0-3",0,3,"T1",1,3,-3,"A"
"3065",2004-08-07,2004,"Malatyaspor","Besiktas","1-1",1,1,"T1",1,2,0,"D"
"3066",2004-08-08,2004,"A. Sebatspor","Ankaraspor","1-3",1,3,"T1",1,4,-2,"A"
"3067",2004-08-08,2004,"Galatasaray","Konyaspor","3-1",3,1,"T1",1,4,2,"H"
"3068",2004-08-08,2004,"Istanbulspor","Diyarbakirspor","1-1",1,1,"T1",1,2,0,"D"
"3069",2004-08-08,2004,"Samsunspor","Ankaragucu","1-1",1,1,"T1",1,2,0,"D"
"3070",2004-08-13,2004,"Gaziantepspor","Galatasaray","1-0",1,0,"T1",1,1,1,"H"
"3071",2004-08-14,2004,"Ankaragucu","Istanbulspor","0-0",0,0,"T1",1,0,0,"D"
"3072",2004-08-14,2004,"Ankaraspor","Malatyaspor","1-3",1,3,"T1",1,4,-2,"A"
"3073",2004-08-14,2004,"Diyarbakirspor","Kayserispor","2-1",2,1,"T1",1,3,1,"H"
"3074",2004-08-14,2004,"Fenerbahce","Samsunspor","2-1",2,1,"T1",1,3,1,"H"
"3075",2004-08-15,2004,"Genclerbirligi","Besiktas","1-1",1,1,"T1",1,2,0,"D"
"3076",2004-08-15,2004,"Konyaspor","Rizespor","0-0",0,0,"T1",1,0,0,"D"
"3077",2004-08-15,2004,"Sakaryaspor","Denizlispor","1-2",1,2,"T1",1,3,-1,"A"
"3078",2004-08-15,2004,"Trabzonspor","A. Sebatspor","3-1",3,1,"T1",1,4,2,"H"
"3079",2004-08-21,2004,"Denizlispor","Besiktas","3-1",3,1,"T1",1,4,2,"H"
"3080",2004-08-21,2004,"Genclerbirligi","Ankaraspor","1-1",1,1,"T1",1,2,0,"D"
"3081",2004-08-21,2004,"Istanbulspor","Fenerbahce","0-3",0,3,"T1",1,3,-3,"A"
"3082",2004-08-21,2004,"Malatyaspor","Trabzonspor","3-4",3,4,"T1",1,7,-1,"A"
"3083",2004-08-21,2004,"Samsunspor","Konyaspor","1-1",1,1,"T1",1,2,0,"D"
"3084",2004-08-22,2004,"A. Sebatspor","Diyarbakirspor","2-2",2,2,"T1",1,4,0,"D"
"3085",2004-08-22,2004,"Galatasaray","Rizespor","2-1",2,1,"T1",1,3,1,"H"
"3086",2004-08-22,2004,"Gaziantepspor","Sakaryaspor","1-0",1,0,"T1",1,1,1,"H"
"3087",2004-08-22,2004,"Kayserispor","Ankaragucu","1-1",1,1,"T1",1,2,0,"D"
"3088",2004-08-28,2004,"Ankaraspor","Denizlispor","3-2",3,2,"T1",1,5,1,"H"
"3089",2004-08-28,2004,"Kayserispor","Fenerbahce","0-2",0,2,"T1",1,2,-2,"A"
"3090",2004-08-28,2004,"Konyaspor","Istanbulspor","2-1",2,1,"T1",1,3,1,"H"
"3091",2004-08-28,2004,"Rizespor","Samsunspor","2-0",2,0,"T1",1,2,2,"H"
"3092",2004-08-28,2004,"Sakaryaspor","Galatasaray","1-2",1,2,"T1",1,3,-1,"A"
"3093",2004-08-29,2004,"Ankaragucu","A. Sebatspor","2-1",2,1,"T1",1,3,1,"H"
"3094",2004-08-29,2004,"Besiktas","Gaziantepspor","3-4",3,4,"T1",1,7,-1,"A"
"3095",2004-08-29,2004,"Diyarbakirspor","Malatyaspor","1-2",1,2,"T1",1,3,-1,"A"
"3096",2004-08-29,2004,"Trabzonspor","Genclerbirligi","3-1",3,1,"T1",1,4,2,"H"
"3097",2004-09-11,2004,"A. Sebatspor","Fenerbahce","1-4",1,4,"T1",1,5,-3,"A"
"3098",2004-09-11,2004,"Denizlispor","Trabzonspor","0-2",0,2,"T1",1,2,-2,"A"
"3099",2004-09-11,2004,"Gaziantepspor","Ankaraspor","2-1",2,1,"T1",1,3,1,"H"
"3100",2004-09-11,2004,"Genclerbirligi","Diyarbakirspor","2-0",2,0,"T1",1,2,2,"H"
"3101",2004-09-12,2004,"Galatasaray","Samsunspor","3-1",3,1,"T1",1,4,2,"H"
"3102",2004-09-12,2004,"Istanbulspor","Rizespor","0-3",0,3,"T1",1,3,-3,"A"
"3103",2004-09-12,2004,"Kayserispor","Konyaspor","2-2",2,2,"T1",1,4,0,"D"
"3104",2004-09-12,2004,"Malatyaspor","Ankaragucu","1-0",1,0,"T1",1,1,1,"H"
"3105",2004-09-12,2004,"Sakaryaspor","Besiktas","1-4",1,4,"T1",1,5,-3,"A"
"3106",2004-09-17,2004,"Diyarbakirspor","Denizlispor","0-1",0,1,"T1",1,1,-1,"A"
"3107",2004-09-18,2004,"Ankaraspor","Sakaryaspor","1-1",1,1,"T1",1,2,0,"D"
"3108",2004-09-18,2004,"Fenerbahce","Malatyaspor","3-1",3,1,"T1",1,4,2,"H"
"3109",2004-09-18,2004,"Konyaspor","A. Sebatspor","3-3",3,3,"T1",1,6,0,"D"
"3110",2004-09-18,2004,"Samsunspor","Istanbulspor","2-1",2,1,"T1",1,3,1,"H"
"3111",2004-09-19,2004,"Ankaragucu","Genclerbirligi","1-0",1,0,"T1",1,1,1,"H"
"3112",2004-09-19,2004,"Besiktas","Galatasaray","0-0",0,0,"T1",1,0,0,"D"
"3113",2004-09-19,2004,"Rizespor","Kayserispor","2-1",2,1,"T1",1,3,1,"H"
"3114",2004-09-19,2004,"Trabzonspor","Gaziantepspor","0-0",0,0,"T1",1,0,0,"D"
"3115",2004-09-24,2004,"Genclerbirligi","Fenerbahce","1-2",1,2,"T1",1,3,-1,"A"
"3116",2004-09-25,2004,"A. Sebatspor","Rizespor","0-0",0,0,"T1",1,0,0,"D"
"3117",2004-09-25,2004,"Besiktas","Ankaraspor","2-3",2,3,"T1",1,5,-1,"A"
"3118",2004-09-25,2004,"Kayserispor","Samsunspor","1-4",1,4,"T1",1,5,-3,"A"
"3119",2004-09-25,2004,"Sakaryaspor","Trabzonspor","1-3",1,3,"T1",1,4,-2,"A"
"3120",2004-09-26,2004,"Denizlispor","Ankaragucu","2-0",2,0,"T1",1,2,2,"H"
"3121",2004-09-26,2004,"Galatasaray","Istanbulspor","4-1",4,1,"T1",1,5,3,"H"
"3122",2004-09-26,2004,"Gaziantepspor","Diyarbakirspor","1-1",1,1,"T1",1,2,0,"D"
"3123",2004-09-26,2004,"Malatyaspor","Konyaspor","5-0",5,0,"T1",1,5,5,"H"
"3124",2004-10-01,2004,"Ankaraspor","Galatasaray","0-2",0,2,"T1",1,2,-2,"A"
"3125",2004-10-02,2004,"Ankaragucu","Gaziantepspor","2-1",2,1,"T1",1,3,1,"H"
"3126",2004-10-02,2004,"Diyarbakirspor","Sakaryaspor","1-0",1,0,"T1",1,1,1,"H"
"3127",2004-10-02,2004,"Fenerbahce","Denizlispor","2-0",2,0,"T1",1,2,2,"H"
"3128",2004-10-02,2004,"Rizespor","Malatyaspor","0-1",0,1,"T1",1,1,-1,"A"
"3129",2004-10-03,2004,"Istanbulspor","Kayserispor","2-0",2,0,"T1",1,2,2,"H"
"3130",2004-10-03,2004,"Konyaspor","Genclerbirligi","3-2",3,2,"T1",1,5,1,"H"
"3131",2004-10-03,2004,"Samsunspor","A. Sebatspor","3-0",3,0,"T1",1,3,3,"H"
"3132",2004-10-03,2004,"Trabzonspor","Besiktas","1-0",1,0,"T1",1,1,1,"H"
"3133",2004-10-16,2004,"Besiktas","Diyarbakirspor","4-0",4,0,"T1",1,4,4,"H"
"3134",2004-10-16,2004,"Gaziantepspor","Fenerbahce","0-1",0,1,"T1",1,1,-1,"A"
"3135",2004-10-16,2004,"Genclerbirligi","Rizespor","2-1",2,1,"T1",1,3,1,"H"
"3136",2004-10-16,2004,"Sakaryaspor","Ankaragucu","1-0",1,0,"T1",1,1,1,"H"
"3137",2004-10-17,2004,"A. Sebatspor","Istanbulspor","2-2",2,2,"T1",1,4,0,"D"
"3138",2004-10-17,2004,"Ankaraspor","Trabzonspor","1-1",1,1,"T1",1,2,0,"D"
"3139",2004-10-17,2004,"Denizlispor","Konyaspor","2-1",2,1,"T1",1,3,1,"H"
"3140",2004-10-17,2004,"Galatasaray","Kayserispor","5-1",5,1,"T1",1,6,4,"H"
"3141",2004-10-17,2004,"Malatyaspor","Samsunspor","1-2",1,2,"T1",1,3,-1,"A"
"3142",2004-10-23,2004,"Istanbulspor","Malatyaspor","0-2",0,2,"T1",1,2,-2,"A"
"3143",2004-10-23,2004,"Konyaspor","Gaziantepspor","2-2",2,2,"T1",1,4,0,"D"
"3144",2004-10-23,2004,"Samsunspor","Genclerbirligi","2-0",2,0,"T1",1,2,2,"H"
"3145",2004-10-23,2004,"Trabzonspor","Galatasaray","0-1",0,1,"T1",1,1,-1,"A"
"3146",2004-10-24,2004,"Ankaragucu","Besiktas","1-4",1,4,"T1",1,5,-3,"A"
"3147",2004-10-24,2004,"Diyarbakirspor","Ankaraspor","1-0",1,0,"T1",1,1,1,"H"
"3148",2004-10-24,2004,"Fenerbahce","Sakaryaspor","6-0",6,0,"T1",1,6,6,"H"
"3149",2004-10-24,2004,"Kayserispor","A. Sebatspor","4-1",4,1,"T1",1,5,3,"H"
"3150",2004-10-24,2004,"Rizespor","Denizlispor","2-0",2,0,"T1",1,2,2,"H"
"3151",2004-10-29,2004,"Trabzonspor","Diyarbakirspor","4-1",4,1,"T1",1,5,3,"H"
"3152",2004-10-30,2004,"Besiktas","Fenerbahce","2-1",2,1,"T1",1,3,1,"H"
"3153",2004-10-30,2004,"Denizlispor","Samsunspor","2-0",2,0,"T1",1,2,2,"H"
"3154",2004-10-30,2004,"Gaziantepspor","Rizespor","0-1",0,1,"T1",1,1,-1,"A"
"3155",2004-10-30,2004,"Genclerbirligi","Istanbulspor","1-0",1,0,"T1",1,1,1,"H"
"3156",2004-10-31,2004,"Ankaraspor","Ankaragucu","2-0",2,0,"T1",1,2,2,"H"
"3157",2004-10-31,2004,"Galatasaray","A. Sebatspor","2-0",2,0,"T1",1,2,2,"H"
"3158",2004-10-31,2004,"Malatyaspor","Kayserispor","0-1",0,1,"T1",1,1,-1,"A"
"3159",2004-10-31,2004,"Sakaryaspor","Konyaspor","1-4",1,4,"T1",1,5,-3,"A"
"3160",2004-11-05,2004,"Diyarbakirspor","Galatasaray","2-0",2,0,"T1",1,2,2,"H"
"3161",2004-11-06,2004,"A. Sebatspor","Malatyaspor","1-1",1,1,"T1",1,2,0,"D"
"3162",2004-11-06,2004,"Fenerbahce","Ankaraspor","1-0",1,0,"T1",1,1,1,"H"
"3163",2004-11-06,2004,"Istanbulspor","Denizlispor","1-1",1,1,"T1",1,2,0,"D"
"3164",2004-11-06,2004,"Samsunspor","Gaziantepspor","1-3",1,3,"T1",1,4,-2,"A"
"3165",2004-11-07,2004,"Ankaragucu","Trabzonspor","0-2",0,2,"T1",1,2,-2,"A"
"3166",2004-11-07,2004,"Kayserispor","Genclerbirligi","1-2",1,2,"T1",1,3,-1,"A"
"3167",2004-11-07,2004,"Konyaspor","Besiktas","2-2",2,2,"T1",1,4,0,"D"
"3168",2004-11-07,2004,"Rizespor","Sakaryaspor","2-0",2,0,"T1",1,2,2,"H"
"3169",2004-11-20,2004,"Ankaraspor","Konyaspor","1-3",1,3,"T1",1,4,-2,"A"
"3170",2004-11-20,2004,"Galatasaray","Malatyaspor","1-1",1,1,"T1",1,2,0,"D"
"3171",2004-11-20,2004,"Sakaryaspor","Samsunspor","4-2",4,2,"T1",1,6,2,"H"
"3172",2004-11-20,2004,"Trabzonspor","Fenerbahce","0-2",0,2,"T1",1,2,-2,"A"
"3173",2004-11-21,2004,"Besiktas","Rizespor","2-2",2,2,"T1",1,4,0,"D"
"3174",2004-11-21,2004,"Denizlispor","Kayserispor","2-1",2,1,"T1",1,3,1,"H"
"3175",2004-11-21,2004,"Diyarbakirspor","Ankaragucu","0-1",0,1,"T1",1,1,-1,"A"
"3176",2004-11-21,2004,"Gaziantepspor","Istanbulspor","0-1",0,1,"T1",1,1,-1,"A"
"3177",2004-11-21,2004,"Genclerbirligi","A. Sebatspor","1-1",1,1,"T1",1,2,0,"D"
"3178",2004-11-26,2004,"Ankaragucu","Galatasaray","0-1",0,1,"T1",1,1,-1,"A"
"3179",2004-11-27,2004,"Fenerbahce","Diyarbakirspor","3-0",3,0,"T1",1,3,3,"H"
"3180",2004-11-27,2004,"Kayserispor","Gaziantepspor","3-1",3,1,"T1",1,4,2,"H"
"3181",2004-11-27,2004,"Konyaspor","Trabzonspor","1-1",1,1,"T1",1,2,0,"D"
"3182",2004-11-27,2004,"Rizespor","Ankaraspor","2-1",2,1,"T1",1,3,1,"H"
"3183",2004-11-28,2004,"A. Sebatspor","Denizlispor","2-1",2,1,"T1",1,3,1,"H"
"3184",2004-11-28,2004,"Istanbulspor","Sakaryaspor","3-0",3,0,"T1",1,3,3,"H"
"3185",2004-11-28,2004,"Malatyaspor","Genclerbirligi","0-2",0,2,"T1",1,2,-2,"A"
"3186",2004-11-28,2004,"Samsunspor","Besiktas","2-4",2,4,"T1",1,6,-2,"A"
"3187",2004-12-03,2004,"Fenerbahce","Ankaragucu","5-0",5,0,"T1",1,5,5,"H"
"3188",2004-12-04,2004,"Denizlispor","Malatyaspor","0-0",0,0,"T1",1,0,0,"D"
"3189",2004-12-04,2004,"Diyarbakirspor","Konyaspor","3-3",3,3,"T1",1,6,0,"D"
"3190",2004-12-04,2004,"Genclerbirligi","Galatasaray","1-3",1,3,"T1",1,4,-2,"A"
"3191",2004-12-04,2004,"Trabzonspor","Rizespor","1-0",1,0,"T1",1,1,1,"H"
"3192",2004-12-05,2004,"Ankaraspor","Samsunspor","0-1",0,1,"T1",1,1,-1,"A"
"3193",2004-12-05,2004,"Besiktas","Istanbulspor","2-1",2,1,"T1",1,3,1,"H"
"3194",2004-12-05,2004,"Gaziantepspor","A. Sebatspor","6-4",6,4,"T1",1,10,2,"H"
"3195",2004-12-05,2004,"Sakaryaspor","Kayserispor","4-2",4,2,"T1",1,6,2,"H"
"3196",2004-12-10,2004,"Kayserispor","Besiktas","1-2",1,2,"T1",1,3,-1,"A"
"3197",2004-12-11,2004,"A. Sebatspor","Sakaryaspor","0-1",0,1,"T1",1,1,-1,"A"
"3198",2004-12-11,2004,"Istanbulspor","Ankaraspor","1-1",1,1,"T1",1,2,0,"D"
"3199",2004-12-11,2004,"Malatyaspor","Gaziantepspor","2-1",2,1,"T1",1,3,1,"H"
"3200",2004-12-11,2004,"Samsunspor","Trabzonspor","0-4",0,4,"T1",1,4,-4,"A"
"3201",2004-12-12,2004,"Galatasaray","Fenerbahce","1-0",1,0,"T1",1,1,1,"H"
"3202",2004-12-12,2004,"Genclerbirligi","Denizlispor","1-3",1,3,"T1",1,4,-2,"A"
"3203",2004-12-12,2004,"Konyaspor","Ankaragucu","3-4",3,4,"T1",1,7,-1,"A"
"3204",2004-12-12,2004,"Rizespor","Diyarbakirspor","3-0",3,0,"T1",1,3,3,"H"
"3205",2004-12-17,2004,"Denizlispor","Galatasaray","0-0",0,0,"T1",1,0,0,"D"
"3206",2004-12-18,2004,"Ankaragucu","Rizespor","0-0",0,0,"T1",1,0,0,"D"
"3207",2004-12-18,2004,"Fenerbahce","Konyaspor","3-0",3,0,"T1",1,3,3,"H"
"3208",2004-12-18,2004,"Gaziantepspor","Genclerbirligi","1-0",1,0,"T1",1,1,1,"H"
"3209",2004-12-18,2004,"Trabzonspor","Istanbulspor","1-1",1,1,"T1",1,2,0,"D"
"3210",2004-12-19,2004,"Ankaraspor","Kayserispor","4-1",4,1,"T1",1,5,3,"H"
"3211",2004-12-19,2004,"Besiktas","A. Sebatspor","6-1",6,1,"T1",1,7,5,"H"
"3212",2004-12-19,2004,"Diyarbakirspor","Samsunspor","3-0",3,0,"T1",1,3,3,"H"
"3213",2004-12-19,2004,"Sakaryaspor","Malatyaspor","4-1",4,1,"T1",1,5,3,"H"
"3214",2005-01-28,2004,"Konyaspor","Galatasaray","0-2",0,2,"T1",1,2,-2,"A"
"3215",2005-01-29,2004,"Ankaraspor","A. Sebatspor","2-1",2,1,"T1",1,3,1,"H"
"3216",2005-01-29,2004,"Besiktas","Malatyaspor","1-0",1,0,"T1",1,1,1,"H"
"3217",2005-01-29,2004,"Diyarbakirspor","Istanbulspor","1-0",1,0,"T1",1,1,1,"H"
"3218",2005-01-29,2004,"Sakaryaspor","Genclerbirligi","2-2",2,2,"T1",1,4,0,"D"
"3219",2005-01-30,2004,"Ankaragucu","Samsunspor","1-2",1,2,"T1",1,3,-1,"A"
"3220",2005-01-30,2004,"Fenerbahce","Rizespor","2-0",2,0,"T1",1,2,2,"H"
"3221",2005-01-30,2004,"Gaziantepspor","Denizlispor","3-1",3,1,"T1",1,4,2,"H"
"3222",2005-01-30,2004,"Trabzonspor","Kayserispor","3-1",3,1,"T1",1,4,2,"H"
"3223",2005-02-04,2004,"Galatasaray","Gaziantepspor","5-1",5,1,"T1",1,6,4,"H"
"3224",2005-02-05,2004,"Kayserispor","Diyarbakirspor","3-0",3,0,"T1",1,3,3,"H"
"3225",2005-02-05,2004,"Malatyaspor","Ankaraspor","2-1",2,1,"T1",1,3,1,"H"
"3226",2005-02-05,2004,"Rizespor","Konyaspor","1-1",1,1,"T1",1,2,0,"D"
"3227",2005-02-05,2004,"Samsunspor","Fenerbahce","1-1",1,1,"T1",1,2,0,"D"
"3228",2005-02-06,2004,"A. Sebatspor","Trabzonspor","0-1",0,1,"T1",1,1,-1,"A"
"3229",2005-02-06,2004,"Denizlispor","Sakaryaspor","6-1",6,1,"T1",1,7,5,"H"
"3230",2005-02-12,2004,"Ankaragucu","Kayserispor","2-2",2,2,"T1",1,4,0,"D"
"3231",2005-02-12,2004,"Besiktas","Denizlispor","2-0",2,0,"T1",1,2,2,"H"
"3232",2005-02-12,2004,"Konyaspor","Samsunspor","3-0",3,0,"T1",1,3,3,"H"
"3233",2005-02-12,2004,"Rizespor","Galatasaray","0-3",0,3,"T1",1,3,-3,"A"
"3234",2005-02-13,2004,"Ankaraspor","Genclerbirligi","2-1",2,1,"T1",1,3,1,"H"
"3235",2005-02-13,2004,"Diyarbakirspor","A. Sebatspor","1-0",1,0,"T1",1,1,1,"H"
"3236",2005-02-13,2004,"Fenerbahce","Istanbulspor","4-0",4,0,"T1",1,4,4,"H"
"3237",2005-02-13,2004,"Sakaryaspor","Gaziantepspor","2-2",2,2,"T1",1,4,0,"D"
"3238",2005-02-13,2004,"Trabzonspor","Malatyaspor","3-0",3,0,"T1",1,3,3,"H"
"3239",2005-02-18,2004,"Gaziantepspor","Besiktas","0-1",0,1,"T1",1,1,-1,"A"
"3240",2005-02-19,2004,"A. Sebatspor","Ankaragucu","0-0",0,0,"T1",1,0,0,"D"
"3241",2005-02-19,2004,"Denizlispor","Ankaraspor","1-1",1,1,"T1",1,2,0,"D"
"3242",2005-02-19,2004,"Galatasaray","Sakaryaspor","1-0",1,0,"T1",1,1,1,"H"
"3243",2005-02-19,2004,"Istanbulspor","Konyaspor","2-2",2,2,"T1",1,4,0,"D"
"3244",2005-02-20,2004,"Fenerbahce","Kayserispor","7-0",7,0,"T1",1,7,7,"H"
"3245",2005-02-20,2004,"Genclerbirligi","Trabzonspor","0-1",0,1,"T1",1,1,-1,"A"
"3246",2005-02-20,2004,"Malatyaspor","Diyarbakirspor","2-1",2,1,"T1",1,3,1,"H"
"3247",2005-02-20,2004,"Samsunspor","Rizespor","0-1",0,1,"T1",1,1,-1,"A"
"3248",2005-02-26,2004,"Ankaragucu","Malatyaspor","3-0",3,0,"T1",1,3,3,"H"
"3249",2005-02-26,2004,"Diyarbakirspor","Genclerbirligi","1-3",1,3,"T1",1,4,-2,"A"
"3250",2005-02-26,2004,"Rizespor","Istanbulspor","1-1",1,1,"T1",1,2,0,"D"
"3251",2005-02-26,2004,"Samsunspor","Galatasaray","2-1",2,1,"T1",1,3,1,"H"
"3252",2005-02-27,2004,"Ankaraspor","Gaziantepspor","1-0",1,0,"T1",1,1,1,"H"
"3253",2005-02-27,2004,"Besiktas","Sakaryaspor","2-1",2,1,"T1",1,3,1,"H"
"3254",2005-02-27,2004,"Fenerbahce","A. Sebatspor","2-0",2,0,"T1",1,2,2,"H"
"3255",2005-02-27,2004,"Konyaspor","Kayserispor","3-1",3,1,"T1",1,4,2,"H"
"3256",2005-02-27,2004,"Trabzonspor","Denizlispor","3-0",3,0,"T1",1,3,3,"H"
"3257",2005-03-05,2004,"Galatasaray","Besiktas","1-0",1,0,"T1",1,1,1,"H"
"3258",2005-03-05,2004,"Genclerbirligi","Ankaragucu","4-0",4,0,"T1",1,4,4,"H"
"3259",2005-03-05,2004,"Istanbulspor","Samsunspor","1-1",1,1,"T1",1,2,0,"D"
"3260",2005-03-05,2004,"Sakaryaspor","Ankaraspor","1-1",1,1,"T1",1,2,0,"D"
"3261",2005-03-06,2004,"A. Sebatspor","Konyaspor","3-5",3,5,"T1",1,8,-2,"A"
"3262",2005-03-06,2004,"Denizlispor","Diyarbakirspor","0-0",0,0,"T1",1,0,0,"D"
"3263",2005-03-06,2004,"Gaziantepspor","Trabzonspor","3-2",3,2,"T1",1,5,1,"H"
"3264",2005-03-06,2004,"Kayserispor","Rizespor","2-1",2,1,"T1",1,3,1,"H"
"3265",2005-03-06,2004,"Malatyaspor","Fenerbahce","0-2",0,2,"T1",1,2,-2,"A"
"3266",2005-03-09,2004,"Besiktas","Genclerbirligi","0-0",0,0,"T1",1,0,0,"D"
"3267",2005-03-09,2004,"Istanbulspor","Ankaragucu","1-2",1,2,"T1",1,3,-1,"A"
"3268",2005-03-12,2004,"Ankaragucu","Denizlispor","1-1",1,1,"T1",1,2,0,"D"
"3269",2005-03-12,2004,"Istanbulspor","Galatasaray","0-3",0,3,"T1",1,3,-3,"A"
"3270",2005-03-12,2004,"Konyaspor","Malatyaspor","2-0",2,0,"T1",1,2,2,"H"
"3271",2005-03-12,2004,"Trabzonspor","Sakaryaspor","4-3",4,3,"T1",1,7,1,"H"
"3272",2005-03-13,2004,"Ankaraspor","Besiktas","2-4",2,4,"T1",1,6,-2,"A"
"3273",2005-03-13,2004,"Diyarbakirspor","Gaziantepspor","3-0",3,0,"T1",1,3,3,"H"
"3274",2005-03-13,2004,"Fenerbahce","Genclerbirligi","3-2",3,2,"T1",1,5,1,"H"
"3275",2005-03-13,2004,"Rizespor","A. Sebatspor","2-1",2,1,"T1",1,3,1,"H"
"3276",2005-03-13,2004,"Samsunspor","Kayserispor","3-3",3,3,"T1",1,6,0,"D"
"3277",2005-03-18,2004,"Denizlispor","Fenerbahce","2-0",2,0,"T1",1,2,2,"H"
"3278",2005-03-19,2004,"Besiktas","Trabzonspor","1-0",1,0,"T1",1,1,1,"H"
"3279",2005-03-19,2004,"Gaziantepspor","Ankaragucu","2-0",2,0,"T1",1,2,2,"H"
"3280",2005-03-19,2004,"Kayserispor","Istanbulspor","0-0",0,0,"T1",1,0,0,"D"
"3281",2005-03-19,2004,"Malatyaspor","Rizespor","0-1",0,1,"T1",1,1,-1,"A"
"3282",2005-03-20,2004,"A. Sebatspor","Samsunspor","3-0",3,0,"T1",1,3,3,"H"
"3283",2005-03-20,2004,"Galatasaray","Ankaraspor","4-2",4,2,"T1",1,6,2,"H"
"3284",2005-03-20,2004,"Genclerbirligi","Konyaspor","2-1",2,1,"T1",1,3,1,"H"
"3285",2005-03-20,2004,"Sakaryaspor","Diyarbakirspor","3-2",3,2,"T1",1,5,1,"H"
"3286",2005-04-02,2004,"Ankaragucu","Sakaryaspor","2-7",2,7,"T1",1,9,-5,"A"
"3287",2005-04-02,2004,"Fenerbahce","Gaziantepspor","2-0",2,0,"T1",1,2,2,"H"
"3288",2005-04-02,2004,"Istanbulspor","A. Sebatspor","1-0",1,0,"T1",1,1,1,"H"
"3289",2005-04-02,2004,"Rizespor","Genclerbirligi","1-1",1,1,"T1",1,2,0,"D"
"3290",2005-04-03,2004,"Diyarbakirspor","Besiktas","0-0",0,0,"T1",1,0,0,"D"
"3291",2005-04-03,2004,"Kayserispor","Galatasaray","2-2",2,2,"T1",1,4,0,"D"
"3292",2005-04-03,2004,"Konyaspor","Denizlispor","0-0",0,0,"T1",1,0,0,"D"
"3293",2005-04-03,2004,"Samsunspor","Malatyaspor","0-1",0,1,"T1",1,1,-1,"A"
"3294",2005-04-03,2004,"Trabzonspor","Ankaraspor","2-2",2,2,"T1",1,4,0,"D"
"3295",2005-04-08,2004,"Besiktas","Ankaragucu","4-1",4,1,"T1",1,5,3,"H"
"3296",2005-04-09,2004,"A. Sebatspor","Kayserispor","0-0",0,0,"T1",1,0,0,"D"
"3297",2005-04-09,2004,"Ankaraspor","Diyarbakirspor","3-0",3,0,"T1",1,3,3,"H"
"3298",2005-04-09,2004,"Malatyaspor","Istanbulspor","2-0",2,0,"T1",1,2,2,"H"
"3299",2005-04-09,2004,"Sakaryaspor","Fenerbahce","0-1",0,1,"T1",1,1,-1,"A"
"3300",2005-04-10,2004,"Denizlispor","Rizespor","3-0",3,0,"T1",1,3,3,"H"
"3301",2005-04-10,2004,"Galatasaray","Trabzonspor","0-2",0,2,"T1",1,2,-2,"A"
"3302",2005-04-10,2004,"Gaziantepspor","Konyaspor","2-0",2,0,"T1",1,2,2,"H"
"3303",2005-04-10,2004,"Genclerbirligi","Samsunspor","0-0",0,0,"T1",1,0,0,"D"
"3304",2005-04-15,2004,"Diyarbakirspor","Trabzonspor","0-1",0,1,"T1",1,1,-1,"A"
"3305",2005-04-16,2004,"A. Sebatspor","Galatasaray","1-3",1,3,"T1",1,4,-2,"A"
"3306",2005-04-16,2004,"Kayserispor","Malatyaspor","1-1",1,1,"T1",1,2,0,"D"
"3307",2005-04-16,2004,"Konyaspor","Sakaryaspor","2-0",2,0,"T1",1,2,2,"H"
"3308",2005-04-16,2004,"Samsunspor","Denizlispor","4-0",4,0,"T1",1,4,4,"H"
"3309",2005-04-17,2004,"Ankaragucu","Ankaraspor","2-5",2,5,"T1",1,7,-3,"A"
"3310",2005-04-17,2004,"Fenerbahce","Besiktas","3-4",3,4,"T1",1,7,-1,"A"
"3311",2005-04-17,2004,"Istanbulspor","Genclerbirligi","1-3",1,3,"T1",1,4,-2,"A"
"3312",2005-04-17,2004,"Rizespor","Gaziantepspor","1-1",1,1,"T1",1,2,0,"D"
"3313",2005-04-23,2004,"Besiktas","Konyaspor","2-1",2,1,"T1",1,3,1,"H"
"3314",2005-04-23,2004,"Gaziantepspor","Samsunspor","1-3",1,3,"T1",1,4,-2,"A"
"3315",2005-04-23,2004,"Genclerbirligi","Kayserispor","0-0",0,0,"T1",1,0,0,"D"
"3316",2005-04-23,2004,"Malatyaspor","A. Sebatspor","2-2",2,2,"T1",1,4,0,"D"
"3317",2005-04-24,2004,"Ankaraspor","Fenerbahce","0-1",0,1,"T1",1,1,-1,"A"
"3318",2005-04-24,2004,"Denizlispor","Istanbulspor","2-2",2,2,"T1",1,4,0,"D"
"3319",2005-04-24,2004,"Galatasaray","Diyarbakirspor","1-0",1,0,"T1",1,1,1,"H"
"3320",2005-04-24,2004,"Sakaryaspor","Rizespor","3-1",3,1,"T1",1,4,2,"H"
"3321",2005-04-24,2004,"Trabzonspor","Ankaragucu","3-1",3,1,"T1",1,4,2,"H"
"3322",2005-04-29,2004,"Istanbulspor","Gaziantepspor","1-3",1,3,"T1",1,4,-2,"A"
"3323",2005-04-29,2004,"Rizespor","Besiktas","0-1",0,1,"T1",1,1,-1,"A"
"3324",2005-04-30,2004,"Ankaragucu","Diyarbakirspor","4-1",4,1,"T1",1,5,3,"H"
"3325",2005-04-30,2004,"Fenerbahce","Trabzonspor","2-1",2,1,"T1",1,3,1,"H"
"3326",2005-04-30,2004,"Kayserispor","Denizlispor","1-0",1,0,"T1",1,1,1,"H"
"3327",2005-04-30,2004,"Samsunspor","Sakaryaspor","1-1",1,1,"T1",1,2,0,"D"
"3328",2005-05-01,2004,"A. Sebatspor","Genclerbirligi","0-5",0,5,"T1",1,5,-5,"A"
"3329",2005-05-01,2004,"Konyaspor","Ankaraspor","2-3",2,3,"T1",1,5,-1,"A"
"3330",2005-05-01,2004,"Malatyaspor","Galatasaray","0-1",0,1,"T1",1,1,-1,"A"
"3331",2005-05-07,2004,"Ankaraspor","Rizespor","1-0",1,0,"T1",1,1,1,"H"
"3332",2005-05-07,2004,"Diyarbakirspor","Fenerbahce","0-2",0,2,"T1",1,2,-2,"A"
"3333",2005-05-07,2004,"Galatasaray","Ankaragucu","2-1",2,1,"T1",1,3,1,"H"
"3334",2005-05-07,2004,"Gaziantepspor","Kayserispor","1-2",1,2,"T1",1,3,-1,"A"
"3335",2005-05-07,2004,"Sakaryaspor","Istanbulspor","1-3",1,3,"T1",1,4,-2,"A"
"3336",2005-05-07,2004,"Trabzonspor","Konyaspor","4-2",4,2,"T1",1,6,2,"H"
"3337",2005-05-08,2004,"Besiktas","Samsunspor","2-0",2,0,"T1",1,2,2,"H"
"3338",2005-05-08,2004,"Denizlispor","A. Sebatspor","4-2",4,2,"T1",1,6,2,"H"
"3339",2005-05-08,2004,"Genclerbirligi","Malatyaspor","5-3",5,3,"T1",1,8,2,"H"
"3340",2005-05-14,2004,"A. Sebatspor","Gaziantepspor","2-0",2,0,"T1",1,2,2,"H"
"3341",2005-05-14,2004,"Malatyaspor","Denizlispor","2-2",2,2,"T1",1,4,0,"D"
"3342",2005-05-14,2004,"Samsunspor","Ankaraspor","0-0",0,0,"T1",1,0,0,"D"
"3343",2005-05-15,2004,"Ankaragucu","Fenerbahce","1-0",1,0,"T1",1,1,1,"H"
"3344",2005-05-15,2004,"Galatasaray","Genclerbirligi","1-2",1,2,"T1",1,3,-1,"A"
"3345",2005-05-15,2004,"Istanbulspor","Besiktas","1-1",1,1,"T1",1,2,0,"D"
"3346",2005-05-15,2004,"Kayserispor","Sakaryaspor","1-0",1,0,"T1",1,1,1,"H"
"3347",2005-05-15,2004,"Konyaspor","Diyarbakirspor","2-1",2,1,"T1",1,3,1,"H"
"3348",2005-05-15,2004,"Rizespor","Trabzonspor","1-2",1,2,"T1",1,3,-1,"A"
"3349",2005-05-21,2004,"Ankaragucu","Konyaspor","1-1",1,1,"T1",1,2,0,"D"
"3350",2005-05-21,2004,"Ankaraspor","Istanbulspor","3-2",3,2,"T1",1,5,1,"H"
"3351",2005-05-21,2004,"Besiktas","Kayserispor","3-2",3,2,"T1",1,5,1,"H"
"3352",2005-05-21,2004,"Diyarbakirspor","Rizespor","1-1",1,1,"T1",1,2,0,"D"
"3353",2005-05-21,2004,"Gaziantepspor","Malatyaspor","4-3",4,3,"T1",1,7,1,"H"
"3354",2005-05-21,2004,"Sakaryaspor","A. Sebatspor","4-2",4,2,"T1",1,6,2,"H"
"3355",2005-05-22,2004,"Denizlispor","Genclerbirligi","1-1",1,1,"T1",1,2,0,"D"
"3356",2005-05-22,2004,"Fenerbahce","Galatasaray","1-0",1,0,"T1",1,1,1,"H"
"3357",2005-05-22,2004,"Trabzonspor","Samsunspor","3-0",3,0,"T1",1,3,3,"H"
"3358",2005-05-29,2004,"A. Sebatspor","Besiktas","2-2",2,2,"T1",1,4,0,"D"
"3359",2005-05-29,2004,"Galatasaray","Denizlispor","4-0",4,0,"T1",1,4,4,"H"
"3360",2005-05-29,2004,"Genclerbirligi","Gaziantepspor","2-1",2,1,"T1",1,3,1,"H"
"3361",2005-05-29,2004,"Istanbulspor","Trabzonspor","0-5",0,5,"T1",1,5,-5,"A"
"3362",2005-05-29,2004,"Kayserispor","Ankaraspor","0-0",0,0,"T1",1,0,0,"D"
"3363",2005-05-29,2004,"Konyaspor","Fenerbahce","4-2",4,2,"T1",1,6,2,"H"
"3364",2005-05-29,2004,"Malatyaspor","Sakaryaspor","4-2",4,2,"T1",1,6,2,"H"
"3365",2005-05-29,2004,"Rizespor","Ankaragucu","1-2",1,2,"T1",1,3,-1,"A"
"3366",2005-05-29,2004,"Samsunspor","Diyarbakirspor","0-1",0,1,"T1",1,1,-1,"A"
"3367",2005-08-05,2005,"Genclerbirligi","Fenerbahce","0-0",0,0,"T1",1,0,0,"D"
"3368",2005-08-06,2005,"Diyarbakirspor","Rizespor","1-0",1,0,"T1",1,1,1,"H"
"3369",2005-08-06,2005,"Erciyesspor","Besiktas","1-1",1,1,"T1",1,2,0,"D"
"3370",2005-08-06,2005,"Sivasspor","Malatyaspor","1-1",1,1,"T1",1,2,0,"D"
"3371",2005-08-06,2005,"Trabzonspor","Kayserispor","2-1",2,1,"T1",1,3,1,"H"
"3372",2005-08-07,2005,"Denizlispor","Ankaraspor","1-1",1,1,"T1",1,2,0,"D"
"3373",2005-08-07,2005,"Galatasaray","Konyaspor","2-1",2,1,"T1",1,3,1,"H"
"3374",2005-08-07,2005,"Manisaspor","Ankaragucu","2-2",2,2,"T1",1,4,0,"D"
"3375",2005-08-07,2005,"Samsunspor","Gaziantepspor","2-3",2,3,"T1",1,5,-1,"A"
"3376",2005-08-12,2005,"Ankaragucu","Galatasaray","0-1",0,1,"T1",1,1,-1,"A"
"3377",2005-08-13,2005,"Fenerbahce","Diyarbakirspor","2-2",2,2,"T1",1,4,0,"D"
"3378",2005-08-13,2005,"Gaziantepspor","Sivasspor","0-0",0,0,"T1",1,0,0,"D"
"3379",2005-08-13,2005,"Malatyaspor","Manisaspor","0-5",0,5,"T1",1,5,-5,"A"
"3380",2005-08-13,2005,"Rizespor","Samsunspor","1-2",1,2,"T1",1,3,-1,"A"
"3381",2005-08-14,2005,"Ankaraspor","Genclerbirligi","0-0",0,0,"T1",1,0,0,"D"
"3382",2005-08-14,2005,"Besiktas","Denizlispor","2-0",2,0,"T1",1,2,2,"H"
"3383",2005-08-14,2005,"Kayserispor","Erciyesspor","1-2",1,2,"T1",1,3,-1,"A"
"3384",2005-08-14,2005,"Konyaspor","Trabzonspor","0-0",0,0,"T1",1,0,0,"D"
"3385",2005-08-20,2005,"Denizlispor","Kayserispor","1-3",1,3,"T1",1,4,-2,"A"
"3386",2005-08-20,2005,"Genclerbirligi","Besiktas","0-2",0,2,"T1",1,2,-2,"A"
"3387",2005-08-20,2005,"Samsunspor","Sivasspor","1-2",1,2,"T1",1,3,-1,"A"
"3388",2005-08-20,2005,"Trabzonspor","Ankaragucu","3-1",3,1,"T1",1,4,2,"H"
"3389",2005-08-21,2005,"Diyarbakirspor","Ankaraspor","1-2",1,2,"T1",1,3,-1,"A"
"3390",2005-08-21,2005,"Erciyesspor","Konyaspor","0-0",0,0,"T1",1,0,0,"D"
"3391",2005-08-21,2005,"Galatasaray","Malatyaspor","5-2",5,2,"T1",1,7,3,"H"
"3392",2005-08-21,2005,"Manisaspor","Gaziantepspor","1-2",1,2,"T1",1,3,-1,"A"
"3393",2005-08-21,2005,"Rizespor","Fenerbahce","1-2",1,2,"T1",1,3,-1,"A"
"3394",2005-08-26,2005,"Gaziantepspor","Galatasaray","2-2",2,2,"T1",1,4,0,"D"
"3395",2005-08-27,2005,"Ankaraspor","Rizespor","0-0",0,0,"T1",1,0,0,"D"
"3396",2005-08-27,2005,"Fenerbahce","Samsunspor","5-2",5,2,"T1",1,7,3,"H"
"3397",2005-08-27,2005,"Konyaspor","Denizlispor","1-0",1,0,"T1",1,1,1,"H"
"3398",2005-08-27,2005,"Sivasspor","Manisaspor","1-0",1,0,"T1",1,1,1,"H"
"3399",2005-08-28,2005,"Ankaragucu","Erciyesspor","1-2",1,2,"T1",1,3,-1,"A"
"3400",2005-08-28,2005,"Besiktas","Diyarbakirspor","1-1",1,1,"T1",1,2,0,"D"
"3401",2005-08-28,2005,"Kayserispor","Genclerbirligi","2-0",2,0,"T1",1,2,2,"H"
"3402",2005-08-28,2005,"Malatyaspor","Trabzonspor","1-1",1,1,"T1",1,2,0,"D"
"3403",2005-09-10,2005,"Diyarbakirspor","Kayserispor","0-2",0,2,"T1",1,2,-2,"A"
"3404",2005-09-10,2005,"Erciyesspor","Malatyaspor","1-1",1,1,"T1",1,2,0,"D"
"3405",2005-09-10,2005,"Fenerbahce","Ankaraspor","2-1",2,1,"T1",1,3,1,"H"
"3406",2005-09-10,2005,"Rizespor","Besiktas","1-0",1,0,"T1",1,1,1,"H"
"3407",2005-09-11,2005,"Denizlispor","Ankaragucu","0-0",0,0,"T1",1,0,0,"D"
"3408",2005-09-11,2005,"Galatasaray","Sivasspor","2-0",2,0,"T1",1,2,2,"H"
"3409",2005-09-11,2005,"Genclerbirligi","Konyaspor","1-1",1,1,"T1",1,2,0,"D"
"3410",2005-09-11,2005,"Samsunspor","Manisaspor","1-1",1,1,"T1",1,2,0,"D"
"3411",2005-09-11,2005,"Trabzonspor","Gaziantepspor","2-0",2,0,"T1",1,2,2,"H"
"3412",2005-09-16,2005,"Sivasspor","Trabzonspor","2-1",2,1,"T1",1,3,1,"H"
"3413",2005-09-17,2005,"Ankaragucu","Genclerbirligi","1-1",1,1,"T1",1,2,0,"D"
"3414",2005-09-17,2005,"Kayserispor","Rizespor","3-1",3,1,"T1",1,4,2,"H"
"3415",2005-09-17,2005,"Konyaspor","Diyarbakirspor","5-1",5,1,"T1",1,6,4,"H"
"3416",2005-09-17,2005,"Malatyaspor","Denizlispor","0-1",0,1,"T1",1,1,-1,"A"
"3417",2005-09-18,2005,"Ankaraspor","Samsunspor","3-3",3,3,"T1",1,6,0,"D"
"3418",2005-09-18,2005,"Besiktas","Fenerbahce","1-2",1,2,"T1",1,3,-1,"A"
"3419",2005-09-18,2005,"Gaziantepspor","Erciyesspor","1-2",1,2,"T1",1,3,-1,"A"
"3420",2005-09-18,2005,"Manisaspor","Galatasaray","1-4",1,4,"T1",1,5,-3,"A"
"3421",2005-09-23,2005,"Trabzonspor","Manisaspor","0-2",0,2,"T1",1,2,-2,"A"
"3422",2005-09-24,2005,"Denizlispor","Gaziantepspor","1-2",1,2,"T1",1,3,-1,"A"
"3423",2005-09-24,2005,"Fenerbahce","Kayserispor","3-0",3,0,"T1",1,3,3,"H"
"3424",2005-09-24,2005,"Genclerbirligi","Malatyaspor","2-0",2,0,"T1",1,2,2,"H"
"3425",2005-09-25,2005,"Ankaraspor","Besiktas","2-0",2,0,"T1",1,2,2,"H"
"3426",2005-09-25,2005,"Diyarbakirspor","Ankaragucu","0-3",0,3,"T1",1,3,-3,"A"
"3427",2005-09-25,2005,"Erciyesspor","Sivasspor","0-0",0,0,"T1",1,0,0,"D"
"3428",2005-09-25,2005,"Rizespor","Konyaspor","1-1",1,1,"T1",1,2,0,"D"
"3429",2005-09-25,2005,"Samsunspor","Galatasaray","1-2",1,2,"T1",1,3,-1,"A"
"3430",2005-09-30,2005,"Gaziantepspor","Genclerbirligi","1-1",1,1,"T1",1,2,0,"D"
"3431",2005-10-01,2005,"Konyaspor","Fenerbahce","2-4",2,4,"T1",1,6,-2,"A"
"3432",2005-10-01,2005,"Manisaspor","Erciyesspor","0-2",0,2,"T1",1,2,-2,"A"
"3433",2005-10-01,2005,"Sivasspor","Denizlispor","1-0",1,0,"T1",1,1,1,"H"
"3434",2005-10-02,2005,"Ankaragucu","Rizespor","1-0",1,0,"T1",1,1,1,"H"
"3435",2005-10-02,2005,"Besiktas","Samsunspor","3-2",3,2,"T1",1,5,1,"H"
"3436",2005-10-02,2005,"Galatasaray","Trabzonspor","4-1",4,1,"T1",1,5,3,"H"
"3437",2005-10-02,2005,"Kayserispor","Ankaraspor","2-1",2,1,"T1",1,3,1,"H"
"3438",2005-10-02,2005,"Malatyaspor","Diyarbakirspor","1-2",1,2,"T1",1,3,-1,"A"
"3439",2005-10-15,2005,"Ankaraspor","Konyaspor","0-0",0,0,"T1",1,0,0,"D"
"3440",2005-10-15,2005,"Diyarbakirspor","Gaziantepspor","1-2",1,2,"T1",1,3,-1,"A"
"3441",2005-10-15,2005,"Erciyesspor","Galatasaray","1-2",1,2,"T1",1,3,-1,"A"
"3442",2005-10-15,2005,"Fenerbahce","Ankaragucu","2-1",2,1,"T1",1,3,1,"H"
"3443",2005-10-16,2005,"Besiktas","Kayserispor","0-0",0,0,"T1",1,0,0,"D"
"3444",2005-10-16,2005,"Denizlispor","Manisaspor","1-1",1,1,"T1",1,2,0,"D"
"3445",2005-10-16,2005,"Genclerbirligi","Sivasspor","0-1",0,1,"T1",1,1,-1,"A"
"3446",2005-10-16,2005,"Rizespor","Malatyaspor","1-0",1,0,"T1",1,1,1,"H"
"3447",2005-10-16,2005,"Samsunspor","Trabzonspor","3-1",3,1,"T1",1,4,2,"H"
"3448",2005-10-21,2005,"Trabzonspor","Erciyesspor","0-0",0,0,"T1",1,0,0,"D"
"3449",2005-10-22,2005,"Ankaragucu","Ankaraspor","3-2",3,2,"T1",1,5,1,"H"
"3450",2005-10-22,2005,"Galatasaray","Denizlispor","1-1",1,1,"T1",1,2,0,"D"
"3451",2005-10-22,2005,"Kayserispor","Samsunspor","6-3",6,3,"T1",1,9,3,"H"
"3452",2005-10-23,2005,"Gaziantepspor","Rizespor","1-1",1,1,"T1",1,2,0,"D"
"3453",2005-10-23,2005,"Konyaspor","Besiktas","0-1",0,1,"T1",1,1,-1,"A"
"3454",2005-10-23,2005,"Malatyaspor","Fenerbahce","0-3",0,3,"T1",1,3,-3,"A"
"3455",2005-10-23,2005,"Manisaspor","Genclerbirligi","0-3",0,3,"T1",1,3,-3,"A"
"3456",2005-10-23,2005,"Sivasspor","Diyarbakirspor","4-1",4,1,"T1",1,5,3,"H"
"3457",2005-10-28,2005,"Denizlispor","Trabzonspor","0-1",0,1,"T1",1,1,-1,"A"
"3458",2005-10-29,2005,"Ankaraspor","Malatyaspor","1-2",1,2,"T1",1,3,-1,"A"
"3459",2005-10-29,2005,"Fenerbahce","Gaziantepspor","1-0",1,0,"T1",1,1,1,"H"
"3460",2005-10-30,2005,"Besiktas","Ankaragucu","4-2",4,2,"T1",1,6,2,"H"
"3461",2005-10-30,2005,"Diyarbakirspor","Manisaspor","0-2",0,2,"T1",1,2,-2,"A"
"3462",2005-10-30,2005,"Genclerbirligi","Galatasaray","2-1",2,1,"T1",1,3,1,"H"
"3463",2005-10-30,2005,"Kayserispor","Konyaspor","1-0",1,0,"T1",1,1,1,"H"
"3464",2005-10-30,2005,"Rizespor","Sivasspor","1-0",1,0,"T1",1,1,1,"H"
"3465",2005-10-30,2005,"Samsunspor","Erciyesspor","1-1",1,1,"T1",1,2,0,"D"
"3466",2005-11-04,2005,"Galatasaray","Diyarbakirspor","2-0",2,0,"T1",1,2,2,"H"
"3467",2005-11-05,2005,"Erciyesspor","Denizlispor","2-0",2,0,"T1",1,2,2,"H"
"3468",2005-11-05,2005,"Gaziantepspor","Ankaraspor","3-3",3,3,"T1",1,6,0,"D"
"3469",2005-11-05,2005,"Trabzonspor","Genclerbirligi","1-1",1,1,"T1",1,2,0,"D"
"3470",2005-11-06,2005,"Ankaragucu","Kayserispor","2-0",2,0,"T1",1,2,2,"H"
"3471",2005-11-06,2005,"Konyaspor","Samsunspor","4-2",4,2,"T1",1,6,2,"H"
"3472",2005-11-06,2005,"Malatyaspor","Besiktas","1-1",1,1,"T1",1,2,0,"D"
"3473",2005-11-06,2005,"Manisaspor","Rizespor","1-1",1,1,"T1",1,2,0,"D"
"3474",2005-11-06,2005,"Sivasspor","Fenerbahce","2-3",2,3,"T1",1,5,-1,"A"
"3475",2005-11-19,2005,"Diyarbakirspor","Trabzonspor","3-0",3,0,"T1",1,3,3,"H"
"3476",2005-11-19,2005,"Fenerbahce","Manisaspor","2-1",2,1,"T1",1,3,1,"H"
"3477",2005-11-19,2005,"Genclerbirligi","Erciyesspor","3-0",3,0,"T1",1,3,3,"H"
"3478",2005-11-19,2005,"Samsunspor","Denizlispor","1-2",1,2,"T1",1,3,-1,"A"
"3479",2005-11-20,2005,"Ankaraspor","Sivasspor","1-1",1,1,"T1",1,2,0,"D"
"3480",2005-11-20,2005,"Besiktas","Gaziantepspor","0-1",0,1,"T1",1,1,-1,"A"
"3481",2005-11-20,2005,"Kayserispor","Malatyaspor","2-0",2,0,"T1",1,2,2,"H"
"3482",2005-11-20,2005,"Konyaspor","Ankaragucu","2-0",2,0,"T1",1,2,2,"H"
"3483",2005-11-20,2005,"Rizespor","Galatasaray","0-3",0,3,"T1",1,3,-3,"A"
"3484",2005-11-25,2005,"Trabzonspor","Rizespor","3-1",3,1,"T1",1,4,2,"H"
"3485",2005-11-26,2005,"Malatyaspor","Konyaspor","1-0",1,0,"T1",1,1,1,"H"
"3486",2005-11-26,2005,"Manisaspor","Ankaraspor","1-0",1,0,"T1",1,1,1,"H"
"3487",2005-11-26,2005,"Sivasspor","Besiktas","1-3",1,3,"T1",1,4,-2,"A"
"3488",2005-11-27,2005,"Ankaragucu","Samsunspor","1-1",1,1,"T1",1,2,0,"D"
"3489",2005-11-27,2005,"Denizlispor","Genclerbirligi","0-2",0,2,"T1",1,2,-2,"A"
"3490",2005-11-27,2005,"Erciyesspor","Diyarbakirspor","0-2",0,2,"T1",1,2,-2,"A"
"3491",2005-11-27,2005,"Galatasaray","Fenerbahce","0-1",0,1,"T1",1,1,-1,"A"
"3492",2005-11-27,2005,"Gaziantepspor","Kayserispor","1-4",1,4,"T1",1,5,-3,"A"
"3493",2005-12-02,2005,"Fenerbahce","Trabzonspor","2-2",2,2,"T1",1,4,0,"D"
"3494",2005-12-03,2005,"Ankaraspor","Galatasaray","1-2",1,2,"T1",1,3,-1,"A"
"3495",2005-12-03,2005,"Konyaspor","Gaziantepspor","3-2",3,2,"T1",1,5,1,"H"
"3496",2005-12-03,2005,"Rizespor","Erciyesspor","2-2",2,2,"T1",1,4,0,"D"
"3497",2005-12-04,2005,"Besiktas","Manisaspor","3-1",3,1,"T1",1,4,2,"H"
"3498",2005-12-04,2005,"Diyarbakirspor","Denizlispor","1-0",1,0,"T1",1,1,1,"H"
"3499",2005-12-04,2005,"Genclerbirligi","Samsunspor","0-1",0,1,"T1",1,1,-1,"A"
"3500",2005-12-04,2005,"Kayserispor","Sivasspor","2-2",2,2,"T1",1,4,0,"D"
"3501",2005-12-05,2005,"Malatyaspor","Ankaragucu","0-0",0,0,"T1",1,0,0,"D"
"3502",2005-12-09,2005,"Manisaspor","Kayserispor","1-0",1,0,"T1",1,1,1,"H"
"3503",2005-12-10,2005,"Denizlispor","Rizespor","2-0",2,0,"T1",1,2,2,"H"
"3504",2005-12-10,2005,"Galatasaray","Besiktas","3-2",3,2,"T1",1,5,1,"H"
"3505",2005-12-10,2005,"Gaziantepspor","Ankaragucu","1-1",1,1,"T1",1,2,0,"D"
"3506",2005-12-11,2005,"Erciyesspor","Fenerbahce","0-3",0,3,"T1",1,3,-3,"A"
"3507",2005-12-11,2005,"Genclerbirligi","Diyarbakirspor","4-0",4,0,"T1",1,4,4,"H"
"3508",2005-12-11,2005,"Samsunspor","Malatyaspor","1-2",1,2,"T1",1,3,-1,"A"
"3509",2005-12-11,2005,"Sivasspor","Konyaspor","1-1",1,1,"T1",1,2,0,"D"
"3510",2005-12-11,2005,"Trabzonspor","Ankaraspor","2-3",2,3,"T1",1,5,-1,"A"
"3511",2005-12-16,2005,"Kayserispor","Galatasaray","1-3",1,3,"T1",1,4,-2,"A"
"3512",2005-12-17,2005,"Ankaragucu","Sivasspor","0-0",0,0,"T1",1,0,0,"D"
"3513",2005-12-17,2005,"Fenerbahce","Denizlispor","6-2",6,2,"T1",1,8,4,"H"
"3514",2005-12-17,2005,"Malatyaspor","Gaziantepspor","2-0",2,0,"T1",1,2,2,"H"
"3515",2005-12-18,2005,"Ankaraspor","Erciyesspor","1-1",1,1,"T1",1,2,0,"D"
"3516",2005-12-18,2005,"Besiktas","Trabzonspor","0-1",0,1,"T1",1,1,-1,"A"
"3517",2005-12-18,2005,"Diyarbakirspor","Samsunspor","0-0",0,0,"T1",1,0,0,"D"
"3518",2005-12-18,2005,"Konyaspor","Manisaspor","1-1",1,1,"T1",1,2,0,"D"
"3519",2005-12-18,2005,"Rizespor","Genclerbirligi","1-1",1,1,"T1",1,2,0,"D"
"3520",2006-01-20,2005,"Fenerbahce","Genclerbirligi","3-0",3,0,"T1",1,3,3,"H"
"3521",2006-01-21,2005,"Ankaragucu","Manisaspor","0-2",0,2,"T1",1,2,-2,"A"
"3522",2006-01-21,2005,"Besiktas","Erciyesspor","2-2",2,2,"T1",1,4,0,"D"
"3523",2006-01-21,2005,"Gaziantepspor","Samsunspor","0-1",0,1,"T1",1,1,-1,"A"
"3524",2006-01-22,2005,"Ankaraspor","Denizlispor","1-3",1,3,"T1",1,4,-2,"A"
"3525",2006-01-22,2005,"Kayserispor","Trabzonspor","4-2",4,2,"T1",1,6,2,"H"
"3526",2006-01-22,2005,"Konyaspor","Galatasaray","0-1",0,1,"T1",1,1,-1,"A"
"3527",2006-01-22,2005,"Malatyaspor","Sivasspor","0-0",0,0,"T1",1,0,0,"D"
"3528",2006-01-22,2005,"Rizespor","Diyarbakirspor","2-0",2,0,"T1",1,2,2,"H"
"3529",2006-01-27,2006,"Ankaragucu","Bursaspor","1-1",1,1,"T1",1,2,0,"D"
"3530",2006-01-27,2006,"Besiktas","Manisaspor","3-1",3,1,"T1",1,4,2,"H"
"3531",2006-01-27,2006,"Denizlispor","Gaziantepspor","0-2",0,2,"T1",1,2,-2,"A"
"3532",2006-01-27,2006,"Erciyesspor","Fenerbahce","1-1",1,1,"T1",1,2,0,"D"
"3533",2006-01-27,2006,"Galatasaray","Ankaraspor","2-0",2,0,"T1",1,2,2,"H"
"3534",2006-01-27,2006,"Genclerbirligi","Sivasspor","0-1",0,1,"T1",1,1,-1,"A"
"3535",2006-01-27,2006,"Rizespor","Antalyaspor","1-0",1,0,"T1",1,1,1,"H"
"3536",2006-01-27,2006,"Sakaryaspor","Konyaspor","1-1",1,1,"T1",1,2,0,"D"
"3537",2006-01-27,2006,"Trabzonspor","Kayserispor","0-0",0,0,"T1",1,0,0,"D"
"3538",2006-02-02,2006,"Fenerbahce","Genclerbirligi","2-1",2,1,"T1",1,3,1,"H"
"3539",2006-02-03,2006,"Antalyaspor","Sakaryaspor","1-0",1,0,"T1",1,1,1,"H"
"3540",2006-02-03,2006,"Konyaspor","Denizlispor","5-1",5,1,"T1",1,6,4,"H"
"3541",2006-02-03,2006,"Manisaspor","Trabzonspor","0-0",0,0,"T1",1,0,0,"D"
"3542",2006-02-03,2005,"Fenerbahce","Rizespor","1-1",1,1,"T1",1,2,0,"D"
"3543",2006-02-04,2006,"Ankaraspor","Ankaragucu","1-0",1,0,"T1",1,1,1,"H"
"3544",2006-02-04,2006,"Bursaspor","Erciyesspor","0-0",0,0,"T1",1,0,0,"D"
"3545",2006-02-04,2006,"Gaziantepspor","Besiktas","0-0",0,0,"T1",1,0,0,"D"
"3546",2006-02-04,2006,"Kayserispor","Galatasaray","0-0",0,0,"T1",1,0,0,"D"
"3547",2006-02-04,2006,"Sivasspor","Rizespor","1-0",1,0,"T1",1,1,1,"H"
"3548",2006-02-04,2005,"Ankaraspor","Diyarbakirspor","3-3",3,3,"T1",1,6,0,"D"
"3549",2006-02-04,2005,"Besiktas","Genclerbirligi","2-1",2,1,"T1",1,3,1,"H"
"3550",2006-02-04,2005,"Kayserispor","Denizlispor","2-2",2,2,"T1",1,4,0,"D"
"3551",2006-02-05,2005,"Ankaragucu","Trabzonspor","1-2",1,2,"T1",1,3,-1,"A"
"3552",2006-02-05,2005,"Gaziantepspor","Manisaspor","1-1",1,1,"T1",1,2,0,"D"
"3553",2006-02-05,2005,"Konyaspor","Erciyesspor","2-0",2,0,"T1",1,2,2,"H"
"3554",2006-02-05,2005,"Malatyaspor","Galatasaray","1-1",1,1,"T1",1,2,0,"D"
"3555",2006-02-05,2005,"Sivasspor","Samsunspor","0-3",0,3,"T1",1,3,-3,"A"
"3556",2006-02-10,2006,"Ankaragucu","Kayserispor","0-4",0,4,"T1",1,4,-4,"A"
"3557",2006-02-10,2006,"Besiktas","Denizlispor","2-0",2,0,"T1",1,2,2,"H"
"3558",2006-02-10,2006,"Rizespor","Fenerbahce","2-1",2,1,"T1",1,3,1,"H"
"3559",2006-02-10,2005,"Diyarbakirspor","Besiktas","1-3",1,3,"T1",1,4,-2,"A"
"3560",2006-02-11,2006,"Antalyaspor","Konyaspor","1-0",1,0,"T1",1,1,1,"H"
"3561",2006-02-11,2006,"Erciyesspor","Ankaraspor","1-0",1,0,"T1",1,1,1,"H"
"3562",2006-02-11,2006,"Galatasaray","Manisaspor","4-0",4,0,"T1",1,4,4,"H"
"3563",2006-02-11,2006,"Genclerbirligi","Bursaspor","1-0",1,0,"T1",1,1,1,"H"
"3564",2006-02-11,2006,"Sakaryaspor","Sivasspor","1-3",1,3,"T1",1,4,-2,"A"
"3565",2006-02-11,2006,"Trabzonspor","Gaziantepspor","2-0",2,0,"T1",1,2,2,"H"
"3566",2006-02-11,2005,"Erciyesspor","Ankaragucu","1-2",1,2,"T1",1,3,-1,"A"
"3567",2006-02-11,2005,"Manisaspor","Sivasspor","3-1",3,1,"T1",1,4,2,"H"
"3568",2006-02-11,2005,"Samsunspor","Fenerbahce","0-5",0,5,"T1",1,5,-5,"A"
"3569",2006-02-12,2005,"Denizlispor","Konyaspor","5-2",5,2,"T1",1,7,3,"H"
"3570",2006-02-12,2005,"Galatasaray","Gaziantepspor","6-0",6,0,"T1",1,6,6,"H"
"3571",2006-02-12,2005,"Genclerbirligi","Kayserispor","3-2",3,2,"T1",1,5,1,"H"
"3572",2006-02-12,2005,"Rizespor","Ankaraspor","1-1",1,1,"T1",1,2,0,"D"
"3573",2006-02-12,2005,"Trabzonspor","Malatyaspor","1-0",1,0,"T1",1,1,1,"H"
"3574",2006-02-16,2006,"Konyaspor","Besiktas","2-1",2,1,"T1",1,3,1,"H"
"3575",2006-02-17,2006,"Bursaspor","Rizespor","1-0",1,0,"T1",1,1,1,"H"
"3576",2006-02-17,2006,"Gaziantepspor","Galatasaray","1-0",1,0,"T1",1,1,1,"H"
"3577",2006-02-17,2005,"Besiktas","Rizespor","0-1",0,1,"T1",1,1,-1,"A"
"3578",2006-02-18,2006,"Ankaraspor","Genclerbirligi","1-2",1,2,"T1",1,3,-1,"A"
"3579",2006-02-18,2006,"Denizlispor","Trabzonspor","3-4",3,4,"T1",1,7,-1,"A"
"3580",2006-02-18,2006,"Fenerbahce","Sakaryaspor","1-0",1,0,"T1",1,1,1,"H"
"3581",2006-02-18,2006,"Kayserispor","Erciyesspor","1-0",1,0,"T1",1,1,1,"H"
"3582",2006-02-18,2006,"Manisaspor","Ankaragucu","0-1",0,1,"T1",1,1,-1,"A"
"3583",2006-02-18,2006,"Sivasspor","Antalyaspor","0-1",0,1,"T1",1,1,-1,"A"
"3584",2006-02-18,2005,"Ankaraspor","Fenerbahce","2-1",2,1,"T1",1,3,1,"H"
"3585",2006-02-19,2005,"Ankaragucu","Denizlispor","1-1",1,1,"T1",1,2,0,"D"
"3586",2006-02-19,2005,"Gaziantepspor","Trabzonspor","0-2",0,2,"T1",1,2,-2,"A"
"3587",2006-02-19,2005,"Kayserispor","Diyarbakirspor","3-0",3,0,"T1",1,3,3,"H"
"3588",2006-02-19,2005,"Konyaspor","Genclerbirligi","0-3",0,3,"T1",1,3,-3,"A"
"3589",2006-02-19,2005,"Malatyaspor","Erciyesspor","2-2",2,2,"T1",1,4,0,"D"
"3590",2006-02-19,2005,"Manisaspor","Samsunspor","3-0",3,0,"T1",1,3,3,"H"
"3591",2006-02-19,2005,"Sivasspor","Galatasaray","0-0",0,0,"T1",1,0,0,"D"
"3592",2006-02-23,2006,"Erciyesspor","Manisaspor","1-0",1,0,"T1",1,1,1,"H"
"3593",2006-02-23,2006,"Galatasaray","Denizlispor","1-1",1,1,"T1",1,2,0,"D"
"3594",2006-02-24,2006,"Ankaragucu","Gaziantepspor","2-1",2,1,"T1",1,3,1,"H"
"3595",2006-02-24,2006,"Trabzonspor","Besiktas","3-2",3,2,"T1",1,5,1,"H"
"3596",2006-02-25,2006,"Antalyaspor","Fenerbahce","1-0",1,0,"T1",1,1,1,"H"
"3597",2006-02-25,2006,"Genclerbirligi","Kayserispor","2-2",2,2,"T1",1,4,0,"D"
"3598",2006-02-25,2006,"Rizespor","Ankaraspor","1-1",1,1,"T1",1,2,0,"D"
"3599",2006-02-25,2006,"Sakaryaspor","Bursaspor","1-3",1,3,"T1",1,4,-2,"A"
"3600",2006-02-25,2006,"Sivasspor","Konyaspor","1-3",1,3,"T1",1,4,-2,"A"
"3601",2006-02-25,2005,"Erciyesspor","Gaziantepspor","1-0",1,0,"T1",1,1,1,"H"
"3602",2006-02-25,2005,"Galatasaray","Manisaspor","4-2",4,2,"T1",1,6,2,"H"
"3603",2006-02-26,2005,"Denizlispor","Malatyaspor","1-0",1,0,"T1",1,1,1,"H"
"3604",2006-02-26,2005,"Diyarbakirspor","Konyaspor","0-3",0,3,"T1",1,3,-3,"A"
"3605",2006-02-26,2005,"Fenerbahce","Besiktas","2-2",2,2,"T1",1,4,0,"D"
"3606",2006-02-26,2005,"Genclerbirligi","Ankaragucu","1-1",1,1,"T1",1,2,0,"D"
"3607",2006-02-26,2005,"Rizespor","Kayserispor","0-0",0,0,"T1",1,0,0,"D"
"3608",2006-02-26,2005,"Samsunspor","Ankaraspor","0-1",0,1,"T1",1,1,-1,"A"
"3609",2006-02-26,2005,"Trabzonspor","Sivasspor","0-0",0,0,"T1",1,0,0,"D"
"3610",2006-03-02,2006,"Bursaspor","Antalyaspor","0-0",0,0,"T1",1,0,0,"D"
"3611",2006-03-03,2006,"Besiktas","Galatasaray","2-1",2,1,"T1",1,3,1,"H"
"3612",2006-03-03,2006,"Denizlispor","Ankaragucu","1-0",1,0,"T1",1,1,1,"H"
"3613",2006-03-03,2006,"Kayserispor","Rizespor","1-0",1,0,"T1",1,1,1,"H"
"3614",2006-03-04,2006,"Ankaraspor","Sakaryaspor","1-0",1,0,"T1",1,1,1,"H"
"3615",2006-03-04,2006,"Fenerbahce","Sivasspor","2-2",2,2,"T1",1,4,0,"D"
"3616",2006-03-04,2006,"Gaziantepspor","Erciyesspor","0-1",0,1,"T1",1,1,-1,"A"
"3617",2006-03-04,2006,"Konyaspor","Trabzonspor","1-2",1,2,"T1",1,3,-1,"A"
"3618",2006-03-04,2006,"Manisaspor","Genclerbirligi","0-3",0,3,"T1",1,3,-3,"A"
"3619",2006-03-04,2005,"Galatasaray","Samsunspor","3-2",3,2,"T1",1,5,1,"H"
"3620",2006-03-04,2005,"Manisaspor","Trabzonspor","1-2",1,2,"T1",1,3,-1,"A"
"3621",2006-03-05,2005,"Ankaragucu","Diyarbakirspor","5-1",5,1,"T1",1,6,4,"H"
"3622",2006-03-05,2005,"Besiktas","Ankaraspor","3-0",3,0,"T1",1,3,3,"H"
"3623",2006-03-05,2005,"Gaziantepspor","Denizlispor","1-0",1,0,"T1",1,1,1,"H"
"3624",2006-03-05,2005,"Kayserispor","Fenerbahce","1-0",1,0,"T1",1,1,1,"H"
"3625",2006-03-05,2005,"Konyaspor","Rizespor","3-1",3,1,"T1",1,4,2,"H"
"3626",2006-03-05,2005,"Malatyaspor","Genclerbirligi","1-3",1,3,"T1",1,4,-2,"A"
"3627",2006-03-05,2005,"Sivasspor","Erciyesspor","3-0",3,0,"T1",1,3,3,"H"
"3628",2006-03-09,2006,"Sakaryaspor","Kayserispor","3-3",3,3,"T1",1,6,0,"D"
"3629",2006-03-10,2006,"Fenerbahce","Konyaspor","3-0",3,0,"T1",1,3,3,"H"
"3630",2006-03-10,2006,"Genclerbirligi","Gaziantepspor","0-0",0,0,"T1",1,0,0,"D"
"3631",2006-03-10,2006,"Sivasspor","Bursaspor","3-1",3,1,"T1",1,4,2,"H"
"3632",2006-03-10,2005,"Erciyesspor","Manisaspor","2-1",2,1,"T1",1,3,1,"H"
"3633",2006-03-11,2006,"Ankaragucu","Besiktas","0-1",0,1,"T1",1,1,-1,"A"
"3634",2006-03-11,2006,"Antalyaspor","Ankaraspor","1-1",1,1,"T1",1,2,0,"D"
"3635",2006-03-11,2006,"Erciyesspor","Denizlispor","2-0",2,0,"T1",1,2,2,"H"
"3636",2006-03-11,2006,"Galatasaray","Trabzonspor","2-1",2,1,"T1",1,3,1,"H"
"3637",2006-03-11,2006,"Rizespor","Manisaspor","3-1",3,1,"T1",1,4,2,"H"
"3638",2006-03-11,2005,"Fenerbahce","Konyaspor","5-0",5,0,"T1",1,5,5,"H"
"3639",2006-03-11,2005,"Genclerbirligi","Gaziantepspor","3-1",3,1,"T1",1,4,2,"H"
"3640",2006-03-11,2005,"Rizespor","Ankaragucu","1-0",1,0,"T1",1,1,1,"H"
"3641",2006-03-12,2005,"Ankaraspor","Kayserispor","1-3",1,3,"T1",1,4,-2,"A"
"3642",2006-03-12,2005,"Denizlispor","Sivasspor","4-0",4,0,"T1",1,4,4,"H"
"3643",2006-03-12,2005,"Diyarbakirspor","Malatyaspor","3-2",3,2,"T1",1,5,1,"H"
"3644",2006-03-12,2005,"Samsunspor","Besiktas","1-3",1,3,"T1",1,4,-2,"A"
"3645",2006-03-12,2005,"Trabzonspor","Galatasaray","1-1",1,1,"T1",1,2,0,"D"
"3646",2006-03-16,2006,"Konyaspor","Galatasaray","2-2",2,2,"T1",1,4,0,"D"
"3647",2006-03-17,2006,"Ankaraspor","Sivasspor","2-1",2,1,"T1",1,3,1,"H"
"3648",2006-03-17,2006,"Bursaspor","Fenerbahce","0-4",0,4,"T1",1,4,-4,"A"
"3649",2006-03-17,2006,"Denizlispor","Genclerbirligi","3-2",3,2,"T1",1,5,1,"H"
"3650",2006-03-17,2006,"Gaziantepspor","Rizespor","1-0",1,0,"T1",1,1,1,"H"
"3651",2006-03-17,2006,"Kayserispor","Antalyaspor","4-4",4,4,"T1",1,8,0,"D"
"3652",2006-03-17,2006,"Manisaspor","Sakaryaspor","0-3",0,3,"T1",1,3,-3,"A"
"3653",2006-03-17,2006,"Trabzonspor","Ankaragucu","0-1",0,1,"T1",1,1,-1,"A"
"3654",2006-03-17,2005,"Kayserispor","Besiktas","0-1",0,1,"T1",1,1,-1,"A"
"3655",2006-03-18,2006,"Besiktas","Erciyesspor","1-0",1,0,"T1",1,1,1,"H"
"3656",2006-03-18,2005,"Ankaragucu","Fenerbahce","1-4",1,4,"T1",1,5,-3,"A"
"3657",2006-03-18,2005,"Manisaspor","Denizlispor","4-2",4,2,"T1",1,6,2,"H"
"3658",2006-03-19,2005,"Galatasaray","Erciyesspor","4-2",4,2,"T1",1,6,2,"H"
"3659",2006-03-19,2005,"Gaziantepspor","Diyarbakirspor","2-0",2,0,"T1",1,2,2,"H"
"3660",2006-03-19,2005,"Konyaspor","Ankaraspor","0-0",0,0,"T1",1,0,0,"D"
"3661",2006-03-19,2005,"Malatyaspor","Rizespor","1-0",1,0,"T1",1,1,1,"H"
"3662",2006-03-19,2005,"Sivasspor","Genclerbirligi","2-1",2,1,"T1",1,3,1,"H"
"3663",2006-03-19,2005,"Trabzonspor","Samsunspor","2-1",2,1,"T1",1,3,1,"H"
"3664",2006-03-24,2005,"Besiktas","Konyaspor","0-1",0,1,"T1",1,1,-1,"A"
"3665",2006-03-25,2005,"Denizlispor","Galatasaray","1-2",1,2,"T1",1,3,-1,"A"
"3666",2006-03-25,2005,"Diyarbakirspor","Sivasspor","1-1",1,1,"T1",1,2,0,"D"
"3667",2006-03-25,2005,"Genclerbirligi","Manisaspor","2-1",2,1,"T1",1,3,1,"H"
"3668",2006-03-26,2005,"Ankaraspor","Ankaragucu","1-2",1,2,"T1",1,3,-1,"A"
"3669",2006-03-26,2005,"Erciyesspor","Trabzonspor","1-0",1,0,"T1",1,1,1,"H"
"3670",2006-03-26,2005,"Fenerbahce","Malatyaspor","2-0",2,0,"T1",1,2,2,"H"
"3671",2006-03-26,2005,"Rizespor","Gaziantepspor","0-0",0,0,"T1",1,0,0,"D"
"3672",2006-03-26,2005,"Samsunspor","Kayserispor","0-0",0,0,"T1",1,0,0,"D"
"3673",2006-03-29,2005,"Denizlispor","Besiktas","1-1",1,1,"T1",1,2,0,"D"
"3674",2006-03-29,2005,"Erciyesspor","Kayserispor","0-0",0,0,"T1",1,0,0,"D"
"3675",2006-03-29,2005,"Galatasaray","Ankaragucu","2-0",2,0,"T1",1,2,2,"H"
"3676",2006-03-29,2005,"Genclerbirligi","Ankaraspor","2-1",2,1,"T1",1,3,1,"H"
"3677",2006-03-29,2005,"Manisaspor","Malatyaspor","4-3",4,3,"T1",1,7,1,"H"
"3678",2006-03-29,2005,"Samsunspor","Rizespor","0-0",0,0,"T1",1,0,0,"D"
"3679",2006-03-29,2005,"Sivasspor","Gaziantepspor","0-0",0,0,"T1",1,0,0,"D"
"3680",2006-03-30,2005,"Diyarbakirspor","Fenerbahce","0-4",0,4,"T1",1,4,-4,"A"
"3681",2006-03-30,2005,"Trabzonspor","Konyaspor","1-2",1,2,"T1",1,3,-1,"A"
"3682",2006-04-01,2006,"Ankaragucu","Galatasaray","1-2",1,2,"T1",1,3,-1,"A"
"3683",2006-04-01,2006,"Antalyaspor","Manisaspor","1-0",1,0,"T1",1,1,1,"H"
"3684",2006-04-01,2006,"Bursaspor","Konyaspor","1-0",1,0,"T1",1,1,1,"H"
"3685",2006-04-01,2006,"Fenerbahce","Ankaraspor","2-1",2,1,"T1",1,3,1,"H"
"3686",2006-04-01,2006,"Rizespor","Denizlispor","2-2",2,2,"T1",1,4,0,"D"
"3687",2006-04-01,2006,"Sakaryaspor","Gaziantepspor","1-2",1,2,"T1",1,3,-1,"A"
"3688",2006-04-01,2006,"Sivasspor","Kayserispor","3-2",3,2,"T1",1,5,1,"H"
"3689",2006-04-01,2005,"Ankaragucu","Besiktas","2-3",2,3,"T1",1,5,-1,"A"
"3690",2006-04-01,2005,"Galatasaray","Genclerbirligi","3-0",3,0,"T1",1,3,3,"H"
"3691",2006-04-02,2006,"Erciyesspor","Trabzonspor","0-1",0,1,"T1",1,1,-1,"A"
"3692",2006-04-02,2006,"Genclerbirligi","Besiktas","0-2",0,2,"T1",1,2,-2,"A"
"3693",2006-04-02,2005,"Erciyesspor","Samsunspor","2-2",2,2,"T1",1,4,0,"D"
"3694",2006-04-02,2005,"Gaziantepspor","Fenerbahce","0-2",0,2,"T1",1,2,-2,"A"
"3695",2006-04-02,2005,"Konyaspor","Kayserispor","1-0",1,0,"T1",1,1,1,"H"
"3696",2006-04-02,2005,"Malatyaspor","Ankaraspor","0-2",0,2,"T1",1,2,-2,"A"
"3697",2006-04-02,2005,"Manisaspor","Diyarbakirspor","0-3",0,3,"T1",1,3,-3,"A"
"3698",2006-04-02,2005,"Sivasspor","Rizespor","1-2",1,2,"T1",1,3,-1,"A"
"3699",2006-04-02,2005,"Trabzonspor","Denizlispor","3-0",3,0,"T1",1,3,3,"H"
"3700",2006-04-06,2006,"Galatasaray","Erciyesspor","0-1",0,1,"T1",1,1,-1,"A"
"3701",2006-04-07,2006,"Kayserispor","Fenerbahce","2-2",2,2,"T1",1,4,0,"D"
"3702",2006-04-07,2006,"Trabzonspor","Genclerbirligi","4-3",4,3,"T1",1,7,1,"H"
"3703",2006-04-07,2005,"Diyarbakirspor","Galatasaray","1-3",1,3,"T1",1,4,-2,"A"
"3704",2006-04-08,2006,"Ankaraspor","Bursaspor","0-0",0,0,"T1",1,0,0,"D"
"3705",2006-04-08,2006,"Besiktas","Rizespor","1-0",1,0,"T1",1,1,1,"H"
"3706",2006-04-08,2006,"Denizlispor","Sakaryaspor","1-0",1,0,"T1",1,1,1,"H"
"3707",2006-04-08,2006,"Gaziantepspor","Antalyaspor","0-0",0,0,"T1",1,0,0,"D"
"3708",2006-04-08,2006,"Konyaspor","Ankaragucu","2-0",2,0,"T1",1,2,2,"H"
"3709",2006-04-08,2006,"Manisaspor","Sivasspor","1-0",1,0,"T1",1,1,1,"H"
"3710",2006-04-08,2005,"Ankaraspor","Gaziantepspor","3-0",3,0,"T1",1,3,3,"H"
"3711",2006-04-08,2005,"Besiktas","Malatyaspor","2-2",2,2,"T1",1,4,0,"D"
"3712",2006-04-09,2005,"Denizlispor","Erciyesspor","1-1",1,1,"T1",1,2,0,"D"
"3713",2006-04-09,2005,"Fenerbahce","Sivasspor","3-0",3,0,"T1",1,3,3,"H"
"3714",2006-04-09,2005,"Genclerbirligi","Trabzonspor","1-0",1,0,"T1",1,1,1,"H"
"3715",2006-04-09,2005,"Kayserispor","Ankaragucu","1-2",1,2,"T1",1,3,-1,"A"
"3716",2006-04-09,2005,"Rizespor","Manisaspor","4-1",4,1,"T1",1,5,3,"H"
"3717",2006-04-09,2005,"Samsunspor","Konyaspor","1-1",1,1,"T1",1,2,0,"D"
"3718",2006-04-13,2006,"Genclerbirligi","Galatasaray","1-3",1,3,"T1",1,4,-2,"A"
"3719",2006-04-14,2006,"Sakaryaspor","Besiktas","1-1",1,1,"T1",1,2,0,"D"
"3720",2006-04-15,2006,"Ankaraspor","Konyaspor","4-2",4,2,"T1",1,6,2,"H"
"3721",2006-04-15,2006,"Antalyaspor","Denizlispor","1-1",1,1,"T1",1,2,0,"D"
"3722",2006-04-15,2006,"Bursaspor","Kayserispor","0-3",0,3,"T1",1,3,-3,"A"
"3723",2006-04-15,2006,"Erciyesspor","Ankaragucu","0-1",0,1,"T1",1,1,-1,"A"
"3724",2006-04-15,2006,"Fenerbahce","Manisaspor","0-0",0,0,"T1",1,0,0,"D"
"3725",2006-04-15,2006,"Rizespor","Trabzonspor","3-2",3,2,"T1",1,5,1,"H"
"3726",2006-04-15,2006,"Sivasspor","Gaziantepspor","2-1",2,1,"T1",1,3,1,"H"
"3727",2006-04-15,2005,"Denizlispor","Samsunspor","1-2",1,2,"T1",1,3,-1,"A"
"3728",2006-04-15,2005,"Malatyaspor","Kayserispor","2-1",2,1,"T1",1,3,1,"H"
"3729",2006-04-15,2005,"Manisaspor","Fenerbahce","5-3",5,3,"T1",1,8,2,"H"
"3730",2006-04-16,2005,"Ankaragucu","Konyaspor","3-0",3,0,"T1",1,3,3,"H"
"3731",2006-04-16,2005,"Erciyesspor","Genclerbirligi","2-0",2,0,"T1",1,2,2,"H"
"3732",2006-04-16,2005,"Galatasaray","Rizespor","4-2",4,2,"T1",1,6,2,"H"
"3733",2006-04-16,2005,"Gaziantepspor","Besiktas","2-2",2,2,"T1",1,4,0,"D"
"3734",2006-04-16,2005,"Sivasspor","Ankaraspor","2-2",2,2,"T1",1,4,0,"D"
"3735",2006-04-16,2005,"Trabzonspor","Diyarbakirspor","3-0",3,0,"T1",1,3,3,"H"
"3736",2006-04-20,2006,"Gaziantepspor","Fenerbahce","0-2",0,2,"T1",1,2,-2,"A"
"3737",2006-04-21,2006,"Besiktas","Antalyaspor","1-0",1,0,"T1",1,1,1,"H"
"3738",2006-04-22,2006,"Ankaragucu","Genclerbirligi","0-0",0,0,"T1",1,0,0,"D"
"3739",2006-04-22,2006,"Denizlispor","Sivasspor","2-0",2,0,"T1",1,2,2,"H"
"3740",2006-04-22,2006,"Galatasaray","Rizespor","3-1",3,1,"T1",1,4,2,"H"
"3741",2006-04-22,2006,"Kayserispor","Ankaraspor","3-3",3,3,"T1",1,6,0,"D"
"3742",2006-04-22,2006,"Konyaspor","Erciyesspor","1-1",1,1,"T1",1,2,0,"D"
"3743",2006-04-22,2006,"Manisaspor","Bursaspor","4-1",4,1,"T1",1,5,3,"H"
"3744",2006-04-22,2006,"Trabzonspor","Sakaryaspor","5-2",5,2,"T1",1,7,3,"H"
"3745",2006-04-22,2005,"Ankaraspor","Manisaspor","3-1",3,1,"T1",1,4,2,"H"
"3746",2006-04-22,2005,"Fenerbahce","Galatasaray","4-0",4,0,"T1",1,4,4,"H"
"3747",2006-04-23,2005,"Besiktas","Sivasspor","0-1",0,1,"T1",1,1,-1,"A"
"3748",2006-04-23,2005,"Diyarbakirspor","Erciyesspor","2-1",2,1,"T1",1,3,1,"H"
"3749",2006-04-23,2005,"Genclerbirligi","Denizlispor","3-3",3,3,"T1",1,6,0,"D"
"3750",2006-04-23,2005,"Kayserispor","Gaziantepspor","0-1",0,1,"T1",1,1,-1,"A"
"3751",2006-04-23,2005,"Konyaspor","Malatyaspor","0-2",0,2,"T1",1,2,-2,"A"
"3752",2006-04-23,2005,"Rizespor","Trabzonspor","1-6",1,6,"T1",1,7,-5,"A"
"3753",2006-04-23,2005,"Samsunspor","Ankaragucu","2-1",2,1,"T1",1,3,1,"H"
"3754",2006-04-28,2006,"Ankaraspor","Manisaspor","1-1",1,1,"T1",1,2,0,"D"
"3755",2006-04-28,2006,"Antalyaspor","Trabzonspor","1-2",1,2,"T1",1,3,-1,"A"
"3756",2006-04-28,2006,"Bursaspor","Gaziantepspor","1-1",1,1,"T1",1,2,0,"D"
"3757",2006-04-28,2006,"Genclerbirligi","Erciyesspor","1-2",1,2,"T1",1,3,-1,"A"
"3758",2006-04-28,2006,"Kayserispor","Konyaspor","2-1",2,1,"T1",1,3,1,"H"
"3759",2006-04-28,2006,"Rizespor","Ankaragucu","3-1",3,1,"T1",1,4,2,"H"
"3760",2006-04-28,2006,"Sakaryaspor","Galatasaray","0-3",0,3,"T1",1,3,-3,"A"
"3761",2006-04-28,2005,"Manisaspor","Besiktas","0-1",0,1,"T1",1,1,-1,"A"
"3762",2006-04-29,2006,"Fenerbahce","Denizlispor","2-2",2,2,"T1",1,4,0,"D"
"3763",2006-04-29,2006,"Sivasspor","Besiktas","0-1",0,1,"T1",1,1,-1,"A"
"3764",2006-04-29,2005,"Ankaragucu","Malatyaspor","0-1",0,1,"T1",1,1,-1,"A"
"3765",2006-04-29,2005,"Denizlispor","Diyarbakirspor","1-0",1,0,"T1",1,1,1,"H"
"3766",2006-04-29,2005,"Erciyesspor","Rizespor","0-2",0,2,"T1",1,2,-2,"A"
"3767",2006-04-29,2005,"Galatasaray","Ankaraspor","4-0",4,0,"T1",1,4,4,"H"
"3768",2006-04-29,2005,"Gaziantepspor","Konyaspor","2-0",2,0,"T1",1,2,2,"H"
"3769",2006-04-29,2005,"Samsunspor","Genclerbirligi","2-0",2,0,"T1",1,2,2,"H"
"3770",2006-04-29,2005,"Trabzonspor","Fenerbahce","2-3",2,3,"T1",1,5,-1,"A"
"3771",2006-04-30,2005,"Sivasspor","Kayserispor","0-5",0,5,"T1",1,5,-5,"A"
"3772",2006-05-04,2006,"Trabzonspor","Sivasspor","2-0",2,0,"T1",1,2,2,"H"
"3773",2006-05-05,2006,"Ankaragucu","Sakaryaspor","1-0",1,0,"T1",1,1,1,"H"
"3774",2006-05-05,2006,"Besiktas","Fenerbahce","0-1",0,1,"T1",1,1,-1,"A"
"3775",2006-05-05,2006,"Denizlispor","Bursaspor","0-0",0,0,"T1",1,0,0,"D"
"3776",2006-05-05,2006,"Erciyesspor","Rizespor","1-1",1,1,"T1",1,2,0,"D"
"3777",2006-05-05,2006,"Gaziantepspor","Ankaraspor","0-2",0,2,"T1",1,2,-2,"A"
"3778",2006-05-05,2006,"Konyaspor","Genclerbirligi","2-1",2,1,"T1",1,3,1,"H"
"3779",2006-05-05,2006,"Manisaspor","Kayserispor","1-0",1,0,"T1",1,1,1,"H"
"3780",2006-05-06,2006,"Galatasaray","Antalyaspor","1-1",1,1,"T1",1,2,0,"D"
"3781",2006-05-06,2005,"Ankaraspor","Trabzonspor","0-2",0,2,"T1",1,2,-2,"A"
"3782",2006-05-06,2005,"Diyarbakirspor","Genclerbirligi","0-2",0,2,"T1",1,2,-2,"A"
"3783",2006-05-06,2005,"Kayserispor","Manisaspor","7-2",7,2,"T1",1,9,5,"H"
"3784",2006-05-06,2005,"Malatyaspor","Samsunspor","3-0",3,0,"T1",1,3,3,"H"
"3785",2006-05-06,2005,"Rizespor","Denizlispor","1-2",1,2,"T1",1,3,-1,"A"
"3786",2006-05-07,2005,"Ankaragucu","Gaziantepspor","2-1",2,1,"T1",1,3,1,"H"
"3787",2006-05-07,2005,"Besiktas","Galatasaray","1-2",1,2,"T1",1,3,-1,"A"
"3788",2006-05-07,2005,"Fenerbahce","Erciyesspor","4-2",4,2,"T1",1,6,2,"H"
"3789",2006-05-07,2005,"Konyaspor","Sivasspor","2-1",2,1,"T1",1,3,1,"H"
"3790",2006-05-13,2006,"Ankaraspor","Denizlispor","1-1",1,1,"T1",1,2,0,"D"
"3791",2006-05-13,2006,"Antalyaspor","Ankaragucu","0-1",0,1,"T1",1,1,-1,"A"
"3792",2006-05-13,2006,"Bursaspor","Besiktas","3-0",3,0,"T1",1,3,3,"H"
"3793",2006-05-13,2006,"Fenerbahce","Trabzonspor","2-2",2,2,"T1",1,4,0,"D"
"3794",2006-05-13,2006,"Genclerbirligi","Rizespor","2-1",2,1,"T1",1,3,1,"H"
"3795",2006-05-13,2006,"Kayserispor","Gaziantepspor","1-2",1,2,"T1",1,3,-1,"A"
"3796",2006-05-13,2006,"Konyaspor","Manisaspor","1-0",1,0,"T1",1,1,1,"H"
"3797",2006-05-13,2006,"Sakaryaspor","Erciyesspor","1-2",1,2,"T1",1,3,-1,"A"
"3798",2006-05-13,2006,"Sivasspor","Galatasaray","1-1",1,1,"T1",1,2,0,"D"
"3799",2006-05-13,2005,"Manisaspor","Konyaspor","0-0",0,0,"T1",1,0,0,"D"
"3800",2006-05-13,2005,"Sivasspor","Ankaragucu","3-1",3,1,"T1",1,4,2,"H"
"3801",2006-05-14,2005,"Denizlispor","Fenerbahce","1-1",1,1,"T1",1,2,0,"D"
"3802",2006-05-14,2005,"Erciyesspor","Ankaraspor","0-1",0,1,"T1",1,1,-1,"A"
"3803",2006-05-14,2005,"Galatasaray","Kayserispor","3-0",3,0,"T1",1,3,3,"H"
"3804",2006-05-14,2005,"Gaziantepspor","Malatyaspor","1-0",1,0,"T1",1,1,1,"H"
"3805",2006-05-14,2005,"Genclerbirligi","Rizespor","1-3",1,3,"T1",1,4,-2,"A"
"3806",2006-05-14,2005,"Samsunspor","Diyarbakirspor","1-0",1,0,"T1",1,1,1,"H"
"3807",2006-05-14,2005,"Trabzonspor","Besiktas","1-2",1,2,"T1",1,3,-1,"A"
"3808",2006-05-19,2006,"Besiktas","Ankaraspor","2-1",2,1,"T1",1,3,1,"H"
"3809",2006-05-19,2006,"Galatasaray","Fenerbahce","1-2",1,2,"T1",1,3,-1,"A"
"3810",2006-05-19,2006,"Genclerbirligi","Sakaryaspor","1-0",1,0,"T1",1,1,1,"H"
"3811",2006-05-20,2006,"Ankaragucu","Sivasspor","1-4",1,4,"T1",1,5,-3,"A"
"3812",2006-05-20,2006,"Denizlispor","Kayserispor","2-1",2,1,"T1",1,3,1,"H"
"3813",2006-05-20,2006,"Erciyesspor","Antalyaspor","0-0",0,0,"T1",1,0,0,"D"
"3814",2006-05-20,2006,"Gaziantepspor","Manisaspor","0-0",0,0,"T1",1,0,0,"D"
"3815",2006-05-20,2006,"Rizespor","Konyaspor","1-0",1,0,"T1",1,1,1,"H"
"3816",2006-05-20,2006,"Trabzonspor","Bursaspor","3-1",3,1,"T1",1,4,2,"H"
"3817",2006-05-25,2006,"Ankaraspor","Trabzonspor","2-1",2,1,"T1",1,3,1,"H"
"3818",2006-05-25,2006,"Bursaspor","Galatasaray","2-0",2,0,"T1",1,2,2,"H"
"3819",2006-05-25,2006,"Kayserispor","Besiktas","3-0",3,0,"T1",1,3,3,"H"
"3820",2006-05-26,2006,"Antalyaspor","Genclerbirligi","1-3",1,3,"T1",1,4,-2,"A"
"3821",2006-05-26,2006,"Fenerbahce","Ankaragucu","3-1",3,1,"T1",1,4,2,"H"
"3822",2006-05-26,2006,"Konyaspor","Gaziantepspor","0-2",0,2,"T1",1,2,-2,"A"
"3823",2006-05-26,2006,"Manisaspor","Denizlispor","0-0",0,0,"T1",1,0,0,"D"
"3824",2006-05-26,2006,"Sakaryaspor","Rizespor","1-1",1,1,"T1",1,2,0,"D"
"3825",2006-05-26,2006,"Sivasspor","Erciyesspor","2-1",2,1,"T1",1,3,1,"H"
"3826",2006-08-04,2006,"Ankaraspor","Galatasaray","1-1",1,1,"T1",1,2,0,"D"
"3827",2006-08-05,2006,"Fenerbahce","Erciyesspor","6-0",6,0,"T1",1,6,6,"H"
"3828",2006-08-05,2006,"Kayserispor","Trabzonspor","1-0",1,0,"T1",1,1,1,"H"
"3829",2006-08-06,2006,"Antalyaspor","Rizespor","0-0",0,0,"T1",1,0,0,"D"
"3830",2006-08-06,2006,"Bursaspor","Ankaragucu","0-0",0,0,"T1",1,0,0,"D"
"3831",2006-08-06,2006,"Gaziantepspor","Denizlispor","1-1",1,1,"T1",1,2,0,"D"
"3832",2006-08-06,2006,"Konyaspor","Sakaryaspor","1-1",1,1,"T1",1,2,0,"D"
"3833",2006-08-06,2006,"Manisaspor","Besiktas","1-0",1,0,"T1",1,1,1,"H"
"3834",2006-08-06,2006,"Sivasspor","Genclerbirligi","1-2",1,2,"T1",1,3,-1,"A"
"3835",2006-08-11,2006,"Besiktas","Gaziantepspor","2-1",2,1,"T1",1,3,1,"H"
"3836",2006-08-12,2006,"Genclerbirligi","Fenerbahce","0-2",0,2,"T1",1,2,-2,"A"
"3837",2006-08-13,2006,"Ankaragucu","Ankaraspor","1-1",1,1,"T1",1,2,0,"D"
"3838",2006-08-13,2006,"Denizlispor","Konyaspor","0-1",0,1,"T1",1,1,-1,"A"
"3839",2006-08-13,2006,"Erciyesspor","Bursaspor","2-1",2,1,"T1",1,3,1,"H"
"3840",2006-08-13,2006,"Galatasaray","Kayserispor","4-0",4,0,"T1",1,4,4,"H"
"3841",2006-08-13,2006,"Rizespor","Sivasspor","1-1",1,1,"T1",1,2,0,"D"
"3842",2006-08-13,2006,"Sakaryaspor","Antalyaspor","0-0",0,0,"T1",1,0,0,"D"
"3843",2006-08-13,2006,"Trabzonspor","Manisaspor","1-1",1,1,"T1",1,2,0,"D"
"3844",2006-08-19,2006,"Ankaraspor","Erciyesspor","2-2",2,2,"T1",1,4,0,"D"
"3845",2006-08-19,2006,"Fenerbahce","Rizespor","2-1",2,1,"T1",1,3,1,"H"
"3846",2006-08-19,2006,"Manisaspor","Galatasaray","2-2",2,2,"T1",1,4,0,"D"
"3847",2006-08-20,2006,"Bursaspor","Genclerbirligi","0-0",0,0,"T1",1,0,0,"D"
"3848",2006-08-20,2006,"Denizlispor","Besiktas","0-2",0,2,"T1",1,2,-2,"A"
"3849",2006-08-20,2006,"Gaziantepspor","Trabzonspor","2-1",2,1,"T1",1,3,1,"H"
"3850",2006-08-20,2006,"Kayserispor","Ankaragucu","2-1",2,1,"T1",1,3,1,"H"
"3851",2006-08-20,2006,"Konyaspor","Antalyaspor","0-0",0,0,"T1",1,0,0,"D"
"3852",2006-08-20,2006,"Sivasspor","Sakaryaspor","0-2",0,2,"T1",1,2,-2,"A"
"3853",2006-08-25,2006,"Besiktas","Konyaspor","3-1",3,1,"T1",1,4,2,"H"
"3854",2006-08-26,2006,"Galatasaray","Gaziantepspor","2-2",2,2,"T1",1,4,0,"D"
"3855",2006-08-26,2006,"Genclerbirligi","Ankaraspor","2-1",2,1,"T1",1,3,1,"H"
"3856",2006-08-27,2006,"Ankaragucu","Manisaspor","0-1",0,1,"T1",1,1,-1,"A"
"3857",2006-08-27,2006,"Antalyaspor","Sivasspor","1-2",1,2,"T1",1,3,-1,"A"
"3858",2006-08-27,2006,"Erciyesspor","Kayserispor","0-4",0,4,"T1",1,4,-4,"A"
"3859",2006-08-27,2006,"Rizespor","Bursaspor","1-2",1,2,"T1",1,3,-1,"A"
"3860",2006-08-27,2006,"Sakaryaspor","Fenerbahce","2-1",2,1,"T1",1,3,1,"H"
"3861",2006-08-27,2006,"Trabzonspor","Denizlispor","1-0",1,0,"T1",1,1,1,"H"
"3862",2006-09-09,2006,"Denizlispor","Galatasaray","1-1",1,1,"T1",1,2,0,"D"
"3863",2006-09-09,2006,"Fenerbahce","Antalyaspor","4-2",4,2,"T1",1,6,2,"H"
"3864",2006-09-09,2006,"Kayserispor","Genclerbirligi","0-0",0,0,"T1",1,0,0,"D"
"3865",2006-09-10,2006,"Ankaraspor","Rizespor","2-1",2,1,"T1",1,3,1,"H"
"3866",2006-09-10,2006,"Besiktas","Trabzonspor","2-3",2,3,"T1",1,5,-1,"A"
"3867",2006-09-10,2006,"Bursaspor","Sakaryaspor","3-1",3,1,"T1",1,4,2,"H"
"3868",2006-09-10,2006,"Gaziantepspor","Ankaragucu","2-2",2,2,"T1",1,4,0,"D"
"3869",2006-09-10,2006,"Konyaspor","Sivasspor","2-0",2,0,"T1",1,2,2,"H"
"3870",2006-09-10,2006,"Manisaspor","Erciyesspor","5-1",5,1,"T1",1,6,4,"H"
"3871",2006-09-15,2006,"Genclerbirligi","Manisaspor","0-5",0,5,"T1",1,5,-5,"A"
"3872",2006-09-16,2006,"Ankaragucu","Denizlispor","0-0",0,0,"T1",1,0,0,"D"
"3873",2006-09-16,2006,"Antalyaspor","Bursaspor","3-2",3,2,"T1",1,5,1,"H"
"3874",2006-09-16,2006,"Sakaryaspor","Ankaraspor","0-0",0,0,"T1",1,0,0,"D"
"3875",2006-09-17,2006,"Erciyesspor","Gaziantepspor","1-1",1,1,"T1",1,2,0,"D"
"3876",2006-09-17,2006,"Galatasaray","Besiktas","1-0",1,0,"T1",1,1,1,"H"
"3877",2006-09-17,2006,"Rizespor","Kayserispor","2-1",2,1,"T1",1,3,1,"H"
"3878",2006-09-17,2006,"Sivasspor","Fenerbahce","1-1",1,1,"T1",1,2,0,"D"
"3879",2006-09-17,2006,"Trabzonspor","Konyaspor","1-1",1,1,"T1",1,2,0,"D"
"3880",2006-09-22,2006,"Konyaspor","Fenerbahce","0-1",0,1,"T1",1,1,-1,"A"
"3881",2006-09-23,2006,"Trabzonspor","Galatasaray","3-1",3,1,"T1",1,4,2,"H"
"3882",2006-09-24,2006,"Ankaraspor","Antalyaspor","1-1",1,1,"T1",1,2,0,"D"
"3883",2006-09-24,2006,"Besiktas","Ankaragucu","2-1",2,1,"T1",1,3,1,"H"
"3884",2006-09-24,2006,"Bursaspor","Sivasspor","1-3",1,3,"T1",1,4,-2,"A"
"3885",2006-09-24,2006,"Denizlispor","Erciyesspor","2-1",2,1,"T1",1,3,1,"H"
"3886",2006-09-24,2006,"Gaziantepspor","Genclerbirligi","2-0",2,0,"T1",1,2,2,"H"
"3887",2006-09-24,2006,"Kayserispor","Sakaryaspor","2-0",2,0,"T1",1,2,2,"H"
"3888",2006-09-24,2006,"Manisaspor","Rizespor","2-0",2,0,"T1",1,2,2,"H"
"3889",2006-09-30,2006,"Galatasaray","Konyaspor","3-3",3,3,"T1",1,6,0,"D"
"3890",2006-09-30,2006,"Genclerbirligi","Denizlispor","3-1",3,1,"T1",1,4,2,"H"
"3891",2006-09-30,2006,"Rizespor","Gaziantepspor","2-0",2,0,"T1",1,2,2,"H"
"3892",2006-09-30,2006,"Sivasspor","Ankaraspor","0-2",0,2,"T1",1,2,-2,"A"
"3893",2006-10-01,2006,"Antalyaspor","Kayserispor","1-0",1,0,"T1",1,1,1,"H"
"3894",2006-10-01,2006,"Erciyesspor","Besiktas","1-1",1,1,"T1",1,2,0,"D"
"3895",2006-10-01,2006,"Fenerbahce","Bursaspor","0-1",0,1,"T1",1,1,-1,"A"
"3896",2006-10-01,2006,"Sakaryaspor","Manisaspor","0-1",0,1,"T1",1,1,-1,"A"
"3897",2006-10-02,2006,"Ankaragucu","Trabzonspor","2-2",2,2,"T1",1,4,0,"D"
"3898",2006-10-14,2006,"Galatasaray","Ankaragucu","1-1",1,1,"T1",1,2,0,"D"
"3899",2006-10-14,2006,"Gaziantepspor","Sakaryaspor","1-0",1,0,"T1",1,1,1,"H"
"3900",2006-10-14,2006,"Konyaspor","Bursaspor","1-0",1,0,"T1",1,1,1,"H"
"3901",2006-10-14,2006,"Trabzonspor","Erciyesspor","3-1",3,1,"T1",1,4,2,"H"
"3902",2006-10-15,2006,"Ankaraspor","Fenerbahce","2-2",2,2,"T1",1,4,0,"D"
"3903",2006-10-15,2006,"Besiktas","Genclerbirligi","1-0",1,0,"T1",1,1,1,"H"
"3904",2006-10-15,2006,"Denizlispor","Rizespor","2-0",2,0,"T1",1,2,2,"H"
"3905",2006-10-15,2006,"Kayserispor","Sivasspor","1-1",1,1,"T1",1,2,0,"D"
"3906",2006-10-15,2006,"Manisaspor","Antalyaspor","3-2",3,2,"T1",1,5,1,"H"
"3907",2006-10-20,2006,"Genclerbirligi","Trabzonspor","3-0",3,0,"T1",1,3,3,"H"
"3908",2006-10-20,2006,"Sivasspor","Manisaspor","3-2",3,2,"T1",1,5,1,"H"
"3909",2006-10-21,2006,"Bursaspor","Ankaraspor","0-0",0,0,"T1",1,0,0,"D"
"3910",2006-10-21,2006,"Erciyesspor","Galatasaray","1-2",1,2,"T1",1,3,-1,"A"
"3911",2006-10-21,2006,"Sakaryaspor","Denizlispor","1-2",1,2,"T1",1,3,-1,"A"
"3912",2006-10-22,2006,"Ankaragucu","Konyaspor","2-0",2,0,"T1",1,2,2,"H"
"3913",2006-10-22,2006,"Antalyaspor","Gaziantepspor","0-0",0,0,"T1",1,0,0,"D"
"3914",2006-10-22,2006,"Fenerbahce","Kayserispor","4-1",4,1,"T1",1,5,3,"H"
"3915",2006-10-22,2006,"Rizespor","Besiktas","0-1",0,1,"T1",1,1,-1,"A"
"3916",2006-10-28,2006,"Galatasaray","Genclerbirligi","1-0",1,0,"T1",1,1,1,"H"
"3917",2006-10-29,2006,"Ankaragucu","Erciyesspor","4-1",4,1,"T1",1,5,3,"H"
"3918",2006-10-29,2006,"Besiktas","Sakaryaspor","0-0",0,0,"T1",1,0,0,"D"
"3919",2006-10-29,2006,"Denizlispor","Antalyaspor","1-1",1,1,"T1",1,2,0,"D"
"3920",2006-10-29,2006,"Gaziantepspor","Sivasspor","1-0",1,0,"T1",1,1,1,"H"
"3921",2006-10-29,2006,"Kayserispor","Bursaspor","2-0",2,0,"T1",1,2,2,"H"
"3922",2006-10-29,2006,"Konyaspor","Ankaraspor","2-2",2,2,"T1",1,4,0,"D"
"3923",2006-10-29,2006,"Manisaspor","Fenerbahce","2-3",2,3,"T1",1,5,-1,"A"
"3924",2006-10-30,2006,"Trabzonspor","Rizespor","0-1",0,1,"T1",1,1,-1,"A"
"3925",2006-11-03,2006,"Fenerbahce","Gaziantepspor","4-1",4,1,"T1",1,5,3,"H"
"3926",2006-11-04,2006,"Ankaraspor","Kayserispor","1-1",1,1,"T1",1,2,0,"D"
"3927",2006-11-04,2006,"Erciyesspor","Konyaspor","1-2",1,2,"T1",1,3,-1,"A"
"3928",2006-11-04,2006,"Sakaryaspor","Trabzonspor","1-0",1,0,"T1",1,1,1,"H"
"3929",2006-11-04,2006,"Sivasspor","Denizlispor","0-2",0,2,"T1",1,2,-2,"A"
"3930",2006-11-05,2006,"Antalyaspor","Besiktas","4-4",4,4,"T1",1,8,0,"D"
"3931",2006-11-05,2006,"Bursaspor","Manisaspor","4-0",4,0,"T1",1,4,4,"H"
"3932",2006-11-05,2006,"Genclerbirligi","Ankaragucu","1-2",1,2,"T1",1,3,-1,"A"
"3933",2006-11-05,2006,"Rizespor","Galatasaray","2-1",2,1,"T1",1,3,1,"H"
"3934",2006-11-10,2006,"Denizlispor","Fenerbahce","0-0",0,0,"T1",1,0,0,"D"
"3935",2006-11-11,2006,"Besiktas","Sivasspor","0-1",0,1,"T1",1,1,-1,"A"
"3936",2006-11-12,2006,"Ankaragucu","Rizespor","2-0",2,0,"T1",1,2,2,"H"
"3937",2006-11-12,2006,"Erciyesspor","Genclerbirligi","0-2",0,2,"T1",1,2,-2,"A"
"3938",2006-11-12,2006,"Galatasaray","Sakaryaspor","4-0",4,0,"T1",1,4,4,"H"
"3939",2006-11-12,2006,"Gaziantepspor","Bursaspor","1-2",1,2,"T1",1,3,-1,"A"
"3940",2006-11-12,2006,"Konyaspor","Kayserispor","1-1",1,1,"T1",1,2,0,"D"
"3941",2006-11-12,2006,"Manisaspor","Ankaraspor","1-3",1,3,"T1",1,4,-2,"A"
"3942",2006-11-12,2006,"Trabzonspor","Antalyaspor","0-0",0,0,"T1",1,0,0,"D"
"3943",2006-11-18,2006,"Antalyaspor","Galatasaray","0-1",0,1,"T1",1,1,-1,"A"
"3944",2006-11-18,2006,"Genclerbirligi","Konyaspor","4-1",4,1,"T1",1,5,3,"H"
"3945",2006-11-18,2006,"Kayserispor","Manisaspor","2-2",2,2,"T1",1,4,0,"D"
"3946",2006-11-18,2006,"Sakaryaspor","Ankaragucu","0-0",0,0,"T1",1,0,0,"D"
"3947",2006-11-19,2006,"Ankaraspor","Gaziantepspor","2-0",2,0,"T1",1,2,2,"H"
"3948",2006-11-19,2006,"Bursaspor","Denizlispor","1-0",1,0,"T1",1,1,1,"H"
"3949",2006-11-19,2006,"Fenerbahce","Besiktas","0-0",0,0,"T1",1,0,0,"D"
"3950",2006-11-19,2006,"Rizespor","Erciyesspor","0-0",0,0,"T1",1,0,0,"D"
"3951",2006-11-19,2006,"Sivasspor","Trabzonspor","1-0",1,0,"T1",1,1,1,"H"
"3952",2006-11-24,2006,"Besiktas","Bursaspor","3-1",3,1,"T1",1,4,2,"H"
"3953",2006-11-25,2006,"Denizlispor","Ankaraspor","1-1",1,1,"T1",1,2,0,"D"
"3954",2006-11-25,2006,"Galatasaray","Sivasspor","3-1",3,1,"T1",1,4,2,"H"
"3955",2006-11-25,2006,"Gaziantepspor","Kayserispor","1-2",1,2,"T1",1,3,-1,"A"
"3956",2006-11-25,2006,"Manisaspor","Konyaspor","0-1",0,1,"T1",1,1,-1,"A"
"3957",2006-11-26,2006,"Ankaragucu","Antalyaspor","1-0",1,0,"T1",1,1,1,"H"
"3958",2006-11-26,2006,"Erciyesspor","Sakaryaspor","2-0",2,0,"T1",1,2,2,"H"
"3959",2006-11-26,2006,"Rizespor","Genclerbirligi","0-1",0,1,"T1",1,1,-1,"A"
"3960",2006-11-26,2006,"Trabzonspor","Fenerbahce","1-2",1,2,"T1",1,3,-1,"A"
"3961",2006-12-01,2006,"Bursaspor","Trabzonspor","2-1",2,1,"T1",1,3,1,"H"
"3962",2006-12-02,2006,"Ankaraspor","Besiktas","0-0",0,0,"T1",1,0,0,"D"
"3963",2006-12-02,2006,"Kayserispor","Denizlispor","1-0",1,0,"T1",1,1,1,"H"
"3964",2006-12-02,2006,"Konyaspor","Rizespor","2-0",2,0,"T1",1,2,2,"H"
"3965",2006-12-02,2006,"Sivasspor","Ankaragucu","2-1",2,1,"T1",1,3,1,"H"
"3966",2006-12-03,2006,"Antalyaspor","Erciyesspor","3-1",3,1,"T1",1,4,2,"H"
"3967",2006-12-03,2006,"Fenerbahce","Galatasaray","2-1",2,1,"T1",1,3,1,"H"
"3968",2006-12-03,2006,"Manisaspor","Gaziantepspor","4-1",4,1,"T1",1,5,3,"H"
"3969",2006-12-03,2006,"Sakaryaspor","Genclerbirligi","1-1",1,1,"T1",1,2,0,"D"
"3970",2006-12-08,2006,"Ankaragucu","Fenerbahce","0-1",0,1,"T1",1,1,-1,"A"
"3971",2006-12-09,2006,"Besiktas","Kayserispor","2-1",2,1,"T1",1,3,1,"H"
"3972",2006-12-09,2006,"Erciyesspor","Sivasspor","0-0",0,0,"T1",1,0,0,"D"
"3973",2006-12-09,2006,"Rizespor","Sakaryaspor","3-1",3,1,"T1",1,4,2,"H"
"3974",2006-12-10,2006,"Denizlispor","Manisaspor","0-0",0,0,"T1",1,0,0,"D"
"3975",2006-12-10,2006,"Galatasaray","Bursaspor","3-1",3,1,"T1",1,4,2,"H"
"3976",2006-12-10,2006,"Gaziantepspor","Konyaspor","1-0",1,0,"T1",1,1,1,"H"
"3977",2006-12-10,2006,"Genclerbirligi","Antalyaspor","1-0",1,0,"T1",1,1,1,"H"
"3978",2006-12-10,2006,"Trabzonspor","Ankaraspor","3-0",3,0,"T1",1,3,3,"H"
"3979",2007-08-10,2007,"Buyuksehyr","Fenerbahce","2-0",2,0,"T1",1,2,2,"H"
"3980",2007-08-11,2007,"Ankaraspor","Ankaragucu","1-2",1,2,"T1",1,3,-1,"A"
"3981",2007-08-11,2007,"Besiktas","Konyaspor","1-0",1,0,"T1",1,1,1,"H"
"3982",2007-08-12,2007,"Denizlispor","Bursaspor","0-0",0,0,"T1",1,0,0,"D"
"3983",2007-08-12,2007,"Galatasaray","Rizespor","4-0",4,0,"T1",1,4,4,"H"
"3984",2007-08-12,2007,"Gaziantepspor","Kasimpasa","2-0",2,0,"T1",1,2,2,"H"
"3985",2007-08-12,2007,"Genclerbirligi","Oftasspor","1-2",1,2,"T1",1,3,-1,"A"
"3986",2007-08-12,2007,"Kayserispor","Manisaspor","3-1",3,1,"T1",1,4,2,"H"
"3987",2007-08-12,2007,"Trabzonspor","Sivasspor","0-3",0,3,"T1",1,3,-3,"A"
"3988",2007-08-17,2007,"Oftasspor","Trabzonspor","0-2",0,2,"T1",1,2,-2,"A"
"3989",2007-08-18,2007,"Fenerbahce","Gaziantepspor","2-1",2,1,"T1",1,3,1,"H"
"3990",2007-08-19,2007,"Ankaragucu","Denizlispor","3-2",3,2,"T1",1,5,1,"H"
"3991",2007-08-19,2007,"Bursaspor","Galatasaray","0-1",0,1,"T1",1,1,-1,"A"
"3992",2007-08-19,2007,"Kasimpasa","Besiktas","1-2",1,2,"T1",1,3,-1,"A"
"3993",2007-08-19,2007,"Konyaspor","Kayserispor","1-1",1,1,"T1",1,2,0,"D"
"3994",2007-08-19,2007,"Manisaspor","Ankaraspor","2-1",2,1,"T1",1,3,1,"H"
"3995",2007-08-19,2007,"Rizespor","Genclerbirligi","0-2",0,2,"T1",1,2,-2,"A"
"3996",2007-08-19,2007,"Sivasspor","Buyuksehyr","2-1",2,1,"T1",1,3,1,"H"
"3997",2007-08-25,2007,"Fenerbahce","Sivasspor","1-0",1,0,"T1",1,1,1,"H"
"3998",2007-08-25,2007,"Gaziantepspor","Besiktas","0-1",0,1,"T1",1,1,-1,"A"
"3999",2007-08-25,2007,"Genclerbirligi","Bursaspor","1-3",1,3,"T1",1,4,-2,"A"
"4000",2007-08-26,2007,"Ankaraspor","Konyaspor","1-1",1,1,"T1",1,2,0,"D"
"4001",2007-08-26,2007,"Buyuksehyr","Oftasspor","1-0",1,0,"T1",1,1,1,"H"
"4002",2007-08-26,2007,"Denizlispor","Manisaspor","3-2",3,2,"T1",1,5,1,"H"
"4003",2007-08-26,2007,"Galatasaray","Ankaragucu","1-0",1,0,"T1",1,1,1,"H"
"4004",2007-08-26,2007,"Kayserispor","Kasimpasa","2-0",2,0,"T1",1,2,2,"H"
"4005",2007-08-26,2007,"Trabzonspor","Rizespor","5-1",5,1,"T1",1,6,4,"H"
"4006",2007-08-31,2007,"Bursaspor","Trabzonspor","1-1",1,1,"T1",1,2,0,"D"
"4007",2007-09-01,2007,"Ankaragucu","Genclerbirligi","2-2",2,2,"T1",1,4,0,"D"
"4008",2007-09-01,2007,"Besiktas","Kayserispor","0-0",0,0,"T1",1,0,0,"D"
"4009",2007-09-01,2007,"Konyaspor","Denizlispor","2-2",2,2,"T1",1,4,0,"D"
"4010",2007-09-01,2007,"Rizespor","Buyuksehyr","3-1",3,1,"T1",1,4,2,"H"
"4011",2007-09-02,2007,"Kasimpasa","Ankaraspor","3-1",3,1,"T1",1,4,2,"H"
"4012",2007-09-02,2007,"Manisaspor","Galatasaray","2-2",2,2,"T1",1,4,0,"D"
"4013",2007-09-02,2007,"Oftasspor","Fenerbahce","1-1",1,1,"T1",1,2,0,"D"
"4014",2007-09-02,2007,"Sivasspor","Gaziantepspor","2-0",2,0,"T1",1,2,2,"H"
"4015",2007-09-15,2007,"Ankaraspor","Besiktas","0-0",0,0,"T1",1,0,0,"D"
"4016",2007-09-15,2007,"Denizlispor","Kasimpasa","0-1",0,1,"T1",1,1,-1,"A"
"4017",2007-09-15,2007,"Fenerbahce","Rizespor","1-1",1,1,"T1",1,2,0,"D"
"4018",2007-09-15,2007,"Sivasspor","Oftasspor","1-0",1,0,"T1",1,1,1,"H"
"4019",2007-09-16,2007,"Buyuksehyr","Bursaspor","1-0",1,0,"T1",1,1,1,"H"
"4020",2007-09-16,2007,"Galatasaray","Konyaspor","6-0",6,0,"T1",1,6,6,"H"
"4021",2007-09-16,2007,"Gaziantepspor","Kayserispor","4-3",4,3,"T1",1,7,1,"H"
"4022",2007-09-16,2007,"Genclerbirligi","Manisaspor","0-2",0,2,"T1",1,2,-2,"A"
"4023",2007-09-16,2007,"Trabzonspor","Ankaragucu","0-0",0,0,"T1",1,0,0,"D"
"4024",2007-09-21,2007,"Ankaragucu","Buyuksehyr","1-0",1,0,"T1",1,1,1,"H"
"4025",2007-09-21,2007,"Manisaspor","Trabzonspor","1-1",1,1,"T1",1,2,0,"D"
"4026",2007-09-22,2007,"Besiktas","Denizlispor","3-2",3,2,"T1",1,5,1,"H"
"4027",2007-09-22,2007,"Kayserispor","Ankaraspor","3-1",3,1,"T1",1,4,2,"H"
"4028",2007-09-22,2007,"Konyaspor","Genclerbirligi","1-1",1,1,"T1",1,2,0,"D"
"4029",2007-09-23,2007,"Bursaspor","Fenerbahce","1-1",1,1,"T1",1,2,0,"D"
"4030",2007-09-23,2007,"Kasimpasa","Galatasaray","0-1",0,1,"T1",1,1,-1,"A"
"4031",2007-09-23,2007,"Oftasspor","Gaziantepspor","1-2",1,2,"T1",1,3,-1,"A"
"4032",2007-09-23,2007,"Rizespor","Sivasspor","0-2",0,2,"T1",1,2,-2,"A"
"4033",2007-09-28,2007,"Fenerbahce","Ankaragucu","2-0",2,0,"T1",1,2,2,"H"
"4034",2007-09-29,2007,"Galatasaray","Besiktas","2-1",2,1,"T1",1,3,1,"H"
"4035",2007-09-29,2007,"Oftasspor","Rizespor","2-0",2,0,"T1",1,2,2,"H"
"4036",2007-09-30,2007,"Buyuksehyr","Manisaspor","4-1",4,1,"T1",1,5,3,"H"
"4037",2007-09-30,2007,"Denizlispor","Kayserispor","2-0",2,0,"T1",1,2,2,"H"
"4038",2007-09-30,2007,"Gaziantepspor","Ankaraspor","1-0",1,0,"T1",1,1,1,"H"
"4039",2007-09-30,2007,"Genclerbirligi","Kasimpasa","3-1",3,1,"T1",1,4,2,"H"
"4040",2007-09-30,2007,"Sivasspor","Bursaspor","3-2",3,2,"T1",1,5,1,"H"
"4041",2007-09-30,2007,"Trabzonspor","Konyaspor","1-0",1,0,"T1",1,1,1,"H"
"4042",2007-10-05,2007,"Kasimpasa","Trabzonspor","0-0",0,0,"T1",1,0,0,"D"
"4043",2007-10-06,2007,"Ankaraspor","Denizlispor","0-0",0,0,"T1",1,0,0,"D"
"4044",2007-10-06,2007,"Bursaspor","Oftasspor","1-1",1,1,"T1",1,2,0,"D"
"4045",2007-10-06,2007,"Manisaspor","Fenerbahce","1-1",1,1,"T1",1,2,0,"D"
"4046",2007-10-07,2007,"Ankaragucu","Sivasspor","2-2",2,2,"T1",1,4,0,"D"
"4047",2007-10-07,2007,"Besiktas","Genclerbirligi","1-0",1,0,"T1",1,1,1,"H"
"4048",2007-10-07,2007,"Kayserispor","Galatasaray","1-1",1,1,"T1",1,2,0,"D"
"4049",2007-10-07,2007,"Konyaspor","Buyuksehyr","3-2",3,2,"T1",1,5,1,"H"
"4050",2007-10-07,2007,"Rizespor","Gaziantepspor","2-1",2,1,"T1",1,3,1,"H"
"4051",2007-10-20,2007,"Buyuksehyr","Kasimpasa","2-0",2,0,"T1",1,2,2,"H"
"4052",2007-10-20,2007,"Fenerbahce","Konyaspor","4-1",4,1,"T1",1,5,3,"H"
"4053",2007-10-20,2007,"Gaziantepspor","Denizlispor","1-2",1,2,"T1",1,3,-1,"A"
"4054",2007-10-20,2007,"Genclerbirligi","Kayserispor","1-1",1,1,"T1",1,2,0,"D"
"4055",2007-10-20,2007,"Rizespor","Bursaspor","2-0",2,0,"T1",1,2,2,"H"
"4056",2007-10-20,2007,"Trabzonspor","Besiktas","2-3",2,3,"T1",1,5,-1,"A"
"4057",2007-10-21,2007,"Galatasaray","Ankaraspor","0-0",0,0,"T1",1,0,0,"D"
"4058",2007-10-22,2007,"Oftasspor","Ankaragucu","2-1",2,1,"T1",1,3,1,"H"
"4059",2007-10-22,2007,"Sivasspor","Manisaspor","1-0",1,0,"T1",1,1,1,"H"
"4060",2007-10-26,2007,"Kayserispor","Trabzonspor","1-0",1,0,"T1",1,1,1,"H"
"4061",2007-10-27,2007,"Ankaraspor","Genclerbirligi","2-0",2,0,"T1",1,2,2,"H"
"4062",2007-10-27,2007,"Bursaspor","Gaziantepspor","1-1",1,1,"T1",1,2,0,"D"
"4063",2007-10-27,2007,"Kasimpasa","Fenerbahce","1-2",1,2,"T1",1,3,-1,"A"
"4064",2007-10-27,2007,"Manisaspor","Oftasspor","0-2",0,2,"T1",1,2,-2,"A"
"4065",2007-10-28,2007,"Ankaragucu","Rizespor","1-0",1,0,"T1",1,1,1,"H"
"4066",2007-10-28,2007,"Besiktas","Buyuksehyr","0-0",0,0,"T1",1,0,0,"D"
"4067",2007-10-28,2007,"Denizlispor","Galatasaray","1-2",1,2,"T1",1,3,-1,"A"
"4068",2007-10-28,2007,"Konyaspor","Sivasspor","2-1",2,1,"T1",1,3,1,"H"
"4069",2007-11-02,2007,"Trabzonspor","Ankaraspor","2-1",2,1,"T1",1,3,1,"H"
"4070",2007-11-03,2007,"Fenerbahce","Besiktas","2-1",2,1,"T1",1,3,1,"H"
"4071",2007-11-03,2007,"Oftasspor","Konyaspor","0-1",0,1,"T1",1,1,-1,"A"
"4072",2007-11-04,2007,"Bursaspor","Ankaragucu","2-1",2,1,"T1",1,3,1,"H"
"4073",2007-11-04,2007,"Buyuksehyr","Kayserispor","1-1",1,1,"T1",1,2,0,"D"
"4074",2007-11-04,2007,"Gaziantepspor","Galatasaray","1-1",1,1,"T1",1,2,0,"D"
"4075",2007-11-04,2007,"Genclerbirligi","Denizlispor","1-2",1,2,"T1",1,3,-1,"A"
"4076",2007-11-04,2007,"Rizespor","Manisaspor","1-4",1,4,"T1",1,5,-3,"A"
"4077",2007-11-04,2007,"Sivasspor","Kasimpasa","4-0",4,0,"T1",1,4,4,"H"
"4078",2007-11-09,2007,"Denizlispor","Trabzonspor","2-0",2,0,"T1",1,2,2,"H"
"4079",2007-11-10,2007,"Ankaragucu","Gaziantepspor","1-0",1,0,"T1",1,1,1,"H"
"4080",2007-11-10,2007,"Ankaraspor","Buyuksehyr","1-1",1,1,"T1",1,2,0,"D"
"4081",2007-11-10,2007,"Besiktas","Sivasspor","1-2",1,2,"T1",1,3,-1,"A"
"4082",2007-11-10,2007,"Kasimpasa","Oftasspor","1-3",1,3,"T1",1,4,-2,"A"
"4083",2007-11-10,2007,"Konyaspor","Rizespor","2-1",2,1,"T1",1,3,1,"H"
"4084",2007-11-10,2007,"Manisaspor","Bursaspor","1-1",1,1,"T1",1,2,0,"D"
"4085",2007-11-11,2007,"Galatasaray","Genclerbirligi","3-2",3,2,"T1",1,5,1,"H"
"4086",2007-11-11,2007,"Kayserispor","Fenerbahce","2-1",2,1,"T1",1,3,1,"H"
"4087",2007-11-24,2007,"Buyuksehyr","Denizlispor","0-2",0,2,"T1",1,2,-2,"A"
"4088",2007-11-24,2007,"Fenerbahce","Ankaraspor","4-2",4,2,"T1",1,6,2,"H"
"4089",2007-11-24,2007,"Oftasspor","Besiktas","0-1",0,1,"T1",1,1,-1,"A"
"4090",2007-11-25,2007,"Ankaragucu","Manisaspor","1-0",1,0,"T1",1,1,1,"H"
"4091",2007-11-25,2007,"Bursaspor","Konyaspor","1-0",1,0,"T1",1,1,1,"H"
"4092",2007-11-25,2007,"Gaziantepspor","Genclerbirligi","2-2",2,2,"T1",1,4,0,"D"
"4093",2007-11-25,2007,"Rizespor","Kasimpasa","2-0",2,0,"T1",1,2,2,"H"
"4094",2007-11-25,2007,"Sivasspor","Kayserispor","1-0",1,0,"T1",1,1,1,"H"
"4095",2007-11-25,2007,"Trabzonspor","Galatasaray","0-1",0,1,"T1",1,1,-1,"A"
"4096",2007-11-30,2007,"Genclerbirligi","Trabzonspor","2-1",2,1,"T1",1,3,1,"H"
"4097",2007-12-01,2007,"Denizlispor","Fenerbahce","0-1",0,1,"T1",1,1,-1,"A"
"4098",2007-12-01,2007,"Kasimpasa","Bursaspor","0-2",0,2,"T1",1,2,-2,"A"
"4099",2007-12-01,2007,"Konyaspor","Ankaragucu","1-0",1,0,"T1",1,1,1,"H"
"4100",2007-12-02,2007,"Ankaraspor","Sivasspor","2-0",2,0,"T1",1,2,2,"H"
"4101",2007-12-02,2007,"Besiktas","Rizespor","1-1",1,1,"T1",1,2,0,"D"
"4102",2007-12-02,2007,"Galatasaray","Buyuksehyr","2-2",2,2,"T1",1,4,0,"D"
"4103",2007-12-02,2007,"Kayserispor","Oftasspor","1-1",1,1,"T1",1,2,0,"D"
"4104",2007-12-02,2007,"Manisaspor","Gaziantepspor","1-0",1,0,"T1",1,1,1,"H"
"4105",2007-12-07,2007,"Bursaspor","Besiktas","0-1",0,1,"T1",1,1,-1,"A"
"4106",2007-12-08,2007,"Ankaragucu","Kasimpasa","2-2",2,2,"T1",1,4,0,"D"
"4107",2007-12-08,2007,"Fenerbahce","Galatasaray","2-0",2,0,"T1",1,2,2,"H"
"4108",2007-12-08,2007,"Rizespor","Kayserispor","0-0",0,0,"T1",1,0,0,"D"
"4109",2007-12-09,2007,"Buyuksehyr","Genclerbirligi","0-0",0,0,"T1",1,0,0,"D"
"4110",2007-12-09,2007,"Konyaspor","Manisaspor","4-2",4,2,"T1",1,6,2,"H"
"4111",2007-12-09,2007,"Oftasspor","Ankaraspor","0-0",0,0,"T1",1,0,0,"D"
"4112",2007-12-09,2007,"Sivasspor","Denizlispor","2-0",2,0,"T1",1,2,2,"H"
"4113",2007-12-09,2007,"Trabzonspor","Gaziantepspor","3-2",3,2,"T1",1,5,1,"H"
"4114",2007-12-14,2007,"Galatasaray","Sivasspor","2-0",2,0,"T1",1,2,2,"H"
"4115",2007-12-15,2007,"Ankaraspor","Rizespor","1-2",1,2,"T1",1,3,-1,"A"
"4116",2007-12-15,2007,"Gaziantepspor","Konyaspor","2-1",2,1,"T1",1,3,1,"H"
"4117",2007-12-15,2007,"Trabzonspor","Buyuksehyr","2-1",2,1,"T1",1,3,1,"H"
"4118",2007-12-16,2007,"Besiktas","Ankaragucu","3-1",3,1,"T1",1,4,2,"H"
"4119",2007-12-16,2007,"Denizlispor","Oftasspor","2-1",2,1,"T1",1,3,1,"H"
"4120",2007-12-16,2007,"Genclerbirligi","Fenerbahce","1-2",1,2,"T1",1,3,-1,"A"
"4121",2007-12-16,2007,"Kasimpasa","Manisaspor","2-2",2,2,"T1",1,4,0,"D"
"4122",2007-12-16,2007,"Kayserispor","Bursaspor","4-1",4,1,"T1",1,5,3,"H"
"4123",2007-12-21,2007,"Manisaspor","Besiktas","1-2",1,2,"T1",1,3,-1,"A"
"4124",2007-12-22,2007,"Ankaragucu","Kayserispor","1-1",1,1,"T1",1,2,0,"D"
"4125",2007-12-22,2007,"Fenerbahce","Trabzonspor","3-2",3,2,"T1",1,5,1,"H"
"4126",2007-12-22,2007,"Konyaspor","Kasimpasa","2-1",2,1,"T1",1,3,1,"H"
"4127",2007-12-23,2007,"Bursaspor","Ankaraspor","0-0",0,0,"T1",1,0,0,"D"
"4128",2007-12-23,2007,"Buyuksehyr","Gaziantepspor","1-2",1,2,"T1",1,3,-1,"A"
"4129",2007-12-23,2007,"Oftasspor","Galatasaray","0-0",0,0,"T1",1,0,0,"D"
"4130",2007-12-23,2007,"Rizespor","Denizlispor","2-0",2,0,"T1",1,2,2,"H"
"4131",2007-12-23,2007,"Sivasspor","Genclerbirligi","2-0",2,0,"T1",1,2,2,"H"
"4132",2008-01-12,2007,"Kasimpasa","Gaziantepspor","0-1",0,1,"T1",1,1,-1,"A"
"4133",2008-01-12,2007,"Konyaspor","Besiktas","1-2",1,2,"T1",1,3,-1,"A"
"4134",2008-01-12,2007,"Oftasspor","Genclerbirligi","1-1",1,1,"T1",1,2,0,"D"
"4135",2008-01-12,2007,"Rizespor","Galatasaray","2-5",2,5,"T1",1,7,-3,"A"
"4136",2008-01-13,2007,"Ankaragucu","Ankaraspor","1-1",1,1,"T1",1,2,0,"D"
"4137",2008-01-13,2007,"Bursaspor","Denizlispor","1-1",1,1,"T1",1,2,0,"D"
"4138",2008-01-13,2007,"Fenerbahce","Buyuksehyr","2-2",2,2,"T1",1,4,0,"D"
"4139",2008-01-13,2007,"Manisaspor","Kayserispor","0-1",0,1,"T1",1,1,-1,"A"
"4140",2008-01-13,2007,"Sivasspor","Trabzonspor","2-0",2,0,"T1",1,2,2,"H"
"4141",2008-01-19,2007,"Besiktas","Kasimpasa","4-2",4,2,"T1",1,6,2,"H"
"4142",2008-01-19,2007,"Buyuksehyr","Sivasspor","0-2",0,2,"T1",1,2,-2,"A"
"4143",2008-01-19,2007,"Trabzonspor","Oftasspor","1-2",1,2,"T1",1,3,-1,"A"
"4144",2008-01-20,2007,"Ankaraspor","Manisaspor","1-0",1,0,"T1",1,1,1,"H"
"4145",2008-01-20,2007,"Denizlispor","Ankaragucu","1-1",1,1,"T1",1,2,0,"D"
"4146",2008-01-20,2007,"Galatasaray","Bursaspor","1-0",1,0,"T1",1,1,1,"H"
"4147",2008-01-20,2007,"Gaziantepspor","Fenerbahce","0-5",0,5,"T1",1,5,-5,"A"
"4148",2008-01-20,2007,"Genclerbirligi","Rizespor","4-1",4,1,"T1",1,5,3,"H"
"4149",2008-01-20,2007,"Kayserispor","Konyaspor","3-0",3,0,"T1",1,3,3,"H"
"4150",2008-01-26,2007,"Besiktas","Gaziantepspor","3-1",3,1,"T1",1,4,2,"H"
"4151",2008-01-26,2007,"Oftasspor","Buyuksehyr","3-2",3,2,"T1",1,5,1,"H"
"4152",2008-01-27,2007,"Ankaragucu","Galatasaray","0-4",0,4,"T1",1,4,-4,"A"
"4153",2008-01-27,2007,"Kasimpasa","Kayserispor","0-2",0,2,"T1",1,2,-2,"A"
"4154",2008-01-27,2007,"Konyaspor","Ankaraspor","1-3",1,3,"T1",1,4,-2,"A"
"4155",2008-01-27,2007,"Manisaspor","Denizlispor","3-2",3,2,"T1",1,5,1,"H"
"4156",2008-01-27,2007,"Sivasspor","Fenerbahce","1-4",1,4,"T1",1,5,-3,"A"
"4157",2008-01-28,2007,"Bursaspor","Genclerbirligi","2-1",2,1,"T1",1,3,1,"H"
"4158",2008-01-28,2007,"Rizespor","Trabzonspor","0-4",0,4,"T1",1,4,-4,"A"
"4159",2008-02-09,2007,"Ankaraspor","Kasimpasa","2-0",2,0,"T1",1,2,2,"H"
"4160",2008-02-09,2007,"Buyuksehyr","Rizespor","2-1",2,1,"T1",1,3,1,"H"
"4161",2008-02-09,2007,"Galatasaray","Manisaspor","6-3",6,3,"T1",1,9,3,"H"
"4162",2008-02-09,2007,"Kayserispor","Besiktas","2-0",2,0,"T1",1,2,2,"H"
"4163",2008-02-10,2007,"Denizlispor","Konyaspor","2-1",2,1,"T1",1,3,1,"H"
"4164",2008-02-10,2007,"Fenerbahce","Oftasspor","3-1",3,1,"T1",1,4,2,"H"
"4165",2008-02-10,2007,"Gaziantepspor","Sivasspor","0-0",0,0,"T1",1,0,0,"D"
"4166",2008-02-10,2007,"Genclerbirligi","Ankaragucu","1-0",1,0,"T1",1,1,1,"H"
"4167",2008-02-10,2007,"Trabzonspor","Bursaspor","2-1",2,1,"T1",1,3,1,"H"
"4168",2008-02-15,2007,"Rizespor","Fenerbahce","2-4",2,4,"T1",1,6,-2,"A"
"4169",2008-02-16,2007,"Besiktas","Ankaraspor","3-2",3,2,"T1",1,5,1,"H"
"4170",2008-02-16,2007,"Bursaspor","Buyuksehyr","2-2",2,2,"T1",1,4,0,"D"
"4171",2008-02-16,2007,"Oftasspor","Sivasspor","0-1",0,1,"T1",1,1,-1,"A"
"4172",2008-02-17,2007,"Ankaragucu","Trabzonspor","0-2",0,2,"T1",1,2,-2,"A"
"4173",2008-02-17,2007,"Kasimpasa","Denizlispor","1-0",1,0,"T1",1,1,1,"H"
"4174",2008-02-17,2007,"Kayserispor","Gaziantepspor","3-1",3,1,"T1",1,4,2,"H"
"4175",2008-02-17,2007,"Manisaspor","Genclerbirligi","1-2",1,2,"T1",1,3,-1,"A"
"4176",2008-02-17,2007,"Konyaspor","Galatasaray","0-1",0,1,"T1",1,1,-1,"A"
"4177",2008-02-22,2007,"Denizlispor","Besiktas","1-2",1,2,"T1",1,3,-1,"A"
"4178",2008-02-23,2007,"Fenerbahce","Bursaspor","0-2",0,2,"T1",1,2,-2,"A"
"4179",2008-02-23,2007,"Gaziantepspor","Oftasspor","1-1",1,1,"T1",1,2,0,"D"
"4180",2008-02-23,2007,"Genclerbirligi","Konyaspor","6-1",6,1,"T1",1,7,5,"H"
"4181",2008-02-24,2007,"Ankaraspor","Kayserispor","0-3",0,3,"T1",1,3,-3,"A"
"4182",2008-02-24,2007,"Buyuksehyr","Ankaragucu","1-2",1,2,"T1",1,3,-1,"A"
"4183",2008-02-24,2007,"Galatasaray","Kasimpasa","0-1",0,1,"T1",1,1,-1,"A"
"4184",2008-02-24,2007,"Sivasspor","Rizespor","0-0",0,0,"T1",1,0,0,"D"
"4185",2008-02-24,2007,"Trabzonspor","Manisaspor","2-2",2,2,"T1",1,4,0,"D"
"4186",2008-02-29,2007,"Konyaspor","Trabzonspor","1-0",1,0,"T1",1,1,1,"H"
"4187",2008-03-01,2007,"Ankaragucu","Fenerbahce","0-0",0,0,"T1",1,0,0,"D"
"4188",2008-03-01,2007,"Kasimpasa","Genclerbirligi","0-0",0,0,"T1",1,0,0,"D"
"4189",2008-03-01,2007,"Manisaspor","Buyuksehyr","1-1",1,1,"T1",1,2,0,"D"
"4190",2008-03-02,2007,"Ankaraspor","Gaziantepspor","1-1",1,1,"T1",1,2,0,"D"
"4191",2008-03-02,2007,"Besiktas","Galatasaray","1-0",1,0,"T1",1,1,1,"H"
"4192",2008-03-02,2007,"Bursaspor","Sivasspor","0-1",0,1,"T1",1,1,-1,"A"
"4193",2008-03-02,2007,"Kayserispor","Denizlispor","1-1",1,1,"T1",1,2,0,"D"
"4194",2008-03-02,2007,"Rizespor","Oftasspor","0-0",0,0,"T1",1,0,0,"D"
"4195",2008-03-07,2007,"Genclerbirligi","Besiktas","1-2",1,2,"T1",1,3,-1,"A"
"4196",2008-03-08,2007,"Buyuksehyr","Konyaspor","5-0",5,0,"T1",1,5,5,"H"
"4197",2008-03-08,2007,"Denizlispor","Ankaraspor","1-0",1,0,"T1",1,1,1,"H"
"4198",2008-03-08,2007,"Galatasaray","Kayserispor","2-0",2,0,"T1",1,2,2,"H"
"4199",2008-03-09,2007,"Fenerbahce","Manisaspor","4-1",4,1,"T1",1,5,3,"H"
"4200",2008-03-09,2007,"Gaziantepspor","Rizespor","1-1",1,1,"T1",1,2,0,"D"
"4201",2008-03-09,2007,"Oftasspor","Bursaspor","2-2",2,2,"T1",1,4,0,"D"
"4202",2008-03-09,2007,"Sivasspor","Ankaragucu","3-2",3,2,"T1",1,5,1,"H"
"4203",2008-03-09,2007,"Trabzonspor","Kasimpasa","2-1",2,1,"T1",1,3,1,"H"
"4204",2008-03-14,2007,"Manisaspor","Sivasspor","1-1",1,1,"T1",1,2,0,"D"
"4205",2008-03-15,2007,"Ankaraspor","Galatasaray","0-1",0,1,"T1",1,1,-1,"A"
"4206",2008-03-15,2007,"Bursaspor","Rizespor","2-1",2,1,"T1",1,3,1,"H"
"4207",2008-03-15,2007,"Kayserispor","Genclerbirligi","3-0",3,0,"T1",1,3,3,"H"
"4208",2008-03-16,2007,"Ankaragucu","Oftasspor","2-0",2,0,"T1",1,2,2,"H"
"4209",2008-03-16,2007,"Besiktas","Trabzonspor","3-0",3,0,"T1",1,3,3,"H"
"4210",2008-03-16,2007,"Denizlispor","Gaziantepspor","2-1",2,1,"T1",1,3,1,"H"
"4211",2008-03-16,2007,"Kasimpasa","Buyuksehyr","1-0",1,0,"T1",1,1,1,"H"
"4212",2008-03-16,2007,"Konyaspor","Fenerbahce","1-4",1,4,"T1",1,5,-3,"A"
"4213",2008-03-21,2007,"Fenerbahce","Kasimpasa","3-0",3,0,"T1",1,3,3,"H"
"4214",2008-03-22,2007,"Buyuksehyr","Besiktas","2-1",2,1,"T1",1,3,1,"H"
"4215",2008-03-22,2007,"Gaziantepspor","Bursaspor","1-0",1,0,"T1",1,1,1,"H"
"4216",2008-03-22,2007,"Oftasspor","Manisaspor","1-0",1,0,"T1",1,1,1,"H"
"4217",2008-03-23,2007,"Galatasaray","Denizlispor","2-1",2,1,"T1",1,3,1,"H"
"4218",2008-03-23,2007,"Genclerbirligi","Ankaraspor","1-3",1,3,"T1",1,4,-2,"A"
"4219",2008-03-23,2007,"Rizespor","Ankaragucu","0-0",0,0,"T1",1,0,0,"D"
"4220",2008-03-23,2007,"Sivasspor","Konyaspor","3-0",3,0,"T1",1,3,3,"H"
"4221",2008-03-23,2007,"Trabzonspor","Kayserispor","2-1",2,1,"T1",1,3,1,"H"
"4222",2008-03-29,2007,"Ankaraspor","Trabzonspor","1-0",1,0,"T1",1,1,1,"H"
"4223",2008-03-29,2007,"Besiktas","Fenerbahce","1-2",1,2,"T1",1,3,-1,"A"
"4224",2008-03-29,2007,"Denizlispor","Genclerbirligi","3-2",3,2,"T1",1,5,1,"H"
"4225",2008-03-30,2007,"Ankaragucu","Bursaspor","2-0",2,0,"T1",1,2,2,"H"
"4226",2008-03-30,2007,"Galatasaray","Gaziantepspor","0-0",0,0,"T1",1,0,0,"D"
"4227",2008-03-30,2007,"Kasimpasa","Sivasspor","0-4",0,4,"T1",1,4,-4,"A"
"4228",2008-03-30,2007,"Kayserispor","Buyuksehyr","1-2",1,2,"T1",1,3,-1,"A"
"4229",2008-03-30,2007,"Konyaspor","Oftasspor","0-1",0,1,"T1",1,1,-1,"A"
"4230",2008-03-30,2007,"Manisaspor","Rizespor","2-1",2,1,"T1",1,3,1,"H"
"4231",2008-04-04,2007,"Trabzonspor","Denizlispor","2-0",2,0,"T1",1,2,2,"H"
"4232",2008-04-05,2007,"Fenerbahce","Kayserispor","2-1",2,1,"T1",1,3,1,"H"
"4233",2008-04-05,2007,"Oftasspor","Kasimpasa","0-1",0,1,"T1",1,1,-1,"A"
"4234",2008-04-06,2007,"Bursaspor","Manisaspor","1-0",1,0,"T1",1,1,1,"H"
"4235",2008-04-06,2007,"Buyuksehyr","Ankaraspor","0-1",0,1,"T1",1,1,-1,"A"
"4236",2008-04-06,2007,"Gaziantepspor","Ankaragucu","2-1",2,1,"T1",1,3,1,"H"
"4237",2008-04-06,2007,"Genclerbirligi","Galatasaray","0-1",0,1,"T1",1,1,-1,"A"
"4238",2008-04-06,2007,"Rizespor","Konyaspor","2-2",2,2,"T1",1,4,0,"D"
"4239",2008-04-06,2007,"Sivasspor","Besiktas","1-2",1,2,"T1",1,3,-1,"A"
"4240",2008-04-11,2007,"Besiktas","Oftasspor","0-1",0,1,"T1",1,1,-1,"A"
"4241",2008-04-12,2007,"Denizlispor","Buyuksehyr","2-3",2,3,"T1",1,5,-1,"A"
"4242",2008-04-12,2007,"Galatasaray","Trabzonspor","1-0",1,0,"T1",1,1,1,"H"
"4243",2008-04-12,2007,"Genclerbirligi","Gaziantepspor","2-0",2,0,"T1",1,2,2,"H"
"4244",2008-04-13,2007,"Ankaraspor","Fenerbahce","2-2",2,2,"T1",1,4,0,"D"
"4245",2008-04-13,2007,"Kasimpasa","Rizespor","0-1",0,1,"T1",1,1,-1,"A"
"4246",2008-04-13,2007,"Kayserispor","Sivasspor","0-1",0,1,"T1",1,1,-1,"A"
"4247",2008-04-13,2007,"Konyaspor","Bursaspor","2-0",2,0,"T1",1,2,2,"H"
"4248",2008-04-13,2007,"Manisaspor","Ankaragucu","1-2",1,2,"T1",1,3,-1,"A"
"4249",2008-04-19,2007,"Ankaragucu","Konyaspor","0-3",0,3,"T1",1,3,-3,"A"
"4250",2008-04-19,2007,"Bursaspor","Kasimpasa","1-0",1,0,"T1",1,1,1,"H"
"4251",2008-04-19,2007,"Fenerbahce","Denizlispor","4-1",4,1,"T1",1,5,3,"H"
"4252",2008-04-19,2007,"Gaziantepspor","Manisaspor","1-0",1,0,"T1",1,1,1,"H"
"4253",2008-04-19,2007,"Sivasspor","Ankaraspor","2-1",2,1,"T1",1,3,1,"H"
"4254",2008-04-19,2007,"Trabzonspor","Genclerbirligi","0-0",0,0,"T1",1,0,0,"D"
"4255",2008-04-20,2007,"Buyuksehyr","Galatasaray","0-3",0,3,"T1",1,3,-3,"A"
"4256",2008-04-20,2007,"Oftasspor","Kayserispor","1-1",1,1,"T1",1,2,0,"D"
"4257",2008-04-20,2007,"Rizespor","Besiktas","1-2",1,2,"T1",1,3,-1,"A"
"4258",2008-04-26,2007,"Ankaraspor","Oftasspor","1-0",1,0,"T1",1,1,1,"H"
"4259",2008-04-26,2007,"Besiktas","Bursaspor","3-0",3,0,"T1",1,3,3,"H"
"4260",2008-04-26,2007,"Denizlispor","Sivasspor","1-2",1,2,"T1",1,3,-1,"A"
"4261",2008-04-26,2007,"Gaziantepspor","Trabzonspor","1-1",1,1,"T1",1,2,0,"D"
"4262",2008-04-26,2007,"Genclerbirligi","Buyuksehyr","2-1",2,1,"T1",1,3,1,"H"
"4263",2008-04-26,2007,"Kasimpasa","Ankaragucu","2-2",2,2,"T1",1,4,0,"D"
"4264",2008-04-26,2007,"Kayserispor","Rizespor","3-0",3,0,"T1",1,3,3,"H"
"4265",2008-04-26,2007,"Manisaspor","Konyaspor","2-0",2,0,"T1",1,2,2,"H"
"4266",2008-04-27,2007,"Galatasaray","Fenerbahce","1-0",1,0,"T1",1,1,1,"H"
"4267",2008-05-03,2007,"Buyuksehyr","Trabzonspor","1-2",1,2,"T1",1,3,-1,"A"
"4268",2008-05-03,2007,"Oftasspor","Denizlispor","0-2",0,2,"T1",1,2,-2,"A"
"4269",2008-05-03,2007,"Rizespor","Ankaraspor","0-1",0,1,"T1",1,1,-1,"A"
"4270",2008-05-04,2007,"Ankaragucu","Besiktas","0-2",0,2,"T1",1,2,-2,"A"
"4271",2008-05-04,2007,"Bursaspor","Kayserispor","0-1",0,1,"T1",1,1,-1,"A"
"4272",2008-05-04,2007,"Fenerbahce","Genclerbirligi","3-2",3,2,"T1",1,5,1,"H"
"4273",2008-05-04,2007,"Konyaspor","Gaziantepspor","1-1",1,1,"T1",1,2,0,"D"
"4274",2008-05-04,2007,"Manisaspor","Kasimpasa","1-2",1,2,"T1",1,3,-1,"A"
"4275",2008-05-04,2007,"Sivasspor","Galatasaray","3-5",3,5,"T1",1,8,-2,"A"
"4276",2008-05-10,2007,"Ankaraspor","Bursaspor","1-1",1,1,"T1",1,2,0,"D"
"4277",2008-05-10,2007,"Besiktas","Manisaspor","5-1",5,1,"T1",1,6,4,"H"
"4278",2008-05-10,2007,"Denizlispor","Rizespor","5-1",5,1,"T1",1,6,4,"H"
"4279",2008-05-10,2007,"Galatasaray","Oftasspor","2-0",2,0,"T1",1,2,2,"H"
"4280",2008-05-10,2007,"Gaziantepspor","Buyuksehyr","1-0",1,0,"T1",1,1,1,"H"
"4281",2008-05-10,2007,"Genclerbirligi","Sivasspor","0-2",0,2,"T1",1,2,-2,"A"
"4282",2008-05-10,2007,"Kasimpasa","Konyaspor","2-1",2,1,"T1",1,3,1,"H"
"4283",2008-05-10,2007,"Kayserispor","Ankaragucu","0-2",0,2,"T1",1,2,-2,"A"
"4284",2008-05-10,2007,"Trabzonspor","Fenerbahce","2-0",2,0,"T1",1,2,2,"H"
"4285",2008-08-23,2008,"Buyuksehyr","Eskisehirspor","0-0",0,0,"T1",1,0,0,"D"
"4286",2008-08-23,2008,"Galatasaray","Denizlispor","4-1",4,1,"T1",1,5,3,"H"
"4287",2008-08-23,2008,"Gaziantepspor","Fenerbahce","1-0",1,0,"T1",1,1,1,"H"
"4288",2008-08-23,2008,"Hacettepespor","Bursaspor","1-2",1,2,"T1",1,3,-1,"A"
"4289",2008-08-23,2008,"Sivasspor","Kayserispor","0-0",0,0,"T1",1,0,0,"D"
"4290",2008-08-24,2008,"Antalyaspor","Besiktas","2-3",2,3,"T1",1,5,-1,"A"
"4291",2008-08-24,2008,"Genclerbirligi","Kocaelispor","1-1",1,1,"T1",1,2,0,"D"
"4292",2008-08-24,2008,"Konyaspor","Ankaragucu","3-2",3,2,"T1",1,5,1,"H"
"4293",2008-08-24,2008,"Trabzonspor","Ankaraspor","2-0",2,0,"T1",1,2,2,"H"
"4294",2008-08-29,2008,"Ankaragucu","Trabzonspor","1-2",1,2,"T1",1,3,-1,"A"
"4295",2008-08-30,2008,"Ankaraspor","Gaziantepspor","0-2",0,2,"T1",1,2,-2,"A"
"4296",2008-08-30,2008,"Fenerbahce","Buyuksehyr","2-0",2,0,"T1",1,2,2,"H"
"4297",2008-08-30,2008,"Kocaelispor","Sivasspor","0-2",0,2,"T1",1,2,-2,"A"
"4298",2008-08-31,2008,"Bursaspor","Genclerbirligi","2-0",2,0,"T1",1,2,2,"H"
"4299",2008-08-31,2008,"Denizlispor","Antalyaspor","3-2",3,2,"T1",1,5,1,"H"
"4300",2008-08-31,2008,"Eskisehirspor","Hacettepespor","0-0",0,0,"T1",1,0,0,"D"
"4301",2008-08-31,2008,"Kayserispor","Galatasaray","0-0",0,0,"T1",1,0,0,"D"
"4302",2008-09-01,2008,"Besiktas","Konyaspor","2-0",2,0,"T1",1,2,2,"H"
"4303",2008-09-13,2008,"Galatasaray","Antalyaspor","1-1",1,1,"T1",1,2,0,"D"
"4304",2008-09-13,2008,"Hacettepespor","Fenerbahce","2-1",2,1,"T1",1,3,1,"H"
"4305",2008-09-13,2008,"Kayserispor","Kocaelispor","1-0",1,0,"T1",1,1,1,"H"
"4306",2008-09-13,2008,"Konyaspor","Denizlispor","1-1",1,1,"T1",1,2,0,"D"
"4307",2008-09-14,2008,"Buyuksehyr","Ankaraspor","1-2",1,2,"T1",1,3,-1,"A"
"4308",2008-09-14,2008,"Gaziantepspor","Ankaragucu","2-2",2,2,"T1",1,4,0,"D"
"4309",2008-09-14,2008,"Genclerbirligi","Eskisehirspor","3-1",3,1,"T1",1,4,2,"H"
"4310",2008-09-14,2008,"Sivasspor","Bursaspor","3-1",3,1,"T1",1,4,2,"H"
"4311",2008-09-14,2008,"Trabzonspor","Besiktas","0-0",0,0,"T1",1,0,0,"D"
"4312",2008-09-19,2008,"Denizlispor","Trabzonspor","0-1",0,1,"T1",1,1,-1,"A"
"4313",2008-09-20,2008,"Ankaragucu","Buyuksehyr","0-0",0,0,"T1",1,0,0,"D"
"4314",2008-09-20,2008,"Eskisehirspor","Sivasspor","2-2",2,2,"T1",1,4,0,"D"
"4315",2008-09-20,2008,"Fenerbahce","Genclerbirligi","3-0",3,0,"T1",1,3,3,"H"
"4316",2008-09-21,2008,"Ankaraspor","Hacettepespor","4-0",4,0,"T1",1,4,4,"H"
"4317",2008-09-21,2008,"Antalyaspor","Konyaspor","0-1",0,1,"T1",1,1,-1,"A"
"4318",2008-09-21,2008,"Besiktas","Gaziantepspor","3-0",3,0,"T1",1,3,3,"H"
"4319",2008-09-21,2008,"Bursaspor","Kayserispor","1-0",1,0,"T1",1,1,1,"H"
"4320",2008-09-21,2008,"Kocaelispor","Galatasaray","1-4",1,4,"T1",1,5,-3,"A"
"4321",2008-09-26,2008,"Sivasspor","Fenerbahce","2-1",2,1,"T1",1,3,1,"H"
"4322",2008-09-27,2008,"Buyuksehyr","Besiktas","1-1",1,1,"T1",1,2,0,"D"
"4323",2008-09-27,2008,"Genclerbirligi","Ankaraspor","1-1",1,1,"T1",1,2,0,"D"
"4324",2008-09-27,2008,"Kocaelispor","Bursaspor","2-3",2,3,"T1",1,5,-1,"A"
"4325",2008-09-27,2008,"Trabzonspor","Antalyaspor","3-2",3,2,"T1",1,5,1,"H"
"4326",2008-09-28,2008,"Galatasaray","Konyaspor","4-1",4,1,"T1",1,5,3,"H"
"4327",2008-09-28,2008,"Gaziantepspor","Denizlispor","2-1",2,1,"T1",1,3,1,"H"
"4328",2008-09-28,2008,"Hacettepespor","Ankaragucu","0-1",0,1,"T1",1,1,-1,"A"
"4329",2008-09-28,2008,"Kayserispor","Eskisehirspor","1-0",1,0,"T1",1,1,1,"H"
"4330",2008-10-04,2008,"Ankaraspor","Sivasspor","2-0",2,0,"T1",1,2,2,"H"
"4331",2008-10-04,2008,"Antalyaspor","Gaziantepspor","1-4",1,4,"T1",1,5,-3,"A"
"4332",2008-10-04,2008,"Konyaspor","Trabzonspor","2-3",2,3,"T1",1,5,-1,"A"
"4333",2008-10-05,2008,"Ankaragucu","Genclerbirligi","0-2",0,2,"T1",1,2,-2,"A"
"4334",2008-10-05,2008,"Bursaspor","Galatasaray","2-1",2,1,"T1",1,3,1,"H"
"4335",2008-10-05,2008,"Denizlispor","Buyuksehyr","2-1",2,1,"T1",1,3,1,"H"
"4336",2008-10-05,2008,"Eskisehirspor","Kocaelispor","2-1",2,1,"T1",1,3,1,"H"
"4337",2008-10-05,2008,"Fenerbahce","Kayserispor","1-4",1,4,"T1",1,5,-3,"A"
"4338",2008-10-06,2008,"Besiktas","Hacettepespor","2-1",2,1,"T1",1,3,1,"H"
"4339",2008-10-18,2008,"Bursaspor","Eskisehirspor","1-2",1,2,"T1",1,3,-1,"A"
"4340",2008-10-18,2008,"Buyuksehyr","Antalyaspor","2-1",2,1,"T1",1,3,1,"H"
"4341",2008-10-18,2008,"Hacettepespor","Denizlispor","1-0",1,0,"T1",1,1,1,"H"
"4342",2008-10-18,2008,"Kocaelispor","Fenerbahce","2-3",2,3,"T1",1,5,-1,"A"
"4343",2008-10-19,2008,"Galatasaray","Trabzonspor","3-0",3,0,"T1",1,3,3,"H"
"4344",2008-10-19,2008,"Gaziantepspor","Konyaspor","0-1",0,1,"T1",1,1,-1,"A"
"4345",2008-10-19,2008,"Genclerbirligi","Besiktas","1-3",1,3,"T1",1,4,-2,"A"
"4346",2008-10-19,2008,"Kayserispor","Ankaraspor","1-2",1,2,"T1",1,3,-1,"A"
"4347",2008-10-19,2008,"Sivasspor","Ankaragucu","3-0",3,0,"T1",1,3,3,"H"
"4348",2008-10-24,2008,"Besiktas","Sivasspor","1-1",1,1,"T1",1,2,0,"D"
"4349",2008-10-25,2008,"Ankaraspor","Kocaelispor","4-0",4,0,"T1",1,4,4,"H"
"4350",2008-10-25,2008,"Denizlispor","Genclerbirligi","2-2",2,2,"T1",1,4,0,"D"
"4351",2008-10-25,2008,"Fenerbahce","Bursaspor","5-2",5,2,"T1",1,7,3,"H"
"4352",2008-10-26,2008,"Ankaragucu","Kayserispor","1-3",1,3,"T1",1,4,-2,"A"
"4353",2008-10-26,2008,"Antalyaspor","Hacettepespor","1-1",1,1,"T1",1,2,0,"D"
"4354",2008-10-26,2008,"Eskisehirspor","Galatasaray","4-2",4,2,"T1",1,6,2,"H"
"4355",2008-10-26,2008,"Konyaspor","Buyuksehyr","1-2",1,2,"T1",1,3,-1,"A"
"4356",2008-10-26,2008,"Trabzonspor","Gaziantepspor","1-1",1,1,"T1",1,2,0,"D"
"4357",2008-11-01,2008,"Buyuksehyr","Trabzonspor","0-4",0,4,"T1",1,4,-4,"A"
"4358",2008-11-01,2008,"Eskisehirspor","Fenerbahce","2-2",2,2,"T1",1,4,0,"D"
"4359",2008-11-01,2008,"Hacettepespor","Konyaspor","1-2",1,2,"T1",1,3,-1,"A"
"4360",2008-11-02,2008,"Bursaspor","Ankaraspor","0-1",0,1,"T1",1,1,-1,"A"
"4361",2008-11-02,2008,"Galatasaray","Gaziantepspor","3-1",3,1,"T1",1,4,2,"H"
"4362",2008-11-02,2008,"Genclerbirligi","Antalyaspor","1-2",1,2,"T1",1,3,-1,"A"
"4363",2008-11-02,2008,"Kayserispor","Besiktas","1-0",1,0,"T1",1,1,1,"H"
"4364",2008-11-02,2008,"Kocaelispor","Ankaragucu","1-1",1,1,"T1",1,2,0,"D"
"4365",2008-11-02,2008,"Sivasspor","Denizlispor","3-1",3,1,"T1",1,4,2,"H"
"4366",2008-11-07,2008,"Besiktas","Kocaelispor","5-2",5,2,"T1",1,7,3,"H"
"4367",2008-11-08,2008,"Ankaragucu","Bursaspor","1-1",1,1,"T1",1,2,0,"D"
"4368",2008-11-08,2008,"Trabzonspor","Hacettepespor","1-0",1,0,"T1",1,1,1,"H"
"4369",2008-11-09,2008,"Ankaraspor","Eskisehirspor","2-0",2,0,"T1",1,2,2,"H"
"4370",2008-11-09,2008,"Antalyaspor","Sivasspor","2-1",2,1,"T1",1,3,1,"H"
"4371",2008-11-09,2008,"Denizlispor","Kayserispor","1-0",1,0,"T1",1,1,1,"H"
"4372",2008-11-09,2008,"Fenerbahce","Galatasaray","4-1",4,1,"T1",1,5,3,"H"
"4373",2008-11-09,2008,"Gaziantepspor","Buyuksehyr","1-4",1,4,"T1",1,5,-3,"A"
"4374",2008-11-09,2008,"Konyaspor","Genclerbirligi","2-2",2,2,"T1",1,4,0,"D"
"4375",2008-11-14,2008,"Genclerbirligi","Trabzonspor","0-1",0,1,"T1",1,1,-1,"A"
"4376",2008-11-15,2008,"Fenerbahce","Ankaraspor","2-0",2,0,"T1",1,2,2,"H"
"4377",2008-11-15,2008,"Kocaelispor","Denizlispor","3-2",3,2,"T1",1,5,1,"H"
"4378",2008-11-16,2008,"Bursaspor","Besiktas","0-0",0,0,"T1",1,0,0,"D"
"4379",2008-11-16,2008,"Eskisehirspor","Ankaragucu","1-3",1,3,"T1",1,4,-2,"A"
"4380",2008-11-16,2008,"Galatasaray","Buyuksehyr","2-0",2,0,"T1",1,2,2,"H"
"4381",2008-11-16,2008,"Hacettepespor","Gaziantepspor","0-0",0,0,"T1",1,0,0,"D"
"4382",2008-11-16,2008,"Kayserispor","Antalyaspor","0-0",0,0,"T1",1,0,0,"D"
"4383",2008-11-16,2008,"Sivasspor","Konyaspor","1-0",1,0,"T1",1,1,1,"H"
"4384",2008-11-22,2008,"Ankaragucu","Fenerbahce","0-0",0,0,"T1",1,0,0,"D"
"4385",2008-11-22,2008,"Ankaraspor","Galatasaray","0-0",0,0,"T1",1,0,0,"D"
"4386",2008-11-22,2008,"Antalyaspor","Kocaelispor","0-0",0,0,"T1",1,0,0,"D"
"4387",2008-11-22,2008,"Gaziantepspor","Genclerbirligi","2-0",2,0,"T1",1,2,2,"H"
"4388",2008-11-23,2008,"Besiktas","Eskisehirspor","2-0",2,0,"T1",1,2,2,"H"
"4389",2008-11-23,2008,"Buyuksehyr","Hacettepespor","1-0",1,0,"T1",1,1,1,"H"
"4390",2008-11-23,2008,"Denizlispor","Bursaspor","4-3",4,3,"T1",1,7,1,"H"
"4391",2008-11-23,2008,"Konyaspor","Kayserispor","0-0",0,0,"T1",1,0,0,"D"
"4392",2008-11-23,2008,"Trabzonspor","Sivasspor","0-0",0,0,"T1",1,0,0,"D"
"4393",2008-11-28,2008,"Kayserispor","Trabzonspor","1-1",1,1,"T1",1,2,0,"D"
"4394",2008-11-29,2008,"Ankaraspor","Ankaragucu","0-1",0,1,"T1",1,1,-1,"A"
"4395",2008-11-29,2008,"Eskisehirspor","Denizlispor","4-3",4,3,"T1",1,7,1,"H"
"4396",2008-11-29,2008,"Fenerbahce","Besiktas","2-1",2,1,"T1",1,3,1,"H"
"4397",2008-11-29,2008,"Sivasspor","Gaziantepspor","3-0",3,0,"T1",1,3,3,"H"
"4398",2008-11-30,2008,"Bursaspor","Antalyaspor","1-1",1,1,"T1",1,2,0,"D"
"4399",2008-11-30,2008,"Galatasaray","Hacettepespor","3-1",3,1,"T1",1,4,2,"H"
"4400",2008-11-30,2008,"Genclerbirligi","Buyuksehyr","0-0",0,0,"T1",1,0,0,"D"
"4401",2008-11-30,2008,"Kocaelispor","Konyaspor","3-0",3,0,"T1",1,3,3,"H"
"4402",2008-12-05,2008,"Denizlispor","Fenerbahce","0-1",0,1,"T1",1,1,-1,"A"
"4403",2008-12-06,2008,"Antalyaspor","Eskisehirspor","0-0",0,0,"T1",1,0,0,"D"
"4404",2008-12-06,2008,"Besiktas","Ankaraspor","1-3",1,3,"T1",1,4,-2,"A"
"4405",2008-12-06,2008,"Gaziantepspor","Kayserispor","0-0",0,0,"T1",1,0,0,"D"
"4406",2008-12-06,2008,"Hacettepespor","Genclerbirligi","0-3",0,3,"T1",1,3,-3,"A"
"4407",2008-12-07,2008,"Ankaragucu","Galatasaray","0-3",0,3,"T1",1,3,-3,"A"
"4408",2008-12-07,2008,"Buyuksehyr","Sivasspor","0-3",0,3,"T1",1,3,-3,"A"
"4409",2008-12-07,2008,"Konyaspor","Bursaspor","0-0",0,0,"T1",1,0,0,"D"
"4410",2008-12-07,2008,"Trabzonspor","Kocaelispor","2-1",2,1,"T1",1,3,1,"H"
"4411",2008-12-12,2008,"Genclerbirligi","Galatasaray","1-3",1,3,"T1",1,4,-2,"A"
"4412",2008-12-13,2008,"Besiktas","Ankaragucu","1-0",1,0,"T1",1,1,1,"H"
"4413",2008-12-13,2008,"Bursaspor","Trabzonspor","2-1",2,1,"T1",1,3,1,"H"
"4414",2008-12-13,2008,"Kayserispor","Buyuksehyr","2-0",2,0,"T1",1,2,2,"H"
"4415",2008-12-13,2008,"Sivasspor","Hacettepespor","2-1",2,1,"T1",1,3,1,"H"
"4416",2008-12-14,2008,"Ankaraspor","Denizlispor","2-0",2,0,"T1",1,2,2,"H"
"4417",2008-12-14,2008,"Eskisehirspor","Konyaspor","0-0",0,0,"T1",1,0,0,"D"
"4418",2008-12-14,2008,"Fenerbahce","Antalyaspor","2-0",2,0,"T1",1,2,2,"H"
"4419",2008-12-14,2008,"Kocaelispor","Gaziantepspor","2-5",2,5,"T1",1,7,-3,"A"
"4420",2008-12-19,2008,"Konyaspor","Fenerbahce","1-2",1,2,"T1",1,3,-1,"A"
"4421",2008-12-20,2008,"Buyuksehyr","Kocaelispor","5-0",5,0,"T1",1,5,5,"H"
"4422",2008-12-20,2008,"Hacettepespor","Kayserispor","0-3",0,3,"T1",1,3,-3,"A"
"4423",2008-12-20,2008,"Trabzonspor","Eskisehirspor","2-1",2,1,"T1",1,3,1,"H"
"4424",2008-12-21,2008,"Antalyaspor","Ankaraspor","1-1",1,1,"T1",1,2,0,"D"
"4425",2008-12-21,2008,"Denizlispor","Ankaragucu","1-1",1,1,"T1",1,2,0,"D"
"4426",2008-12-21,2008,"Galatasaray","Besiktas","4-2",4,2,"T1",1,6,2,"H"
"4427",2008-12-21,2008,"Gaziantepspor","Bursaspor","2-0",2,0,"T1",1,2,2,"H"
"4428",2008-12-21,2008,"Genclerbirligi","Sivasspor","1-2",1,2,"T1",1,3,-1,"A"
"4429",2009-01-23,2008,"Ankaraspor","Konyaspor","3-0",3,0,"T1",1,3,3,"H"
"4430",2009-01-24,2008,"Ankaragucu","Antalyaspor","0-1",0,1,"T1",1,1,-1,"A"
"4431",2009-01-24,2008,"Besiktas","Denizlispor","1-0",1,0,"T1",1,1,1,"H"
"4432",2009-01-24,2008,"Eskisehirspor","Gaziantepspor","1-1",1,1,"T1",1,2,0,"D"
"4433",2009-01-24,2008,"Kayserispor","Genclerbirligi","1-3",1,3,"T1",1,4,-2,"A"
"4434",2009-01-24,2008,"Sivasspor","Galatasaray","2-0",2,0,"T1",1,2,2,"H"
"4435",2009-01-25,2008,"Bursaspor","Buyuksehyr","2-0",2,0,"T1",1,2,2,"H"
"4436",2009-01-25,2008,"Fenerbahce","Trabzonspor","0-0",0,0,"T1",1,0,0,"D"
"4437",2009-01-25,2008,"Kocaelispor","Hacettepespor","4-0",4,0,"T1",1,4,4,"H"
"4438",2009-01-31,2008,"Ankaraspor","Trabzonspor","0-2",0,2,"T1",1,2,-2,"A"
"4439",2009-01-31,2008,"Denizlispor","Galatasaray","0-2",0,2,"T1",1,2,-2,"A"
"4440",2009-01-31,2008,"Kayserispor","Sivasspor","0-0",0,0,"T1",1,0,0,"D"
"4441",2009-01-31,2008,"Kocaelispor","Genclerbirligi","0-2",0,2,"T1",1,2,-2,"A"
"4442",2009-02-01,2008,"Ankaragucu","Konyaspor","1-3",1,3,"T1",1,4,-2,"A"
"4443",2009-02-01,2008,"Besiktas","Antalyaspor","1-0",1,0,"T1",1,1,1,"H"
"4444",2009-02-01,2008,"Bursaspor","Hacettepespor","0-0",0,0,"T1",1,0,0,"D"
"4445",2009-02-01,2008,"Eskisehirspor","Buyuksehyr","6-1",6,1,"T1",1,7,5,"H"
"4446",2009-02-01,2008,"Fenerbahce","Gaziantepspor","1-1",1,1,"T1",1,2,0,"D"
"4447",2009-02-06,2008,"Trabzonspor","Ankaragucu","2-1",2,1,"T1",1,3,1,"H"
"4448",2009-02-07,2008,"Galatasaray","Kayserispor","1-1",1,1,"T1",1,2,0,"D"
"4449",2009-02-07,2008,"Hacettepespor","Eskisehirspor","2-2",2,2,"T1",1,4,0,"D"
"4450",2009-02-07,2008,"Sivasspor","Kocaelispor","2-0",2,0,"T1",1,2,2,"H"
"4451",2009-02-08,2008,"Antalyaspor","Denizlispor","2-1",2,1,"T1",1,3,1,"H"
"4452",2009-02-08,2008,"Buyuksehyr","Fenerbahce","2-0",2,0,"T1",1,2,2,"H"
"4453",2009-02-08,2008,"Gaziantepspor","Ankaraspor","2-0",2,0,"T1",1,2,2,"H"
"4454",2009-02-08,2008,"Genclerbirligi","Bursaspor","1-2",1,2,"T1",1,3,-1,"A"
"4455",2009-02-08,2008,"Konyaspor","Besiktas","0-0",0,0,"T1",1,0,0,"D"
"4456",2009-02-14,2008,"Ankaragucu","Gaziantepspor","3-1",3,1,"T1",1,4,2,"H"
"4457",2009-02-14,2008,"Antalyaspor","Galatasaray","1-0",1,0,"T1",1,1,1,"H"
"4458",2009-02-14,2008,"Eskisehirspor","Genclerbirligi","0-0",0,0,"T1",1,0,0,"D"
"4459",2009-02-14,2008,"Fenerbahce","Hacettepespor","7-0",7,0,"T1",1,7,7,"H"
"4460",2009-02-15,2008,"Ankaraspor","Buyuksehyr","1-2",1,2,"T1",1,3,-1,"A"
"4461",2009-02-15,2008,"Besiktas","Trabzonspor","1-1",1,1,"T1",1,2,0,"D"
"4462",2009-02-15,2008,"Bursaspor","Sivasspor","1-1",1,1,"T1",1,2,0,"D"
"4463",2009-02-15,2008,"Denizlispor","Konyaspor","2-1",2,1,"T1",1,3,1,"H"
"4464",2009-02-15,2008,"Kocaelispor","Kayserispor","1-2",1,2,"T1",1,3,-1,"A"
"4465",2009-02-20,2008,"Gaziantepspor","Besiktas","0-3",0,3,"T1",1,3,-3,"A"
"4466",2009-02-21,2008,"Buyuksehyr","Ankaragucu","1-2",1,2,"T1",1,3,-1,"A"
"4467",2009-02-21,2008,"Genclerbirligi","Fenerbahce","1-0",1,0,"T1",1,1,1,"H"
"4468",2009-02-21,2008,"Kayserispor","Bursaspor","0-0",0,0,"T1",1,0,0,"D"
"4469",2009-02-21,2008,"Konyaspor","Antalyaspor","2-0",2,0,"T1",1,2,2,"H"
"4470",2009-02-21,2008,"Trabzonspor","Denizlispor","0-2",0,2,"T1",1,2,-2,"A"
"4471",2009-02-22,2008,"Galatasaray","Kocaelispor","2-5",2,5,"T1",1,7,-3,"A"
"4472",2009-02-22,2008,"Hacettepespor","Ankaraspor","3-1",3,1,"T1",1,4,2,"H"
"4473",2009-02-22,2008,"Sivasspor","Eskisehirspor","1-0",1,0,"T1",1,1,1,"H"
"4474",2009-02-27,2008,"Besiktas","Buyuksehyr","2-1",2,1,"T1",1,3,1,"H"
"4475",2009-02-28,2008,"Ankaraspor","Genclerbirligi","0-0",0,0,"T1",1,0,0,"D"
"4476",2009-02-28,2008,"Denizlispor","Gaziantepspor","2-0",2,0,"T1",1,2,2,"H"
"4477",2009-02-28,2008,"Eskisehirspor","Kayserispor","1-0",1,0,"T1",1,1,1,"H"
"4478",2009-02-28,2008,"Fenerbahce","Sivasspor","4-2",4,2,"T1",1,6,2,"H"
"4479",2009-03-01,2008,"Ankaragucu","Hacettepespor","1-0",1,0,"T1",1,1,1,"H"
"4480",2009-03-01,2008,"Antalyaspor","Trabzonspor","0-1",0,1,"T1",1,1,-1,"A"
"4481",2009-03-01,2008,"Bursaspor","Kocaelispor","1-1",1,1,"T1",1,2,0,"D"
"4482",2009-03-01,2008,"Konyaspor","Galatasaray","0-1",0,1,"T1",1,1,-1,"A"
"4483",2009-03-06,2008,"Galatasaray","Bursaspor","2-1",2,1,"T1",1,3,1,"H"
"4484",2009-03-07,2008,"Buyuksehyr","Denizlispor","0-2",0,2,"T1",1,2,-2,"A"
"4485",2009-03-07,2008,"Gaziantepspor","Antalyaspor","1-1",1,1,"T1",1,2,0,"D"
"4486",2009-03-07,2008,"Hacettepespor","Besiktas","2-3",2,3,"T1",1,5,-1,"A"
"4487",2009-03-07,2008,"Trabzonspor","Konyaspor","0-1",0,1,"T1",1,1,-1,"A"
"4488",2009-03-08,2008,"Genclerbirligi","Ankaragucu","2-0",2,0,"T1",1,2,2,"H"
"4489",2009-03-08,2008,"Kayserispor","Fenerbahce","0-2",0,2,"T1",1,2,-2,"A"
"4490",2009-03-08,2008,"Kocaelispor","Eskisehirspor","1-0",1,0,"T1",1,1,1,"H"
"4491",2009-03-08,2008,"Sivasspor","Ankaraspor","1-1",1,1,"T1",1,2,0,"D"
"4492",2009-03-13,2008,"Fenerbahce","Kocaelispor","1-1",1,1,"T1",1,2,0,"D"
"4493",2009-03-14,2008,"Ankaragucu","Sivasspor","0-2",0,2,"T1",1,2,-2,"A"
"4494",2009-03-14,2008,"Antalyaspor","Buyuksehyr","1-0",1,0,"T1",1,1,1,"H"
"4495",2009-03-14,2008,"Besiktas","Genclerbirligi","3-0",3,0,"T1",1,3,3,"H"
"4496",2009-03-14,2008,"Konyaspor","Gaziantepspor","2-3",2,3,"T1",1,5,-1,"A"
"4497",2009-03-15,2008,"Ankaraspor","Kayserispor","2-2",2,2,"T1",1,4,0,"D"
"4498",2009-03-15,2008,"Denizlispor","Hacettepespor","0-0",0,0,"T1",1,0,0,"D"
"4499",2009-03-15,2008,"Eskisehirspor","Bursaspor","1-2",1,2,"T1",1,3,-1,"A"
"4500",2009-03-15,2008,"Trabzonspor","Galatasaray","2-2",2,2,"T1",1,4,0,"D"
"4501",2009-03-20,2008,"Bursaspor","Fenerbahce","2-1",2,1,"T1",1,3,1,"H"
"4502",2009-03-21,2008,"Buyuksehyr","Konyaspor","2-0",2,0,"T1",1,2,2,"H"
"4503",2009-03-21,2008,"Gaziantepspor","Trabzonspor","3-2",3,2,"T1",1,5,1,"H"
"4504",2009-03-21,2008,"Hacettepespor","Antalyaspor","1-2",1,2,"T1",1,3,-1,"A"
"4505",2009-03-21,2008,"Kayserispor","Ankaragucu","2-0",2,0,"T1",1,2,2,"H"
"4506",2009-03-21,2008,"Kocaelispor","Ankaraspor","3-1",3,1,"T1",1,4,2,"H"
"4507",2009-03-21,2008,"Sivasspor","Besiktas","1-1",1,1,"T1",1,2,0,"D"
"4508",2009-03-22,2008,"Galatasaray","Eskisehirspor","0-1",0,1,"T1",1,1,-1,"A"
"4509",2009-03-22,2008,"Genclerbirligi","Denizlispor","0-0",0,0,"T1",1,0,0,"D"
"4510",2009-04-04,2008,"Ankaraspor","Bursaspor","0-2",0,2,"T1",1,2,-2,"A"
"4511",2009-04-04,2008,"Besiktas","Kayserispor","1-0",1,0,"T1",1,1,1,"H"
"4512",2009-04-04,2008,"Denizlispor","Sivasspor","0-2",0,2,"T1",1,2,-2,"A"
"4513",2009-04-04,2008,"Konyaspor","Hacettepespor","2-0",2,0,"T1",1,2,2,"H"
"4514",2009-04-05,2008,"Ankaragucu","Kocaelispor","4-0",4,0,"T1",1,4,4,"H"
"4515",2009-04-05,2008,"Antalyaspor","Genclerbirligi","4-2",4,2,"T1",1,6,2,"H"
"4516",2009-04-05,2008,"Fenerbahce","Eskisehirspor","2-1",2,1,"T1",1,3,1,"H"
"4517",2009-04-05,2008,"Trabzonspor","Buyuksehyr","0-0",0,0,"T1",1,0,0,"D"
"4518",2009-04-06,2008,"Gaziantepspor","Galatasaray","0-1",0,1,"T1",1,1,-1,"A"
"4519",2009-04-10,2008,"Kocaelispor","Besiktas","1-3",1,3,"T1",1,4,-2,"A"
"4520",2009-04-11,2008,"Bursaspor","Ankaragucu","2-0",2,0,"T1",1,2,2,"H"
"4521",2009-04-11,2008,"Buyuksehyr","Gaziantepspor","1-1",1,1,"T1",1,2,0,"D"
"4522",2009-04-11,2008,"Hacettepespor","Trabzonspor","1-4",1,4,"T1",1,5,-3,"A"
"4523",2009-04-11,2008,"Sivasspor","Antalyaspor","1-0",1,0,"T1",1,1,1,"H"
"4524",2009-04-12,2008,"Eskisehirspor","Ankaraspor","2-0",2,0,"T1",1,2,2,"H"
"4525",2009-04-12,2008,"Galatasaray","Fenerbahce","0-0",0,0,"T1",1,0,0,"D"
"4526",2009-04-12,2008,"Genclerbirligi","Konyaspor","1-0",1,0,"T1",1,1,1,"H"
"4527",2009-04-12,2008,"Kayserispor","Denizlispor","2-0",2,0,"T1",1,2,2,"H"
"4528",2009-04-17,2008,"Trabzonspor","Genclerbirligi","2-0",2,0,"T1",1,2,2,"H"
"4529",2009-04-18,2008,"Ankaraspor","Fenerbahce","1-0",1,0,"T1",1,1,1,"H"
"4530",2009-04-18,2008,"Konyaspor","Sivasspor","0-0",0,0,"T1",1,0,0,"D"
"4531",2009-04-19,2008,"Ankaragucu","Eskisehirspor","3-2",3,2,"T1",1,5,1,"H"
"4532",2009-04-19,2008,"Antalyaspor","Kayserispor","2-1",2,1,"T1",1,3,1,"H"
"4533",2009-04-19,2008,"Besiktas","Bursaspor","0-0",0,0,"T1",1,0,0,"D"
"4534",2009-04-19,2008,"Buyuksehyr","Galatasaray","0-1",0,1,"T1",1,1,-1,"A"
"4535",2009-04-19,2008,"Denizlispor","Kocaelispor","2-1",2,1,"T1",1,3,1,"H"
"4536",2009-04-19,2008,"Gaziantepspor","Hacettepespor","0-0",0,0,"T1",1,0,0,"D"
"4537",2009-04-25,2008,"Fenerbahce","Ankaragucu","1-2",1,2,"T1",1,3,-1,"A"
"4538",2009-04-25,2008,"Hacettepespor","Buyuksehyr","2-1",2,1,"T1",1,3,1,"H"
"4539",2009-04-25,2008,"Sivasspor","Trabzonspor","3-0",3,0,"T1",1,3,3,"H"
"4540",2009-04-26,2008,"Bursaspor","Denizlispor","2-0",2,0,"T1",1,2,2,"H"
"4541",2009-04-26,2008,"Eskisehirspor","Besiktas","0-2",0,2,"T1",1,2,-2,"A"
"4542",2009-04-26,2008,"Galatasaray","Ankaraspor","1-1",1,1,"T1",1,2,0,"D"
"4543",2009-04-26,2008,"Genclerbirligi","Gaziantepspor","1-0",1,0,"T1",1,1,1,"H"
"4544",2009-04-26,2008,"Kayserispor","Konyaspor","1-1",1,1,"T1",1,2,0,"D"
"4545",2009-04-26,2008,"Kocaelispor","Antalyaspor","1-0",1,0,"T1",1,1,1,"H"
"4546",2009-05-01,2008,"Hacettepespor","Galatasaray","2-0",2,0,"T1",1,2,2,"H"
"4547",2009-05-02,2008,"Trabzonspor","Kayserispor","4-1",4,1,"T1",1,5,3,"H"
"4548",2009-05-03,2008,"Ankaragucu","Ankaraspor","1-0",1,0,"T1",1,1,1,"H"
"4549",2009-05-03,2008,"Antalyaspor","Bursaspor","2-3",2,3,"T1",1,5,-1,"A"
"4550",2009-05-03,2008,"Besiktas","Fenerbahce","1-2",1,2,"T1",1,3,-1,"A"
"4551",2009-05-03,2008,"Buyuksehyr","Genclerbirligi","3-1",3,1,"T1",1,4,2,"H"
"4552",2009-05-03,2008,"Denizlispor","Eskisehirspor","3-2",3,2,"T1",1,5,1,"H"
"4553",2009-05-03,2008,"Gaziantepspor","Sivasspor","2-1",2,1,"T1",1,3,1,"H"
"4554",2009-05-03,2008,"Konyaspor","Kocaelispor","2-0",2,0,"T1",1,2,2,"H"
"4555",2009-05-09,2008,"Ankaraspor","Besiktas","1-4",1,4,"T1",1,5,-3,"A"
"4556",2009-05-09,2008,"Bursaspor","Konyaspor","3-0",3,0,"T1",1,3,3,"H"
"4557",2009-05-09,2008,"Eskisehirspor","Antalyaspor","2-0",2,0,"T1",1,2,2,"H"
"4558",2009-05-09,2008,"Fenerbahce","Denizlispor","1-0",1,0,"T1",1,1,1,"H"
"4559",2009-05-09,2008,"Galatasaray","Ankaragucu","1-0",1,0,"T1",1,1,1,"H"
"4560",2009-05-09,2008,"Genclerbirligi","Hacettepespor","3-1",3,1,"T1",1,4,2,"H"
"4561",2009-05-09,2008,"Kocaelispor","Trabzonspor","1-3",1,3,"T1",1,4,-2,"A"
"4562",2009-05-09,2008,"Sivasspor","Buyuksehyr","1-2",1,2,"T1",1,3,-1,"A"
"4563",2009-05-10,2008,"Kayserispor","Gaziantepspor","3-0",3,0,"T1",1,3,3,"H"
"4564",2009-05-16,2008,"Hacettepespor","Sivasspor","1-2",1,2,"T1",1,3,-1,"A"
"4565",2009-05-17,2008,"Ankaragucu","Besiktas","1-3",1,3,"T1",1,4,-2,"A"
"4566",2009-05-17,2008,"Antalyaspor","Fenerbahce","1-1",1,1,"T1",1,2,0,"D"
"4567",2009-05-17,2008,"Buyuksehyr","Kayserispor","1-0",1,0,"T1",1,1,1,"H"
"4568",2009-05-17,2008,"Denizlispor","Ankaraspor","2-0",2,0,"T1",1,2,2,"H"
"4569",2009-05-17,2008,"Galatasaray","Genclerbirligi","2-1",2,1,"T1",1,3,1,"H"
"4570",2009-05-17,2008,"Gaziantepspor","Kocaelispor","5-2",5,2,"T1",1,7,3,"H"
"4571",2009-05-17,2008,"Konyaspor","Eskisehirspor","1-2",1,2,"T1",1,3,-1,"A"
"4572",2009-05-17,2008,"Trabzonspor","Bursaspor","1-0",1,0,"T1",1,1,1,"H"
"4573",2009-05-23,2008,"Kayserispor","Hacettepespor","1-0",1,0,"T1",1,1,1,"H"
"4574",2009-05-24,2008,"Ankaragucu","Denizlispor","3-0",3,0,"T1",1,3,3,"H"
"4575",2009-05-24,2008,"Ankaraspor","Antalyaspor","0-0",0,0,"T1",1,0,0,"D"
"4576",2009-05-24,2008,"Besiktas","Galatasaray","2-1",2,1,"T1",1,3,1,"H"
"4577",2009-05-24,2008,"Bursaspor","Gaziantepspor","2-2",2,2,"T1",1,4,0,"D"
"4578",2009-05-24,2008,"Eskisehirspor","Trabzonspor","2-5",2,5,"T1",1,7,-3,"A"
"4579",2009-05-24,2008,"Fenerbahce","Konyaspor","4-2",4,2,"T1",1,6,2,"H"
"4580",2009-05-24,2008,"Kocaelispor","Buyuksehyr","2-3",2,3,"T1",1,5,-1,"A"
"4581",2009-05-24,2008,"Sivasspor","Genclerbirligi","3-2",3,2,"T1",1,5,1,"H"
"4582",2009-05-29,2008,"Gaziantepspor","Eskisehirspor","1-1",1,1,"T1",1,2,0,"D"
"4583",2009-05-29,2008,"Hacettepespor","Kocaelispor","0-4",0,4,"T1",1,4,-4,"A"
"4584",2009-05-30,2008,"Antalyaspor","Ankaragucu","1-0",1,0,"T1",1,1,1,"H"
"4585",2009-05-30,2008,"Buyuksehyr","Bursaspor","0-1",0,1,"T1",1,1,-1,"A"
"4586",2009-05-30,2008,"Denizlispor","Besiktas","1-2",1,2,"T1",1,3,-1,"A"
"4587",2009-05-30,2008,"Galatasaray","Sivasspor","2-1",2,1,"T1",1,3,1,"H"
"4588",2009-05-30,2008,"Genclerbirligi","Kayserispor","0-4",0,4,"T1",1,4,-4,"A"
"4589",2009-05-30,2008,"Konyaspor","Ankaraspor","3-0",3,0,"T1",1,3,3,"H"
"4590",2009-05-30,2008,"Trabzonspor","Fenerbahce","1-2",1,2,"T1",1,3,-1,"A"
"4591",2009-08-07,2009,"Buyuksehyr","Besiktas","1-1",1,1,"T1",1,2,0,"D"
"4592",2009-08-08,2009,"Diyarbakirspor","Ankaragucu","2-2",2,2,"T1",1,4,0,"D"
"4593",2009-08-08,2009,"Sivasspor","Trabzonspor","1-2",1,2,"T1",1,3,-1,"A"
"4594",2009-08-09,2009,"Bursaspor","Kasimpasa","2-1",2,1,"T1",1,3,1,"H"
"4595",2009-08-09,2009,"Denizlispor","Fenerbahce","0-2",0,2,"T1",1,2,-2,"A"
"4596",2009-08-09,2009,"Gaziantepspor","Galatasaray","2-3",2,3,"T1",1,5,-1,"A"
"4597",2009-08-09,2009,"Genclerbirligi","Kayserispor","0-0",0,0,"T1",1,0,0,"D"
"4598",2009-08-09,2009,"Manisaspor","Eskisehirspor","0-0",0,0,"T1",1,0,0,"D"
"4599",2009-08-15,2009,"Ankaragucu","Manisaspor","1-1",1,1,"T1",1,2,0,"D"
"4600",2009-08-15,2009,"Galatasaray","Denizlispor","4-1",4,1,"T1",1,5,3,"H"
"4601",2009-08-15,2009,"Trabzonspor","Diyarbakirspor","1-2",1,2,"T1",1,3,-1,"A"
"4602",2009-08-16,2009,"Eskisehirspor","Bursaspor","3-2",3,2,"T1",1,5,1,"H"
"4603",2009-08-16,2009,"Fenerbahce","Sivasspor","3-0",3,0,"T1",1,3,3,"H"
"4604",2009-08-16,2009,"Kasimpasa","Buyuksehyr","1-3",1,3,"T1",1,4,-2,"A"
"4605",2009-08-16,2009,"Kayserispor","Gaziantepspor","1-1",1,1,"T1",1,2,0,"D"
"4606",2009-08-17,2009,"Besiktas","Antalyaspor","2-0",2,0,"T1",1,2,2,"H"
"4607",2009-08-22,2009,"Bursaspor","Ankaragucu","1-0",1,0,"T1",1,1,1,"H"
"4608",2009-08-22,2009,"Buyuksehyr","Eskisehirspor","0-0",0,0,"T1",1,0,0,"D"
"4609",2009-08-22,2009,"Genclerbirligi","Besiktas","0-0",0,0,"T1",1,0,0,"D"
"4610",2009-08-23,2009,"Antalyaspor","Kasimpasa","2-0",2,0,"T1",1,2,2,"H"
"4611",2009-08-23,2009,"Galatasaray","Kayserispor","4-1",4,1,"T1",1,5,3,"H"
"4612",2009-08-23,2009,"Manisaspor","Trabzonspor","1-0",1,0,"T1",1,1,1,"H"
"4613",2009-08-24,2009,"Diyarbakirspor","Fenerbahce","1-3",1,3,"T1",1,4,-2,"A"
"4614",2009-08-28,2009,"Besiktas","Gaziantepspor","0-0",0,0,"T1",1,0,0,"D"
"4615",2009-08-29,2009,"Ankaragucu","Buyuksehyr","2-2",2,2,"T1",1,4,0,"D"
"4616",2009-08-29,2009,"Eskisehirspor","Antalyaspor","2-1",2,1,"T1",1,3,1,"H"
"4617",2009-08-29,2009,"Kayserispor","Denizlispor","3-0",3,0,"T1",1,3,3,"H"
"4618",2009-08-30,2009,"Fenerbahce","Manisaspor","2-1",2,1,"T1",1,3,1,"H"
"4619",2009-08-30,2009,"Kasimpasa","Genclerbirligi","0-4",0,4,"T1",1,4,-4,"A"
"4620",2009-08-30,2009,"Sivasspor","Diyarbakirspor","0-2",0,2,"T1",1,2,-2,"A"
"4621",2009-08-30,2009,"Trabzonspor","Bursaspor","1-1",1,1,"T1",1,2,0,"D"
"4622",2009-09-12,2009,"Denizlispor","Diyarbakirspor","0-0",0,0,"T1",1,0,0,"D"
"4623",2009-09-12,2009,"Galatasaray","Besiktas","3-0",3,0,"T1",1,3,3,"H"
"4624",2009-09-12,2009,"Manisaspor","Sivasspor","3-1",3,1,"T1",1,4,2,"H"
"4625",2009-09-13,2009,"Antalyaspor","Ankaragucu","1-0",1,0,"T1",1,1,1,"H"
"4626",2009-09-13,2009,"Bursaspor","Fenerbahce","0-1",0,1,"T1",1,1,-1,"A"
"4627",2009-09-13,2009,"Buyuksehyr","Trabzonspor","1-6",1,6,"T1",1,7,-5,"A"
"4628",2009-09-13,2009,"Gaziantepspor","Kasimpasa","1-0",1,0,"T1",1,1,1,"H"
"4629",2009-09-13,2009,"Genclerbirligi","Eskisehirspor","2-2",2,2,"T1",1,4,0,"D"
"4630",2009-09-16,2009,"Denizlispor","Sivasspor","1-1",1,1,"T1",1,2,0,"D"
"4631",2009-09-18,2009,"Trabzonspor","Antalyaspor","3-1",3,1,"T1",1,4,2,"H"
"4632",2009-09-19,2009,"Ankaragucu","Genclerbirligi","1-2",1,2,"T1",1,3,-1,"A"
"4633",2009-09-19,2009,"Besiktas","Kayserispor","0-1",0,1,"T1",1,1,-1,"A"
"4634",2009-09-19,2009,"Diyarbakirspor","Manisaspor","0-0",0,0,"T1",1,0,0,"D"
"4635",2009-09-19,2009,"Eskisehirspor","Gaziantepspor","3-2",3,2,"T1",1,5,1,"H"
"4636",2009-09-19,2009,"Sivasspor","Bursaspor","1-3",1,3,"T1",1,4,-2,"A"
"4637",2009-09-20,2009,"Fenerbahce","Buyuksehyr","1-0",1,0,"T1",1,1,1,"H"
"4638",2009-09-21,2009,"Kasimpasa","Galatasaray","1-3",1,3,"T1",1,4,-2,"A"
"4639",2009-09-25,2009,"Genclerbirligi","Trabzonspor","2-2",2,2,"T1",1,4,0,"D"
"4640",2009-09-26,2009,"Antalyaspor","Fenerbahce","1-2",1,2,"T1",1,3,-1,"A"
"4641",2009-09-26,2009,"Bursaspor","Diyarbakirspor","4-0",4,0,"T1",1,4,4,"H"
"4642",2009-09-26,2009,"Buyuksehyr","Sivasspor","1-0",1,0,"T1",1,1,1,"H"
"4643",2009-09-26,2009,"Gaziantepspor","Ankaragucu","1-3",1,3,"T1",1,4,-2,"A"
"4644",2009-09-27,2009,"Denizlispor","Manisaspor","1-1",1,1,"T1",1,2,0,"D"
"4645",2009-09-27,2009,"Galatasaray","Eskisehirspor","1-1",1,1,"T1",1,2,0,"D"
"4646",2009-09-27,2009,"Kayserispor","Kasimpasa","0-0",0,0,"T1",1,0,0,"D"
"4647",2009-10-02,2009,"Trabzonspor","Gaziantepspor","0-0",0,0,"T1",1,0,0,"D"
"4648",2009-10-03,2009,"Besiktas","Denizlispor","1-0",1,0,"T1",1,1,1,"H"
"4649",2009-10-03,2009,"Diyarbakirspor","Buyuksehyr","1-3",1,3,"T1",1,4,-2,"A"
"4650",2009-10-03,2009,"Manisaspor","Bursaspor","0-2",0,2,"T1",1,2,-2,"A"
"4651",2009-10-04,2009,"Ankaragucu","Galatasaray","3-0",3,0,"T1",1,3,3,"H"
"4652",2009-10-04,2009,"Eskisehirspor","Kayserispor","0-1",0,1,"T1",1,1,-1,"A"
"4653",2009-10-04,2009,"Fenerbahce","Genclerbirligi","3-0",3,0,"T1",1,3,3,"H"
"4654",2009-10-04,2009,"Sivasspor","Antalyaspor","2-0",2,0,"T1",1,2,2,"H"
"4655",2009-10-17,2009,"Besiktas","Kasimpasa","2-1",2,1,"T1",1,3,1,"H"
"4656",2009-10-17,2009,"Denizlispor","Bursaspor","2-3",2,3,"T1",1,5,-1,"A"
"4657",2009-10-18,2009,"Antalyaspor","Diyarbakirspor","4-1",4,1,"T1",1,5,3,"H"
"4658",2009-10-18,2009,"Buyuksehyr","Manisaspor","1-0",1,0,"T1",1,1,1,"H"
"4659",2009-10-18,2009,"Galatasaray","Trabzonspor","4-3",4,3,"T1",1,7,1,"H"
"4660",2009-10-18,2009,"Gaziantepspor","Fenerbahce","2-1",2,1,"T1",1,3,1,"H"
"4661",2009-10-18,2009,"Genclerbirligi","Sivasspor","2-0",2,0,"T1",1,2,2,"H"
"4662",2009-10-18,2009,"Kayserispor","Ankaragucu","3-0",3,0,"T1",1,3,3,"H"
"4663",2009-10-23,2009,"Trabzonspor","Kayserispor","2-1",2,1,"T1",1,3,1,"H"
"4664",2009-10-24,2009,"Bursaspor","Buyuksehyr","6-0",6,0,"T1",1,6,6,"H"
"4665",2009-10-24,2009,"Eskisehirspor","Besiktas","0-1",0,1,"T1",1,1,-1,"A"
"4666",2009-10-25,2009,"Diyarbakirspor","Genclerbirligi","1-0",1,0,"T1",1,1,1,"H"
"4667",2009-10-25,2009,"Fenerbahce","Galatasaray","3-1",3,1,"T1",1,4,2,"H"
"4668",2009-10-25,2009,"Kasimpasa","Denizlispor","3-1",3,1,"T1",1,4,2,"H"
"4669",2009-10-25,2009,"Manisaspor","Antalyaspor","1-2",1,2,"T1",1,3,-1,"A"
"4670",2009-10-25,2009,"Sivasspor","Gaziantepspor","3-0",3,0,"T1",1,3,3,"H"
"4671",2009-10-31,2009,"Antalyaspor","Bursaspor","1-1",1,1,"T1",1,2,0,"D"
"4672",2009-10-31,2009,"Besiktas","Ankaragucu","1-0",1,0,"T1",1,1,1,"H"
"4673",2009-11-01,2009,"Denizlispor","Buyuksehyr","0-1",0,1,"T1",1,1,-1,"A"
"4674",2009-11-01,2009,"Galatasaray","Sivasspor","2-0",2,0,"T1",1,2,2,"H"
"4675",2009-11-01,2009,"Gaziantepspor","Diyarbakirspor","2-1",2,1,"T1",1,3,1,"H"
"4676",2009-11-01,2009,"Genclerbirligi","Manisaspor","0-2",0,2,"T1",1,2,-2,"A"
"4677",2009-11-01,2009,"Kasimpasa","Eskisehirspor","1-1",1,1,"T1",1,2,0,"D"
"4678",2009-11-01,2009,"Kayserispor","Fenerbahce","1-1",1,1,"T1",1,2,0,"D"
"4679",2009-11-06,2009,"Bursaspor","Genclerbirligi","1-2",1,2,"T1",1,3,-1,"A"
"4680",2009-11-07,2009,"Buyuksehyr","Antalyaspor","1-0",1,0,"T1",1,1,1,"H"
"4681",2009-11-07,2009,"Trabzonspor","Besiktas","0-2",0,2,"T1",1,2,-2,"A"
"4682",2009-11-08,2009,"Ankaragucu","Kasimpasa","2-2",2,2,"T1",1,4,0,"D"
"4683",2009-11-08,2009,"Diyarbakirspor","Galatasaray","1-2",1,2,"T1",1,3,-1,"A"
"4684",2009-11-08,2009,"Eskisehirspor","Denizlispor","2-0",2,0,"T1",1,2,2,"H"
"4685",2009-11-08,2009,"Manisaspor","Gaziantepspor","0-3",0,3,"T1",1,3,-3,"A"
"4686",2009-11-08,2009,"Sivasspor","Kayserispor","2-4",2,4,"T1",1,6,-2,"A"
"4687",2009-11-21,2009,"Besiktas","Fenerbahce","3-0",3,0,"T1",1,3,3,"H"
"4688",2009-11-21,2009,"Gaziantepspor","Bursaspor","0-1",0,1,"T1",1,1,-1,"A"
"4689",2009-11-22,2009,"Denizlispor","Antalyaspor","1-1",1,1,"T1",1,2,0,"D"
"4690",2009-11-22,2009,"Eskisehirspor","Ankaragucu","0-0",0,0,"T1",1,0,0,"D"
"4691",2009-11-22,2009,"Galatasaray","Manisaspor","1-1",1,1,"T1",1,2,0,"D"
"4692",2009-11-22,2009,"Genclerbirligi","Buyuksehyr","3-1",3,1,"T1",1,4,2,"H"
"4693",2009-11-22,2009,"Kasimpasa","Trabzonspor","3-1",3,1,"T1",1,4,2,"H"
"4694",2009-11-22,2009,"Kayserispor","Diyarbakirspor","2-0",2,0,"T1",1,2,2,"H"
"4695",2009-11-27,2009,"Bursaspor","Galatasaray","1-0",1,0,"T1",1,1,1,"H"
"4696",2009-11-28,2009,"Fenerbahce","Kasimpasa","1-3",1,3,"T1",1,4,-2,"A"
"4697",2009-11-29,2009,"Ankaragucu","Denizlispor","1-0",1,0,"T1",1,1,1,"H"
"4698",2009-11-29,2009,"Antalyaspor","Genclerbirligi","2-0",2,0,"T1",1,2,2,"H"
"4699",2009-11-29,2009,"Buyuksehyr","Gaziantepspor","1-1",1,1,"T1",1,2,0,"D"
"4700",2009-11-29,2009,"Manisaspor","Kayserispor","0-1",0,1,"T1",1,1,-1,"A"
"4701",2009-11-29,2009,"Sivasspor","Besiktas","0-1",0,1,"T1",1,1,-1,"A"
"4702",2009-11-29,2009,"Trabzonspor","Eskisehirspor","2-1",2,1,"T1",1,3,1,"H"
"4703",2009-12-04,2009,"Besiktas","Diyarbakirspor","0-0",0,0,"T1",1,0,0,"D"
"4704",2009-12-05,2009,"Eskisehirspor","Fenerbahce","2-1",2,1,"T1",1,3,1,"H"
"4705",2009-12-05,2009,"Kasimpasa","Sivasspor","2-2",2,2,"T1",1,4,0,"D"
"4706",2009-12-06,2009,"Galatasaray","Buyuksehyr","1-1",1,1,"T1",1,2,0,"D"
"4707",2009-12-06,2009,"Gaziantepspor","Antalyaspor","1-1",1,1,"T1",1,2,0,"D"
"4708",2009-12-06,2009,"Genclerbirligi","Denizlispor","2-0",2,0,"T1",1,2,2,"H"
"4709",2009-12-06,2009,"Kayserispor","Bursaspor","3-0",3,0,"T1",1,3,3,"H"
"4710",2009-12-06,2009,"Trabzonspor","Ankaragucu","3-0",3,0,"T1",1,3,3,"H"
"4711",2009-12-11,2009,"Antalyaspor","Galatasaray","2-3",2,3,"T1",1,5,-1,"A"
"4712",2009-12-12,2009,"Fenerbahce","Ankaragucu","3-2",3,2,"T1",1,5,1,"H"
"4713",2009-12-13,2009,"Buyuksehyr","Kayserispor","1-2",1,2,"T1",1,3,-1,"A"
"4714",2009-12-13,2009,"Denizlispor","Trabzonspor","0-1",0,1,"T1",1,1,-1,"A"
"4715",2009-12-13,2009,"Diyarbakirspor","Kasimpasa","2-2",2,2,"T1",1,4,0,"D"
"4716",2009-12-13,2009,"Genclerbirligi","Gaziantepspor","1-1",1,1,"T1",1,2,0,"D"
"4717",2009-12-13,2009,"Manisaspor","Besiktas","1-1",1,1,"T1",1,2,0,"D"
"4718",2009-12-13,2009,"Sivasspor","Eskisehirspor","2-1",2,1,"T1",1,3,1,"H"
"4719",2009-12-18,2009,"Besiktas","Bursaspor","2-3",2,3,"T1",1,5,-1,"A"
"4720",2009-12-19,2009,"Ankaragucu","Sivasspor","2-3",2,3,"T1",1,5,-1,"A"
"4721",2009-12-19,2009,"Eskisehirspor","Diyarbakirspor","0-0",0,0,"T1",1,0,0,"D"
"4722",2009-12-19,2009,"Galatasaray","Genclerbirligi","1-0",1,0,"T1",1,1,1,"H"
"4723",2009-12-19,2009,"Gaziantepspor","Denizlispor","2-1",2,1,"T1",1,3,1,"H"
"4724",2009-12-19,2009,"Kasimpasa","Manisaspor","3-1",3,1,"T1",1,4,2,"H"
"4725",2009-12-19,2009,"Kayserispor","Antalyaspor","1-2",1,2,"T1",1,3,-1,"A"
"4726",2009-12-20,2009,"Trabzonspor","Fenerbahce","0-1",0,1,"T1",1,1,-1,"A"
"4727",2010-01-22,2009,"Fenerbahce","Denizlispor","3-1",3,1,"T1",1,4,2,"H"
"4728",2010-01-23,2009,"Eskisehirspor","Manisaspor","1-0",1,0,"T1",1,1,1,"H"
"4729",2010-01-24,2009,"Ankaragucu","Diyarbakirspor","0-0",0,0,"T1",1,0,0,"D"
"4730",2010-01-24,2009,"Galatasaray","Gaziantepspor","1-0",1,0,"T1",1,1,1,"H"
"4731",2010-01-24,2009,"Kayserispor","Genclerbirligi","1-1",1,1,"T1",1,2,0,"D"
"4732",2010-01-24,2009,"Trabzonspor","Sivasspor","3-1",3,1,"T1",1,4,2,"H"
"4733",2010-01-29,2009,"Antalyaspor","Besiktas","0-1",0,1,"T1",1,1,-1,"A"
"4734",2010-01-30,2009,"Buyuksehyr","Kasimpasa","4-2",4,2,"T1",1,6,2,"H"
"4735",2010-01-30,2009,"Diyarbakirspor","Trabzonspor","1-2",1,2,"T1",1,3,-1,"A"
"4736",2010-01-31,2009,"Bursaspor","Eskisehirspor","3-1",3,1,"T1",1,4,2,"H"
"4737",2010-01-31,2009,"Denizlispor","Galatasaray","1-2",1,2,"T1",1,3,-1,"A"
"4738",2010-01-31,2009,"Gaziantepspor","Kayserispor","0-1",0,1,"T1",1,1,-1,"A"
"4739",2010-01-31,2009,"Manisaspor","Ankaragucu","0-0",0,0,"T1",1,0,0,"D"
"4740",2010-01-31,2009,"Sivasspor","Fenerbahce","1-5",1,5,"T1",1,6,-4,"A"
"4741",2010-02-05,2009,"Besiktas","Genclerbirligi","4-1",4,1,"T1",1,5,3,"H"
"4742",2010-02-06,2009,"Eskisehirspor","Buyuksehyr","2-1",2,1,"T1",1,3,1,"H"
"4743",2010-02-06,2009,"Kayserispor","Galatasaray","0-0",0,0,"T1",1,0,0,"D"
"4744",2010-02-07,2009,"Ankaragucu","Bursaspor","0-0",0,0,"T1",1,0,0,"D"
"4745",2010-02-07,2009,"Fenerbahce","Diyarbakirspor","1-1",1,1,"T1",1,2,0,"D"
"4746",2010-02-07,2009,"Kasimpasa","Antalyaspor","2-2",2,2,"T1",1,4,0,"D"
"4747",2010-02-07,2009,"Sivasspor","Denizlispor","2-0",2,0,"T1",1,2,2,"H"
"4748",2010-02-07,2009,"Trabzonspor","Manisaspor","3-0",3,0,"T1",1,3,3,"H"
"4749",2010-02-13,2009,"Diyarbakirspor","Sivasspor","1-1",1,1,"T1",1,2,0,"D"
"4750",2010-02-13,2009,"Gaziantepspor","Besiktas","2-0",2,0,"T1",1,2,2,"H"
"4751",2010-02-14,2009,"Antalyaspor","Eskisehirspor","1-2",1,2,"T1",1,3,-1,"A"
"4752",2010-02-14,2009,"Buyuksehyr","Ankaragucu","1-1",1,1,"T1",1,2,0,"D"
"4753",2010-02-14,2009,"Denizlispor","Kayserispor","1-0",1,0,"T1",1,1,1,"H"
"4754",2010-02-14,2009,"Genclerbirligi","Kasimpasa","0-2",0,2,"T1",1,2,-2,"A"
"4755",2010-02-14,2009,"Manisaspor","Fenerbahce","2-2",2,2,"T1",1,4,0,"D"
"4756",2010-02-15,2009,"Bursaspor","Trabzonspor","1-1",1,1,"T1",1,2,0,"D"
"4757",2010-02-20,2009,"Eskisehirspor","Genclerbirligi","0-0",0,0,"T1",1,0,0,"D"
"4758",2010-02-20,2009,"Sivasspor","Manisaspor","1-0",1,0,"T1",1,1,1,"H"
"4759",2010-02-20,2009,"Trabzonspor","Buyuksehyr","0-0",0,0,"T1",1,0,0,"D"
"4760",2010-02-21,2009,"Ankaragucu","Antalyaspor","2-2",2,2,"T1",1,4,0,"D"
"4761",2010-02-21,2009,"Besiktas","Galatasaray","1-1",1,1,"T1",1,2,0,"D"
"4762",2010-02-21,2009,"Diyarbakirspor","Denizlispor","0-2",0,2,"T1",1,2,-2,"A"
"4763",2010-02-21,2009,"Kasimpasa","Gaziantepspor","3-0",3,0,"T1",1,3,3,"H"
"4764",2010-02-22,2009,"Fenerbahce","Bursaspor","2-3",2,3,"T1",1,5,-1,"A"
"4765",2010-02-26,2009,"Antalyaspor","Trabzonspor","1-1",1,1,"T1",1,2,0,"D"
"4766",2010-02-27,2009,"Bursaspor","Sivasspor","3-0",3,0,"T1",1,3,3,"H"
"4767",2010-02-27,2009,"Kayserispor","Besiktas","1-2",1,2,"T1",1,3,-1,"A"
"4768",2010-02-28,2009,"Buyuksehyr","Fenerbahce","2-1",2,1,"T1",1,3,1,"H"
"4769",2010-02-28,2009,"Galatasaray","Kasimpasa","4-1",4,1,"T1",1,5,3,"H"
"4770",2010-02-28,2009,"Gaziantepspor","Eskisehirspor","1-1",1,1,"T1",1,2,0,"D"
"4771",2010-02-28,2009,"Genclerbirligi","Ankaragucu","0-1",0,1,"T1",1,1,-1,"A"
"4772",2010-02-28,2009,"Manisaspor","Diyarbakirspor","2-1",2,1,"T1",1,3,1,"H"
"4773",2010-03-06,2009,"Diyarbakirspor","Bursaspor","0-3",0,3,"T1",1,3,-3,"A"
"4774",2010-03-06,2009,"Kasimpasa","Kayserispor","2-2",2,2,"T1",1,4,0,"D"
"4775",2010-03-06,2009,"Sivasspor","Buyuksehyr","0-1",0,1,"T1",1,1,-1,"A"
"4776",2010-03-06,2009,"Trabzonspor","Genclerbirligi","3-1",3,1,"T1",1,4,2,"H"
"4777",2010-03-07,2009,"Ankaragucu","Gaziantepspor","0-0",0,0,"T1",1,0,0,"D"
"4778",2010-03-07,2009,"Fenerbahce","Antalyaspor","1-0",1,0,"T1",1,1,1,"H"
"4779",2010-03-07,2009,"Manisaspor","Denizlispor","0-0",0,0,"T1",1,0,0,"D"
"4780",2010-03-08,2009,"Eskisehirspor","Galatasaray","2-1",2,1,"T1",1,3,1,"H"
"4781",2010-03-10,2009,"Besiktas","Buyuksehyr","2-0",2,0,"T1",1,2,2,"H"
"4782",2010-03-10,2009,"Kasimpasa","Bursaspor","0-2",0,2,"T1",1,2,-2,"A"
"4783",2010-03-12,2009,"Gaziantepspor","Trabzonspor","1-1",1,1,"T1",1,2,0,"D"
"4784",2010-03-13,2009,"Genclerbirligi","Fenerbahce","0-0",0,0,"T1",1,0,0,"D"
"4785",2010-03-14,2009,"Antalyaspor","Sivasspor","3-0",3,0,"T1",1,3,3,"H"
"4786",2010-03-14,2009,"Bursaspor","Manisaspor","2-0",2,0,"T1",1,2,2,"H"
"4787",2010-03-14,2009,"Buyuksehyr","Diyarbakirspor","1-0",1,0,"T1",1,1,1,"H"
"4788",2010-03-14,2009,"Galatasaray","Ankaragucu","3-0",3,0,"T1",1,3,3,"H"
"4789",2010-03-14,2009,"Kayserispor","Eskisehirspor","1-2",1,2,"T1",1,3,-1,"A"
"4790",2010-03-15,2009,"Denizlispor","Besiktas","0-1",0,1,"T1",1,1,-1,"A"
"4791",2010-03-19,2009,"Kasimpasa","Besiktas","2-2",2,2,"T1",1,4,0,"D"
"4792",2010-03-20,2009,"Diyarbakirspor","Antalyaspor","1-0",1,0,"T1",1,1,1,"H"
"4793",2010-03-20,2009,"Fenerbahce","Gaziantepspor","1-0",1,0,"T1",1,1,1,"H"
"4794",2010-03-20,2009,"Manisaspor","Buyuksehyr","1-0",1,0,"T1",1,1,1,"H"
"4795",2010-03-21,2009,"Ankaragucu","Kayserispor","3-0",3,0,"T1",1,3,3,"H"
"4796",2010-03-21,2009,"Sivasspor","Genclerbirligi","0-2",0,2,"T1",1,2,-2,"A"
"4797",2010-03-21,2009,"Trabzonspor","Galatasaray","1-0",1,0,"T1",1,1,1,"H"
"4798",2010-03-22,2009,"Bursaspor","Denizlispor","2-1",2,1,"T1",1,3,1,"H"
"4799",2010-03-26,2009,"Buyuksehyr","Bursaspor","2-1",2,1,"T1",1,3,1,"H"
"4800",2010-03-27,2009,"Besiktas","Eskisehirspor","3-2",3,2,"T1",1,5,1,"H"
"4801",2010-03-27,2009,"Genclerbirligi","Diyarbakirspor","1-0",1,0,"T1",1,1,1,"H"
"4802",2010-03-28,2009,"Antalyaspor","Manisaspor","0-0",0,0,"T1",1,0,0,"D"
"4803",2010-03-28,2009,"Denizlispor","Kasimpasa","3-3",3,3,"T1",1,6,0,"D"
"4804",2010-03-28,2009,"Galatasaray","Fenerbahce","0-1",0,1,"T1",1,1,-1,"A"
"4805",2010-03-28,2009,"Gaziantepspor","Sivasspor","2-2",2,2,"T1",1,4,0,"D"
"4806",2010-03-29,2009,"Kayserispor","Trabzonspor","1-0",1,0,"T1",1,1,1,"H"
"4807",2010-04-02,2009,"Ankaragucu","Besiktas","0-0",0,0,"T1",1,0,0,"D"
"4808",2010-04-03,2009,"Bursaspor","Antalyaspor","2-1",2,1,"T1",1,3,1,"H"
"4809",2010-04-03,2009,"Buyuksehyr","Denizlispor","3-1",3,1,"T1",1,4,2,"H"
"4810",2010-04-04,2009,"Diyarbakirspor","Gaziantepspor","1-3",1,3,"T1",1,4,-2,"A"
"4811",2010-04-04,2009,"Eskisehirspor","Kasimpasa","2-0",2,0,"T1",1,2,2,"H"
"4812",2010-04-04,2009,"Fenerbahce","Kayserispor","2-0",2,0,"T1",1,2,2,"H"
"4813",2010-04-04,2009,"Manisaspor","Genclerbirligi","0-0",0,0,"T1",1,0,0,"D"
"4814",2010-04-05,2009,"Sivasspor","Galatasaray","1-1",1,1,"T1",1,2,0,"D"
"4815",2010-04-09,2009,"Gaziantepspor","Manisaspor","0-0",0,0,"T1",1,0,0,"D"
"4816",2010-04-10,2009,"Antalyaspor","Buyuksehyr","1-3",1,3,"T1",1,4,-2,"A"
"4817",2010-04-10,2009,"Besiktas","Trabzonspor","0-0",0,0,"T1",1,0,0,"D"
"4818",2010-04-11,2009,"Denizlispor","Eskisehirspor","1-0",1,0,"T1",1,1,1,"H"
"4819",2010-04-11,2009,"Galatasaray","Diyarbakirspor","4-1",4,1,"T1",1,5,3,"H"
"4820",2010-04-11,2009,"Genclerbirligi","Bursaspor","0-0",0,0,"T1",1,0,0,"D"
"4821",2010-04-11,2009,"Kasimpasa","Ankaragucu","2-0",2,0,"T1",1,2,2,"H"
"4822",2010-04-12,2009,"Kayserispor","Sivasspor","2-2",2,2,"T1",1,4,0,"D"
"4823",2010-04-16,2009,"Bursaspor","Gaziantepspor","2-0",2,0,"T1",1,2,2,"H"
"4824",2010-04-17,2009,"Buyuksehyr","Genclerbirligi","1-3",1,3,"T1",1,4,-2,"A"
"4825",2010-04-17,2009,"Manisaspor","Galatasaray","1-2",1,2,"T1",1,3,-1,"A"
"4826",2010-04-18,2009,"Ankaragucu","Eskisehirspor","3-1",3,1,"T1",1,4,2,"H"
"4827",2010-04-18,2009,"Antalyaspor","Denizlispor","2-1",2,1,"T1",1,3,1,"H"
"4828",2010-04-18,2009,"Diyarbakirspor","Kayserispor","0-3",0,3,"T1",1,3,-3,"A"
"4829",2010-04-18,2009,"Fenerbahce","Besiktas","1-0",1,0,"T1",1,1,1,"H"
"4830",2010-04-19,2009,"Trabzonspor","Kasimpasa","2-0",2,0,"T1",1,2,2,"H"
"4831",2010-04-24,2009,"Besiktas","Sivasspor","2-2",2,2,"T1",1,4,0,"D"
"4832",2010-04-24,2009,"Denizlispor","Ankaragucu","0-0",0,0,"T1",1,0,0,"D"
"4833",2010-04-24,2009,"Genclerbirligi","Antalyaspor","0-2",0,2,"T1",1,2,-2,"A"
"4834",2010-04-24,2009,"Kayserispor","Manisaspor","1-2",1,2,"T1",1,3,-1,"A"
"4835",2010-04-25,2009,"Galatasaray","Bursaspor","0-0",0,0,"T1",1,0,0,"D"
"4836",2010-04-25,2009,"Gaziantepspor","Buyuksehyr","2-3",2,3,"T1",1,5,-1,"A"
"4837",2010-04-25,2009,"Kasimpasa","Fenerbahce","0-1",0,1,"T1",1,1,-1,"A"
"4838",2010-04-26,2009,"Eskisehirspor","Trabzonspor","1-0",1,0,"T1",1,1,1,"H"
"4839",2010-05-01,2009,"Ankaragucu","Trabzonspor","1-0",1,0,"T1",1,1,1,"H"
"4840",2010-05-01,2009,"Bursaspor","Kayserispor","2-0",2,0,"T1",1,2,2,"H"
"4841",2010-05-01,2009,"Buyuksehyr","Galatasaray","0-1",0,1,"T1",1,1,-1,"A"
"4842",2010-05-01,2009,"Fenerbahce","Eskisehirspor","2-0",2,0,"T1",1,2,2,"H"
"4843",2010-05-02,2009,"Antalyaspor","Gaziantepspor","1-0",1,0,"T1",1,1,1,"H"
"4844",2010-05-02,2009,"Denizlispor","Genclerbirligi","2-0",2,0,"T1",1,2,2,"H"
"4845",2010-05-02,2009,"Diyarbakirspor","Besiktas","1-3",1,3,"T1",1,4,-2,"A"
"4846",2010-05-02,2009,"Sivasspor","Kasimpasa","1-1",1,1,"T1",1,2,0,"D"
"4847",2010-05-07,2009,"Besiktas","Manisaspor","2-0",2,0,"T1",1,2,2,"H"
"4848",2010-05-08,2009,"Galatasaray","Antalyaspor","1-2",1,2,"T1",1,3,-1,"A"
"4849",2010-05-08,2009,"Gaziantepspor","Genclerbirligi","1-1",1,1,"T1",1,2,0,"D"
"4850",2010-05-09,2009,"Ankaragucu","Fenerbahce","0-3",0,3,"T1",1,3,-3,"A"
"4851",2010-05-09,2009,"Eskisehirspor","Sivasspor","1-1",1,1,"T1",1,2,0,"D"
"4852",2010-05-09,2009,"Kasimpasa","Diyarbakirspor","1-0",1,0,"T1",1,1,1,"H"
"4853",2010-05-09,2009,"Kayserispor","Buyuksehyr","1-1",1,1,"T1",1,2,0,"D"
"4854",2010-05-10,2009,"Trabzonspor","Denizlispor","2-1",2,1,"T1",1,3,1,"H"
"4855",2010-05-15,2009,"Antalyaspor","Kayserispor","4-0",4,0,"T1",1,4,4,"H"
"4856",2010-05-15,2009,"Denizlispor","Gaziantepspor","1-1",1,1,"T1",1,2,0,"D"
"4857",2010-05-15,2009,"Diyarbakirspor","Eskisehirspor","0-2",0,2,"T1",1,2,-2,"A"
"4858",2010-05-15,2009,"Sivasspor","Ankaragucu","3-3",3,3,"T1",1,6,0,"D"
"4859",2010-05-16,2009,"Bursaspor","Besiktas","2-1",2,1,"T1",1,3,1,"H"
"4860",2010-05-16,2009,"Fenerbahce","Trabzonspor","1-1",1,1,"T1",1,2,0,"D"
"4861",2010-05-16,2009,"Genclerbirligi","Galatasaray","2-1",2,1,"T1",1,3,1,"H"
"4862",2010-05-16,2009,"Manisaspor","Kasimpasa","0-0",0,0,"T1",1,0,0,"D"
"4863",2010-08-14,2010,"Bucaspor","Besiktas","0-1",0,1,"T1",1,1,-1,"A"
"4864",2010-08-14,2010,"Eskisehirspor","Genclerbirligi","0-0",0,0,"T1",1,0,0,"D"
"4865",2010-08-14,2010,"Gaziantepspor","Kasimpasa","0-0",0,0,"T1",1,0,0,"D"
"4866",2010-08-14,2010,"Sivasspor","Galatasaray","2-1",2,1,"T1",1,3,1,"H"
"4867",2010-08-15,2010,"Ankaragucu","Trabzonspor","0-2",0,2,"T1",1,2,-2,"A"
"4868",2010-08-15,2010,"Fenerbahce","Antalyaspor","4-0",4,0,"T1",1,4,4,"H"
"4869",2010-08-15,2010,"Karabukspor","Manisaspor","2-1",2,1,"T1",1,3,1,"H"
"4870",2010-08-16,2010,"Bursaspor","Konyaspor","1-0",1,0,"T1",1,1,1,"H"
"4871",2010-08-16,2010,"Buyuksehyr","Kayserispor","0-2",0,2,"T1",1,2,-2,"A"
"4872",2010-08-20,2010,"Kayserispor","Karabukspor","1-0",1,0,"T1",1,1,1,"H"
"4873",2010-08-20,2010,"Konyaspor","Eskisehirspor","2-1",2,1,"T1",1,3,1,"H"
"4874",2010-08-21,2010,"Antalyaspor","Sivasspor","1-1",1,1,"T1",1,2,0,"D"
"4875",2010-08-21,2010,"Besiktas","Buyuksehyr","0-2",0,2,"T1",1,2,-2,"A"
"4876",2010-08-22,2010,"Galatasaray","Bursaspor","0-2",0,2,"T1",1,2,-2,"A"
"4877",2010-08-22,2010,"Genclerbirligi","Gaziantepspor","0-0",0,0,"T1",1,0,0,"D"
"4878",2010-08-22,2010,"Manisaspor","Ankaragucu","0-3",0,3,"T1",1,3,-3,"A"
"4879",2010-08-23,2010,"Kasimpasa","Bucaspor","0-0",0,0,"T1",1,0,0,"D"
"4880",2010-08-23,2010,"Trabzonspor","Fenerbahce","3-2",3,2,"T1",1,5,1,"H"
"4881",2010-08-27,2010,"Ankaragucu","Kayserispor","1-1",1,1,"T1",1,2,0,"D"
"4882",2010-08-27,2010,"Gaziantepspor","Konyaspor","2-2",2,2,"T1",1,4,0,"D"
"4883",2010-08-28,2010,"Bucaspor","Genclerbirligi","3-1",3,1,"T1",1,4,2,"H"
"4884",2010-08-28,2010,"Buyuksehyr","Kasimpasa","3-1",3,1,"T1",1,4,2,"H"
"4885",2010-08-28,2010,"Sivasspor","Bursaspor","0-2",0,2,"T1",1,2,-2,"A"
"4886",2010-08-29,2010,"Eskisehirspor","Galatasaray","1-3",1,3,"T1",1,4,-2,"A"
"4887",2010-08-29,2010,"Fenerbahce","Manisaspor","4-2",4,2,"T1",1,6,2,"H"
"4888",2010-08-29,2010,"Karabukspor","Besiktas","1-4",1,4,"T1",1,5,-3,"A"
"4889",2010-08-30,2010,"Antalyaspor","Trabzonspor","0-0",0,0,"T1",1,0,0,"D"
"4890",2010-09-10,2010,"Bursaspor","Eskisehirspor","2-1",2,1,"T1",1,3,1,"H"
"4891",2010-09-11,2010,"Besiktas","Ankaragucu","4-0",4,0,"T1",1,4,4,"H"
"4892",2010-09-11,2010,"Kayserispor","Fenerbahce","2-0",2,0,"T1",1,2,2,"H"
"4893",2010-09-11,2010,"Konyaspor","Bucaspor","1-1",1,1,"T1",1,2,0,"D"
"4894",2010-09-11,2010,"Manisaspor","Antalyaspor","1-2",1,2,"T1",1,3,-1,"A"
"4895",2010-09-13,2010,"Galatasaray","Gaziantepspor","1-0",1,0,"T1",1,1,1,"H"
"4896",2010-09-13,2010,"Genclerbirligi","Buyuksehyr","2-1",2,1,"T1",1,3,1,"H"
"4897",2010-09-13,2010,"Kasimpasa","Karabukspor","1-2",1,2,"T1",1,3,-1,"A"
"4898",2010-09-13,2010,"Trabzonspor","Sivasspor","6-1",6,1,"T1",1,7,5,"H"
"4899",2010-09-17,2010,"Trabzonspor","Manisaspor","1-3",1,3,"T1",1,4,-2,"A"
"4900",2010-09-18,2010,"Ankaragucu","Kasimpasa","3-0",3,0,"T1",1,3,3,"H"
"4901",2010-09-18,2010,"Antalyaspor","Kayserispor","2-1",2,1,"T1",1,3,1,"H"
"4902",2010-09-18,2010,"Bucaspor","Galatasaray","0-1",0,1,"T1",1,1,-1,"A"
"4903",2010-09-18,2010,"Sivasspor","Eskisehirspor","1-1",1,1,"T1",1,2,0,"D"
"4904",2010-09-19,2010,"Buyuksehyr","Konyaspor","1-0",1,0,"T1",1,1,1,"H"
"4905",2010-09-19,2010,"Fenerbahce","Besiktas","1-1",1,1,"T1",1,2,0,"D"
"4906",2010-09-19,2010,"Karabukspor","Genclerbirligi","3-0",3,0,"T1",1,3,3,"H"
"4907",2010-09-20,2010,"Gaziantepspor","Bursaspor","0-3",0,3,"T1",1,3,-3,"A"
"4908",2010-09-24,2010,"Bursaspor","Bucaspor","1-0",1,0,"T1",1,1,1,"H"
"4909",2010-09-25,2010,"Besiktas","Antalyaspor","2-1",2,1,"T1",1,3,1,"H"
"4910",2010-09-25,2010,"Eskisehirspor","Gaziantepspor","0-1",0,1,"T1",1,1,-1,"A"
"4911",2010-09-25,2010,"Genclerbirligi","Ankaragucu","1-0",1,0,"T1",1,1,1,"H"
"4912",2010-09-26,2010,"Galatasaray","Buyuksehyr","3-1",3,1,"T1",1,4,2,"H"
"4913",2010-09-26,2010,"Kayserispor","Trabzonspor","0-0",0,0,"T1",1,0,0,"D"
"4914",2010-09-26,2010,"Konyaspor","Karabukspor","2-2",2,2,"T1",1,4,0,"D"
"4915",2010-09-26,2010,"Manisaspor","Sivasspor","3-0",3,0,"T1",1,3,3,"H"
"4916",2010-09-27,2010,"Kasimpasa","Fenerbahce","2-6",2,6,"T1",1,8,-4,"A"
"4917",2010-10-01,2010,"Bucaspor","Eskisehirspor","0-0",0,0,"T1",1,0,0,"D"
"4918",2010-10-01,2010,"Karabukspor","Galatasaray","2-1",2,1,"T1",1,3,1,"H"
"4919",2010-10-02,2010,"Ankaragucu","Konyaspor","4-1",4,1,"T1",1,5,3,"H"
"4920",2010-10-02,2010,"Fenerbahce","Genclerbirligi","3-0",3,0,"T1",1,3,3,"H"
"4921",2010-10-02,2010,"Manisaspor","Kayserispor","0-2",0,2,"T1",1,2,-2,"A"
"4922",2010-10-03,2010,"Antalyaspor","Kasimpasa","3-1",3,1,"T1",1,4,2,"H"
"4923",2010-10-03,2010,"Buyuksehyr","Bursaspor","0-0",0,0,"T1",1,0,0,"D"
"4924",2010-10-03,2010,"Sivasspor","Gaziantepspor","1-1",1,1,"T1",1,2,0,"D"
"4925",2010-10-03,2010,"Trabzonspor","Besiktas","1-0",1,0,"T1",1,1,1,"H"
"4926",2010-10-15,2010,"Bursaspor","Karabukspor","2-2",2,2,"T1",1,4,0,"D"
"4927",2010-10-16,2010,"Besiktas","Manisaspor","2-3",2,3,"T1",1,5,-1,"A"
"4928",2010-10-16,2010,"Eskisehirspor","Buyuksehyr","1-0",1,0,"T1",1,1,1,"H"
"4929",2010-10-16,2010,"Gaziantepspor","Bucaspor","2-0",2,0,"T1",1,2,2,"H"
"4930",2010-10-17,2010,"Galatasaray","Ankaragucu","2-4",2,4,"T1",1,6,-2,"A"
"4931",2010-10-17,2010,"Genclerbirligi","Antalyaspor","2-3",2,3,"T1",1,5,-1,"A"
"4932",2010-10-17,2010,"Kasimpasa","Trabzonspor","0-7",0,7,"T1",1,7,-7,"A"
"4933",2010-10-17,2010,"Kayserispor","Sivasspor","4-1",4,1,"T1",1,5,3,"H"
"4934",2010-10-18,2010,"Konyaspor","Fenerbahce","1-4",1,4,"T1",1,5,-3,"A"
"4935",2010-10-22,2010,"Karabukspor","Eskisehirspor","1-2",1,2,"T1",1,3,-1,"A"
"4936",2010-10-22,2010,"Sivasspor","Bucaspor","1-1",1,1,"T1",1,2,0,"D"
"4937",2010-10-23,2010,"Antalyaspor","Konyaspor","1-0",1,0,"T1",1,1,1,"H"
"4938",2010-10-23,2010,"Buyuksehyr","Gaziantepspor","1-0",1,0,"T1",1,1,1,"H"
"4939",2010-10-23,2010,"Trabzonspor","Genclerbirligi","3-1",3,1,"T1",1,4,2,"H"
"4940",2010-10-24,2010,"Ankaragucu","Bursaspor","1-5",1,5,"T1",1,6,-4,"A"
"4941",2010-10-24,2010,"Fenerbahce","Galatasaray","0-0",0,0,"T1",1,0,0,"D"
"4942",2010-10-24,2010,"Manisaspor","Kasimpasa","2-1",2,1,"T1",1,3,1,"H"
"4943",2010-10-25,2010,"Kayserispor","Besiktas","1-0",1,0,"T1",1,1,1,"H"
"4944",2010-10-29,2010,"Bursaspor","Fenerbahce","1-1",1,1,"T1",1,2,0,"D"
"4945",2010-10-30,2010,"Eskisehirspor","Ankaragucu","0-0",0,0,"T1",1,0,0,"D"
"4946",2010-10-30,2010,"Galatasaray","Antalyaspor","2-1",2,1,"T1",1,3,1,"H"
"4947",2010-10-30,2010,"Gaziantepspor","Karabukspor","0-0",0,0,"T1",1,0,0,"D"
"4948",2010-10-31,2010,"Besiktas","Sivasspor","2-1",2,1,"T1",1,3,1,"H"
"4949",2010-10-31,2010,"Bucaspor","Buyuksehyr","0-2",0,2,"T1",1,2,-2,"A"
"4950",2010-10-31,2010,"Genclerbirligi","Manisaspor","2-0",2,0,"T1",1,2,2,"H"
"4951",2010-10-31,2010,"Kasimpasa","Kayserispor","1-2",1,2,"T1",1,3,-1,"A"
"4952",2010-11-01,2010,"Konyaspor","Trabzonspor","1-2",1,2,"T1",1,3,-1,"A"
"4953",2010-11-05,2010,"Kayserispor","Genclerbirligi","1-1",1,1,"T1",1,2,0,"D"
"4954",2010-11-06,2010,"Ankaragucu","Gaziantepspor","0-2",0,2,"T1",1,2,-2,"A"
"4955",2010-11-06,2010,"Antalyaspor","Bursaspor","2-2",2,2,"T1",1,4,0,"D"
"4956",2010-11-06,2010,"Fenerbahce","Eskisehirspor","4-2",4,2,"T1",1,6,2,"H"
"4957",2010-11-06,2010,"Karabukspor","Bucaspor","3-0",3,0,"T1",1,3,3,"H"
"4958",2010-11-07,2010,"Manisaspor","Konyaspor","0-1",0,1,"T1",1,1,-1,"A"
"4959",2010-11-07,2010,"Sivasspor","Buyuksehyr","0-4",0,4,"T1",1,4,-4,"A"
"4960",2010-11-07,2010,"Trabzonspor","Galatasaray","2-0",2,0,"T1",1,2,2,"H"
"4961",2010-11-08,2010,"Besiktas","Kasimpasa","1-1",1,1,"T1",1,2,0,"D"
"4962",2010-11-12,2010,"Konyaspor","Kayserispor","0-1",0,1,"T1",1,1,-1,"A"
"4963",2010-11-13,2010,"Bucaspor","Ankaragucu","0-0",0,0,"T1",1,0,0,"D"
"4964",2010-11-13,2010,"Bursaspor","Trabzonspor","0-2",0,2,"T1",1,2,-2,"A"
"4965",2010-11-13,2010,"Eskisehirspor","Antalyaspor","0-0",0,0,"T1",1,0,0,"D"
"4966",2010-11-13,2010,"Gaziantepspor","Fenerbahce","2-1",2,1,"T1",1,3,1,"H"
"4967",2010-11-14,2010,"Buyuksehyr","Karabukspor","2-1",2,1,"T1",1,3,1,"H"
"4968",2010-11-14,2010,"Galatasaray","Manisaspor","0-2",0,2,"T1",1,2,-2,"A"
"4969",2010-11-14,2010,"Genclerbirligi","Besiktas","0-2",0,2,"T1",1,2,-2,"A"
"4970",2010-11-14,2010,"Kasimpasa","Sivasspor","2-0",2,0,"T1",1,2,2,"H"
"4971",2010-11-20,2010,"Besiktas","Konyaspor","2-2",2,2,"T1",1,4,0,"D"
"4972",2010-11-20,2010,"Kasimpasa","Genclerbirligi","1-1",1,1,"T1",1,2,0,"D"
"4973",2010-11-20,2010,"Manisaspor","Bursaspor","0-2",0,2,"T1",1,2,-2,"A"
"4974",2010-11-20,2010,"Sivasspor","Karabukspor","5-1",5,1,"T1",1,6,4,"H"
"4975",2010-11-21,2010,"Ankaragucu","Buyuksehyr","2-2",2,2,"T1",1,4,0,"D"
"4976",2010-11-21,2010,"Antalyaspor","Gaziantepspor","0-1",0,1,"T1",1,1,-1,"A"
"4977",2010-11-21,2010,"Kayserispor","Galatasaray","0-0",0,0,"T1",1,0,0,"D"
"4978",2010-11-21,2010,"Trabzonspor","Eskisehirspor","0-0",0,0,"T1",1,0,0,"D"
"4979",2010-11-22,2010,"Fenerbahce","Bucaspor","5-2",5,2,"T1",1,7,3,"H"
"4980",2010-11-26,2010,"Eskisehirspor","Manisaspor","2-1",2,1,"T1",1,3,1,"H"
"4981",2010-11-27,2010,"Buyuksehyr","Fenerbahce","0-1",0,1,"T1",1,1,-1,"A"
"4982",2010-11-27,2010,"Gaziantepspor","Trabzonspor","1-3",1,3,"T1",1,4,-2,"A"
"4983",2010-11-27,2010,"Genclerbirligi","Sivasspor","1-1",1,1,"T1",1,2,0,"D"
"4984",2010-11-27,2010,"Konyaspor","Kasimpasa","2-2",2,2,"T1",1,4,0,"D"
"4985",2010-11-28,2010,"Bucaspor","Antalyaspor","1-0",1,0,"T1",1,1,1,"H"
"4986",2010-11-28,2010,"Galatasaray","Besiktas","1-2",1,2,"T1",1,3,-1,"A"
"4987",2010-11-28,2010,"Karabukspor","Ankaragucu","5-1",5,1,"T1",1,6,4,"H"
"4988",2010-11-29,2010,"Bursaspor","Kayserispor","2-0",2,0,"T1",1,2,2,"H"
"4989",2010-12-03,2010,"Trabzonspor","Bucaspor","2-0",2,0,"T1",1,2,2,"H"
"4990",2010-12-04,2010,"Ankaragucu","Sivasspor","1-1",1,1,"T1",1,2,0,"D"
"4991",2010-12-04,2010,"Kasimpasa","Galatasaray","0-3",0,3,"T1",1,3,-3,"A"
"4992",2010-12-04,2010,"Manisaspor","Gaziantepspor","2-0",2,0,"T1",1,2,2,"H"
"4993",2010-12-05,2010,"Antalyaspor","Buyuksehyr","1-0",1,0,"T1",1,1,1,"H"
"4994",2010-12-05,2010,"Besiktas","Bursaspor","1-0",1,0,"T1",1,1,1,"H"
"4995",2010-12-05,2010,"Fenerbahce","Karabukspor","2-1",2,1,"T1",1,3,1,"H"
"4996",2010-12-05,2010,"Konyaspor","Genclerbirligi","2-1",2,1,"T1",1,3,1,"H"
"4997",2010-12-06,2010,"Kayserispor","Eskisehirspor","2-2",2,2,"T1",1,4,0,"D"
"4998",2010-12-10,2010,"Eskisehirspor","Besiktas","2-0",2,0,"T1",1,2,2,"H"
"4999",2010-12-11,2010,"Bucaspor","Manisaspor","1-1",1,1,"T1",1,2,0,"D"
"5000",2010-12-11,2010,"Galatasaray","Genclerbirligi","0-2",0,2,"T1",1,2,-2,"A"
"5001",2010-12-11,2010,"Karabukspor","Antalyaspor","2-0",2,0,"T1",1,2,2,"H"
"5002",2010-12-12,2010,"Ankaragucu","Fenerbahce","2-1",2,1,"T1",1,3,1,"H"
"5003",2010-12-12,2010,"Buyuksehyr","Trabzonspor","1-3",1,3,"T1",1,4,-2,"A"
"5004",2010-12-12,2010,"Gaziantepspor","Kayserispor","2-0",2,0,"T1",1,2,2,"H"
"5005",2010-12-12,2010,"Sivasspor","Konyaspor","1-0",1,0,"T1",1,1,1,"H"
"5006",2010-12-13,2010,"Bursaspor","Kasimpasa","2-1",2,1,"T1",1,3,1,"H"
"5007",2010-12-17,2010,"Trabzonspor","Karabukspor","3-0",3,0,"T1",1,3,3,"H"
"5008",2010-12-18,2010,"Antalyaspor","Ankaragucu","2-2",2,2,"T1",1,4,0,"D"
"5009",2010-12-18,2010,"Fenerbahce","Sivasspor","1-0",1,0,"T1",1,1,1,"H"
"5010",2010-12-18,2010,"Genclerbirligi","Bursaspor","1-5",1,5,"T1",1,6,-4,"A"
"5011",2010-12-18,2010,"Kayserispor","Bucaspor","2-0",2,0,"T1",1,2,2,"H"
"5012",2010-12-19,2010,"Besiktas","Gaziantepspor","1-1",1,1,"T1",1,2,0,"D"
"5013",2010-12-19,2010,"Kasimpasa","Eskisehirspor","0-2",0,2,"T1",1,2,-2,"A"
"5014",2010-12-19,2010,"Konyaspor","Galatasaray","0-1",0,1,"T1",1,1,-1,"A"
"5015",2010-12-19,2010,"Manisaspor","Buyuksehyr","1-0",1,0,"T1",1,1,1,"H"
"5016",2011-01-21,2010,"Besiktas","Bucaspor","5-1",5,1,"T1",1,6,4,"H"
"5017",2011-01-22,2010,"Antalyaspor","Fenerbahce","0-1",0,1,"T1",1,1,-1,"A"
"5018",2011-01-22,2010,"Genclerbirligi","Eskisehirspor","0-1",0,1,"T1",1,1,-1,"A"
"5019",2011-01-22,2010,"Manisaspor","Karabukspor","4-2",4,2,"T1",1,6,2,"H"
"5020",2011-01-22,2010,"Trabzonspor","Ankaragucu","1-1",1,1,"T1",1,2,0,"D"
"5021",2011-01-23,2010,"Galatasaray","Sivasspor","1-0",1,0,"T1",1,1,1,"H"
"5022",2011-01-23,2010,"Kasimpasa","Gaziantepspor","0-1",0,1,"T1",1,1,-1,"A"
"5023",2011-01-23,2010,"Konyaspor","Bursaspor","0-0",0,0,"T1",1,0,0,"D"
"5024",2011-01-24,2010,"Kayserispor","Buyuksehyr","3-2",3,2,"T1",1,5,1,"H"
"5025",2011-01-29,2010,"Bucaspor","Kasimpasa","4-0",4,0,"T1",1,4,4,"H"
"5026",2011-01-29,2010,"Bursaspor","Galatasaray","2-0",2,0,"T1",1,2,2,"H"
"5027",2011-01-29,2010,"Karabukspor","Kayserispor","0-0",0,0,"T1",1,0,0,"D"
"5028",2011-01-29,2010,"Sivasspor","Antalyaspor","1-1",1,1,"T1",1,2,0,"D"
"5029",2011-01-30,2010,"Ankaragucu","Manisaspor","1-3",1,3,"T1",1,4,-2,"A"
"5030",2011-01-30,2010,"Buyuksehyr","Besiktas","2-1",2,1,"T1",1,3,1,"H"
"5031",2011-01-30,2010,"Fenerbahce","Trabzonspor","2-0",2,0,"T1",1,2,2,"H"
"5032",2011-01-30,2010,"Gaziantepspor","Genclerbirligi","1-1",1,1,"T1",1,2,0,"D"
"5033",2011-01-31,2010,"Eskisehirspor","Konyaspor","1-0",1,0,"T1",1,1,1,"H"
"5034",2011-02-04,2010,"Bursaspor","Sivasspor","2-1",2,1,"T1",1,3,1,"H"
"5035",2011-02-05,2010,"Besiktas","Karabukspor","1-1",1,1,"T1",1,2,0,"D"
"5036",2011-02-05,2010,"Kasimpasa","Buyuksehyr","1-3",1,3,"T1",1,4,-2,"A"
"5037",2011-02-05,2010,"Kayserispor","Ankaragucu","2-1",2,1,"T1",1,3,1,"H"
"5038",2011-02-05,2010,"Manisaspor","Fenerbahce","1-3",1,3,"T1",1,4,-2,"A"
"5039",2011-02-06,2010,"Galatasaray","Eskisehirspor","4-2",4,2,"T1",1,6,2,"H"
"5040",2011-02-06,2010,"Genclerbirligi","Bucaspor","1-0",1,0,"T1",1,1,1,"H"
"5041",2011-02-06,2010,"Konyaspor","Gaziantepspor","0-2",0,2,"T1",1,2,-2,"A"
"5042",2011-02-06,2010,"Trabzonspor","Antalyaspor","0-0",0,0,"T1",1,0,0,"D"
"5043",2011-02-12,2010,"Bucaspor","Konyaspor","3-2",3,2,"T1",1,5,1,"H"
"5044",2011-02-12,2010,"Buyuksehyr","Genclerbirligi","0-1",0,1,"T1",1,1,-1,"A"
"5045",2011-02-12,2010,"Gaziantepspor","Galatasaray","1-0",1,0,"T1",1,1,1,"H"
"5046",2011-02-12,2010,"Sivasspor","Trabzonspor","2-3",2,3,"T1",1,5,-1,"A"
"5047",2011-02-13,2010,"Ankaragucu","Besiktas","1-0",1,0,"T1",1,1,1,"H"
"5048",2011-02-13,2010,"Antalyaspor","Manisaspor","1-4",1,4,"T1",1,5,-3,"A"
"5049",2011-02-13,2010,"Eskisehirspor","Bursaspor","1-1",1,1,"T1",1,2,0,"D"
"5050",2011-02-13,2010,"Karabukspor","Kasimpasa","1-3",1,3,"T1",1,4,-2,"A"
"5051",2011-02-14,2010,"Fenerbahce","Kayserispor","2-0",2,0,"T1",1,2,2,"H"
"5052",2011-02-18,2010,"Eskisehirspor","Sivasspor","2-1",2,1,"T1",1,3,1,"H"
"5053",2011-02-19,2010,"Bursaspor","Gaziantepspor","1-4",1,4,"T1",1,5,-3,"A"
"5054",2011-02-19,2010,"Galatasaray","Bucaspor","1-0",1,0,"T1",1,1,1,"H"
"5055",2011-02-19,2010,"Genclerbirligi","Karabukspor","2-3",2,3,"T1",1,5,-1,"A"
"5056",2011-02-19,2010,"Kasimpasa","Ankaragucu","2-1",2,1,"T1",1,3,1,"H"
"5057",2011-02-20,2010,"Besiktas","Fenerbahce","2-4",2,4,"T1",1,6,-2,"A"
"5058",2011-02-20,2010,"Kayserispor","Antalyaspor","2-0",2,0,"T1",1,2,2,"H"
"5059",2011-02-20,2010,"Konyaspor","Buyuksehyr","0-0",0,0,"T1",1,0,0,"D"
"5060",2011-02-21,2010,"Manisaspor","Trabzonspor","1-2",1,2,"T1",1,3,-1,"A"
"5061",2011-02-25,2010,"Bucaspor","Bursaspor","0-2",0,2,"T1",1,2,-2,"A"
"5062",2011-02-26,2010,"Ankaragucu","Genclerbirligi","2-4",2,4,"T1",1,6,-2,"A"
"5063",2011-02-26,2010,"Buyuksehyr","Galatasaray","3-1",3,1,"T1",1,4,2,"H"
"5064",2011-02-26,2010,"Fenerbahce","Kasimpasa","2-0",2,0,"T1",1,2,2,"H"
"5065",2011-02-26,2010,"Gaziantepspor","Eskisehirspor","2-1",2,1,"T1",1,3,1,"H"
"5066",2011-02-27,2010,"Karabukspor","Konyaspor","2-1",2,1,"T1",1,3,1,"H"
"5067",2011-02-27,2010,"Sivasspor","Manisaspor","4-2",4,2,"T1",1,6,2,"H"
"5068",2011-02-27,2010,"Trabzonspor","Kayserispor","3-3",3,3,"T1",1,6,0,"D"
"5069",2011-02-28,2010,"Antalyaspor","Besiktas","0-2",0,2,"T1",1,2,-2,"A"
"5070",2011-03-04,2010,"Kayserispor","Manisaspor","1-2",1,2,"T1",1,3,-1,"A"
"5071",2011-03-05,2010,"Galatasaray","Karabukspor","0-0",0,0,"T1",1,0,0,"D"
"5072",2011-03-05,2010,"Gaziantepspor","Sivasspor","3-1",3,1,"T1",1,4,2,"H"
"5073",2011-03-05,2010,"Konyaspor","Ankaragucu","0-2",0,2,"T1",1,2,-2,"A"
"5074",2011-03-06,2010,"Besiktas","Trabzonspor","1-2",1,2,"T1",1,3,-1,"A"
"5075",2011-03-06,2010,"Bursaspor","Buyuksehyr","1-1",1,1,"T1",1,2,0,"D"
"5076",2011-03-06,2010,"Eskisehirspor","Bucaspor","1-0",1,0,"T1",1,1,1,"H"
"5077",2011-03-06,2010,"Kasimpasa","Antalyaspor","2-3",2,3,"T1",1,5,-1,"A"
"5078",2011-03-07,2010,"Genclerbirligi","Fenerbahce","2-4",2,4,"T1",1,6,-2,"A"
"5079",2011-03-11,2010,"Manisaspor","Besiktas","0-0",0,0,"T1",1,0,0,"D"
"5080",2011-03-12,2010,"Buyuksehyr","Eskisehirspor","0-2",0,2,"T1",1,2,-2,"A"
"5081",2011-03-12,2010,"Karabukspor","Bursaspor","1-1",1,1,"T1",1,2,0,"D"
"5082",2011-03-12,2010,"Trabzonspor","Kasimpasa","1-0",1,0,"T1",1,1,1,"H"
"5083",2011-03-13,2010,"Ankaragucu","Galatasaray","3-2",3,2,"T1",1,5,1,"H"
"5084",2011-03-13,2010,"Antalyaspor","Genclerbirligi","0-0",0,0,"T1",1,0,0,"D"
"5085",2011-03-13,2010,"Bucaspor","Gaziantepspor","2-1",2,1,"T1",1,3,1,"H"
"5086",2011-03-13,2010,"Fenerbahce","Konyaspor","2-0",2,0,"T1",1,2,2,"H"
"5087",2011-03-13,2010,"Sivasspor","Kayserispor","1-0",1,0,"T1",1,1,1,"H"
"5088",2011-03-18,2010,"Galatasaray","Fenerbahce","1-2",1,2,"T1",1,3,-1,"A"
"5089",2011-03-19,2010,"Besiktas","Kayserispor","4-2",4,2,"T1",1,6,2,"H"
"5090",2011-03-19,2010,"Gaziantepspor","Buyuksehyr","4-1",4,1,"T1",1,5,3,"H"
"5091",2011-03-19,2010,"Kasimpasa","Manisaspor","1-0",1,0,"T1",1,1,1,"H"
"5092",2011-03-19,2010,"Konyaspor","Antalyaspor","0-0",0,0,"T1",1,0,0,"D"
"5093",2011-03-20,2010,"Bucaspor","Sivasspor","0-4",0,4,"T1",1,4,-4,"A"
"5094",2011-03-20,2010,"Eskisehirspor","Karabukspor","1-0",1,0,"T1",1,1,1,"H"
"5095",2011-03-20,2010,"Genclerbirligi","Trabzonspor","1-2",1,2,"T1",1,3,-1,"A"
"5096",2011-03-21,2010,"Bursaspor","Ankaragucu","0-0",0,0,"T1",1,0,0,"D"
"5097",2011-04-02,2010,"Ankaragucu","Eskisehirspor","2-2",2,2,"T1",1,4,0,"D"
"5098",2011-04-02,2010,"Karabukspor","Gaziantepspor","3-2",3,2,"T1",1,5,1,"H"
"5099",2011-04-02,2010,"Sivasspor","Besiktas","1-0",1,0,"T1",1,1,1,"H"
"5100",2011-04-02,2010,"Trabzonspor","Konyaspor","1-0",1,0,"T1",1,1,1,"H"
"5101",2011-04-03,2010,"Buyuksehyr","Bucaspor","2-1",2,1,"T1",1,3,1,"H"
"5102",2011-04-03,2010,"Fenerbahce","Bursaspor","0-0",0,0,"T1",1,0,0,"D"
"5103",2011-04-03,2010,"Kayserispor","Kasimpasa","1-3",1,3,"T1",1,4,-2,"A"
"5104",2011-04-03,2010,"Manisaspor","Genclerbirligi","0-3",0,3,"T1",1,3,-3,"A"
"5105",2011-04-04,2010,"Antalyaspor","Galatasaray","3-0",3,0,"T1",1,3,3,"H"
"5106",2011-04-08,2010,"Bursaspor","Antalyaspor","2-3",2,3,"T1",1,5,-1,"A"
"5107",2011-04-09,2010,"Bucaspor","Karabukspor","2-1",2,1,"T1",1,3,1,"H"
"5108",2011-04-09,2010,"Eskisehirspor","Fenerbahce","1-3",1,3,"T1",1,4,-2,"A"
"5109",2011-04-09,2010,"Konyaspor","Manisaspor","0-0",0,0,"T1",1,0,0,"D"
"5110",2011-04-10,2010,"Buyuksehyr","Sivasspor","1-2",1,2,"T1",1,3,-1,"A"
"5111",2011-04-10,2010,"Galatasaray","Trabzonspor","0-1",0,1,"T1",1,1,-1,"A"
"5112",2011-04-10,2010,"Gaziantepspor","Ankaragucu","3-2",3,2,"T1",1,5,1,"H"
"5113",2011-04-10,2010,"Genclerbirligi","Kayserispor","4-1",4,1,"T1",1,5,3,"H"
"5114",2011-04-11,2010,"Kasimpasa","Besiktas","0-1",0,1,"T1",1,1,-1,"A"
"5115",2011-04-15,2010,"Besiktas","Genclerbirligi","2-2",2,2,"T1",1,4,0,"D"
"5116",2011-04-16,2010,"Ankaragucu","Bucaspor","5-3",5,3,"T1",1,8,2,"H"
"5117",2011-04-16,2010,"Fenerbahce","Gaziantepspor","1-0",1,0,"T1",1,1,1,"H"
"5118",2011-04-16,2010,"Karabukspor","Buyuksehyr","0-2",0,2,"T1",1,2,-2,"A"
"5119",2011-04-17,2010,"Antalyaspor","Eskisehirspor","2-2",2,2,"T1",1,4,0,"D"
"5120",2011-04-17,2010,"Kayserispor","Konyaspor","1-3",1,3,"T1",1,4,-2,"A"
"5121",2011-04-17,2010,"Sivasspor","Kasimpasa","1-1",1,1,"T1",1,2,0,"D"
"5122",2011-04-17,2010,"Trabzonspor","Bursaspor","1-0",1,0,"T1",1,1,1,"H"
"5123",2011-04-18,2010,"Manisaspor","Galatasaray","2-3",2,3,"T1",1,5,-1,"A"
"5124",2011-04-22,2010,"Eskisehirspor","Trabzonspor","0-0",0,0,"T1",1,0,0,"D"
"5125",2011-04-23,2010,"Bursaspor","Manisaspor","2-1",2,1,"T1",1,3,1,"H"
"5126",2011-04-23,2010,"Galatasaray","Kayserispor","1-1",1,1,"T1",1,2,0,"D"
"5127",2011-04-23,2010,"Karabukspor","Sivasspor","2-1",2,1,"T1",1,3,1,"H"
"5128",2011-04-24,2010,"Bucaspor","Fenerbahce","3-5",3,5,"T1",1,8,-2,"A"
"5129",2011-04-24,2010,"Buyuksehyr","Ankaragucu","1-4",1,4,"T1",1,5,-3,"A"
"5130",2011-04-24,2010,"Gaziantepspor","Antalyaspor","2-1",2,1,"T1",1,3,1,"H"
"5131",2011-04-24,2010,"Genclerbirligi","Kasimpasa","1-1",1,1,"T1",1,2,0,"D"
"5132",2011-04-25,2010,"Konyaspor","Besiktas","1-1",1,1,"T1",1,2,0,"D"
"5133",2011-04-29,2010,"Sivasspor","Genclerbirligi","1-1",1,1,"T1",1,2,0,"D"
"5134",2011-04-30,2010,"Antalyaspor","Bucaspor","3-3",3,3,"T1",1,6,0,"D"
"5135",2011-04-30,2010,"Besiktas","Galatasaray","2-0",2,0,"T1",1,2,2,"H"
"5136",2011-04-30,2010,"Kasimpasa","Konyaspor","2-2",2,2,"T1",1,4,0,"D"
"5137",2011-05-01,2010,"Fenerbahce","Buyuksehyr","2-0",2,0,"T1",1,2,2,"H"
"5138",2011-05-01,2010,"Kayserispor","Bursaspor","1-0",1,0,"T1",1,1,1,"H"
"5139",2011-05-01,2010,"Manisaspor","Eskisehirspor","3-1",3,1,"T1",1,4,2,"H"
"5140",2011-05-01,2010,"Trabzonspor","Gaziantepspor","3-0",3,0,"T1",1,3,3,"H"
"5141",2011-05-02,2010,"Ankaragucu","Karabukspor","0-0",0,0,"T1",1,0,0,"D"
"5142",2011-05-06,2010,"Eskisehirspor","Kayserispor","1-2",1,2,"T1",1,3,-1,"A"
"5143",2011-05-07,2010,"Bursaspor","Besiktas","0-3",0,3,"T1",1,3,-3,"A"
"5144",2011-05-07,2010,"Buyuksehyr","Antalyaspor","1-1",1,1,"T1",1,2,0,"D"
"5145",2011-05-07,2010,"Gaziantepspor","Manisaspor","1-0",1,0,"T1",1,1,1,"H"
"5146",2011-05-08,2010,"Bucaspor","Trabzonspor","1-2",1,2,"T1",1,3,-1,"A"
"5147",2011-05-08,2010,"Genclerbirligi","Konyaspor","2-1",2,1,"T1",1,3,1,"H"
"5148",2011-05-08,2010,"Karabukspor","Fenerbahce","0-1",0,1,"T1",1,1,-1,"A"
"5149",2011-05-08,2010,"Sivasspor","Ankaragucu","1-1",1,1,"T1",1,2,0,"D"
"5150",2011-05-09,2010,"Galatasaray","Kasimpasa","3-1",3,1,"T1",1,4,2,"H"
"5151",2011-05-13,2010,"Antalyaspor","Karabukspor","1-2",1,2,"T1",1,3,-1,"A"
"5152",2011-05-14,2010,"Genclerbirligi","Galatasaray","2-3",2,3,"T1",1,5,-1,"A"
"5153",2011-05-14,2010,"Konyaspor","Sivasspor","1-1",1,1,"T1",1,2,0,"D"
"5154",2011-05-14,2010,"Manisaspor","Bucaspor","4-2",4,2,"T1",1,6,2,"H"
"5155",2011-05-15,2010,"Fenerbahce","Ankaragucu","6-0",6,0,"T1",1,6,6,"H"
"5156",2011-05-15,2010,"Kasimpasa","Bursaspor","0-3",0,3,"T1",1,3,-3,"A"
"5157",2011-05-15,2010,"Kayserispor","Gaziantepspor","1-2",1,2,"T1",1,3,-1,"A"
"5158",2011-05-15,2010,"Trabzonspor","Buyuksehyr","3-1",3,1,"T1",1,4,2,"H"
"5159",2011-05-16,2010,"Besiktas","Eskisehirspor","3-1",3,1,"T1",1,4,2,"H"
"5160",2011-05-20,2010,"Buyuksehyr","Manisaspor","0-0",0,0,"T1",1,0,0,"D"
"5161",2011-05-20,2010,"Galatasaray","Konyaspor","2-0",2,0,"T1",1,2,2,"H"
"5162",2011-05-21,2010,"Ankaragucu","Antalyaspor","2-3",2,3,"T1",1,5,-1,"A"
"5163",2011-05-21,2010,"Bucaspor","Kayserispor","3-3",3,3,"T1",1,6,0,"D"
"5164",2011-05-21,2010,"Bursaspor","Genclerbirligi","1-0",1,0,"T1",1,1,1,"H"
"5165",2011-05-21,2010,"Gaziantepspor","Besiktas","0-0",0,0,"T1",1,0,0,"D"
"5166",2011-05-22,2010,"Eskisehirspor","Kasimpasa","4-0",4,0,"T1",1,4,4,"H"
"5167",2011-05-22,2010,"Karabukspor","Trabzonspor","0-4",0,4,"T1",1,4,-4,"A"
"5168",2011-05-22,2010,"Sivasspor","Fenerbahce","3-4",3,4,"T1",1,7,-1,"A"
"5169",2011-09-10,2011,"Ankaragucu","Mersin Idman Yurdu","1-2",1,2,"T1",1,3,-1,"A"
"5170",2011-09-10,2011,"Eskisehirspor","Besiktas","2-1",2,1,"T1",1,3,1,"H"
"5171",2011-09-10,2011,"Manisaspor","Trabzonspor","1-1",1,1,"T1",1,2,0,"D"
"5172",2011-09-10,2011,"Samsunspor","Genclerbirligi","3-2",3,2,"T1",1,5,1,"H"
"5173",2011-09-11,2011,"Antalyaspor","Gaziantepspor","1-0",1,0,"T1",1,1,1,"H"
"5174",2011-09-11,2011,"Bursaspor","Kayserispor","3-0",3,0,"T1",1,3,3,"H"
"5175",2011-09-11,2011,"Buyuksehyr","Galatasaray","2-0",2,0,"T1",1,2,2,"H"
"5176",2011-09-11,2011,"Karabukspor","Sivasspor","2-1",2,1,"T1",1,3,1,"H"
"5177",2011-09-12,2011,"Fenerbahce","Orduspor","1-0",1,0,"T1",1,1,1,"H"
"5178",2011-09-16,2011,"Gaziantepspor","Fenerbahce","1-3",1,3,"T1",1,4,-2,"A"
"5179",2011-09-16,2011,"Kayserispor","Antalyaspor","0-1",0,1,"T1",1,1,-1,"A"
"5180",2011-09-17,2011,"Genclerbirligi","Karabukspor","2-1",2,1,"T1",1,3,1,"H"
"5181",2011-09-17,2011,"Orduspor","Manisaspor","1-0",1,0,"T1",1,1,1,"H"
"5182",2011-09-17,2011,"Trabzonspor","Buyuksehyr","0-1",0,1,"T1",1,1,-1,"A"
"5183",2011-09-18,2011,"Galatasaray","Samsunspor","3-1",3,1,"T1",1,4,2,"H"
"5184",2011-09-18,2011,"Mersin Idman Yurdu","Bursaspor","1-3",1,3,"T1",1,4,-2,"A"
"5185",2011-09-18,2011,"Sivasspor","Eskisehirspor","0-4",0,4,"T1",1,4,-4,"A"
"5186",2011-09-19,2011,"Besiktas","Ankaragucu","3-1",3,1,"T1",1,4,2,"H"
"5187",2011-09-20,2011,"Buyuksehyr","Orduspor","1-1",1,1,"T1",1,2,0,"D"
"5188",2011-09-20,2011,"Fenerbahce","Manisaspor","1-1",1,1,"T1",1,2,0,"D"
"5189",2011-09-20,2011,"Gaziantepspor","Kayserispor","1-2",1,2,"T1",1,3,-1,"A"
"5190",2011-09-21,2011,"Antalyaspor","Mersin Idman Yurdu","1-2",1,2,"T1",1,3,-1,"A"
"5191",2011-09-21,2011,"Eskisehirspor","Genclerbirligi","0-0",0,0,"T1",1,0,0,"D"
"5192",2011-09-21,2011,"Karabukspor","Galatasaray","1-1",1,1,"T1",1,2,0,"D"
"5193",2011-09-21,2011,"Samsunspor","Trabzonspor","1-1",1,1,"T1",1,2,0,"D"
"5194",2011-09-22,2011,"Ankaragucu","Sivasspor","1-2",1,2,"T1",1,3,-1,"A"
"5195",2011-09-22,2011,"Bursaspor","Besiktas","1-2",1,2,"T1",1,3,-1,"A"
"5196",2011-09-23,2011,"Kayserispor","Fenerbahce","0-1",0,1,"T1",1,1,-1,"A"
"5197",2011-09-24,2011,"Manisaspor","Buyuksehyr","0-2",0,2,"T1",1,2,-2,"A"
"5198",2011-09-24,2011,"Mersin Idman Yurdu","Gaziantepspor","2-0",2,0,"T1",1,2,2,"H"
"5199",2011-09-24,2011,"Trabzonspor","Karabukspor","3-1",3,1,"T1",1,4,2,"H"
"5200",2011-09-25,2011,"Besiktas","Antalyaspor","1-0",1,0,"T1",1,1,1,"H"
"5201",2011-09-25,2011,"Genclerbirligi","Ankaragucu","1-1",1,1,"T1",1,2,0,"D"
"5202",2011-09-25,2011,"Orduspor","Samsunspor","0-0",0,0,"T1",1,0,0,"D"
"5203",2011-09-25,2011,"Sivasspor","Bursaspor","3-0",3,0,"T1",1,3,3,"H"
"5204",2011-09-26,2011,"Galatasaray","Eskisehirspor","2-0",2,0,"T1",1,2,2,"H"
"5205",2011-09-30,2011,"Bursaspor","Genclerbirligi","4-0",4,0,"T1",1,4,4,"H"
"5206",2011-10-01,2011,"Antalyaspor","Sivasspor","2-2",2,2,"T1",1,4,0,"D"
"5207",2011-10-01,2011,"Fenerbahce","Buyuksehyr","4-2",4,2,"T1",1,6,2,"H"
"5208",2011-10-01,2011,"Karabukspor","Orduspor","1-2",1,2,"T1",1,3,-1,"A"
"5209",2011-10-02,2011,"Ankaragucu","Galatasaray","0-3",0,3,"T1",1,3,-3,"A"
"5210",2011-10-02,2011,"Eskisehirspor","Trabzonspor","0-2",0,2,"T1",1,2,-2,"A"
"5211",2011-10-02,2011,"Kayserispor","Mersin Idman Yurdu","2-2",2,2,"T1",1,4,0,"D"
"5212",2011-10-02,2011,"Samsunspor","Manisaspor","1-2",1,2,"T1",1,3,-1,"A"
"5213",2011-10-03,2011,"Gaziantepspor","Besiktas","0-0",0,0,"T1",1,0,0,"D"
"5214",2011-10-14,2011,"Trabzonspor","Ankaragucu","3-2",3,2,"T1",1,5,1,"H"
"5215",2011-10-15,2011,"Besiktas","Kayserispor","0-2",0,2,"T1",1,2,-2,"A"
"5216",2011-10-15,2011,"Orduspor","Eskisehirspor","2-1",2,1,"T1",1,3,1,"H"
"5217",2011-10-15,2011,"Sivasspor","Gaziantepspor","0-0",0,0,"T1",1,0,0,"D"
"5218",2011-10-16,2011,"Buyuksehyr","Samsunspor","3-0",3,0,"T1",1,3,3,"H"
"5219",2011-10-16,2011,"Galatasaray","Bursaspor","2-1",2,1,"T1",1,3,1,"H"
"5220",2011-10-16,2011,"Genclerbirligi","Antalyaspor","3-0",3,0,"T1",1,3,3,"H"
"5221",2011-10-16,2011,"Manisaspor","Karabukspor","2-1",2,1,"T1",1,3,1,"H"
"5222",2011-10-17,2011,"Mersin Idman Yurdu","Fenerbahce","1-2",1,2,"T1",1,3,-1,"A"
"5223",2011-10-21,2011,"Antalyaspor","Galatasaray","0-0",0,0,"T1",1,0,0,"D"
"5224",2011-10-22,2011,"Bursaspor","Trabzonspor","1-1",1,1,"T1",1,2,0,"D"
"5225",2011-10-22,2011,"Eskisehirspor","Manisaspor","0-2",0,2,"T1",1,2,-2,"A"
"5226",2011-10-22,2011,"Karabukspor","Buyuksehyr","2-0",2,0,"T1",1,2,2,"H"
"5227",2011-10-23,2011,"Ankaragucu","Orduspor","0-2",0,2,"T1",1,2,-2,"A"
"5228",2011-10-23,2011,"Fenerbahce","Samsunspor","0-0",0,0,"T1",1,0,0,"D"
"5229",2011-10-23,2011,"Gaziantepspor","Genclerbirligi","3-0",3,0,"T1",1,3,3,"H"
"5230",2011-10-23,2011,"Kayserispor","Sivasspor","6-2",6,2,"T1",1,8,4,"H"
"5231",2011-10-24,2011,"Mersin Idman Yurdu","Besiktas","0-1",0,1,"T1",1,1,-1,"A"
"5232",2011-10-26,2011,"Buyuksehyr","Eskisehirspor","2-2",2,2,"T1",1,4,0,"D"
"5233",2011-10-26,2011,"Galatasaray","Gaziantepspor","2-4",2,4,"T1",1,6,-2,"A"
"5234",2011-10-26,2011,"Orduspor","Bursaspor","1-1",1,1,"T1",1,2,0,"D"
"5235",2011-10-26,2011,"Samsunspor","Karabukspor","0-0",0,0,"T1",1,0,0,"D"
"5236",2011-10-26,2011,"Trabzonspor","Antalyaspor","2-2",2,2,"T1",1,4,0,"D"
"5237",2011-10-27,2011,"Besiktas","Fenerbahce","2-2",2,2,"T1",1,4,0,"D"
"5238",2011-10-27,2011,"Genclerbirligi","Kayserispor","1-0",1,0,"T1",1,1,1,"H"
"5239",2011-10-27,2011,"Manisaspor","Ankaragucu","2-0",2,0,"T1",1,2,2,"H"
"5240",2011-10-27,2011,"Sivasspor","Mersin Idman Yurdu","1-0",1,0,"T1",1,1,1,"H"
"5241",2011-10-29,2011,"Antalyaspor","Orduspor","1-1",1,1,"T1",1,2,0,"D"
"5242",2011-10-29,2011,"Eskisehirspor","Samsunspor","1-0",1,0,"T1",1,1,1,"H"
"5243",2011-10-29,2011,"Gaziantepspor","Trabzonspor","0-1",0,1,"T1",1,1,-1,"A"
"5244",2011-10-30,2011,"Ankaragucu","Buyuksehyr","1-2",1,2,"T1",1,3,-1,"A"
"5245",2011-10-30,2011,"Besiktas","Sivasspor","3-1",3,1,"T1",1,4,2,"H"
"5246",2011-10-30,2011,"Bursaspor","Manisaspor","0-0",0,0,"T1",1,0,0,"D"
"5247",2011-10-30,2011,"Kayserispor","Galatasaray","0-2",0,2,"T1",1,2,-2,"A"
"5248",2011-10-31,2011,"Fenerbahce","Karabukspor","1-0",1,0,"T1",1,1,1,"H"
"5249",2011-10-31,2011,"Mersin Idman Yurdu","Genclerbirligi","2-1",2,1,"T1",1,3,1,"H"
"5250",2011-11-04,2011,"Samsunspor","Ankaragucu","2-2",2,2,"T1",1,4,0,"D"
"5251",2011-11-04,2011,"Sivasspor","Fenerbahce","2-0",2,0,"T1",1,2,2,"H"
"5252",2011-11-05,2011,"Galatasaray","Mersin Idman Yurdu","0-0",0,0,"T1",1,0,0,"D"
"5253",2011-11-05,2011,"Karabukspor","Eskisehirspor","1-2",1,2,"T1",1,3,-1,"A"
"5254",2011-11-05,2011,"Manisaspor","Antalyaspor","1-0",1,0,"T1",1,1,1,"H"
"5255",2011-11-05,2011,"Orduspor","Gaziantepspor","0-0",0,0,"T1",1,0,0,"D"
"5256",2011-11-06,2011,"Buyuksehyr","Bursaspor","0-0",0,0,"T1",1,0,0,"D"
"5257",2011-11-06,2011,"Genclerbirligi","Besiktas","4-2",4,2,"T1",1,6,2,"H"
"5258",2011-11-06,2011,"Trabzonspor","Kayserispor","2-1",2,1,"T1",1,3,1,"H"
"5259",2011-11-18,2011,"Mersin Idman Yurdu","Trabzonspor","1-1",1,1,"T1",1,2,0,"D"
"5260",2011-11-19,2011,"Ankaragucu","Karabukspor","2-1",2,1,"T1",1,3,1,"H"
"5261",2011-11-19,2011,"Fenerbahce","Eskisehirspor","1-0",1,0,"T1",1,1,1,"H"
"5262",2011-11-19,2011,"Kayserispor","Orduspor","1-0",1,0,"T1",1,1,1,"H"
"5263",2011-11-20,2011,"Antalyaspor","Buyuksehyr","2-1",2,1,"T1",1,3,1,"H"
"5264",2011-11-20,2011,"Besiktas","Galatasaray","0-0",0,0,"T1",1,0,0,"D"
"5265",2011-11-20,2011,"Gaziantepspor","Manisaspor","1-1",1,1,"T1",1,2,0,"D"
"5266",2011-11-20,2011,"Sivasspor","Genclerbirligi","1-1",1,1,"T1",1,2,0,"D"
"5267",2011-11-21,2011,"Bursaspor","Samsunspor","1-0",1,0,"T1",1,1,1,"H"
"5268",2011-11-25,2011,"Genclerbirligi","Fenerbahce","0-0",0,0,"T1",1,0,0,"D"
"5269",2011-11-26,2011,"Galatasaray","Sivasspor","2-1",2,1,"T1",1,3,1,"H"
"5270",2011-11-26,2011,"Orduspor","Mersin Idman Yurdu","0-1",0,1,"T1",1,1,-1,"A"
"5271",2011-11-26,2011,"Samsunspor","Antalyaspor","1-0",1,0,"T1",1,1,1,"H"
"5272",2011-11-27,2011,"Buyuksehyr","Gaziantepspor","3-1",3,1,"T1",1,4,2,"H"
"5273",2011-11-27,2011,"Eskisehirspor","Ankaragucu","3-2",3,2,"T1",1,5,1,"H"
"5274",2011-11-27,2011,"Manisaspor","Kayserispor","1-0",1,0,"T1",1,1,1,"H"
"5275",2011-11-27,2011,"Trabzonspor","Besiktas","0-1",0,1,"T1",1,1,-1,"A"
"5276",2011-11-28,2011,"Karabukspor","Bursaspor","3-1",3,1,"T1",1,4,2,"H"
"5277",2011-12-02,2011,"Sivasspor","Trabzonspor","2-2",2,2,"T1",1,4,0,"D"
"5278",2011-12-03,2011,"Fenerbahce","Ankaragucu","4-2",4,2,"T1",1,6,2,"H"
"5279",2011-12-03,2011,"Gaziantepspor","Samsunspor","1-0",1,0,"T1",1,1,1,"H"
"5280",2011-12-03,2011,"Genclerbirligi","Galatasaray","0-1",0,1,"T1",1,1,-1,"A"
"5281",2011-12-04,2011,"Antalyaspor","Karabukspor","2-1",2,1,"T1",1,3,1,"H"
"5282",2011-12-04,2011,"Bursaspor","Eskisehirspor","0-1",0,1,"T1",1,1,-1,"A"
"5283",2011-12-04,2011,"Kayserispor","Buyuksehyr","1-0",1,0,"T1",1,1,1,"H"
"5284",2011-12-04,2011,"Mersin Idman Yurdu","Manisaspor","0-0",0,0,"T1",1,0,0,"D"
"5285",2011-12-05,2011,"Besiktas","Orduspor","2-1",2,1,"T1",1,3,1,"H"
"5286",2011-12-07,2011,"Eskisehirspor","Antalyaspor","1-0",1,0,"T1",1,1,1,"H"
"5287",2011-12-07,2011,"Galatasaray","Fenerbahce","3-1",3,1,"T1",1,4,2,"H"
"5288",2011-12-07,2011,"Karabukspor","Gaziantepspor","0-0",0,0,"T1",1,0,0,"D"
"5289",2011-12-08,2011,"Ankaragucu","Bursaspor","0-0",0,0,"T1",1,0,0,"D"
"5290",2011-12-08,2011,"Buyuksehyr","Mersin Idman Yurdu","0-0",0,0,"T1",1,0,0,"D"
"5291",2011-12-08,2011,"Manisaspor","Besiktas","1-4",1,4,"T1",1,5,-3,"A"
"5292",2011-12-08,2011,"Orduspor","Sivasspor","1-2",1,2,"T1",1,3,-1,"A"
"5293",2011-12-08,2011,"Samsunspor","Kayserispor","0-1",0,1,"T1",1,1,-1,"A"
"5294",2011-12-10,2011,"Gaziantepspor","Eskisehirspor","0-1",0,1,"T1",1,1,-1,"A"
"5295",2011-12-11,2011,"Antalyaspor","Ankaragucu","1-0",1,0,"T1",1,1,1,"H"
"5296",2011-12-11,2011,"Besiktas","Buyuksehyr","1-1",1,1,"T1",1,2,0,"D"
"5297",2011-12-11,2011,"Genclerbirligi","Orduspor","3-1",3,1,"T1",1,4,2,"H"
"5298",2011-12-11,2011,"Mersin Idman Yurdu","Samsunspor","1-0",1,0,"T1",1,1,1,"H"
"5299",2011-12-11,2011,"Trabzonspor","Galatasaray","0-3",0,3,"T1",1,3,-3,"A"
"5300",2011-12-12,2011,"Bursaspor","Fenerbahce","0-2",0,2,"T1",1,2,-2,"A"
"5301",2011-12-12,2011,"Kayserispor","Karabukspor","2-0",2,0,"T1",1,2,2,"H"
"5302",2011-12-12,2011,"Sivasspor","Manisaspor","2-2",2,2,"T1",1,4,0,"D"
"5303",2011-12-14,2011,"Trabzonspor","Genclerbirligi","1-2",1,2,"T1",1,3,-1,"A"
"5304",2011-12-16,2011,"Orduspor","Galatasaray","0-2",0,2,"T1",1,2,-2,"A"
"5305",2011-12-17,2011,"Ankaragucu","Gaziantepspor","0-0",0,0,"T1",1,0,0,"D"
"5306",2011-12-17,2011,"Bursaspor","Antalyaspor","0-0",0,0,"T1",1,0,0,"D"
"5307",2011-12-17,2011,"Eskisehirspor","Kayserispor","1-0",1,0,"T1",1,1,1,"H"
"5308",2011-12-17,2011,"Karabukspor","Mersin Idman Yurdu","3-5",3,5,"T1",1,8,-2,"A"
"5309",2011-12-18,2011,"Buyuksehyr","Sivasspor","1-1",1,1,"T1",1,2,0,"D"
"5310",2011-12-18,2011,"Fenerbahce","Trabzonspor","1-0",1,0,"T1",1,1,1,"H"
"5311",2011-12-18,2011,"Manisaspor","Genclerbirligi","0-1",0,1,"T1",1,1,-1,"A"
"5312",2011-12-18,2011,"Samsunspor","Besiktas","1-1",1,1,"T1",1,2,0,"D"
"5313",2011-12-21,2011,"Antalyaspor","Fenerbahce","0-0",0,0,"T1",1,0,0,"D"
"5314",2011-12-21,2011,"Galatasaray","Manisaspor","1-0",1,0,"T1",1,1,1,"H"
"5315",2011-12-21,2011,"Kayserispor","Ankaragucu","3-0",3,0,"T1",1,3,3,"H"
"5316",2011-12-21,2011,"Mersin Idman Yurdu","Eskisehirspor","0-0",0,0,"T1",1,0,0,"D"
"5317",2011-12-21,2011,"Sivasspor","Samsunspor","3-2",3,2,"T1",1,5,1,"H"
"5318",2011-12-22,2011,"Besiktas","Karabukspor","1-0",1,0,"T1",1,1,1,"H"
"5319",2011-12-22,2011,"Gaziantepspor","Bursaspor","2-2",2,2,"T1",1,4,0,"D"
"5320",2011-12-22,2011,"Genclerbirligi","Buyuksehyr","4-0",4,0,"T1",1,4,4,"H"
"5321",2011-12-22,2011,"Trabzonspor","Orduspor","4-1",4,1,"T1",1,5,3,"H"
"5322",2012-01-03,2011,"Galatasaray","Buyuksehyr","4-1",4,1,"T1",1,5,3,"H"
"5323",2012-01-03,2011,"Kayserispor","Bursaspor","0-2",0,2,"T1",1,2,-2,"A"
"5324",2012-01-03,2011,"Mersin Idman Yurdu","Ankaragucu","1-2",1,2,"T1",1,3,-1,"A"
"5325",2012-01-03,2011,"Sivasspor","Karabukspor","3-0",3,0,"T1",1,3,3,"H"
"5326",2012-01-03,2011,"Trabzonspor","Manisaspor","2-1",2,1,"T1",1,3,1,"H"
"5327",2012-01-04,2011,"Besiktas","Eskisehirspor","2-0",2,0,"T1",1,2,2,"H"
"5328",2012-01-04,2011,"Gaziantepspor","Antalyaspor","1-0",1,0,"T1",1,1,1,"H"
"5329",2012-01-04,2011,"Genclerbirligi","Samsunspor","1-1",1,1,"T1",1,2,0,"D"
"5330",2012-01-04,2011,"Orduspor","Fenerbahce","1-1",1,1,"T1",1,2,0,"D"
"5331",2012-01-07,2011,"Bursaspor","Mersin Idman Yurdu","1-0",1,0,"T1",1,1,1,"H"
"5332",2012-01-07,2011,"Buyuksehyr","Trabzonspor","0-2",0,2,"T1",1,2,-2,"A"
"5333",2012-01-07,2011,"Samsunspor","Galatasaray","2-4",2,4,"T1",1,6,-2,"A"
"5334",2012-01-08,2011,"Ankaragucu","Besiktas","0-0",0,0,"T1",1,0,0,"D"
"5335",2012-01-08,2011,"Antalyaspor","Kayserispor","1-0",1,0,"T1",1,1,1,"H"
"5336",2012-01-08,2011,"Eskisehirspor","Sivasspor","1-1",1,1,"T1",1,2,0,"D"
"5337",2012-01-08,2011,"Karabukspor","Genclerbirligi","2-1",2,1,"T1",1,3,1,"H"
"5338",2012-01-08,2011,"Manisaspor","Orduspor","0-0",0,0,"T1",1,0,0,"D"
"5339",2012-01-09,2011,"Fenerbahce","Gaziantepspor","3-1",3,1,"T1",1,4,2,"H"
"5340",2012-01-14,2011,"Galatasaray","Karabukspor","5-1",5,1,"T1",1,6,4,"H"
"5341",2012-01-14,2011,"Genclerbirligi","Eskisehirspor","2-1",2,1,"T1",1,3,1,"H"
"5342",2012-01-15,2011,"Besiktas","Bursaspor","3-1",3,1,"T1",1,4,2,"H"
"5343",2012-01-15,2011,"Mersin Idman Yurdu","Antalyaspor","0-2",0,2,"T1",1,2,-2,"A"
"5344",2012-01-15,2011,"Orduspor","Buyuksehyr","1-0",1,0,"T1",1,1,1,"H"
"5345",2012-01-15,2011,"Sivasspor","Ankaragucu","3-0",3,0,"T1",1,3,3,"H"
"5346",2012-01-15,2011,"Trabzonspor","Samsunspor","4-0",4,0,"T1",1,4,4,"H"
"5347",2012-01-16,2011,"Kayserispor","Gaziantepspor","1-1",1,1,"T1",1,2,0,"D"
"5348",2012-01-16,2011,"Manisaspor","Fenerbahce","1-2",1,2,"T1",1,3,-1,"A"
"5349",2012-01-20,2011,"Antalyaspor","Besiktas","1-2",1,2,"T1",1,3,-1,"A"
"5350",2012-01-20,2011,"Gaziantepspor","Mersin Idman Yurdu","1-0",1,0,"T1",1,1,1,"H"
"5351",2012-01-21,2011,"Bursaspor","Sivasspor","1-2",1,2,"T1",1,3,-1,"A"
"5352",2012-01-21,2011,"Buyuksehyr","Manisaspor","3-2",3,2,"T1",1,5,1,"H"
"5353",2012-01-21,2011,"Fenerbahce","Kayserispor","4-0",4,0,"T1",1,4,4,"H"
"5354",2012-01-21,2011,"Karabukspor","Trabzonspor","2-1",2,1,"T1",1,3,1,"H"
"5355",2012-01-21,2011,"Samsunspor","Orduspor","2-0",2,0,"T1",1,2,2,"H"
"5356",2012-01-22,2011,"Ankaragucu","Genclerbirligi","0-1",0,1,"T1",1,1,-1,"A"
"5357",2012-01-22,2011,"Eskisehirspor","Galatasaray","0-0",0,0,"T1",1,0,0,"D"
"5358",2012-01-24,2011,"Besiktas","Gaziantepspor","3-2",3,2,"T1",1,5,1,"H"
"5359",2012-01-24,2011,"Manisaspor","Samsunspor","1-1",1,1,"T1",1,2,0,"D"
"5360",2012-01-24,2011,"Mersin Idman Yurdu","Kayserispor","1-2",1,2,"T1",1,3,-1,"A"
"5361",2012-01-24,2011,"Sivasspor","Antalyaspor","2-1",2,1,"T1",1,3,1,"H"
"5362",2012-01-25,2011,"Buyuksehyr","Fenerbahce","3-2",3,2,"T1",1,5,1,"H"
"5363",2012-01-25,2011,"Galatasaray","Ankaragucu","4-0",4,0,"T1",1,4,4,"H"
"5364",2012-01-25,2011,"Genclerbirligi","Bursaspor","2-2",2,2,"T1",1,4,0,"D"
"5365",2012-01-25,2011,"Orduspor","Karabukspor","3-2",3,2,"T1",1,5,1,"H"
"5366",2012-01-25,2011,"Trabzonspor","Eskisehirspor","4-1",4,1,"T1",1,5,3,"H"
"5367",2012-01-28,2011,"Antalyaspor","Genclerbirligi","2-2",2,2,"T1",1,4,0,"D"
"5368",2012-01-28,2011,"Bursaspor","Galatasaray","1-0",1,0,"T1",1,1,1,"H"
"5369",2012-01-29,2011,"Ankaragucu","Trabzonspor","0-4",0,4,"T1",1,4,-4,"A"
"5370",2012-01-29,2011,"Eskisehirspor","Orduspor","0-1",0,1,"T1",1,1,-1,"A"
"5371",2012-01-29,2011,"Fenerbahce","Mersin Idman Yurdu","2-1",2,1,"T1",1,3,1,"H"
"5372",2012-01-29,2011,"Gaziantepspor","Sivasspor","2-1",2,1,"T1",1,3,1,"H"
"5373",2012-01-29,2011,"Karabukspor","Manisaspor","2-1",2,1,"T1",1,3,1,"H"
"5374",2012-01-29,2011,"Samsunspor","Buyuksehyr","2-4",2,4,"T1",1,6,-2,"A"
"5375",2012-01-30,2011,"Kayserispor","Besiktas","1-0",1,0,"T1",1,1,1,"H"
"5376",2012-02-01,2011,"Galatasaray","Antalyaspor","1-1",1,1,"T1",1,2,0,"D"
"5377",2012-02-01,2011,"Genclerbirligi","Gaziantepspor","1-0",1,0,"T1",1,1,1,"H"
"5378",2012-02-01,2011,"Orduspor","Ankaragucu","2-0",2,0,"T1",1,2,2,"H"
"5379",2012-02-01,2011,"Trabzonspor","Bursaspor","2-1",2,1,"T1",1,3,1,"H"
"5380",2012-02-02,2011,"Besiktas","Mersin Idman Yurdu","0-1",0,1,"T1",1,1,-1,"A"
"5381",2012-02-02,2011,"Manisaspor","Eskisehirspor","2-3",2,3,"T1",1,5,-1,"A"
"5382",2012-02-02,2011,"Samsunspor","Fenerbahce","3-1",3,1,"T1",1,4,2,"H"
"5383",2012-02-02,2011,"Sivasspor","Kayserispor","1-1",1,1,"T1",1,2,0,"D"
"5384",2012-02-04,2011,"Antalyaspor","Trabzonspor","2-1",2,1,"T1",1,3,1,"H"
"5385",2012-02-04,2011,"Gaziantepspor","Galatasaray","1-2",1,2,"T1",1,3,-1,"A"
"5386",2012-02-05,2011,"Bursaspor","Orduspor","0-0",0,0,"T1",1,0,0,"D"
"5387",2012-02-05,2011,"Fenerbahce","Besiktas","2-0",2,0,"T1",1,2,2,"H"
"5388",2012-02-05,2011,"Kayserispor","Genclerbirligi","2-3",2,3,"T1",1,5,-1,"A"
"5389",2012-02-05,2011,"Mersin Idman Yurdu","Sivasspor","1-5",1,5,"T1",1,6,-4,"A"
"5390",2012-02-06,2011,"Ankaragucu","Manisaspor","0-1",0,1,"T1",1,1,-1,"A"
"5391",2012-02-06,2011,"Eskisehirspor","Buyuksehyr","3-1",3,1,"T1",1,4,2,"H"
"5392",2012-02-06,2011,"Karabukspor","Samsunspor","2-1",2,1,"T1",1,3,1,"H"
"5393",2012-02-09,2011,"Buyuksehyr","Karabukspor","2-2",2,2,"T1",1,4,0,"D"
"5394",2012-02-09,2011,"Sivasspor","Besiktas","1-1",1,1,"T1",1,2,0,"D"
"5395",2012-02-10,2011,"Trabzonspor","Gaziantepspor","4-1",4,1,"T1",1,5,3,"H"
"5396",2012-02-11,2011,"Galatasaray","Kayserispor","1-0",1,0,"T1",1,1,1,"H"
"5397",2012-02-11,2011,"Genclerbirligi","Mersin Idman Yurdu","1-2",1,2,"T1",1,3,-1,"A"
"5398",2012-02-12,2011,"Buyuksehyr","Ankaragucu","3-0",3,0,"T1",1,3,3,"H"
"5399",2012-02-12,2011,"Karabukspor","Fenerbahce","2-1",2,1,"T1",1,3,1,"H"
"5400",2012-02-12,2011,"Manisaspor","Bursaspor","1-3",1,3,"T1",1,4,-2,"A"
"5401",2012-02-12,2011,"Orduspor","Antalyaspor","3-2",3,2,"T1",1,5,1,"H"
"5402",2012-02-12,2011,"Samsunspor","Eskisehirspor","3-1",3,1,"T1",1,4,2,"H"
"5403",2012-02-17,2011,"Mersin Idman Yurdu","Galatasaray","1-3",1,3,"T1",1,4,-2,"A"
"5404",2012-02-18,2011,"Ankaragucu","Samsunspor","0-3",0,3,"T1",1,3,-3,"A"
"5405",2012-02-18,2011,"Antalyaspor","Manisaspor","2-1",2,1,"T1",1,3,1,"H"
"5406",2012-02-18,2011,"Fenerbahce","Sivasspor","4-2",4,2,"T1",1,6,2,"H"
"5407",2012-02-19,2011,"Besiktas","Genclerbirligi","3-2",3,2,"T1",1,5,1,"H"
"5408",2012-02-19,2011,"Eskisehirspor","Karabukspor","1-2",1,2,"T1",1,3,-1,"A"
"5409",2012-02-19,2011,"Gaziantepspor","Orduspor","1-0",1,0,"T1",1,1,1,"H"
"5410",2012-02-19,2011,"Kayserispor","Trabzonspor","3-3",3,3,"T1",1,6,0,"D"
"5411",2012-02-20,2011,"Bursaspor","Buyuksehyr","2-1",2,1,"T1",1,3,1,"H"
"5412",2012-02-24,2011,"Orduspor","Kayserispor","1-0",1,0,"T1",1,1,1,"H"
"5413",2012-02-25,2011,"Eskisehirspor","Fenerbahce","2-1",2,1,"T1",1,3,1,"H"
"5414",2012-02-25,2011,"Karabukspor","Ankaragucu","3-2",3,2,"T1",1,5,1,"H"
"5415",2012-02-25,2011,"Manisaspor","Gaziantepspor","0-2",0,2,"T1",1,2,-2,"A"
"5416",2012-02-25,2011,"Samsunspor","Bursaspor","0-3",0,3,"T1",1,3,-3,"A"
"5417",2012-02-26,2011,"Buyuksehyr","Antalyaspor","4-0",4,0,"T1",1,4,4,"H"
"5418",2012-02-26,2011,"Galatasaray","Besiktas","3-2",3,2,"T1",1,5,1,"H"
"5419",2012-02-26,2011,"Genclerbirligi","Sivasspor","3-3",3,3,"T1",1,6,0,"D"
"5420",2012-02-26,2011,"Trabzonspor","Mersin Idman Yurdu","2-3",2,3,"T1",1,5,-1,"A"
"5421",2012-03-03,2011,"Ankaragucu","Eskisehirspor","2-5",2,5,"T1",1,7,-3,"A"
"5422",2012-03-03,2011,"Antalyaspor","Samsunspor","0-2",0,2,"T1",1,2,-2,"A"
"5423",2012-03-03,2011,"Fenerbahce","Genclerbirligi","6-1",6,1,"T1",1,7,5,"H"
"5424",2012-03-03,2011,"Mersin Idman Yurdu","Orduspor","1-0",1,0,"T1",1,1,1,"H"
"5425",2012-03-04,2011,"Besiktas","Trabzonspor","1-2",1,2,"T1",1,3,-1,"A"
"5426",2012-03-04,2011,"Bursaspor","Karabukspor","3-0",3,0,"T1",1,3,3,"H"
"5427",2012-03-04,2011,"Gaziantepspor","Buyuksehyr","5-0",5,0,"T1",1,5,5,"H"
"5428",2012-03-04,2011,"Kayserispor","Manisaspor","2-0",2,0,"T1",1,2,2,"H"
"5429",2012-03-05,2011,"Sivasspor","Galatasaray","0-4",0,4,"T1",1,4,-4,"A"
"5430",2012-03-09,2011,"Ankaragucu","Fenerbahce","0-2",0,2,"T1",1,2,-2,"A"
"5431",2012-03-10,2011,"Buyuksehyr","Kayserispor","1-0",1,0,"T1",1,1,1,"H"
"5432",2012-03-10,2011,"Galatasaray","Genclerbirligi","2-0",2,0,"T1",1,2,2,"H"
"5433",2012-03-11,2011,"Eskisehirspor","Bursaspor","1-1",1,1,"T1",1,2,0,"D"
"5434",2012-03-11,2011,"Karabukspor","Antalyaspor","2-1",2,1,"T1",1,3,1,"H"
"5435",2012-03-11,2011,"Manisaspor","Mersin Idman Yurdu","2-0",2,0,"T1",1,2,2,"H"
"5436",2012-03-11,2011,"Orduspor","Besiktas","1-1",1,1,"T1",1,2,0,"D"
"5437",2012-03-11,2011,"Samsunspor","Gaziantepspor","0-0",0,0,"T1",1,0,0,"D"
"5438",2012-03-12,2011,"Trabzonspor","Sivasspor","2-1",2,1,"T1",1,3,1,"H"
"5439",2012-03-16,2011,"Genclerbirligi","Trabzonspor","1-1",1,1,"T1",1,2,0,"D"
"5440",2012-03-17,2011,"Antalyaspor","Eskisehirspor","0-0",0,0,"T1",1,0,0,"D"
"5441",2012-03-17,2011,"Bursaspor","Ankaragucu","2-1",2,1,"T1",1,3,1,"H"
"5442",2012-03-17,2011,"Fenerbahce","Galatasaray","2-2",2,2,"T1",1,4,0,"D"
"5443",2012-03-17,2011,"Sivasspor","Orduspor","1-1",1,1,"T1",1,2,0,"D"
"5444",2012-03-18,2011,"Gaziantepspor","Karabukspor","3-0",3,0,"T1",1,3,3,"H"
"5445",2012-03-18,2011,"Kayserispor","Samsunspor","2-0",2,0,"T1",1,2,2,"H"
"5446",2012-03-18,2011,"Mersin Idman Yurdu","Buyuksehyr","2-0",2,0,"T1",1,2,2,"H"
"5447",2012-03-19,2011,"Besiktas","Manisaspor","4-1",4,1,"T1",1,5,3,"H"
"5448",2012-03-24,2011,"Fenerbahce","Bursaspor","1-0",1,0,"T1",1,1,1,"H"
"5449",2012-03-25,2011,"Ankaragucu","Antalyaspor","0-3",0,3,"T1",1,3,-3,"A"
"5450",2012-03-25,2011,"Eskisehirspor","Gaziantepspor","0-2",0,2,"T1",1,2,-2,"A"
"5451",2012-03-25,2011,"Galatasaray","Trabzonspor","1-1",1,1,"T1",1,2,0,"D"
"5452",2012-03-25,2011,"Karabukspor","Kayserispor","1-0",1,0,"T1",1,1,1,"H"
"5453",2012-03-25,2011,"Manisaspor","Sivasspor","1-3",1,3,"T1",1,4,-2,"A"
"5454",2012-03-25,2011,"Orduspor","Genclerbirligi","0-0",0,0,"T1",1,0,0,"D"
"5455",2012-03-25,2011,"Samsunspor","Mersin Idman Yurdu","2-0",2,0,"T1",1,2,2,"H"
"5456",2012-03-26,2011,"Buyuksehyr","Besiktas","2-2",2,2,"T1",1,4,0,"D"
"5457",2012-03-30,2011,"Gaziantepspor","Ankaragucu","1-0",1,0,"T1",1,1,1,"H"
"5458",2012-03-30,2011,"Mersin Idman Yurdu","Karabukspor","0-2",0,2,"T1",1,2,-2,"A"
"5459",2012-03-31,2011,"Galatasaray","Orduspor","2-0",2,0,"T1",1,2,2,"H"
"5460",2012-03-31,2011,"Genclerbirligi","Manisaspor","3-0",3,0,"T1",1,3,3,"H"
"5461",2012-03-31,2011,"Kayserispor","Eskisehirspor","2-2",2,2,"T1",1,4,0,"D"
"5462",2012-03-31,2011,"Sivasspor","Buyuksehyr","0-1",0,1,"T1",1,1,-1,"A"
"5463",2012-04-01,2011,"Antalyaspor","Bursaspor","1-3",1,3,"T1",1,4,-2,"A"
"5464",2012-04-01,2011,"Besiktas","Samsunspor","0-1",0,1,"T1",1,1,-1,"A"
"5465",2012-04-01,2011,"Trabzonspor","Fenerbahce","1-1",1,1,"T1",1,2,0,"D"
"5466",2012-04-06,2011,"Karabukspor","Besiktas","1-1",1,1,"T1",1,2,0,"D"
"5467",2012-04-07,2011,"Ankaragucu","Kayserispor","0-5",0,5,"T1",1,5,-5,"A"
"5468",2012-04-07,2011,"Bursaspor","Gaziantepspor","0-2",0,2,"T1",1,2,-2,"A"
"5469",2012-04-07,2011,"Buyuksehyr","Genclerbirligi","1-0",1,0,"T1",1,1,1,"H"
"5470",2012-04-07,2011,"Eskisehirspor","Mersin Idman Yurdu","2-0",2,0,"T1",1,2,2,"H"
"5471",2012-04-07,2011,"Fenerbahce","Antalyaspor","2-0",2,0,"T1",1,2,2,"H"
"5472",2012-04-07,2011,"Samsunspor","Sivasspor","1-2",1,2,"T1",1,3,-1,"A"
"5473",2012-04-08,2011,"Manisaspor","Galatasaray","0-4",0,4,"T1",1,4,-4,"A"
"5474",2012-04-08,2011,"Orduspor","Trabzonspor","0-0",0,0,"T1",1,0,0,"D"
"5475",2012-08-17,2012,"Eskisehirspor","Akhisar Belediyespor","0-1",0,1,"T1",1,1,-1,"A"
"5476",2012-08-18,2012,"Elazigspor","Fenerbahce","1-1",1,1,"T1",1,2,0,"D"
"5477",2012-08-18,2012,"Gaziantepspor","Sivasspor","0-1",0,1,"T1",1,1,-1,"A"
"5478",2012-08-18,2012,"Karabukspor","Trabzonspor","1-1",1,1,"T1",1,2,0,"D"
"5479",2012-08-19,2012,"Buyuksehyr","Besiktas","1-1",1,1,"T1",1,2,0,"D"
"5480",2012-08-19,2012,"Kayserispor","Bursaspor","0-1",0,1,"T1",1,1,-1,"A"
"5481",2012-08-19,2012,"Mersin Idman Yurdu","Orduspor","0-0",0,0,"T1",1,0,0,"D"
"5482",2012-08-20,2012,"Galatasaray","Kasimpasa","2-1",2,1,"T1",1,3,1,"H"
"5483",2012-08-20,2012,"Genclerbirligi","Antalyaspor","3-1",3,1,"T1",1,4,2,"H"
"5484",2012-08-24,2012,"Kasimpasa","Karabukspor","2-1",2,1,"T1",1,3,1,"H"
"5485",2012-08-25,2012,"Akhisar Belediyespor","Genclerbirligi","0-0",0,0,"T1",1,0,0,"D"
"5486",2012-08-25,2012,"Fenerbahce","Gaziantepspor","3-0",3,0,"T1",1,3,3,"H"
"5487",2012-08-25,2012,"Orduspor","Eskisehirspor","2-0",2,0,"T1",1,2,2,"H"
"5488",2012-08-25,2012,"Sivasspor","Mersin Idman Yurdu","3-3",3,3,"T1",1,6,0,"D"
"5489",2012-08-26,2012,"Besiktas","Galatasaray","3-3",3,3,"T1",1,6,0,"D"
"5490",2012-08-26,2012,"Bursaspor","Buyuksehyr","0-1",0,1,"T1",1,1,-1,"A"
"5491",2012-08-26,2012,"Trabzonspor","Elazigspor","2-0",2,0,"T1",1,2,2,"H"
"5492",2012-08-27,2012,"Antalyaspor","Kayserispor","3-0",3,0,"T1",1,3,3,"H"
"5493",2012-08-31,2012,"Genclerbirligi","Orduspor","1-1",1,1,"T1",1,2,0,"D"
"5494",2012-08-31,2012,"Mersin Idman Yurdu","Eskisehirspor","1-3",1,3,"T1",1,4,-2,"A"
"5495",2012-09-01,2012,"Buyuksehyr","Antalyaspor","0-1",0,1,"T1",1,1,-1,"A"
"5496",2012-09-01,2012,"Elazigspor","Kasimpasa","0-3",0,3,"T1",1,3,-3,"A"
"5497",2012-09-01,2012,"Karabukspor","Besiktas","0-3",0,3,"T1",1,3,-3,"A"
"5498",2012-09-01,2012,"Kayserispor","Akhisar Belediyespor","1-1",1,1,"T1",1,2,0,"D"
"5499",2012-09-02,2012,"Galatasaray","Bursaspor","3-2",3,2,"T1",1,5,1,"H"
"5500",2012-09-02,2012,"Gaziantepspor","Trabzonspor","1-0",1,0,"T1",1,1,1,"H"
"5501",2012-09-02,2012,"Sivasspor","Fenerbahce","0-0",0,0,"T1",1,0,0,"D"
"5502",2012-09-15,2012,"Antalyaspor","Galatasaray","0-4",0,4,"T1",1,4,-4,"A"
"5503",2012-09-15,2012,"Bursaspor","Karabukspor","4-1",4,1,"T1",1,5,3,"H"
"5504",2012-09-15,2012,"Kasimpasa","Gaziantepspor","3-0",3,0,"T1",1,3,3,"H"
"5505",2012-09-16,2012,"Akhisar Belediyespor","Buyuksehyr","0-4",0,4,"T1",1,4,-4,"A"
"5506",2012-09-16,2012,"Eskisehirspor","Genclerbirligi","4-2",4,2,"T1",1,6,2,"H"
"5507",2012-09-16,2012,"Fenerbahce","Mersin Idman Yurdu","2-1",2,1,"T1",1,3,1,"H"
"5508",2012-09-16,2012,"Trabzonspor","Sivasspor","1-0",1,0,"T1",1,1,1,"H"
"5509",2012-09-17,2012,"Besiktas","Elazigspor","3-0",3,0,"T1",1,3,3,"H"
"5510",2012-09-17,2012,"Orduspor","Kayserispor","3-2",3,2,"T1",1,5,1,"H"
"5511",2012-09-21,2012,"Karabukspor","Antalyaspor","1-0",1,0,"T1",1,1,1,"H"
"5512",2012-09-22,2012,"Buyuksehyr","Orduspor","1-1",1,1,"T1",1,2,0,"D"
"5513",2012-09-22,2012,"Gaziantepspor","Besiktas","3-2",3,2,"T1",1,5,1,"H"
"5514",2012-09-22,2012,"Kayserispor","Eskisehirspor","3-2",3,2,"T1",1,5,1,"H"
"5515",2012-09-22,2012,"Mersin Idman Yurdu","Genclerbirligi","1-1",1,1,"T1",1,2,0,"D"
"5516",2012-09-23,2012,"Elazigspor","Bursaspor","1-1",1,1,"T1",1,2,0,"D"
"5517",2012-09-23,2012,"Galatasaray","Akhisar Belediyespor","3-0",3,0,"T1",1,3,3,"H"
"5518",2012-09-23,2012,"Sivasspor","Kasimpasa","1-0",1,0,"T1",1,1,1,"H"
"5519",2012-09-24,2012,"Fenerbahce","Trabzonspor","0-0",0,0,"T1",1,0,0,"D"
"5520",2012-09-28,2012,"Orduspor","Galatasaray","2-0",2,0,"T1",1,2,2,"H"
"5521",2012-09-29,2012,"Akhisar Belediyespor","Karabukspor","1-3",1,3,"T1",1,4,-2,"A"
"5522",2012-09-29,2012,"Bursaspor","Gaziantepspor","1-1",1,1,"T1",1,2,0,"D"
"5523",2012-09-29,2012,"Kasimpasa","Fenerbahce","2-0",2,0,"T1",1,2,2,"H"
"5524",2012-09-30,2012,"Antalyaspor","Elazigspor","4-0",4,0,"T1",1,4,4,"H"
"5525",2012-09-30,2012,"Eskisehirspor","Buyuksehyr","1-0",1,0,"T1",1,1,1,"H"
"5526",2012-09-30,2012,"Genclerbirligi","Kayserispor","4-0",4,0,"T1",1,4,4,"H"
"5527",2012-09-30,2012,"Trabzonspor","Mersin Idman Yurdu","1-1",1,1,"T1",1,2,0,"D"
"5528",2012-10-01,2012,"Besiktas","Sivasspor","0-1",0,1,"T1",1,1,-1,"A"
"5529",2012-10-05,2012,"Gaziantepspor","Antalyaspor","0-1",0,1,"T1",1,1,-1,"A"
"5530",2012-10-05,2012,"Karabukspor","Orduspor","1-1",1,1,"T1",1,2,0,"D"
"5531",2012-10-05,2012,"Trabzonspor","Kasimpasa","1-0",1,0,"T1",1,1,1,"H"
"5532",2012-10-06,2012,"Buyuksehyr","Genclerbirligi","0-2",0,2,"T1",1,2,-2,"A"
"5533",2012-10-06,2012,"Elazigspor","Akhisar Belediyespor","0-0",0,0,"T1",1,0,0,"D"
"5534",2012-10-06,2012,"Galatasaray","Eskisehirspor","1-1",1,1,"T1",1,2,0,"D"
"5535",2012-10-07,2012,"Fenerbahce","Besiktas","3-0",3,0,"T1",1,3,3,"H"
"5536",2012-10-07,2012,"Mersin Idman Yurdu","Kayserispor","1-2",1,2,"T1",1,3,-1,"A"
"5537",2012-10-07,2012,"Sivasspor","Bursaspor","2-2",2,2,"T1",1,4,0,"D"
"5538",2012-10-19,2012,"Genclerbirligi","Galatasaray","3-3",3,3,"T1",1,6,0,"D"
"5539",2012-10-20,2012,"Antalyaspor","Sivasspor","4-2",4,2,"T1",1,6,2,"H"
"5540",2012-10-20,2012,"Bursaspor","Fenerbahce","1-1",1,1,"T1",1,2,0,"D"
"5541",2012-10-20,2012,"Orduspor","Elazigspor","2-2",2,2,"T1",1,4,0,"D"
"5542",2012-10-21,2012,"Akhisar Belediyespor","Gaziantepspor","0-0",0,0,"T1",1,0,0,"D"
"5543",2012-10-21,2012,"Besiktas","Trabzonspor","1-1",1,1,"T1",1,2,0,"D"
"5544",2012-10-21,2012,"Eskisehirspor","Karabukspor","5-2",5,2,"T1",1,7,3,"H"
"5545",2012-10-21,2012,"Kasimpasa","Mersin Idman Yurdu","2-2",2,2,"T1",1,4,0,"D"
"5546",2012-10-22,2012,"Kayserispor","Buyuksehyr","0-1",0,1,"T1",1,1,-1,"A"
"5547",2012-10-26,2012,"Elazigspor","Eskisehirspor","1-1",1,1,"T1",1,2,0,"D"
"5548",2012-10-26,2012,"Kasimpasa","Besiktas","1-3",1,3,"T1",1,4,-2,"A"
"5549",2012-10-27,2012,"Galatasaray","Kayserispor","3-0",3,0,"T1",1,3,3,"H"
"5550",2012-10-27,2012,"Mersin Idman Yurdu","Buyuksehyr","2-0",2,0,"T1",1,2,2,"H"
"5551",2012-10-27,2012,"Sivasspor","Akhisar Belediyespor","1-2",1,2,"T1",1,3,-1,"A"
"5552",2012-10-28,2012,"Gaziantepspor","Orduspor","3-0",3,0,"T1",1,3,3,"H"
"5553",2012-10-28,2012,"Karabukspor","Genclerbirligi","0-0",0,0,"T1",1,0,0,"D"
"5554",2012-10-28,2012,"Trabzonspor","Bursaspor","0-1",0,1,"T1",1,1,-1,"A"
"5555",2012-10-29,2012,"Fenerbahce","Antalyaspor","1-3",1,3,"T1",1,4,-2,"A"
"5556",2012-11-02,2012,"Buyuksehyr","Galatasaray","1-3",1,3,"T1",1,4,-2,"A"
"5557",2012-11-03,2012,"Akhisar Belediyespor","Fenerbahce","1-2",1,2,"T1",1,3,-1,"A"
"5558",2012-11-03,2012,"Eskisehirspor","Gaziantepspor","4-0",4,0,"T1",1,4,4,"H"
"5559",2012-11-03,2012,"Kayserispor","Karabukspor","3-0",3,0,"T1",1,3,3,"H"
"5560",2012-11-04,2012,"Besiktas","Mersin Idman Yurdu","3-0",3,0,"T1",1,3,3,"H"
"5561",2012-11-04,2012,"Genclerbirligi","Elazigspor","1-2",1,2,"T1",1,3,-1,"A"
"5562",2012-11-04,2012,"Orduspor","Sivasspor","2-0",2,0,"T1",1,2,2,"H"
"5563",2012-11-05,2012,"Antalyaspor","Trabzonspor","2-1",2,1,"T1",1,3,1,"H"
"5564",2012-11-05,2012,"Bursaspor","Kasimpasa","1-2",1,2,"T1",1,3,-1,"A"
"5565",2012-11-09,2012,"Besiktas","Bursaspor","3-3",3,3,"T1",1,6,0,"D"
"5566",2012-11-09,2012,"Sivasspor","Eskisehirspor","1-0",1,0,"T1",1,1,1,"H"
"5567",2012-11-10,2012,"Karabukspor","Buyuksehyr","3-1",3,1,"T1",1,4,2,"H"
"5568",2012-11-10,2012,"Kasimpasa","Antalyaspor","1-1",1,1,"T1",1,2,0,"D"
"5569",2012-11-10,2012,"Trabzonspor","Akhisar Belediyespor","3-1",3,1,"T1",1,4,2,"H"
"5570",2012-11-11,2012,"Elazigspor","Kayserispor","0-4",0,4,"T1",1,4,-4,"A"
"5571",2012-11-11,2012,"Fenerbahce","Orduspor","2-1",2,1,"T1",1,3,1,"H"
"5572",2012-11-11,2012,"Gaziantepspor","Genclerbirligi","2-3",2,3,"T1",1,5,-1,"A"
"5573",2012-11-11,2012,"Mersin Idman Yurdu","Galatasaray","1-1",1,1,"T1",1,2,0,"D"
"5574",2012-11-16,2012,"Galatasaray","Karabukspor","1-3",1,3,"T1",1,4,-2,"A"
"5575",2012-11-17,2012,"Buyuksehyr","Elazigspor","1-1",1,1,"T1",1,2,0,"D"
"5576",2012-11-17,2012,"Eskisehirspor","Fenerbahce","1-1",1,1,"T1",1,2,0,"D"
"5577",2012-11-17,2012,"Genclerbirligi","Sivasspor","1-1",1,1,"T1",1,2,0,"D"
"5578",2012-11-18,2012,"Akhisar Belediyespor","Kasimpasa","0-2",0,2,"T1",1,2,-2,"A"
"5579",2012-11-18,2012,"Antalyaspor","Besiktas","3-5",3,5,"T1",1,8,-2,"A"
"5580",2012-11-18,2012,"Bursaspor","Mersin Idman Yurdu","3-0",3,0,"T1",1,3,3,"H"
"5581",2012-11-18,2012,"Kayserispor","Gaziantepspor","1-1",1,1,"T1",1,2,0,"D"
"5582",2012-11-19,2012,"Orduspor","Trabzonspor","1-2",1,2,"T1",1,3,-1,"A"
"5583",2012-11-23,2012,"Besiktas","Akhisar Belediyespor","3-1",3,1,"T1",1,4,2,"H"
"5584",2012-11-23,2012,"Mersin Idman Yurdu","Karabukspor","2-1",2,1,"T1",1,3,1,"H"
"5585",2012-11-24,2012,"Bursaspor","Antalyaspor","1-1",1,1,"T1",1,2,0,"D"
"5586",2012-11-24,2012,"Elazigspor","Galatasaray","0-1",0,1,"T1",1,1,-1,"A"
"5587",2012-11-24,2012,"Kasimpasa","Orduspor","1-1",1,1,"T1",1,2,0,"D"
"5588",2012-11-25,2012,"Fenerbahce","Genclerbirligi","4-1",4,1,"T1",1,5,3,"H"
"5589",2012-11-25,2012,"Gaziantepspor","Buyuksehyr","2-1",2,1,"T1",1,3,1,"H"
"5590",2012-11-25,2012,"Sivasspor","Kayserispor","4-2",4,2,"T1",1,6,2,"H"
"5591",2012-11-26,2012,"Trabzonspor","Eskisehirspor","0-3",0,3,"T1",1,3,-3,"A"
"5592",2012-11-30,2012,"Galatasaray","Gaziantepspor","1-1",1,1,"T1",1,2,0,"D"
"5593",2012-12-01,2012,"Akhisar Belediyespor","Bursaspor","2-2",2,2,"T1",1,4,0,"D"
"5594",2012-12-01,2012,"Karabukspor","Elazigspor","0-1",0,1,"T1",1,1,-1,"A"
"5595",2012-12-01,2012,"Orduspor","Besiktas","1-2",1,2,"T1",1,3,-1,"A"
"5596",2012-12-02,2012,"Antalyaspor","Mersin Idman Yurdu","1-0",1,0,"T1",1,1,1,"H"
"5597",2012-12-02,2012,"Buyuksehyr","Sivasspor","2-0",2,0,"T1",1,2,2,"H"
"5598",2012-12-02,2012,"Eskisehirspor","Kasimpasa","2-2",2,2,"T1",1,4,0,"D"
"5599",2012-12-02,2012,"Kayserispor","Fenerbahce","1-1",1,1,"T1",1,2,0,"D"
"5600",2012-12-03,2012,"Genclerbirligi","Trabzonspor","0-4",0,4,"T1",1,4,-4,"A"
"5601",2012-12-07,2012,"Besiktas","Eskisehirspor","2-2",2,2,"T1",1,4,0,"D"
"5602",2012-12-07,2012,"Elazigspor","Mersin Idman Yurdu","1-0",1,0,"T1",1,1,1,"H"
"5603",2012-12-08,2012,"Bursaspor","Orduspor","1-0",1,0,"T1",1,1,1,"H"
"5604",2012-12-08,2012,"Gaziantepspor","Karabukspor","0-2",0,2,"T1",1,2,-2,"A"
"5605",2012-12-08,2012,"Kasimpasa","Genclerbirligi","2-2",2,2,"T1",1,4,0,"D"
"5606",2012-12-08,2012,"Sivasspor","Galatasaray","1-3",1,3,"T1",1,4,-2,"A"
"5607",2012-12-09,2012,"Fenerbahce","Buyuksehyr","2-1",2,1,"T1",1,3,1,"H"
"5608",2012-12-09,2012,"Trabzonspor","Kayserispor","1-1",1,1,"T1",1,2,0,"D"
"5609",2012-12-14,2012,"Eskisehirspor","Bursaspor","2-2",2,2,"T1",1,4,0,"D"
"5610",2012-12-15,2012,"Elazigspor","Gaziantepspor","0-0",0,0,"T1",1,0,0,"D"
"5611",2012-12-15,2012,"Genclerbirligi","Besiktas","1-1",1,1,"T1",1,2,0,"D"
"5612",2012-12-15,2012,"Mersin Idman Yurdu","Akhisar Belediyespor","2-1",2,1,"T1",1,3,1,"H"
"5613",2012-12-16,2012,"Buyuksehyr","Trabzonspor","2-1",2,1,"T1",1,3,1,"H"
"5614",2012-12-16,2012,"Galatasaray","Fenerbahce","2-1",2,1,"T1",1,3,1,"H"
"5615",2012-12-16,2012,"Karabukspor","Sivasspor","1-0",1,0,"T1",1,1,1,"H"
"5616",2012-12-16,2012,"Orduspor","Antalyaspor","1-1",1,1,"T1",1,2,0,"D"
"5617",2012-12-17,2012,"Kayserispor","Kasimpasa","1-0",1,0,"T1",1,1,1,"H"
"5618",2012-12-21,2012,"Akhisar Belediyespor","Orduspor","0-0",0,0,"T1",1,0,0,"D"
"5619",2012-12-21,2012,"Besiktas","Kayserispor","3-1",3,1,"T1",1,4,2,"H"
"5620",2012-12-22,2012,"Fenerbahce","Karabukspor","1-3",1,3,"T1",1,4,-2,"A"
"5621",2012-12-22,2012,"Kasimpasa","Buyuksehyr","0-2",0,2,"T1",1,2,-2,"A"
"5622",2012-12-23,2012,"Antalyaspor","Eskisehirspor","2-1",2,1,"T1",1,3,1,"H"
"5623",2012-12-23,2012,"Bursaspor","Genclerbirligi","0-0",0,0,"T1",1,0,0,"D"
"5624",2012-12-23,2012,"Gaziantepspor","Mersin Idman Yurdu","2-1",2,1,"T1",1,3,1,"H"
"5625",2012-12-23,2012,"Sivasspor","Elazigspor","3-1",3,1,"T1",1,4,2,"H"
"5626",2012-12-23,2012,"Trabzonspor","Galatasaray","0-0",0,0,"T1",1,0,0,"D"
"5627",2013-01-09,2012,"Akhisar Belediyespor","Antalyaspor","1-0",1,0,"T1",1,1,1,"H"
"5628",2013-01-18,2012,"Kasimpasa","Galatasaray","2-1",2,1,"T1",1,3,1,"H"
"5629",2013-01-19,2012,"Besiktas","Buyuksehyr","2-2",2,2,"T1",1,4,0,"D"
"5630",2013-01-19,2012,"Bursaspor","Kayserispor","2-1",2,1,"T1",1,3,1,"H"
"5631",2013-01-19,2012,"Sivasspor","Gaziantepspor","0-0",0,0,"T1",1,0,0,"D"
"5632",2013-01-20,2012,"Antalyaspor","Genclerbirligi","3-5",3,5,"T1",1,8,-2,"A"
"5633",2013-01-20,2012,"Fenerbahce","Elazigspor","2-2",2,2,"T1",1,4,0,"D"
"5634",2013-01-20,2012,"Trabzonspor","Karabukspor","1-3",1,3,"T1",1,4,-2,"A"
"5635",2013-01-21,2012,"Akhisar Belediyespor","Eskisehirspor","1-1",1,1,"T1",1,2,0,"D"
"5636",2013-01-21,2012,"Orduspor","Mersin Idman Yurdu","1-1",1,1,"T1",1,2,0,"D"
"5637",2013-01-25,2012,"Karabukspor","Kasimpasa","0-3",0,3,"T1",1,3,-3,"A"
"5638",2013-01-26,2012,"Buyuksehyr","Bursaspor","4-1",4,1,"T1",1,5,3,"H"
"5639",2013-01-26,2012,"Gaziantepspor","Fenerbahce","1-2",1,2,"T1",1,3,-1,"A"
"5640",2013-01-26,2012,"Genclerbirligi","Akhisar Belediyespor","1-0",1,0,"T1",1,1,1,"H"
"5641",2013-01-27,2012,"Elazigspor","Trabzonspor","3-1",3,1,"T1",1,4,2,"H"
"5642",2013-01-27,2012,"Galatasaray","Besiktas","2-1",2,1,"T1",1,3,1,"H"
"5643",2013-01-27,2012,"Kayserispor","Antalyaspor","2-0",2,0,"T1",1,2,2,"H"
"5644",2013-01-27,2012,"Mersin Idman Yurdu","Sivasspor","3-0",3,0,"T1",1,3,3,"H"
"5645",2013-01-28,2012,"Eskisehirspor","Orduspor","1-0",1,0,"T1",1,1,1,"H"
"5646",2013-02-01,2012,"Akhisar Belediyespor","Kayserispor","1-2",1,2,"T1",1,3,-1,"A"
"5647",2013-02-01,2012,"Besiktas","Karabukspor","2-2",2,2,"T1",1,4,0,"D"
"5648",2013-02-02,2012,"Antalyaspor","Buyuksehyr","1-0",1,0,"T1",1,1,1,"H"
"5649",2013-02-02,2012,"Bursaspor","Galatasaray","1-1",1,1,"T1",1,2,0,"D"
"5650",2013-02-02,2012,"Kasimpasa","Elazigspor","0-0",0,0,"T1",1,0,0,"D"
"5651",2013-02-03,2012,"Eskisehirspor","Mersin Idman Yurdu","0-0",0,0,"T1",1,0,0,"D"
"5652",2013-02-03,2012,"Fenerbahce","Sivasspor","1-2",1,2,"T1",1,3,-1,"A"
"5653",2013-02-03,2012,"Orduspor","Genclerbirligi","2-1",2,1,"T1",1,3,1,"H"
"5654",2013-02-03,2012,"Trabzonspor","Gaziantepspor","4-1",4,1,"T1",1,5,3,"H"
"5655",2013-02-09,2012,"Buyuksehyr","Akhisar Belediyespor","0-2",0,2,"T1",1,2,-2,"A"
"5656",2013-02-09,2012,"Elazigspor","Besiktas","1-3",1,3,"T1",1,4,-2,"A"
"5657",2013-02-09,2012,"Genclerbirligi","Eskisehirspor","0-2",0,2,"T1",1,2,-2,"A"
"5658",2013-02-09,2012,"Karabukspor","Bursaspor","0-3",0,3,"T1",1,3,-3,"A"
"5659",2013-02-10,2012,"Galatasaray","Antalyaspor","2-0",2,0,"T1",1,2,2,"H"
"5660",2013-02-10,2012,"Kayserispor","Orduspor","0-0",0,0,"T1",1,0,0,"D"
"5661",2013-02-10,2012,"Mersin Idman Yurdu","Fenerbahce","0-1",0,1,"T1",1,1,-1,"A"
"5662",2013-02-10,2012,"Sivasspor","Trabzonspor","2-0",2,0,"T1",1,2,2,"H"
"5663",2013-02-11,2012,"Gaziantepspor","Kasimpasa","2-1",2,1,"T1",1,3,1,"H"
"5664",2013-02-15,2012,"Akhisar Belediyespor","Galatasaray","1-2",1,2,"T1",1,3,-1,"A"
"5665",2013-02-16,2012,"Antalyaspor","Karabukspor","0-0",0,0,"T1",1,0,0,"D"
"5666",2013-02-16,2012,"Besiktas","Gaziantepspor","1-1",1,1,"T1",1,2,0,"D"
"5667",2013-02-16,2012,"Eskisehirspor","Kayserispor","0-3",0,3,"T1",1,3,-3,"A"
"5668",2013-02-17,2012,"Bursaspor","Elazigspor","1-0",1,0,"T1",1,1,1,"H"
"5669",2013-02-17,2012,"Genclerbirligi","Mersin Idman Yurdu","3-1",3,1,"T1",1,4,2,"H"
"5670",2013-02-17,2012,"Orduspor","Buyuksehyr","2-2",2,2,"T1",1,4,0,"D"
"5671",2013-02-17,2012,"Trabzonspor","Fenerbahce","0-3",0,3,"T1",1,3,-3,"A"
"5672",2013-02-18,2012,"Kasimpasa","Sivasspor","1-0",1,0,"T1",1,1,1,"H"
"5673",2013-02-22,2012,"Gaziantepspor","Bursaspor","2-1",2,1,"T1",1,3,1,"H"
"5674",2013-02-23,2012,"Buyuksehyr","Eskisehirspor","2-2",2,2,"T1",1,4,0,"D"
"5675",2013-02-23,2012,"Elazigspor","Antalyaspor","2-1",2,1,"T1",1,3,1,"H"
"5676",2013-02-23,2012,"Mersin Idman Yurdu","Trabzonspor","0-1",0,1,"T1",1,1,-1,"A"
"5677",2013-02-23,2012,"Sivasspor","Besiktas","0-1",0,1,"T1",1,1,-1,"A"
"5678",2013-02-24,2012,"Fenerbahce","Kasimpasa","3-1",3,1,"T1",1,4,2,"H"
"5679",2013-02-24,2012,"Karabukspor","Akhisar Belediyespor","0-2",0,2,"T1",1,2,-2,"A"
"5680",2013-02-24,2012,"Kayserispor","Genclerbirligi","1-0",1,0,"T1",1,1,1,"H"
"5681",2013-02-25,2012,"Galatasaray","Orduspor","4-2",4,2,"T1",1,6,2,"H"
"5682",2013-03-01,2012,"Genclerbirligi","Buyuksehyr","0-0",0,0,"T1",1,0,0,"D"
"5683",2013-03-02,2012,"Akhisar Belediyespor","Elazigspor","0-1",0,1,"T1",1,1,-1,"A"
"5684",2013-03-02,2012,"Eskisehirspor","Galatasaray","0-0",0,0,"T1",1,0,0,"D"
"5685",2013-03-02,2012,"Orduspor","Karabukspor","3-2",3,2,"T1",1,5,1,"H"
"5686",2013-03-03,2012,"Antalyaspor","Gaziantepspor","5-2",5,2,"T1",1,7,3,"H"
"5687",2013-03-03,2012,"Besiktas","Fenerbahce","3-2",3,2,"T1",1,5,1,"H"
"5688",2013-03-03,2012,"Bursaspor","Sivasspor","1-0",1,0,"T1",1,1,1,"H"
"5689",2013-03-03,2012,"Kayserispor","Mersin Idman Yurdu","2-1",2,1,"T1",1,3,1,"H"
"5690",2013-03-04,2012,"Kasimpasa","Trabzonspor","2-0",2,0,"T1",1,2,2,"H"
"5691",2013-03-08,2012,"Galatasaray","Genclerbirligi","0-1",0,1,"T1",1,1,-1,"A"
"5692",2013-03-09,2012,"Buyuksehyr","Kayserispor","0-0",0,0,"T1",1,0,0,"D"
"5693",2013-03-09,2012,"Gaziantepspor","Akhisar Belediyespor","2-2",2,2,"T1",1,4,0,"D"
"5694",2013-03-09,2012,"Trabzonspor","Besiktas","0-0",0,0,"T1",1,0,0,"D"
"5695",2013-03-10,2012,"Elazigspor","Orduspor","1-0",1,0,"T1",1,1,1,"H"
"5696",2013-03-10,2012,"Fenerbahce","Bursaspor","4-1",4,1,"T1",1,5,3,"H"
"5697",2013-03-10,2012,"Karabukspor","Eskisehirspor","0-0",0,0,"T1",1,0,0,"D"
"5698",2013-03-10,2012,"Sivasspor","Antalyaspor","2-1",2,1,"T1",1,3,1,"H"
"5699",2013-03-11,2012,"Mersin Idman Yurdu","Kasimpasa","1-1",1,1,"T1",1,2,0,"D"
"5700",2013-03-15,2012,"Bursaspor","Trabzonspor","3-2",3,2,"T1",1,5,1,"H"
"5701",2013-03-15,2012,"Eskisehirspor","Elazigspor","2-2",2,2,"T1",1,4,0,"D"
"5702",2013-03-16,2012,"Besiktas","Kasimpasa","1-3",1,3,"T1",1,4,-2,"A"
"5703",2013-03-16,2012,"Buyuksehyr","Mersin Idman Yurdu","4-2",4,2,"T1",1,6,2,"H"
"5704",2013-03-16,2012,"Genclerbirligi","Karabukspor","2-1",2,1,"T1",1,3,1,"H"
"5705",2013-03-17,2012,"Akhisar Belediyespor","Sivasspor","2-1",2,1,"T1",1,3,1,"H"
"5706",2013-03-17,2012,"Antalyaspor","Fenerbahce","1-2",1,2,"T1",1,3,-1,"A"
"5707",2013-03-17,2012,"Kayserispor","Galatasaray","1-3",1,3,"T1",1,4,-2,"A"
"5708",2013-03-17,2012,"Orduspor","Gaziantepspor","2-3",2,3,"T1",1,5,-1,"A"
"5709",2013-03-30,2012,"Galatasaray","Buyuksehyr","2-0",2,0,"T1",1,2,2,"H"
"5710",2013-03-30,2012,"Gaziantepspor","Eskisehirspor","2-0",2,0,"T1",1,2,2,"H"
"5711",2013-03-30,2012,"Sivasspor","Orduspor","3-2",3,2,"T1",1,5,1,"H"
"5712",2013-03-31,2012,"Elazigspor","Genclerbirligi","1-1",1,1,"T1",1,2,0,"D"
"5713",2013-03-31,2012,"Fenerbahce","Akhisar Belediyespor","2-0",2,0,"T1",1,2,2,"H"
"5714",2013-03-31,2012,"Kasimpasa","Bursaspor","2-0",2,0,"T1",1,2,2,"H"
"5715",2013-03-31,2012,"Trabzonspor","Antalyaspor","2-0",2,0,"T1",1,2,2,"H"
"5716",2013-04-01,2012,"Karabukspor","Kayserispor","3-1",3,1,"T1",1,4,2,"H"
"5717",2013-04-01,2012,"Mersin Idman Yurdu","Besiktas","1-2",1,2,"T1",1,3,-1,"A"
"5718",2013-04-05,2012,"Antalyaspor","Kasimpasa","3-2",3,2,"T1",1,5,1,"H"
"5719",2013-04-06,2012,"Buyuksehyr","Karabukspor","2-2",2,2,"T1",1,4,0,"D"
"5720",2013-04-06,2012,"Galatasaray","Mersin Idman Yurdu","3-1",3,1,"T1",1,4,2,"H"
"5721",2013-04-06,2012,"Kayserispor","Elazigspor","4-1",4,1,"T1",1,5,3,"H"
"5722",2013-04-07,2012,"Akhisar Belediyespor","Trabzonspor","1-0",1,0,"T1",1,1,1,"H"
"5723",2013-04-07,2012,"Eskisehirspor","Sivasspor","2-1",2,1,"T1",1,3,1,"H"
"5724",2013-04-07,2012,"Genclerbirligi","Gaziantepspor","2-2",2,2,"T1",1,4,0,"D"
"5725",2013-04-07,2012,"Orduspor","Fenerbahce","0-2",0,2,"T1",1,2,-2,"A"
"5726",2013-04-08,2012,"Bursaspor","Besiktas","3-0",3,0,"T1",1,3,3,"H"
"5727",2013-04-12,2012,"Sivasspor","Genclerbirligi","1-1",1,1,"T1",1,2,0,"D"
"5728",2013-04-12,2012,"Trabzonspor","Orduspor","1-0",1,0,"T1",1,1,1,"H"
"5729",2013-04-13,2012,"Karabukspor","Galatasaray","0-1",0,1,"T1",1,1,-1,"A"
"5730",2013-04-13,2012,"Mersin Idman Yurdu","Bursaspor","0-1",0,1,"T1",1,1,-1,"A"
"5731",2013-04-14,2012,"Elazigspor","Buyuksehyr","1-0",1,0,"T1",1,1,1,"H"
"5732",2013-04-14,2012,"Fenerbahce","Eskisehirspor","1-0",1,0,"T1",1,1,1,"H"
"5733",2013-04-14,2012,"Gaziantepspor","Kayserispor","0-1",0,1,"T1",1,1,-1,"A"
"5734",2013-04-14,2012,"Kasimpasa","Akhisar Belediyespor","0-1",0,1,"T1",1,1,-1,"A"
"5735",2013-04-15,2012,"Besiktas","Antalyaspor","1-0",1,0,"T1",1,1,1,"H"
"5736",2013-04-19,2012,"Galatasaray","Elazigspor","3-1",3,1,"T1",1,4,2,"H"
"5737",2013-04-20,2012,"Akhisar Belediyespor","Besiktas","4-1",4,1,"T1",1,5,3,"H"
"5738",2013-04-20,2012,"Karabukspor","Mersin Idman Yurdu","1-0",1,0,"T1",1,1,1,"H"
"5739",2013-04-20,2012,"Orduspor","Kasimpasa","0-2",0,2,"T1",1,2,-2,"A"
"5740",2013-04-21,2012,"Antalyaspor","Bursaspor","0-1",0,1,"T1",1,1,-1,"A"
"5741",2013-04-21,2012,"Buyuksehyr","Gaziantepspor","1-3",1,3,"T1",1,4,-2,"A"
"5742",2013-04-21,2012,"Genclerbirligi","Fenerbahce","2-0",2,0,"T1",1,2,2,"H"
"5743",2013-04-21,2012,"Kayserispor","Sivasspor","1-1",1,1,"T1",1,2,0,"D"
"5744",2013-04-22,2012,"Eskisehirspor","Trabzonspor","0-1",0,1,"T1",1,1,-1,"A"
"5745",2013-04-26,2012,"Mersin Idman Yurdu","Antalyaspor","1-1",1,1,"T1",1,2,0,"D"
"5746",2013-04-27,2012,"Besiktas","Orduspor","2-0",2,0,"T1",1,2,2,"H"
"5747",2013-04-27,2012,"Bursaspor","Akhisar Belediyespor","1-1",1,1,"T1",1,2,0,"D"
"5748",2013-04-27,2012,"Elazigspor","Karabukspor","1-0",1,0,"T1",1,1,1,"H"
"5749",2013-04-27,2012,"Sivasspor","Buyuksehyr","4-1",4,1,"T1",1,5,3,"H"
"5750",2013-04-27,2012,"Trabzonspor","Genclerbirligi","2-0",2,0,"T1",1,2,2,"H"
"5751",2013-04-28,2012,"Fenerbahce","Kayserispor","2-1",2,1,"T1",1,3,1,"H"
"5752",2013-04-28,2012,"Gaziantepspor","Galatasaray","0-1",0,1,"T1",1,1,-1,"A"
"5753",2013-04-28,2012,"Kasimpasa","Eskisehirspor","1-2",1,2,"T1",1,3,-1,"A"
"5754",2013-05-03,2012,"Genclerbirligi","Kasimpasa","0-0",0,0,"T1",1,0,0,"D"
"5755",2013-05-04,2012,"Kayserispor","Trabzonspor","2-1",2,1,"T1",1,3,1,"H"
"5756",2013-05-04,2012,"Orduspor","Bursaspor","2-4",2,4,"T1",1,6,-2,"A"
"5757",2013-05-05,2012,"Antalyaspor","Akhisar Belediyespor","4-3",4,3,"T1",1,7,1,"H"
"5758",2013-05-05,2012,"Buyuksehyr","Fenerbahce","2-0",2,0,"T1",1,2,2,"H"
"5759",2013-05-05,2012,"Eskisehirspor","Besiktas","1-2",1,2,"T1",1,3,-1,"A"
"5760",2013-05-05,2012,"Galatasaray","Sivasspor","4-2",4,2,"T1",1,6,2,"H"
"5761",2013-05-05,2012,"Karabukspor","Gaziantepspor","0-2",0,2,"T1",1,2,-2,"A"
"5762",2013-05-05,2012,"Mersin Idman Yurdu","Elazigspor","0-2",0,2,"T1",1,2,-2,"A"
"5763",2013-05-10,2012,"Gaziantepspor","Elazigspor","1-1",1,1,"T1",1,2,0,"D"
"5764",2013-05-10,2012,"Kasimpasa","Kayserispor","1-2",1,2,"T1",1,3,-1,"A"
"5765",2013-05-11,2012,"Antalyaspor","Orduspor","1-0",1,0,"T1",1,1,1,"H"
"5766",2013-05-11,2012,"Besiktas","Genclerbirligi","3-0",3,0,"T1",1,3,3,"H"
"5767",2013-05-12,2012,"Fenerbahce","Galatasaray","2-1",2,1,"T1",1,3,1,"H"
"5768",2013-05-13,2012,"Akhisar Belediyespor","Mersin Idman Yurdu","1-0",1,0,"T1",1,1,1,"H"
"5769",2013-05-13,2012,"Bursaspor","Eskisehirspor","0-0",0,0,"T1",1,0,0,"D"
"5770",2013-05-13,2012,"Sivasspor","Karabukspor","2-1",2,1,"T1",1,3,1,"H"
"5771",2013-05-13,2012,"Trabzonspor","Buyuksehyr","4-3",4,3,"T1",1,7,1,"H"
"5772",2013-05-17,2012,"Mersin Idman Yurdu","Gaziantepspor","1-2",1,2,"T1",1,3,-1,"A"
"5773",2013-05-18,2012,"Buyuksehyr","Kasimpasa","1-2",1,2,"T1",1,3,-1,"A"
"5774",2013-05-18,2012,"Galatasaray","Trabzonspor","2-0",2,0,"T1",1,2,2,"H"
"5775",2013-05-18,2012,"Karabukspor","Fenerbahce","3-2",3,2,"T1",1,5,1,"H"
"5776",2013-05-18,2012,"Orduspor","Akhisar Belediyespor","0-2",0,2,"T1",1,2,-2,"A"
"5777",2013-05-19,2012,"Elazigspor","Sivasspor","0-0",0,0,"T1",1,0,0,"D"
"5778",2013-05-19,2012,"Eskisehirspor","Antalyaspor","3-1",3,1,"T1",1,4,2,"H"
"5779",2013-05-19,2012,"Genclerbirligi","Bursaspor","2-2",2,2,"T1",1,4,0,"D"
"5780",2013-05-19,2012,"Kayserispor","Besiktas","2-0",2,0,"T1",1,2,2,"H"
"5781",2013-08-16,2013,"Antalyaspor","Erciyesspor","0-0",0,0,"T1",1,0,0,"D"
"5782",2013-08-17,2013,"Karabukspor","Kasimpasa","2-0",2,0,"T1",1,2,2,"H"
"5783",2013-08-17,2013,"Konyaspor","Fenerbahce","3-2",3,2,"T1",1,5,1,"H"
"5784",2013-08-17,2013,"Rizespor","Genclerbirligi","1-0",1,0,"T1",1,1,1,"H"
"5785",2013-08-18,2013,"Akhisar Belediyespor","Elazigspor","3-1",3,1,"T1",1,4,2,"H"
"5786",2013-08-18,2013,"Besiktas","Trabzonspor","2-0",2,0,"T1",1,2,2,"H"
"5787",2013-08-18,2013,"Eskisehirspor","Bursaspor","2-0",2,0,"T1",1,2,2,"H"
"5788",2013-08-19,2013,"Galatasaray","Gaziantepspor","2-1",2,1,"T1",1,3,1,"H"
"5789",2013-08-19,2013,"Kayserispor","Sivasspor","1-0",1,0,"T1",1,1,1,"H"
"5790",2013-08-23,2013,"Genclerbirligi","Akhisar Belediyespor","3-0",3,0,"T1",1,3,3,"H"
"5791",2013-08-24,2013,"Fenerbahce","Eskisehirspor","1-0",1,0,"T1",1,1,1,"H"
"5792",2013-08-24,2013,"Gaziantepspor","Antalyaspor","0-0",0,0,"T1",1,0,0,"D"
"5793",2013-08-24,2013,"Kasimpasa","Kayserispor","3-1",3,1,"T1",1,4,2,"H"
"5794",2013-08-25,2013,"Bursaspor","Galatasaray","1-1",1,1,"T1",1,2,0,"D"
"5795",2013-08-25,2013,"Elazigspor","Karabukspor","2-2",2,2,"T1",1,4,0,"D"
"5796",2013-08-25,2013,"Sivasspor","Konyaspor","2-0",2,0,"T1",1,2,2,"H"
"5797",2013-08-26,2013,"Erciyesspor","Besiktas","2-4",2,4,"T1",1,6,-2,"A"
"5798",2013-08-26,2013,"Trabzonspor","Rizespor","2-1",2,1,"T1",1,3,1,"H"
"5799",2013-08-30,2013,"Eskisehirspor","Galatasaray","0-0",0,0,"T1",1,0,0,"D"
"5800",2013-08-30,2013,"Konyaspor","Kasimpasa","1-2",1,2,"T1",1,3,-1,"A"
"5801",2013-08-31,2013,"Antalyaspor","Bursaspor","1-2",1,2,"T1",1,3,-1,"A"
"5802",2013-08-31,2013,"Fenerbahce","Sivasspor","5-2",5,2,"T1",1,7,3,"H"
"5803",2013-08-31,2013,"Kayserispor","Elazigspor","1-3",1,3,"T1",1,4,-2,"A"
"5804",2013-09-01,2013,"Akhisar Belediyespor","Trabzonspor","3-0",3,0,"T1",1,3,3,"H"
"5805",2013-09-01,2013,"Besiktas","Gaziantepspor","2-0",2,0,"T1",1,2,2,"H"
"5806",2013-09-01,2013,"Karabukspor","Genclerbirligi","1-0",1,0,"T1",1,1,1,"H"
"5807",2013-09-01,2013,"Rizespor","Erciyesspor","2-1",2,1,"T1",1,3,1,"H"
"5808",2013-09-13,2013,"Galatasaray","Antalyaspor","1-1",1,1,"T1",1,2,0,"D"
"5809",2013-09-14,2013,"Erciyesspor","Akhisar Belediyespor","1-0",1,0,"T1",1,1,1,"H"
"5810",2013-09-14,2013,"Gaziantepspor","Rizespor","2-5",2,5,"T1",1,7,-3,"A"
"5811",2013-09-14,2013,"Trabzonspor","Karabukspor","1-0",1,0,"T1",1,1,1,"H"
"5812",2013-09-15,2013,"Bursaspor","Besiktas","0-3",0,3,"T1",1,3,-3,"A"
"5813",2013-09-15,2013,"Elazigspor","Konyaspor","2-0",2,0,"T1",1,2,2,"H"
"5814",2013-09-15,2013,"Genclerbirligi","Kayserispor","1-1",1,1,"T1",1,2,0,"D"
"5815",2013-09-15,2013,"Sivasspor","Eskisehirspor","3-2",3,2,"T1",1,5,1,"H"
"5816",2013-09-16,2013,"Kasimpasa","Fenerbahce","2-3",2,3,"T1",1,5,-1,"A"
"5817",2013-09-20,2013,"Akhisar Belediyespor","Gaziantepspor","2-0",2,0,"T1",1,2,2,"H"
"5818",2013-09-20,2013,"Karabukspor","Erciyesspor","0-0",0,0,"T1",1,0,0,"D"
"5819",2013-09-21,2013,"Eskisehirspor","Antalyaspor","2-1",2,1,"T1",1,3,1,"H"
"5820",2013-09-21,2013,"Fenerbahce","Elazigspor","4-0",4,0,"T1",1,4,4,"H"
"5821",2013-09-21,2013,"Konyaspor","Genclerbirligi","1-0",1,0,"T1",1,1,1,"H"
"5822",2013-09-21,2013,"Sivasspor","Kasimpasa","1-2",1,2,"T1",1,3,-1,"A"
"5823",2013-09-22,2013,"Besiktas","Galatasaray","0-3",0,3,"T1",1,3,-3,"A"
"5824",2013-09-22,2013,"Rizespor","Bursaspor","2-1",2,1,"T1",1,3,1,"H"
"5825",2013-09-23,2013,"Kayserispor","Trabzonspor","0-1",0,1,"T1",1,1,-1,"A"
"5826",2013-09-27,2013,"Bursaspor","Akhisar Belediyespor","0-0",0,0,"T1",1,0,0,"D"
"5827",2013-09-28,2013,"Galatasaray","Rizespor","1-1",1,1,"T1",1,2,0,"D"
"5828",2013-09-28,2013,"Gaziantepspor","Karabukspor","3-0",3,0,"T1",1,3,3,"H"
"5829",2013-09-29,2013,"Elazigspor","Sivasspor","2-4",2,4,"T1",1,6,-2,"A"
"5830",2013-09-29,2013,"Genclerbirligi","Fenerbahce","0-1",0,1,"T1",1,1,-1,"A"
"5831",2013-09-29,2013,"Kasimpasa","Eskisehirspor","0-2",0,2,"T1",1,2,-2,"A"
"5832",2013-09-29,2013,"Trabzonspor","Konyaspor","2-0",2,0,"T1",1,2,2,"H"
"5833",2013-09-30,2013,"Antalyaspor","Besiktas","2-0",2,0,"T1",1,2,2,"H"
"5834",2013-09-30,2013,"Erciyesspor","Kayserispor","1-1",1,1,"T1",1,2,0,"D"
"5835",2013-10-04,2013,"Karabukspor","Bursaspor","0-1",0,1,"T1",1,1,-1,"A"
"5836",2013-10-05,2013,"Eskisehirspor","Besiktas","0-1",0,1,"T1",1,1,-1,"A"
"5837",2013-10-05,2013,"Kayserispor","Gaziantepspor","0-1",0,1,"T1",1,1,-1,"A"
"5838",2013-10-05,2013,"Konyaspor","Erciyesspor","1-0",1,0,"T1",1,1,1,"H"
"5839",2013-10-06,2013,"Akhisar Belediyespor","Galatasaray","2-1",2,1,"T1",1,3,1,"H"
"5840",2013-10-06,2013,"Fenerbahce","Trabzonspor","0-0",0,0,"T1",1,0,0,"D"
"5841",2013-10-06,2013,"Kasimpasa","Elazigspor","4-0",4,0,"T1",1,4,4,"H"
"5842",2013-10-06,2013,"Rizespor","Antalyaspor","1-2",1,2,"T1",1,3,-1,"A"
"5843",2013-10-06,2013,"Sivasspor","Genclerbirligi","2-0",2,0,"T1",1,2,2,"H"
"5844",2013-10-19,2013,"Elazigspor","Eskisehirspor","0-2",0,2,"T1",1,2,-2,"A"
"5845",2013-10-19,2013,"Galatasaray","Karabukspor","2-1",2,1,"T1",1,3,1,"H"
"5846",2013-10-19,2013,"Genclerbirligi","Kasimpasa","1-3",1,3,"T1",1,4,-2,"A"
"5847",2013-10-20,2013,"Antalyaspor","Akhisar Belediyespor","1-0",1,0,"T1",1,1,1,"H"
"5848",2013-10-20,2013,"Erciyesspor","Fenerbahce","1-2",1,2,"T1",1,3,-1,"A"
"5849",2013-10-20,2013,"Gaziantepspor","Konyaspor","3-3",3,3,"T1",1,6,0,"D"
"5850",2013-10-20,2013,"Trabzonspor","Sivasspor","0-0",0,0,"T1",1,0,0,"D"
"5851",2013-10-21,2013,"Besiktas","Rizespor","0-0",0,0,"T1",1,0,0,"D"
"5852",2013-10-21,2013,"Bursaspor","Kayserispor","2-0",2,0,"T1",1,2,2,"H"
"5853",2013-10-25,2013,"Fenerbahce","Gaziantepspor","3-1",3,1,"T1",1,4,2,"H"
"5854",2013-10-25,2013,"Sivasspor","Erciyesspor","2-0",2,0,"T1",1,2,2,"H"
"5855",2013-10-26,2013,"Akhisar Belediyespor","Besiktas","3-3",3,3,"T1",1,6,0,"D"
"5856",2013-10-26,2013,"Elazigspor","Genclerbirligi","1-2",1,2,"T1",1,3,-1,"A"
"5857",2013-10-26,2013,"Karabukspor","Antalyaspor","1-1",1,1,"T1",1,2,0,"D"
"5858",2013-10-27,2013,"Eskisehirspor","Rizespor","4-1",4,1,"T1",1,5,3,"H"
"5859",2013-10-27,2013,"Kayserispor","Galatasaray","2-4",2,4,"T1",1,6,-2,"A"
"5860",2013-10-27,2013,"Konyaspor","Bursaspor","0-1",0,1,"T1",1,1,-1,"A"
"5861",2013-10-28,2013,"Kasimpasa","Trabzonspor","3-2",3,2,"T1",1,5,1,"H"
"5862",2013-11-01,2013,"Galatasaray","Konyaspor","2-1",2,1,"T1",1,3,1,"H"
"5863",2013-11-02,2013,"Bursaspor","Fenerbahce","2-3",2,3,"T1",1,5,-1,"A"
"5864",2013-11-02,2013,"Erciyesspor","Kasimpasa","0-3",0,3,"T1",1,3,-3,"A"
"5865",2013-11-03,2013,"Besiktas","Karabukspor","0-0",0,0,"T1",1,0,0,"D"
"5866",2013-11-03,2013,"Rizespor","Akhisar Belediyespor","0-0",0,0,"T1",1,0,0,"D"
"5867",2013-11-03,2013,"Trabzonspor","Elazigspor","4-0",4,0,"T1",1,4,4,"H"
"5868",2013-11-04,2013,"Antalyaspor","Kayserispor","2-2",2,2,"T1",1,4,0,"D"
"5869",2013-11-04,2013,"Gaziantepspor","Sivasspor","0-4",0,4,"T1",1,4,-4,"A"
"5870",2013-11-04,2013,"Genclerbirligi","Eskisehirspor","2-0",2,0,"T1",1,2,2,"H"
"5871",2013-11-08,2013,"Elazigspor","Erciyesspor","0-1",0,1,"T1",1,1,-1,"A"
"5872",2013-11-08,2013,"Eskisehirspor","Akhisar Belediyespor","2-0",2,0,"T1",1,2,2,"H"
"5873",2013-11-09,2013,"Karabukspor","Rizespor","2-1",2,1,"T1",1,3,1,"H"
"5874",2013-11-09,2013,"Kasimpasa","Gaziantepspor","3-0",3,0,"T1",1,3,3,"H"
"5875",2013-11-09,2013,"Kayserispor","Besiktas","0-3",0,3,"T1",1,3,-3,"A"
"5876",2013-11-09,2013,"Sivasspor","Bursaspor","2-1",2,1,"T1",1,3,1,"H"
"5877",2013-11-10,2013,"Fenerbahce","Galatasaray","2-0",2,0,"T1",1,2,2,"H"
"5878",2013-11-10,2013,"Genclerbirligi","Trabzonspor","3-2",3,2,"T1",1,5,1,"H"
"5879",2013-11-10,2013,"Konyaspor","Antalyaspor","2-0",2,0,"T1",1,2,2,"H"
"5880",2013-11-23,2013,"Bursaspor","Kasimpasa","1-1",1,1,"T1",1,2,0,"D"
"5881",2013-11-23,2013,"Galatasaray","Sivasspor","2-1",2,1,"T1",1,3,1,"H"
"5882",2013-11-23,2013,"Rizespor","Kayserispor","0-2",0,2,"T1",1,2,-2,"A"
"5883",2013-11-24,2013,"Antalyaspor","Fenerbahce","1-2",1,2,"T1",1,3,-1,"A"
"5884",2013-11-24,2013,"Erciyesspor","Genclerbirligi","1-0",1,0,"T1",1,1,1,"H"
"5885",2013-11-24,2013,"Gaziantepspor","Elazigspor","3-1",3,1,"T1",1,4,2,"H"
"5886",2013-11-24,2013,"Trabzonspor","Eskisehirspor","1-0",1,0,"T1",1,1,1,"H"
"5887",2013-11-25,2013,"Akhisar Belediyespor","Karabukspor","0-1",0,1,"T1",1,1,-1,"A"
"5888",2013-11-25,2013,"Besiktas","Konyaspor","3-1",3,1,"T1",1,4,2,"H"
"5889",2013-11-29,2013,"Elazigspor","Bursaspor","1-2",1,2,"T1",1,3,-1,"A"
"5890",2013-11-29,2013,"Sivasspor","Antalyaspor","0-3",0,3,"T1",1,3,-3,"A"
"5891",2013-11-30,2013,"Fenerbahce","Besiktas","3-3",3,3,"T1",1,6,0,"D"
"5892",2013-11-30,2013,"Genclerbirligi","Gaziantepspor","1-3",1,3,"T1",1,4,-2,"A"
"5893",2013-11-30,2013,"Kayserispor","Akhisar Belediyespor","0-0",0,0,"T1",1,0,0,"D"
"5894",2013-12-01,2013,"Eskisehirspor","Karabukspor","0-0",0,0,"T1",1,0,0,"D"
"5895",2013-12-01,2013,"Kasimpasa","Galatasaray","1-1",1,1,"T1",1,2,0,"D"
"5896",2013-12-01,2013,"Trabzonspor","Erciyesspor","3-1",3,1,"T1",1,4,2,"H"
"5897",2013-12-02,2013,"Konyaspor","Rizespor","2-1",2,1,"T1",1,3,1,"H"
"5898",2013-12-06,2013,"Galatasaray","Elazigspor","2-0",2,0,"T1",1,2,2,"H"
"5899",2013-12-07,2013,"Antalyaspor","Kasimpasa","1-1",1,1,"T1",1,2,0,"D"
"5900",2013-12-07,2013,"Rizespor","Fenerbahce","1-2",1,2,"T1",1,3,-1,"A"
"5901",2013-12-08,2013,"Akhisar Belediyespor","Konyaspor","2-1",2,1,"T1",1,3,1,"H"
"5902",2013-12-08,2013,"Bursaspor","Genclerbirligi","0-0",0,0,"T1",1,0,0,"D"
"5903",2013-12-08,2013,"Gaziantepspor","Trabzonspor","3-2",3,2,"T1",1,5,1,"H"
"5904",2013-12-08,2013,"Karabukspor","Kayserispor","1-0",1,0,"T1",1,1,1,"H"
"5905",2013-12-09,2013,"Besiktas","Sivasspor","1-1",1,1,"T1",1,2,0,"D"
"5906",2013-12-09,2013,"Erciyesspor","Eskisehirspor","0-2",0,2,"T1",1,2,-2,"A"
"5907",2013-12-13,2013,"Fenerbahce","Akhisar Belediyespor","4-0",4,0,"T1",1,4,4,"H"
"5908",2013-12-13,2013,"Konyaspor","Karabukspor","2-3",2,3,"T1",1,5,-1,"A"
"5909",2013-12-14,2013,"Elazigspor","Antalyaspor","4-1",4,1,"T1",1,5,3,"H"
"5910",2013-12-14,2013,"Kayserispor","Eskisehirspor","1-1",1,1,"T1",1,2,0,"D"
"5911",2013-12-14,2013,"Sivasspor","Rizespor","3-1",3,1,"T1",1,4,2,"H"
"5912",2013-12-15,2013,"Gaziantepspor","Erciyesspor","2-1",2,1,"T1",1,3,1,"H"
"5913",2013-12-15,2013,"Genclerbirligi","Galatasaray","1-1",1,1,"T1",1,2,0,"D"
"5914",2013-12-16,2013,"Trabzonspor","Bursaspor","2-2",2,2,"T1",1,4,0,"D"
"5915",2013-12-20,2013,"Rizespor","Kasimpasa","0-0",0,0,"T1",1,0,0,"D"
"5916",2013-12-21,2013,"Besiktas","Elazigspor","4-1",4,1,"T1",1,5,3,"H"
"5917",2013-12-22,2013,"Antalyaspor","Genclerbirligi","2-3",2,3,"T1",1,5,-1,"A"
"5918",2013-12-22,2013,"Eskisehirspor","Gaziantepspor","2-0",2,0,"T1",1,2,2,"H"
"5919",2013-12-22,2013,"Galatasaray","Trabzonspor","2-1",2,1,"T1",1,3,1,"H"
"5920",2013-12-22,2013,"Karabukspor","Fenerbahce","2-1",2,1,"T1",1,3,1,"H"
"5921",2013-12-22,2013,"Kayserispor","Konyaspor","0-0",0,0,"T1",1,0,0,"D"
"5922",2013-12-23,2013,"Akhisar Belediyespor","Sivasspor","2-1",2,1,"T1",1,3,1,"H"
"5923",2013-12-23,2013,"Bursaspor","Erciyesspor","3-1",3,1,"T1",1,4,2,"H"
"5924",2013-12-27,2013,"Genclerbirligi","Besiktas","1-0",1,0,"T1",1,1,1,"H"
"5925",2013-12-27,2013,"Kasimpasa","Akhisar Belediyespor","2-4",2,4,"T1",1,6,-2,"A"
"5926",2013-12-28,2013,"Elazigspor","Rizespor","1-0",1,0,"T1",1,1,1,"H"
"5927",2013-12-28,2013,"Erciyesspor","Galatasaray","1-3",1,3,"T1",1,4,-2,"A"
"5928",2013-12-28,2013,"Gaziantepspor","Bursaspor","0-0",0,0,"T1",1,0,0,"D"
"5929",2013-12-29,2013,"Fenerbahce","Kayserispor","5-1",5,1,"T1",1,6,4,"H"
"5930",2013-12-29,2013,"Konyaspor","Eskisehirspor","4-1",4,1,"T1",1,5,3,"H"
"5931",2013-12-29,2013,"Sivasspor","Karabukspor","3-1",3,1,"T1",1,4,2,"H"
"5932",2013-12-29,2013,"Trabzonspor","Antalyaspor","2-1",2,1,"T1",1,3,1,"H"
"5933",2014-01-24,2013,"Kasimpasa","Karabukspor","0-0",0,0,"T1",1,0,0,"D"
"5934",2014-01-25,2013,"Bursaspor","Eskisehirspor","3-1",3,1,"T1",1,4,2,"H"
"5935",2014-01-25,2013,"Genclerbirligi","Rizespor","3-1",3,1,"T1",1,4,2,"H"
"5936",2014-01-25,2013,"Trabzonspor","Besiktas","1-1",1,1,"T1",1,2,0,"D"
"5937",2014-01-26,2013,"Elazigspor","Akhisar Belediyespor","2-1",2,1,"T1",1,3,1,"H"
"5938",2014-01-26,2013,"Erciyesspor","Antalyaspor","1-3",1,3,"T1",1,4,-2,"A"
"5939",2014-01-26,2013,"Gaziantepspor","Galatasaray","0-0",0,0,"T1",1,0,0,"D"
"5940",2014-01-26,2013,"Sivasspor","Kayserispor","3-0",3,0,"T1",1,3,3,"H"
"5941",2014-01-27,2013,"Fenerbahce","Konyaspor","2-1",2,1,"T1",1,3,1,"H"
"5942",2014-01-31,2013,"Besiktas","Erciyesspor","3-2",3,2,"T1",1,5,1,"H"
"5943",2014-02-01,2013,"Antalyaspor","Gaziantepspor","0-1",0,1,"T1",1,1,-1,"A"
"5944",2014-02-01,2013,"Eskisehirspor","Fenerbahce","2-1",2,1,"T1",1,3,1,"H"
"5945",2014-02-01,2013,"Kayserispor","Kasimpasa","0-0",0,0,"T1",1,0,0,"D"
"5946",2014-02-02,2013,"Akhisar Belediyespor","Genclerbirligi","3-1",3,1,"T1",1,4,2,"H"
"5947",2014-02-02,2013,"Galatasaray","Bursaspor","6-0",6,0,"T1",1,6,6,"H"
"5948",2014-02-02,2013,"Karabukspor","Elazigspor","3-1",3,1,"T1",1,4,2,"H"
"5949",2014-02-02,2013,"Konyaspor","Sivasspor","3-0",3,0,"T1",1,3,3,"H"
"5950",2014-02-03,2013,"Rizespor","Trabzonspor","0-0",0,0,"T1",1,0,0,"D"
"5951",2014-02-07,2013,"Gaziantepspor","Besiktas","1-2",1,2,"T1",1,3,-1,"A"
"5952",2014-02-07,2013,"Kasimpasa","Konyaspor","1-3",1,3,"T1",1,4,-2,"A"
"5953",2014-02-08,2013,"Erciyesspor","Rizespor","1-1",1,1,"T1",1,2,0,"D"
"5954",2014-02-08,2013,"Galatasaray","Eskisehirspor","3-0",3,0,"T1",1,3,3,"H"
"5955",2014-02-09,2013,"Bursaspor","Antalyaspor","1-1",1,1,"T1",1,2,0,"D"
"5956",2014-02-09,2013,"Elazigspor","Kayserispor","3-0",3,0,"T1",1,3,3,"H"
"5957",2014-02-09,2013,"Sivasspor","Fenerbahce","2-0",2,0,"T1",1,2,2,"H"
"5958",2014-02-09,2013,"Trabzonspor","Akhisar Belediyespor","2-4",2,4,"T1",1,6,-2,"A"
"5959",2014-02-10,2013,"Genclerbirligi","Karabukspor","1-2",1,2,"T1",1,3,-1,"A"
"5960",2014-02-11,2013,"Kasimpasa","Besiktas","0-3",0,3,"T1",1,3,-3,"A"
"5961",2014-02-14,2013,"Rizespor","Gaziantepspor","5-1",5,1,"T1",1,6,4,"H"
"5962",2014-02-15,2013,"Karabukspor","Trabzonspor","2-2",2,2,"T1",1,4,0,"D"
"5963",2014-02-15,2013,"Kayserispor","Genclerbirligi","1-0",1,0,"T1",1,1,1,"H"
"5964",2014-02-16,2013,"Akhisar Belediyespor","Erciyesspor","0-2",0,2,"T1",1,2,-2,"A"
"5965",2014-02-16,2013,"Besiktas","Bursaspor","1-0",1,0,"T1",1,1,1,"H"
"5966",2014-02-16,2013,"Fenerbahce","Kasimpasa","2-1",2,1,"T1",1,3,1,"H"
"5967",2014-02-17,2013,"Antalyaspor","Galatasaray","2-2",2,2,"T1",1,4,0,"D"
"5968",2014-02-17,2013,"Eskisehirspor","Sivasspor","2-2",2,2,"T1",1,4,0,"D"
"5969",2014-02-17,2013,"Konyaspor","Elazigspor","2-3",2,3,"T1",1,5,-1,"A"
"5970",2014-02-21,2013,"Bursaspor","Rizespor","2-0",2,0,"T1",1,2,2,"H"
"5971",2014-02-22,2013,"Erciyesspor","Karabukspor","2-1",2,1,"T1",1,3,1,"H"
"5972",2014-02-22,2013,"Galatasaray","Besiktas","1-0",1,0,"T1",1,1,1,"H"
"5973",2014-02-22,2013,"Gaziantepspor","Akhisar Belediyespor","1-1",1,1,"T1",1,2,0,"D"
"5974",2014-02-23,2013,"Antalyaspor","Eskisehirspor","0-0",0,0,"T1",1,0,0,"D"
"5975",2014-02-23,2013,"Genclerbirligi","Konyaspor","2-2",2,2,"T1",1,4,0,"D"
"5976",2014-02-23,2013,"Kasimpasa","Sivasspor","6-2",6,2,"T1",1,8,4,"H"
"5977",2014-02-23,2013,"Trabzonspor","Kayserispor","2-1",2,1,"T1",1,3,1,"H"
"5978",2014-02-24,2013,"Elazigspor","Fenerbahce","1-1",1,1,"T1",1,2,0,"D"
"5979",2014-02-28,2013,"Akhisar Belediyespor","Bursaspor","2-1",2,1,"T1",1,3,1,"H"
"5980",2014-02-28,2013,"Besiktas","Antalyaspor","0-0",0,0,"T1",1,0,0,"D"
"5981",2014-03-01,2013,"Eskisehirspor","Kasimpasa","0-0",0,0,"T1",1,0,0,"D"
"5982",2014-03-01,2013,"Fenerbahce","Genclerbirligi","2-0",2,0,"T1",1,2,2,"H"
"5983",2014-03-01,2013,"Karabukspor","Gaziantepspor","0-1",0,1,"T1",1,1,-1,"A"
"5984",2014-03-02,2013,"Kayserispor","Erciyesspor","0-4",0,4,"T1",1,4,-4,"A"
"5985",2014-03-02,2013,"Konyaspor","Trabzonspor","0-0",0,0,"T1",1,0,0,"D"
"5986",2014-03-02,2013,"Rizespor","Galatasaray","1-1",1,1,"T1",1,2,0,"D"
"5987",2014-03-02,2013,"Sivasspor","Elazigspor","1-3",1,3,"T1",1,4,-2,"A"
"5988",2014-03-08,2013,"Bursaspor","Karabukspor","1-0",1,0,"T1",1,1,1,"H"
"5989",2014-03-08,2013,"Elazigspor","Kasimpasa","0-0",0,0,"T1",1,0,0,"D"
"5990",2014-03-08,2013,"Erciyesspor","Konyaspor","1-0",1,0,"T1",1,1,1,"H"
"5991",2014-03-08,2013,"Galatasaray","Akhisar Belediyespor","6-1",6,1,"T1",1,7,5,"H"
"5992",2014-03-09,2013,"Antalyaspor","Rizespor","1-2",1,2,"T1",1,3,-1,"A"
"5993",2014-03-09,2013,"Besiktas","Eskisehirspor","1-0",1,0,"T1",1,1,1,"H"
"5994",2014-03-09,2013,"Gaziantepspor","Kayserispor","2-1",2,1,"T1",1,3,1,"H"
"5995",2014-03-09,2013,"Genclerbirligi","Sivasspor","2-1",2,1,"T1",1,3,1,"H"
"5996",2014-03-10,2013,"Trabzonspor","Fenerbahce","0-3",0,3,"T1",1,3,-3,"A"
"5997",2014-03-14,2013,"Karabukspor","Galatasaray","0-0",0,0,"T1",1,0,0,"D"
"5998",2014-03-15,2013,"Akhisar Belediyespor","Antalyaspor","0-0",0,0,"T1",1,0,0,"D"
"5999",2014-03-15,2013,"Kasimpasa","Genclerbirligi","1-2",1,2,"T1",1,3,-1,"A"
"6000",2014-03-15,2013,"Rizespor","Besiktas","2-2",2,2,"T1",1,4,0,"D"
"6001",2014-03-16,2013,"Eskisehirspor","Elazigspor","1-0",1,0,"T1",1,1,1,"H"
"6002",2014-03-16,2013,"Fenerbahce","Erciyesspor","2-1",2,1,"T1",1,3,1,"H"
"6003",2014-03-16,2013,"Konyaspor","Gaziantepspor","0-1",0,1,"T1",1,1,-1,"A"
"6004",2014-03-16,2013,"Sivasspor","Trabzonspor","0-4",0,4,"T1",1,4,-4,"A"
"6005",2014-03-17,2013,"Kayserispor","Bursaspor","2-0",2,0,"T1",1,2,2,"H"
"6006",2014-03-21,2013,"Trabzonspor","Kasimpasa","0-0",0,0,"T1",1,0,0,"D"
"6007",2014-03-22,2013,"Antalyaspor","Karabukspor","0-0",0,0,"T1",1,0,0,"D"
"6008",2014-03-22,2013,"Bursaspor","Konyaspor","1-2",1,2,"T1",1,3,-1,"A"
"6009",2014-03-22,2013,"Galatasaray","Kayserispor","0-1",0,1,"T1",1,1,-1,"A"
"6010",2014-03-22,2013,"Rizespor","Eskisehirspor","0-0",0,0,"T1",1,0,0,"D"
"6011",2014-03-23,2013,"Besiktas","Akhisar Belediyespor","3-0",3,0,"T1",1,3,3,"H"
"6012",2014-03-23,2013,"Erciyesspor","Sivasspor","1-1",1,1,"T1",1,2,0,"D"
"6013",2014-03-23,2013,"Genclerbirligi","Elazigspor","3-1",3,1,"T1",1,4,2,"H"
"6014",2014-03-24,2013,"Gaziantepspor","Fenerbahce","0-3",0,3,"T1",1,3,-3,"A"
"6015",2014-03-28,2013,"Karabukspor","Besiktas","1-0",1,0,"T1",1,1,1,"H"
"6016",2014-03-28,2013,"Kasimpasa","Erciyesspor","3-0",3,0,"T1",1,3,3,"H"
"6017",2014-03-29,2013,"Akhisar Belediyespor","Rizespor","2-3",2,3,"T1",1,5,-1,"A"
"6018",2014-03-29,2013,"Elazigspor","Trabzonspor","0-0",0,0,"T1",1,0,0,"D"
"6019",2014-03-29,2013,"Konyaspor","Galatasaray","0-0",0,0,"T1",1,0,0,"D"
"6020",2014-03-29,2013,"Sivasspor","Gaziantepspor","3-2",3,2,"T1",1,5,1,"H"
"6021",2014-03-31,2013,"Eskisehirspor","Genclerbirligi","0-1",0,1,"T1",1,1,-1,"A"
"6022",2014-03-31,2013,"Fenerbahce","Bursaspor","3-0",3,0,"T1",1,3,3,"H"
"6023",2014-03-31,2013,"Kayserispor","Antalyaspor","3-1",3,1,"T1",1,4,2,"H"
"6024",2014-04-04,2013,"Gaziantepspor","Kasimpasa","2-2",2,2,"T1",1,4,0,"D"
"6025",2014-04-05,2013,"Akhisar Belediyespor","Eskisehirspor","0-0",0,0,"T1",1,0,0,"D"
"6026",2014-04-05,2013,"Antalyaspor","Konyaspor","1-1",1,1,"T1",1,2,0,"D"
"6027",2014-04-05,2013,"Besiktas","Kayserispor","2-1",2,1,"T1",1,3,1,"H"
"6028",2014-04-05,2013,"Rizespor","Karabukspor","0-1",0,1,"T1",1,1,-1,"A"
"6029",2014-04-06,2013,"Bursaspor","Sivasspor","4-3",4,3,"T1",1,7,1,"H"
"6030",2014-04-06,2013,"Erciyesspor","Elazigspor","3-0",3,0,"T1",1,3,3,"H"
"6031",2014-04-06,2013,"Galatasaray","Fenerbahce","1-0",1,0,"T1",1,1,1,"H"
"6032",2014-04-07,2013,"Trabzonspor","Genclerbirligi","3-0",3,0,"T1",1,3,3,"H"
"6033",2014-04-11,2013,"Konyaspor","Besiktas","1-1",1,1,"T1",1,2,0,"D"
"6034",2014-04-12,2013,"Karabukspor","Akhisar Belediyespor","0-2",0,2,"T1",1,2,-2,"A"
"6035",2014-04-12,2013,"Kasimpasa","Bursaspor","1-1",1,1,"T1",1,2,0,"D"
"6036",2014-04-12,2013,"Kayserispor","Rizespor","0-2",0,2,"T1",1,2,-2,"A"
"6037",2014-04-12,2013,"Sivasspor","Galatasaray","2-1",2,1,"T1",1,3,1,"H"
"6038",2014-04-13,2013,"Eskisehirspor","Trabzonspor","2-2",2,2,"T1",1,4,0,"D"
"6039",2014-04-13,2013,"Fenerbahce","Antalyaspor","4-1",4,1,"T1",1,5,3,"H"
"6040",2014-04-13,2013,"Genclerbirligi","Erciyesspor","0-0",0,0,"T1",1,0,0,"D"
"6041",2014-04-14,2013,"Elazigspor","Gaziantepspor","2-1",2,1,"T1",1,3,1,"H"
"6042",2014-04-18,2013,"Erciyesspor","Trabzonspor","0-5",0,5,"T1",1,5,-5,"A"
"6043",2014-04-19,2013,"Akhisar Belediyespor","Kayserispor","2-2",2,2,"T1",1,4,0,"D"
"6044",2014-04-19,2013,"Bursaspor","Elazigspor","1-0",1,0,"T1",1,1,1,"H"
"6045",2014-04-19,2013,"Galatasaray","Kasimpasa","0-4",0,4,"T1",1,4,-4,"A"
"6046",2014-04-19,2013,"Gaziantepspor","Genclerbirligi","0-1",0,1,"T1",1,1,-1,"A"
"6047",2014-04-20,2013,"Besiktas","Fenerbahce","1-1",1,1,"T1",1,2,0,"D"
"6048",2014-04-20,2013,"Rizespor","Konyaspor","3-1",3,1,"T1",1,4,2,"H"
"6049",2014-04-21,2013,"Antalyaspor","Sivasspor","1-2",1,2,"T1",1,3,-1,"A"
"6050",2014-04-21,2013,"Karabukspor","Eskisehirspor","0-0",0,0,"T1",1,0,0,"D"
"6051",2014-04-25,2013,"Genclerbirligi","Bursaspor","1-0",1,0,"T1",1,1,1,"H"
"6052",2014-04-26,2013,"Trabzonspor","Gaziantepspor","2-1",2,1,"T1",1,3,1,"H"
"6053",2014-04-27,2013,"Elazigspor","Galatasaray","0-1",0,1,"T1",1,1,-1,"A"
"6054",2014-04-27,2013,"Eskisehirspor","Erciyesspor","0-1",0,1,"T1",1,1,-1,"A"
"6055",2014-04-27,2013,"Fenerbahce","Rizespor","0-0",0,0,"T1",1,0,0,"D"
"6056",2014-04-27,2013,"Kasimpasa","Antalyaspor","2-0",2,0,"T1",1,2,2,"H"
"6057",2014-04-27,2013,"Kayserispor","Karabukspor","1-3",1,3,"T1",1,4,-2,"A"
"6058",2014-04-27,2013,"Konyaspor","Akhisar Belediyespor","4-0",4,0,"T1",1,4,4,"H"
"6059",2014-04-27,2013,"Sivasspor","Besiktas","3-0",3,0,"T1",1,3,3,"H"
"6060",2014-05-03,2013,"Antalyaspor","Elazigspor","1-2",1,2,"T1",1,3,-1,"A"
"6061",2014-05-03,2013,"Besiktas","Kasimpasa","2-1",2,1,"T1",1,3,1,"H"
"6062",2014-05-03,2013,"Erciyesspor","Gaziantepspor","1-0",1,0,"T1",1,1,1,"H"
"6063",2014-05-03,2013,"Eskisehirspor","Kayserispor","1-4",1,4,"T1",1,5,-3,"A"
"6064",2014-05-03,2013,"Galatasaray","Genclerbirligi","3-2",3,2,"T1",1,5,1,"H"
"6065",2014-05-03,2013,"Karabukspor","Konyaspor","2-2",2,2,"T1",1,4,0,"D"
"6066",2014-05-04,2013,"Akhisar Belediyespor","Fenerbahce","3-1",3,1,"T1",1,4,2,"H"
"6067",2014-05-04,2013,"Bursaspor","Trabzonspor","2-2",2,2,"T1",1,4,0,"D"
"6068",2014-05-04,2013,"Rizespor","Sivasspor","1-1",1,1,"T1",1,2,0,"D"
"6069",2014-05-09,2013,"Fenerbahce","Karabukspor","4-0",4,0,"T1",1,4,4,"H"
"6070",2014-05-10,2013,"Genclerbirligi","Antalyaspor","1-2",1,2,"T1",1,3,-1,"A"
"6071",2014-05-11,2013,"Elazigspor","Besiktas","0-1",0,1,"T1",1,1,-1,"A"
"6072",2014-05-11,2013,"Erciyesspor","Bursaspor","1-1",1,1,"T1",1,2,0,"D"
"6073",2014-05-11,2013,"Gaziantepspor","Eskisehirspor","1-1",1,1,"T1",1,2,0,"D"
"6074",2014-05-11,2013,"Kasimpasa","Rizespor","1-1",1,1,"T1",1,2,0,"D"
"6075",2014-05-11,2013,"Konyaspor","Kayserispor","3-0",3,0,"T1",1,3,3,"H"
"6076",2014-05-11,2013,"Sivasspor","Akhisar Belediyespor","3-1",3,1,"T1",1,4,2,"H"
"6077",2014-05-11,2013,"Trabzonspor","Galatasaray","1-4",1,4,"T1",1,5,-3,"A"
"6078",2014-05-16,2013,"Eskisehirspor","Konyaspor","1-1",1,1,"T1",1,2,0,"D"
"6079",2014-05-16,2013,"Kayserispor","Fenerbahce","0-2",0,2,"T1",1,2,-2,"A"
"6080",2014-05-17,2013,"Besiktas","Genclerbirligi","1-1",1,1,"T1",1,2,0,"D"
"6081",2014-05-17,2013,"Bursaspor","Gaziantepspor","3-1",3,1,"T1",1,4,2,"H"
"6082",2014-05-17,2013,"Galatasaray","Erciyesspor","2-1",2,1,"T1",1,3,1,"H"
"6083",2014-05-17,2013,"Rizespor","Elazigspor","3-1",3,1,"T1",1,4,2,"H"
"6084",2014-05-18,2013,"Akhisar Belediyespor","Kasimpasa","1-3",1,3,"T1",1,4,-2,"A"
"6085",2014-05-18,2013,"Antalyaspor","Trabzonspor","0-2",0,2,"T1",1,2,-2,"A"
"6086",2014-05-18,2013,"Karabukspor","Sivasspor","1-0",1,0,"T1",1,1,1,"H"
"6087",2014-08-29,2014,"Balikesirspor","Akhisar Belediyespor","1-2",1,2,"T1",1,3,-1,"A"
"6088",2014-08-29,2014,"Rizespor","Genclerbirligi","1-1",1,1,"T1",1,2,0,"D"
"6089",2014-08-30,2014,"Bursaspor","Galatasaray","0-2",0,2,"T1",1,2,-2,"A"
"6090",2014-08-30,2014,"Buyuksehyr","Kasimpasa","1-1",1,1,"T1",1,2,0,"D"
"6091",2014-08-30,2014,"Eskisehirspor","Konyaspor","2-1",2,1,"T1",1,3,1,"H"
"6092",2014-08-30,2014,"Mersin Idman Yurdu","Besiktas","0-1",0,1,"T1",1,1,-1,"A"
"6093",2014-08-31,2014,"Erciyesspor","Trabzonspor","0-0",0,0,"T1",1,0,0,"D"
"6094",2014-08-31,2014,"Fenerbahce","Karabukspor","3-2",3,2,"T1",1,5,1,"H"
"6095",2014-08-31,2014,"Sivasspor","Gaziantepspor","1-2",1,2,"T1",1,3,-1,"A"
"6096",2014-09-13,2014,"Galatasaray","Eskisehirspor","0-0",0,0,"T1",1,0,0,"D"
"6097",2014-09-13,2014,"Genclerbirligi","Bursaspor","1-2",1,2,"T1",1,3,-1,"A"
"6098",2014-09-13,2014,"Karabukspor","Buyuksehyr","0-0",0,0,"T1",1,0,0,"D"
"6099",2014-09-13,2014,"Konyaspor","Balikesirspor","2-0",2,0,"T1",1,2,2,"H"
"6100",2014-09-14,2014,"Gaziantepspor","Erciyesspor","2-2",2,2,"T1",1,4,0,"D"
"6101",2014-09-14,2014,"Kasimpasa","Mersin Idman Yurdu","2-2",2,2,"T1",1,4,0,"D"
"6102",2014-09-14,2014,"Trabzonspor","Fenerbahce","0-0",0,0,"T1",1,0,0,"D"
"6103",2014-09-15,2014,"Akhisar Belediyespor","Sivasspor","2-2",2,2,"T1",1,4,0,"D"
"6104",2014-09-15,2014,"Besiktas","Rizespor","1-1",1,1,"T1",1,2,0,"D"
"6105",2014-09-19,2014,"Eskisehirspor","Genclerbirligi","0-2",0,2,"T1",1,2,-2,"A"
"6106",2014-09-20,2014,"Balikesirspor","Galatasaray","2-0",2,0,"T1",1,2,2,"H"
"6107",2014-09-20,2014,"Erciyesspor","Akhisar Belediyespor","1-2",1,2,"T1",1,3,-1,"A"
"6108",2014-09-20,2014,"Mersin Idman Yurdu","Rizespor","2-0",2,0,"T1",1,2,2,"H"
"6109",2014-09-21,2014,"Fenerbahce","Gaziantepspor","1-0",1,0,"T1",1,1,1,"H"
"6110",2014-09-21,2014,"Kasimpasa","Karabukspor","2-1",2,1,"T1",1,3,1,"H"
"6111",2014-09-21,2014,"Sivasspor","Konyaspor","0-0",0,0,"T1",1,0,0,"D"
"6112",2014-09-22,2014,"Bursaspor","Besiktas","0-1",0,1,"T1",1,1,-1,"A"
"6113",2014-09-22,2014,"Buyuksehyr","Trabzonspor","1-1",1,1,"T1",1,2,0,"D"
"6114",2014-09-26,2014,"Galatasaray","Sivasspor","2-1",2,1,"T1",1,3,1,"H"
"6115",2014-09-27,2014,"Besiktas","Eskisehirspor","1-1",1,1,"T1",1,2,0,"D"
"6116",2014-09-27,2014,"Trabzonspor","Kasimpasa","1-1",1,1,"T1",1,2,0,"D"
"6117",2014-09-28,2014,"Akhisar Belediyespor","Fenerbahce","2-0",2,0,"T1",1,2,2,"H"
"6118",2014-09-28,2014,"Genclerbirligi","Balikesirspor","3-1",3,1,"T1",1,4,2,"H"
"6119",2014-09-28,2014,"Konyaspor","Erciyesspor","1-1",1,1,"T1",1,2,0,"D"
"6120",2014-09-28,2014,"Rizespor","Bursaspor","0-1",0,1,"T1",1,1,-1,"A"
"6121",2014-09-29,2014,"Gaziantepspor","Buyuksehyr","0-0",0,0,"T1",1,0,0,"D"
"6122",2014-09-29,2014,"Karabukspor","Mersin Idman Yurdu","0-2",0,2,"T1",1,2,-2,"A"
"6123",2014-10-03,2014,"Mersin Idman Yurdu","Bursaspor","2-1",2,1,"T1",1,3,1,"H"
"6124",2014-10-04,2014,"Erciyesspor","Galatasaray","1-2",1,2,"T1",1,3,-1,"A"
"6125",2014-10-04,2014,"Fenerbahce","Konyaspor","2-1",2,1,"T1",1,3,1,"H"
"6126",2014-10-04,2014,"Kasimpasa","Gaziantepspor","4-2",4,2,"T1",1,6,2,"H"
"6127",2014-10-04,2014,"Sivasspor","Genclerbirligi","1-0",1,0,"T1",1,1,1,"H"
"6128",2014-10-05,2014,"Balikesirspor","Besiktas","0-1",0,1,"T1",1,1,-1,"A"
"6129",2014-10-05,2014,"Buyuksehyr","Akhisar Belediyespor","4-0",4,0,"T1",1,4,4,"H"
"6130",2014-10-05,2014,"Eskisehirspor","Rizespor","1-2",1,2,"T1",1,3,-1,"A"
"6131",2014-10-05,2014,"Karabukspor","Trabzonspor","3-0",3,0,"T1",1,3,3,"H"
"6132",2014-10-18,2014,"Galatasaray","Fenerbahce","2-1",2,1,"T1",1,3,1,"H"
"6133",2014-10-18,2014,"Gaziantepspor","Karabukspor","1-0",1,0,"T1",1,1,1,"H"
"6134",2014-10-18,2014,"Konyaspor","Buyuksehyr","0-0",0,0,"T1",1,0,0,"D"
"6135",2014-10-19,2014,"Akhisar Belediyespor","Kasimpasa","2-0",2,0,"T1",1,2,2,"H"
"6136",2014-10-19,2014,"Besiktas","Sivasspor","3-2",3,2,"T1",1,5,1,"H"
"6137",2014-10-19,2014,"Bursaspor","Eskisehirspor","2-2",2,2,"T1",1,4,0,"D"
"6138",2014-10-19,2014,"Trabzonspor","Mersin Idman Yurdu","3-1",3,1,"T1",1,4,2,"H"
"6139",2014-10-20,2014,"Genclerbirligi","Erciyesspor","0-0",0,0,"T1",1,0,0,"D"
"6140",2014-10-20,2014,"Rizespor","Balikesirspor","2-2",2,2,"T1",1,4,0,"D"
"6141",2014-10-24,2014,"Karabukspor","Akhisar Belediyespor","2-1",2,1,"T1",1,3,1,"H"
"6142",2014-10-24,2014,"Kasimpasa","Konyaspor","2-0",2,0,"T1",1,2,2,"H"
"6143",2014-10-25,2014,"Balikesirspor","Bursaspor","0-5",0,5,"T1",1,5,-5,"A"
"6144",2014-10-25,2014,"Fenerbahce","Genclerbirligi","2-1",2,1,"T1",1,3,1,"H"
"6145",2014-10-25,2014,"Sivasspor","Rizespor","0-1",0,1,"T1",1,1,-1,"A"
"6146",2014-10-26,2014,"Buyuksehyr","Galatasaray","4-0",4,0,"T1",1,4,4,"H"
"6147",2014-10-26,2014,"Mersin Idman Yurdu","Eskisehirspor","4-2",4,2,"T1",1,6,2,"H"
"6148",2014-10-26,2014,"Trabzonspor","Gaziantepspor","4-4",4,4,"T1",1,8,0,"D"
"6149",2014-10-27,2014,"Erciyesspor","Besiktas","3-2",3,2,"T1",1,5,1,"H"
"6150",2014-10-31,2014,"Galatasaray","Kasimpasa","2-1",2,1,"T1",1,3,1,"H"
"6151",2014-11-01,2014,"Akhisar Belediyespor","Trabzonspor","1-1",1,1,"T1",1,2,0,"D"
"6152",2014-11-01,2014,"Bursaspor","Sivasspor","3-0",3,0,"T1",1,3,3,"H"
"6153",2014-11-01,2014,"Genclerbirligi","Buyuksehyr","1-0",1,0,"T1",1,1,1,"H"
"6154",2014-11-02,2014,"Besiktas","Fenerbahce","0-2",0,2,"T1",1,2,-2,"A"
"6155",2014-11-02,2014,"Gaziantepspor","Mersin Idman Yurdu","1-0",1,0,"T1",1,1,1,"H"
"6156",2014-11-02,2014,"Rizespor","Erciyesspor","1-1",1,1,"T1",1,2,0,"D"
"6157",2014-11-03,2014,"Eskisehirspor","Balikesirspor","2-2",2,2,"T1",1,4,0,"D"
"6158",2014-11-03,2014,"Konyaspor","Karabukspor","1-0",1,0,"T1",1,1,1,"H"
"6159",2014-11-07,2014,"Gaziantepspor","Akhisar Belediyespor","1-0",1,0,"T1",1,1,1,"H"
"6160",2014-11-07,2014,"Sivasspor","Eskisehirspor","1-1",1,1,"T1",1,2,0,"D"
"6161",2014-11-08,2014,"Fenerbahce","Rizespor","2-1",2,1,"T1",1,3,1,"H"
"6162",2014-11-08,2014,"Karabukspor","Galatasaray","1-2",1,2,"T1",1,3,-1,"A"
"6163",2014-11-08,2014,"Mersin Idman Yurdu","Balikesirspor","2-1",2,1,"T1",1,3,1,"H"
"6164",2014-11-09,2014,"Buyuksehyr","Besiktas","1-2",1,2,"T1",1,3,-1,"A"
"6165",2014-11-09,2014,"Erciyesspor","Bursaspor","1-1",1,1,"T1",1,2,0,"D"
"6166",2014-11-09,2014,"Kasimpasa","Genclerbirligi","2-2",2,2,"T1",1,4,0,"D"
"6167",2014-11-09,2014,"Trabzonspor","Konyaspor","3-2",3,2,"T1",1,5,1,"H"
"6168",2014-11-22,2014,"Akhisar Belediyespor","Mersin Idman Yurdu","1-1",1,1,"T1",1,2,0,"D"
"6169",2014-11-22,2014,"Galatasaray","Trabzonspor","0-3",0,3,"T1",1,3,-3,"A"
"6170",2014-11-22,2014,"Rizespor","Buyuksehyr","0-2",0,2,"T1",1,2,-2,"A"
"6171",2014-11-23,2014,"Besiktas","Kasimpasa","2-0",2,0,"T1",1,2,2,"H"
"6172",2014-11-23,2014,"Eskisehirspor","Erciyesspor","2-1",2,1,"T1",1,3,1,"H"
"6173",2014-11-23,2014,"Genclerbirligi","Karabukspor","2-2",2,2,"T1",1,4,0,"D"
"6174",2014-11-23,2014,"Konyaspor","Gaziantepspor","2-0",2,0,"T1",1,2,2,"H"
"6175",2014-11-24,2014,"Balikesirspor","Sivasspor","1-3",1,3,"T1",1,4,-2,"A"
"6176",2014-11-24,2014,"Bursaspor","Fenerbahce","1-1",1,1,"T1",1,2,0,"D"
"6177",2014-11-28,2014,"Akhisar Belediyespor","Konyaspor","0-0",0,0,"T1",1,0,0,"D"
"6178",2014-11-28,2014,"Buyuksehyr","Bursaspor","0-0",0,0,"T1",1,0,0,"D"
"6179",2014-11-29,2014,"Erciyesspor","Balikesirspor","4-0",4,0,"T1",1,4,4,"H"
"6180",2014-11-29,2014,"Gaziantepspor","Galatasaray","0-1",0,1,"T1",1,1,-1,"A"
"6181",2014-11-29,2014,"Kasimpasa","Rizespor","3-1",3,1,"T1",1,4,2,"H"
"6182",2014-11-30,2014,"Fenerbahce","Eskisehirspor","2-2",2,2,"T1",1,4,0,"D"
"6183",2014-11-30,2014,"Mersin Idman Yurdu","Sivasspor","2-0",2,0,"T1",1,2,2,"H"
"6184",2014-12-01,2014,"Karabukspor","Besiktas","1-2",1,2,"T1",1,3,-1,"A"
"6185",2014-12-01,2014,"Trabzonspor","Genclerbirligi","4-1",4,1,"T1",1,5,3,"H"
"6186",2014-12-06,2014,"Balikesirspor","Fenerbahce","0-1",0,1,"T1",1,1,-1,"A"
"6187",2014-12-06,2014,"Galatasaray","Akhisar Belediyespor","2-1",2,1,"T1",1,3,1,"H"
"6188",2014-12-06,2014,"Genclerbirligi","Gaziantepspor","2-0",2,0,"T1",1,2,2,"H"
"6189",2014-12-06,2014,"Konyaspor","Mersin Idman Yurdu","2-0",2,0,"T1",1,2,2,"H"
"6190",2014-12-07,2014,"Besiktas","Trabzonspor","3-0",3,0,"T1",1,3,3,"H"
"6191",2014-12-07,2014,"Bursaspor","Kasimpasa","5-1",5,1,"T1",1,6,4,"H"
"6192",2014-12-07,2014,"Eskisehirspor","Buyuksehyr","0-1",0,1,"T1",1,1,-1,"A"
"6193",2014-12-07,2014,"Rizespor","Karabukspor","0-3",0,3,"T1",1,3,-3,"A"
"6194",2014-12-08,2014,"Sivasspor","Erciyesspor","1-1",1,1,"T1",1,2,0,"D"
"6195",2014-12-12,2014,"Fenerbahce","Sivasspor","4-1",4,1,"T1",1,5,3,"H"
"6196",2014-12-13,2014,"Akhisar Belediyespor","Genclerbirligi","1-1",1,1,"T1",1,2,0,"D"
"6197",2014-12-13,2014,"Buyuksehyr","Balikesirspor","1-0",1,0,"T1",1,1,1,"H"
"6198",2014-12-13,2014,"Kasimpasa","Eskisehirspor","1-0",1,0,"T1",1,1,1,"H"
"6199",2014-12-13,2014,"Konyaspor","Galatasaray","0-5",0,5,"T1",1,5,-5,"A"
"6200",2014-12-14,2014,"Gaziantepspor","Besiktas","0-1",0,1,"T1",1,1,-1,"A"
"6201",2014-12-14,2014,"Karabukspor","Bursaspor","3-2",3,2,"T1",1,5,1,"H"
"6202",2014-12-14,2014,"Mersin Idman Yurdu","Erciyesspor","1-1",1,1,"T1",1,2,0,"D"
"6203",2014-12-15,2014,"Trabzonspor","Rizespor","3-2",3,2,"T1",1,5,1,"H"
"6204",2014-12-19,2014,"Erciyesspor","Fenerbahce","0-1",0,1,"T1",1,1,-1,"A"
"6205",2014-12-20,2014,"Eskisehirspor","Karabukspor","1-1",1,1,"T1",1,2,0,"D"
"6206",2014-12-20,2014,"Galatasaray","Mersin Idman Yurdu","3-2",3,2,"T1",1,5,1,"H"
"6207",2014-12-20,2014,"Genclerbirligi","Konyaspor","5-0",5,0,"T1",1,5,5,"H"
"6208",2014-12-20,2014,"Sivasspor","Buyuksehyr","0-2",0,2,"T1",1,2,-2,"A"
"6209",2014-12-21,2014,"Balikesirspor","Kasimpasa","5-3",5,3,"T1",1,8,2,"H"
"6210",2014-12-21,2014,"Besiktas","Akhisar Belediyespor","3-1",3,1,"T1",1,4,2,"H"
"6211",2014-12-21,2014,"Bursaspor","Trabzonspor","3-3",3,3,"T1",1,6,0,"D"
"6212",2014-12-22,2014,"Rizespor","Gaziantepspor","0-1",0,1,"T1",1,1,-1,"A"
"6213",2014-12-26,2014,"Genclerbirligi","Galatasaray","1-1",1,1,"T1",1,2,0,"D"
"6214",2014-12-27,2014,"Buyuksehyr","Erciyesspor","3-1",3,1,"T1",1,4,2,"H"
"6215",2014-12-27,2014,"Fenerbahce","Mersin Idman Yurdu","1-0",1,0,"T1",1,1,1,"H"
"6216",2014-12-27,2014,"Karabukspor","Balikesirspor","0-1",0,1,"T1",1,1,-1,"A"
"6217",2014-12-28,2014,"Akhisar Belediyespor","Rizespor","0-4",0,4,"T1",1,4,-4,"A"
"6218",2014-12-28,2014,"Gaziantepspor","Bursaspor","1-2",1,2,"T1",1,3,-1,"A"
"6219",2014-12-28,2014,"Kasimpasa","Sivasspor","0-0",0,0,"T1",1,0,0,"D"
"6220",2014-12-28,2014,"Konyaspor","Besiktas","1-2",1,2,"T1",1,3,-1,"A"
"6221",2014-12-29,2014,"Trabzonspor","Eskisehirspor","1-4",1,4,"T1",1,5,-3,"A"
"6222",2015-01-03,2014,"Bursaspor","Akhisar Belediyespor","3-1",3,1,"T1",1,4,2,"H"
"6223",2015-01-03,2014,"Fenerbahce","Buyuksehyr","2-0",2,0,"T1",1,2,2,"H"
"6224",2015-01-03,2014,"Rizespor","Konyaspor","1-1",1,1,"T1",1,2,0,"D"
"6225",2015-01-04,2014,"Besiktas","Galatasaray","0-2",0,2,"T1",1,2,-2,"A"
"6226",2015-01-04,2014,"Erciyesspor","Kasimpasa","2-5",2,5,"T1",1,7,-3,"A"
"6227",2015-01-04,2014,"Eskisehirspor","Gaziantepspor","1-3",1,3,"T1",1,4,-2,"A"
"6228",2015-01-04,2014,"Sivasspor","Karabukspor","2-0",2,0,"T1",1,2,2,"H"
"6229",2015-01-05,2014,"Balikesirspor","Trabzonspor","2-2",2,2,"T1",1,4,0,"D"
"6230",2015-01-05,2014,"Mersin Idman Yurdu","Genclerbirligi","1-1",1,1,"T1",1,2,0,"D"
"6231",2015-01-23,2014,"Konyaspor","Bursaspor","2-3",2,3,"T1",1,5,-1,"A"
"6232",2015-01-23,2014,"Trabzonspor","Sivasspor","3-1",3,1,"T1",1,4,2,"H"
"6233",2015-01-24,2014,"Akhisar Belediyespor","Eskisehirspor","2-2",2,2,"T1",1,4,0,"D"
"6234",2015-01-24,2014,"Buyuksehyr","Mersin Idman Yurdu","2-2",2,2,"T1",1,4,0,"D"
"6235",2015-01-24,2014,"Gaziantepspor","Balikesirspor","1-0",1,0,"T1",1,1,1,"H"
"6236",2015-01-24,2014,"Kasimpasa","Fenerbahce","0-3",0,3,"T1",1,3,-3,"A"
"6237",2015-01-25,2014,"Galatasaray","Rizespor","2-0",2,0,"T1",1,2,2,"H"
"6238",2015-01-25,2014,"Karabukspor","Erciyesspor","1-2",1,2,"T1",1,3,-1,"A"
"6239",2015-01-26,2014,"Genclerbirligi","Besiktas","0-2",0,2,"T1",1,2,-2,"A"
"6240",2015-01-30,2014,"Akhisar Belediyespor","Balikesirspor","2-2",2,2,"T1",1,4,0,"D"
"6241",2015-01-30,2014,"Trabzonspor","Erciyesspor","2-1",2,1,"T1",1,3,1,"H"
"6242",2015-01-31,2014,"Gaziantepspor","Sivasspor","1-3",1,3,"T1",1,4,-2,"A"
"6243",2015-01-31,2014,"Karabukspor","Fenerbahce","1-2",1,2,"T1",1,3,-1,"A"
"6244",2015-01-31,2014,"Kasimpasa","Buyuksehyr","0-1",0,1,"T1",1,1,-1,"A"
"6245",2015-02-01,2014,"Besiktas","Mersin Idman Yurdu","2-1",2,1,"T1",1,3,1,"H"
"6246",2015-02-01,2014,"Galatasaray","Bursaspor","2-2",2,2,"T1",1,4,0,"D"
"6247",2015-02-01,2014,"Genclerbirligi","Rizespor","0-2",0,2,"T1",1,2,-2,"A"
"6248",2015-02-01,2014,"Konyaspor","Eskisehirspor","1-0",1,0,"T1",1,1,1,"H"
"6249",2015-02-06,2014,"Buyuksehyr","Karabukspor","2-2",2,2,"T1",1,4,0,"D"
"6250",2015-02-07,2014,"Erciyesspor","Gaziantepspor","0-1",0,1,"T1",1,1,-1,"A"
"6251",2015-02-07,2014,"Fenerbahce","Trabzonspor","0-0",0,0,"T1",1,0,0,"D"
"6252",2015-02-07,2014,"Sivasspor","Akhisar Belediyespor","2-0",2,0,"T1",1,2,2,"H"
"6253",2015-02-08,2014,"Balikesirspor","Konyaspor","0-1",0,1,"T1",1,1,-1,"A"
"6254",2015-02-08,2014,"Bursaspor","Genclerbirligi","3-1",3,1,"T1",1,4,2,"H"
"6255",2015-02-08,2014,"Mersin Idman Yurdu","Kasimpasa","6-2",6,2,"T1",1,8,4,"H"
"6256",2015-02-08,2014,"Rizespor","Besiktas","1-2",1,2,"T1",1,3,-1,"A"
"6257",2015-02-09,2014,"Eskisehirspor","Galatasaray","1-2",1,2,"T1",1,3,-1,"A"
"6258",2015-02-14,2014,"Akhisar Belediyespor","Erciyesspor","1-0",1,0,"T1",1,1,1,"H"
"6259",2015-02-14,2014,"Gaziantepspor","Fenerbahce","0-5",0,5,"T1",1,5,-5,"A"
"6260",2015-02-14,2014,"Karabukspor","Kasimpasa","0-0",0,0,"T1",1,0,0,"D"
"6261",2015-02-15,2014,"Besiktas","Bursaspor","3-2",3,2,"T1",1,5,1,"H"
"6262",2015-02-15,2014,"Konyaspor","Sivasspor","0-1",0,1,"T1",1,1,-1,"A"
"6263",2015-02-15,2014,"Rizespor","Mersin Idman Yurdu","0-4",0,4,"T1",1,4,-4,"A"
"6264",2015-02-15,2014,"Trabzonspor","Buyuksehyr","3-2",3,2,"T1",1,5,1,"H"
"6265",2015-02-16,2014,"Galatasaray","Balikesirspor","3-1",3,1,"T1",1,4,2,"H"
"6266",2015-02-16,2014,"Genclerbirligi","Eskisehirspor","1-2",1,2,"T1",1,3,-1,"A"
"6267",2015-02-20,2014,"Erciyesspor","Konyaspor","3-0",3,0,"T1",1,3,3,"H"
"6268",2015-02-21,2014,"Bursaspor","Rizespor","1-1",1,1,"T1",1,2,0,"D"
"6269",2015-02-21,2014,"Buyuksehyr","Gaziantepspor","1-0",1,0,"T1",1,1,1,"H"
"6270",2015-02-21,2014,"Sivasspor","Galatasaray","2-3",2,3,"T1",1,5,-1,"A"
"6271",2015-02-22,2014,"Balikesirspor","Genclerbirligi","0-1",0,1,"T1",1,1,-1,"A"
"6272",2015-02-22,2014,"Eskisehirspor","Besiktas","1-0",1,0,"T1",1,1,1,"H"
"6273",2015-02-22,2014,"Kasimpasa","Trabzonspor","1-1",1,1,"T1",1,2,0,"D"
"6274",2015-02-22,2014,"Mersin Idman Yurdu","Karabukspor","2-1",2,1,"T1",1,3,1,"H"
"6275",2015-02-23,2014,"Fenerbahce","Akhisar Belediyespor","1-2",1,2,"T1",1,3,-1,"A"
"6276",2015-02-27,2014,"Galatasaray","Erciyesspor","3-1",3,1,"T1",1,4,2,"H"
"6277",2015-02-28,2014,"Genclerbirligi","Sivasspor","0-0",0,0,"T1",1,0,0,"D"
"6278",2015-02-28,2014,"Konyaspor","Fenerbahce","1-1",1,1,"T1",1,2,0,"D"
"6279",2015-02-28,2014,"Rizespor","Eskisehirspor","3-0",3,0,"T1",1,3,3,"H"
"6280",2015-03-01,2014,"Akhisar Belediyespor","Buyuksehyr","0-2",0,2,"T1",1,2,-2,"A"
"6281",2015-03-01,2014,"Besiktas","Balikesirspor","2-2",2,2,"T1",1,4,0,"D"
"6282",2015-03-01,2014,"Bursaspor","Mersin Idman Yurdu","2-1",2,1,"T1",1,3,1,"H"
"6283",2015-03-01,2014,"Gaziantepspor","Kasimpasa","0-2",0,2,"T1",1,2,-2,"A"
"6284",2015-03-02,2014,"Trabzonspor","Karabukspor","3-2",3,2,"T1",1,5,1,"H"
"6285",2015-03-06,2014,"Kasimpasa","Akhisar Belediyespor","2-2",2,2,"T1",1,4,0,"D"
"6286",2015-03-07,2014,"Balikesirspor","Rizespor","2-2",2,2,"T1",1,4,0,"D"
"6287",2015-03-07,2014,"Erciyesspor","Genclerbirligi","2-4",2,4,"T1",1,6,-2,"A"
"6288",2015-03-07,2014,"Eskisehirspor","Bursaspor","0-0",0,0,"T1",1,0,0,"D"
"6289",2015-03-08,2014,"Buyuksehyr","Konyaspor","0-0",0,0,"T1",1,0,0,"D"
"6290",2015-03-08,2014,"Fenerbahce","Galatasaray","1-0",1,0,"T1",1,1,1,"H"
"6291",2015-03-08,2014,"Karabukspor","Gaziantepspor","0-0",0,0,"T1",1,0,0,"D"
"6292",2015-03-08,2014,"Sivasspor","Besiktas","0-1",0,1,"T1",1,1,-1,"A"
"6293",2015-03-09,2014,"Mersin Idman Yurdu","Trabzonspor","1-5",1,5,"T1",1,6,-4,"A"
"6294",2015-03-13,2014,"Bursaspor","Balikesirspor","4-2",4,2,"T1",1,6,2,"H"
"6295",2015-03-13,2014,"Konyaspor","Kasimpasa","2-1",2,1,"T1",1,3,1,"H"
"6296",2015-03-14,2014,"Akhisar Belediyespor","Karabukspor","5-1",5,1,"T1",1,6,4,"H"
"6297",2015-03-14,2014,"Galatasaray","Buyuksehyr","2-2",2,2,"T1",1,4,0,"D"
"6298",2015-03-14,2014,"Rizespor","Sivasspor","2-1",2,1,"T1",1,3,1,"H"
"6299",2015-03-15,2014,"Besiktas","Erciyesspor","5-1",5,1,"T1",1,6,4,"H"
"6300",2015-03-15,2014,"Eskisehirspor","Mersin Idman Yurdu","2-0",2,0,"T1",1,2,2,"H"
"6301",2015-03-15,2014,"Genclerbirligi","Fenerbahce","2-1",2,1,"T1",1,3,1,"H"
"6302",2015-03-16,2014,"Gaziantepspor","Trabzonspor","2-0",2,0,"T1",1,2,2,"H"
"6303",2015-03-20,2014,"Balikesirspor","Eskisehirspor","4-1",4,1,"T1",1,5,3,"H"
"6304",2015-03-20,2014,"Karabukspor","Konyaspor","0-1",0,1,"T1",1,1,-1,"A"
"6305",2015-03-21,2014,"Erciyesspor","Rizespor","0-3",0,3,"T1",1,3,-3,"A"
"6306",2015-03-21,2014,"Kasimpasa","Galatasaray","2-3",2,3,"T1",1,5,-1,"A"
"6307",2015-03-21,2014,"Mersin Idman Yurdu","Gaziantepspor","0-1",0,1,"T1",1,1,-1,"A"
"6308",2015-03-21,2014,"Sivasspor","Bursaspor","4-1",4,1,"T1",1,5,3,"H"
"6309",2015-03-22,2014,"Buyuksehyr","Genclerbirligi","3-1",3,1,"T1",1,4,2,"H"
"6310",2015-03-22,2014,"Fenerbahce","Besiktas","1-0",1,0,"T1",1,1,1,"H"
"6311",2015-03-22,2014,"Trabzonspor","Akhisar Belediyespor","2-0",2,0,"T1",1,2,2,"H"
"6312",2015-04-04,2014,"Balikesirspor","Mersin Idman Yurdu","1-3",1,3,"T1",1,4,-2,"A"
"6313",2015-04-04,2014,"Eskisehirspor","Sivasspor","1-3",1,3,"T1",1,4,-2,"A"
"6314",2015-04-04,2014,"Genclerbirligi","Kasimpasa","5-2",5,2,"T1",1,7,3,"H"
"6315",2015-04-04,2014,"Rizespor","Fenerbahce","1-5",1,5,"T1",1,6,-4,"A"
"6316",2015-04-05,2014,"Akhisar Belediyespor","Gaziantepspor","3-0",3,0,"T1",1,3,3,"H"
"6317",2015-04-05,2014,"Bursaspor","Erciyesspor","3-0",3,0,"T1",1,3,3,"H"
"6318",2015-04-05,2014,"Galatasaray","Karabukspor","4-2",4,2,"T1",1,6,2,"H"
"6319",2015-04-05,2014,"Konyaspor","Trabzonspor","1-0",1,0,"T1",1,1,1,"H"
"6320",2015-04-06,2014,"Besiktas","Buyuksehyr","0-0",0,0,"T1",1,0,0,"D"
"6321",2015-04-17,2014,"Gaziantepspor","Konyaspor","1-1",1,1,"T1",1,2,0,"D"
"6322",2015-04-18,2014,"Karabukspor","Genclerbirligi","2-1",2,1,"T1",1,3,1,"H"
"6323",2015-04-18,2014,"Kasimpasa","Besiktas","1-5",1,5,"T1",1,6,-4,"A"
"6324",2015-04-19,2014,"Buyuksehyr","Rizespor","3-1",3,1,"T1",1,4,2,"H"
"6325",2015-04-19,2014,"Erciyesspor","Eskisehirspor","0-1",0,1,"T1",1,1,-1,"A"
"6326",2015-04-19,2014,"Sivasspor","Balikesirspor","1-1",1,1,"T1",1,2,0,"D"
"6327",2015-04-19,2014,"Trabzonspor","Galatasaray","2-1",2,1,"T1",1,3,1,"H"
"6328",2015-04-20,2014,"Fenerbahce","Bursaspor","1-0",1,0,"T1",1,1,1,"H"
"6329",2015-04-20,2014,"Mersin Idman Yurdu","Akhisar Belediyespor","1-1",1,1,"T1",1,2,0,"D"
"6330",2015-04-24,2014,"Sivasspor","Mersin Idman Yurdu","1-2",1,2,"T1",1,3,-1,"A"
"6331",2015-04-25,2014,"Bursaspor","Buyuksehyr","4-1",4,1,"T1",1,5,3,"H"
"6332",2015-04-25,2014,"Eskisehirspor","Fenerbahce","1-1",1,1,"T1",1,2,0,"D"
"6333",2015-04-25,2014,"Rizespor","Kasimpasa","1-3",1,3,"T1",1,4,-2,"A"
"6334",2015-04-26,2014,"Balikesirspor","Erciyesspor","1-1",1,1,"T1",1,2,0,"D"
"6335",2015-04-26,2014,"Galatasaray","Gaziantepspor","1-0",1,0,"T1",1,1,1,"H"
"6336",2015-04-26,2014,"Genclerbirligi","Trabzonspor","1-1",1,1,"T1",1,2,0,"D"
"6337",2015-04-26,2014,"Konyaspor","Akhisar Belediyespor","2-1",2,1,"T1",1,3,1,"H"
"6338",2015-04-27,2014,"Besiktas","Karabukspor","2-1",2,1,"T1",1,3,1,"H"
"6339",2015-05-02,2014,"Buyuksehyr","Eskisehirspor","1-1",1,1,"T1",1,2,0,"D"
"6340",2015-05-02,2014,"Fenerbahce","Balikesirspor","4-3",4,3,"T1",1,7,1,"H"
"6341",2015-05-02,2014,"Karabukspor","Rizespor","2-0",2,0,"T1",1,2,2,"H"
"6342",2015-05-02,2014,"Mersin Idman Yurdu","Konyaspor","3-1",3,1,"T1",1,4,2,"H"
"6343",2015-05-03,2014,"Gaziantepspor","Genclerbirligi","0-3",0,3,"T1",1,3,-3,"A"
"6344",2015-05-03,2014,"Kasimpasa","Bursaspor","5-3",5,3,"T1",1,8,2,"H"
"6345",2015-05-03,2014,"Trabzonspor","Besiktas","0-2",0,2,"T1",1,2,-2,"A"
"6346",2015-05-04,2014,"Akhisar Belediyespor","Galatasaray","0-2",0,2,"T1",1,2,-2,"A"
"6347",2015-05-04,2014,"Erciyesspor","Sivasspor","2-3",2,3,"T1",1,5,-1,"A"
"6348",2015-05-08,2014,"Erciyesspor","Mersin Idman Yurdu","2-2",2,2,"T1",1,4,0,"D"
"6349",2015-05-08,2014,"Eskisehirspor","Kasimpasa","4-1",4,1,"T1",1,5,3,"H"
"6350",2015-05-08,2014,"Galatasaray","Konyaspor","1-0",1,0,"T1",1,1,1,"H"
"6351",2015-05-09,2014,"Balikesirspor","Buyuksehyr","1-2",1,2,"T1",1,3,-1,"A"
"6352",2015-05-09,2014,"Bursaspor","Karabukspor","7-1",7,1,"T1",1,8,6,"H"
"6353",2015-05-09,2014,"Genclerbirligi","Akhisar Belediyespor","0-0",0,0,"T1",1,0,0,"D"
"6354",2015-05-09,2014,"Sivasspor","Fenerbahce","2-3",2,3,"T1",1,5,-1,"A"
"6355",2015-05-10,2014,"Besiktas","Gaziantepspor","1-1",1,1,"T1",1,2,0,"D"
"6356",2015-05-10,2014,"Rizespor","Trabzonspor","0-2",0,2,"T1",1,2,-2,"A"
"6357",2015-05-12,2014,"Buyuksehyr","Sivasspor","2-1",2,1,"T1",1,3,1,"H"
"6358",2015-05-12,2014,"Karabukspor","Eskisehirspor","2-2",2,2,"T1",1,4,0,"D"
"6359",2015-05-12,2014,"Kasimpasa","Balikesirspor","2-3",2,3,"T1",1,5,-1,"A"
"6360",2015-05-12,2014,"Konyaspor","Genclerbirligi","1-0",1,0,"T1",1,1,1,"H"
"6361",2015-05-12,2014,"Mersin Idman Yurdu","Galatasaray","0-1",0,1,"T1",1,1,-1,"A"
"6362",2015-05-13,2014,"Fenerbahce","Erciyesspor","1-1",1,1,"T1",1,2,0,"D"
"6363",2015-05-13,2014,"Gaziantepspor","Rizespor","1-2",1,2,"T1",1,3,-1,"A"
"6364",2015-05-13,2014,"Trabzonspor","Bursaspor","1-0",1,0,"T1",1,1,1,"H"
"6365",2015-05-14,2014,"Akhisar Belediyespor","Besiktas","1-1",1,1,"T1",1,2,0,"D"
"6366",2015-05-16,2014,"Balikesirspor","Karabukspor","4-2",4,2,"T1",1,6,2,"H"
"6367",2015-05-16,2014,"Galatasaray","Genclerbirligi","1-0",1,0,"T1",1,1,1,"H"
"6368",2015-05-16,2014,"Sivasspor","Kasimpasa","1-1",1,1,"T1",1,2,0,"D"
"6369",2015-05-17,2014,"Bursaspor","Gaziantepspor","2-0",2,0,"T1",1,2,2,"H"
"6370",2015-05-17,2014,"Erciyesspor","Buyuksehyr","0-1",0,1,"T1",1,1,-1,"A"
"6371",2015-05-17,2014,"Eskisehirspor","Trabzonspor","2-0",2,0,"T1",1,2,2,"H"
"6372",2015-05-17,2014,"Mersin Idman Yurdu","Fenerbahce","0-1",0,1,"T1",1,1,-1,"A"
"6373",2015-05-18,2014,"Besiktas","Konyaspor","0-1",0,1,"T1",1,1,-1,"A"
"6374",2015-05-18,2014,"Rizespor","Akhisar Belediyespor","3-1",3,1,"T1",1,4,2,"H"
"6375",2015-05-22,2014,"Genclerbirligi","Mersin Idman Yurdu","1-2",1,2,"T1",1,3,-1,"A"
"6376",2015-05-23,2014,"Kasimpasa","Erciyesspor","3-3",3,3,"T1",1,6,0,"D"
"6377",2015-05-23,2014,"Konyaspor","Rizespor","1-1",1,1,"T1",1,2,0,"D"
"6378",2015-05-23,2014,"Trabzonspor","Balikesirspor","3-2",3,2,"T1",1,5,1,"H"
"6379",2015-05-24,2014,"Galatasaray","Besiktas","2-0",2,0,"T1",1,2,2,"H"
"6380",2015-05-24,2014,"Gaziantepspor","Eskisehirspor","3-2",3,2,"T1",1,5,1,"H"
"6381",2015-05-24,2014,"Karabukspor","Sivasspor","2-1",2,1,"T1",1,3,1,"H"
"6382",2015-05-25,2014,"Akhisar Belediyespor","Bursaspor","0-1",0,1,"T1",1,1,-1,"A"
"6383",2015-05-25,2014,"Buyuksehyr","Fenerbahce","2-2",2,2,"T1",1,4,0,"D"
"6384",2015-05-29,2014,"Balikesirspor","Gaziantepspor","1-1",1,1,"T1",1,2,0,"D"
"6385",2015-05-29,2014,"Besiktas","Genclerbirligi","2-1",2,1,"T1",1,3,1,"H"
"6386",2015-05-29,2014,"Erciyesspor","Karabukspor","4-3",4,3,"T1",1,7,1,"H"
"6387",2015-05-29,2014,"Eskisehirspor","Akhisar Belediyespor","1-3",1,3,"T1",1,4,-2,"A"
"6388",2015-05-30,2014,"Bursaspor","Konyaspor","0-0",0,0,"T1",1,0,0,"D"
"6389",2015-05-30,2014,"Fenerbahce","Kasimpasa","2-0",2,0,"T1",1,2,2,"H"
"6390",2015-05-30,2014,"Mersin Idman Yurdu","Buyuksehyr","2-2",2,2,"T1",1,4,0,"D"
"6391",2015-05-30,2014,"Rizespor","Galatasaray","1-1",1,1,"T1",1,2,0,"D"
"6392",2015-05-30,2014,"Sivasspor","Trabzonspor","1-1",1,1,"T1",1,2,0,"D"
"6393",2015-08-14,2015,"Fenerbahce","Eskisehirspor","2-0",2,0,"T1",1,2,2,"H"
"6394",2015-08-15,2015,"Buyuksehyr","Antalyaspor","2-3",2,3,"T1",1,5,-1,"A"
"6395",2015-08-15,2015,"Sivasspor","Galatasaray","2-2",2,2,"T1",1,4,0,"D"
"6396",2015-08-15,2015,"Trabzonspor","Bursaspor","1-0",1,0,"T1",1,1,1,"H"
"6397",2015-08-16,2015,"Gaziantepspor","Kasimpasa","0-3",0,3,"T1",1,3,-3,"A"
"6398",2015-08-16,2015,"Konyaspor","Akhisar Belediyespor","1-1",1,1,"T1",1,2,0,"D"
"6399",2015-08-16,2015,"Mersin Idman Yurdu","Besiktas","2-5",2,5,"T1",1,7,-3,"A"
"6400",2015-08-16,2015,"Osmanlispor","Kayserispor","1-1",1,1,"T1",1,2,0,"D"
"6401",2015-08-17,2015,"Genclerbirligi","Rizespor","2-3",2,3,"T1",1,5,-1,"A"
"6402",2015-08-21,2015,"Kasimpasa","Buyuksehyr","1-0",1,0,"T1",1,1,1,"H"
"6403",2015-08-22,2015,"Akhisar Belediyespor","Mersin Idman Yurdu","2-0",2,0,"T1",1,2,2,"H"
"6404",2015-08-22,2015,"Besiktas","Trabzonspor","1-2",1,2,"T1",1,3,-1,"A"
"6405",2015-08-22,2015,"Kayserispor","Konyaspor","1-1",1,1,"T1",1,2,0,"D"
"6406",2015-08-23,2015,"Antalyaspor","Genclerbirligi","3-1",3,1,"T1",1,4,2,"H"
"6407",2015-08-23,2015,"Bursaspor","Gaziantepspor","0-1",0,1,"T1",1,1,-1,"A"
"6408",2015-08-23,2015,"Eskisehirspor","Sivasspor","4-2",4,2,"T1",1,6,2,"H"
"6409",2015-08-23,2015,"Rizespor","Fenerbahce","1-1",1,1,"T1",1,2,0,"D"
"6410",2015-08-24,2015,"Galatasaray","Osmanlispor","1-2",1,2,"T1",1,3,-1,"A"
"6411",2015-08-28,2015,"Gaziantepspor","Besiktas","0-4",0,4,"T1",1,4,-4,"A"
"6412",2015-08-29,2015,"Buyuksehyr","Bursaspor","2-1",2,1,"T1",1,3,1,"H"
"6413",2015-08-29,2015,"Genclerbirligi","Kasimpasa","1-0",1,0,"T1",1,1,1,"H"
"6414",2015-08-29,2015,"Konyaspor","Galatasaray","1-4",1,4,"T1",1,5,-3,"A"
"6415",2015-08-29,2015,"Mersin Idman Yurdu","Kayserispor","1-2",1,2,"T1",1,3,-1,"A"
"6416",2015-08-30,2015,"Eskisehirspor","Rizespor","1-1",1,1,"T1",1,2,0,"D"
"6417",2015-08-30,2015,"Fenerbahce","Antalyaspor","2-1",2,1,"T1",1,3,1,"H"
"6418",2015-08-30,2015,"Sivasspor","Osmanlispor","1-1",1,1,"T1",1,2,0,"D"
"6419",2015-08-30,2015,"Trabzonspor","Akhisar Belediyespor","2-2",2,2,"T1",1,4,0,"D"
"6420",2015-09-12,2015,"Akhisar Belediyespor","Gaziantepspor","0-0",0,0,"T1",1,0,0,"D"
"6421",2015-09-12,2015,"Antalyaspor","Eskisehirspor","2-0",2,0,"T1",1,2,2,"H"
"6422",2015-09-12,2015,"Bursaspor","Genclerbirligi","3-2",3,2,"T1",1,5,1,"H"
"6423",2015-09-12,2015,"Galatasaray","Mersin Idman Yurdu","1-1",1,1,"T1",1,2,0,"D"
"6424",2015-09-13,2015,"Besiktas","Buyuksehyr","2-0",2,0,"T1",1,2,2,"H"
"6425",2015-09-13,2015,"Kasimpasa","Fenerbahce","0-1",0,1,"T1",1,1,-1,"A"
"6426",2015-09-13,2015,"Osmanlispor","Konyaspor","1-2",1,2,"T1",1,3,-1,"A"
"6427",2015-09-13,2015,"Rizespor","Sivasspor","1-1",1,1,"T1",1,2,0,"D"
"6428",2015-09-14,2015,"Kayserispor","Trabzonspor","0-1",0,1,"T1",1,1,-1,"A"
"6429",2015-09-18,2015,"Buyuksehyr","Akhisar Belediyespor","2-0",2,0,"T1",1,2,2,"H"
"6430",2015-09-18,2015,"Mersin Idman Yurdu","Osmanlispor","0-4",0,4,"T1",1,4,-4,"A"
"6431",2015-09-19,2015,"Eskisehirspor","Kasimpasa","0-3",0,3,"T1",1,3,-3,"A"
"6432",2015-09-19,2015,"Rizespor","Antalyaspor","5-1",5,1,"T1",1,6,4,"H"
"6433",2015-09-19,2015,"Sivasspor","Konyaspor","0-0",0,0,"T1",1,0,0,"D"
"6434",2015-09-19,2015,"Trabzonspor","Galatasaray","0-1",0,1,"T1",1,1,-1,"A"
"6435",2015-09-20,2015,"Fenerbahce","Bursaspor","2-1",2,1,"T1",1,3,1,"H"
"6436",2015-09-20,2015,"Gaziantepspor","Kayserispor","1-0",1,0,"T1",1,1,1,"H"
"6437",2015-09-21,2015,"Genclerbirligi","Besiktas","1-1",1,1,"T1",1,2,0,"D"
"6438",2015-09-26,2015,"Akhisar Belediyespor","Genclerbirligi","1-0",1,0,"T1",1,1,1,"H"
"6439",2015-09-26,2015,"Galatasaray","Gaziantepspor","2-1",2,1,"T1",1,3,1,"H"
"6440",2015-09-26,2015,"Osmanlispor","Trabzonspor","3-1",3,1,"T1",1,4,2,"H"
"6441",2015-09-27,2015,"Antalyaspor","Sivasspor","1-1",1,1,"T1",1,2,0,"D"
"6442",2015-09-27,2015,"Besiktas","Fenerbahce","3-2",3,2,"T1",1,5,1,"H"
"6443",2015-09-27,2015,"Konyaspor","Mersin Idman Yurdu","2-0",2,0,"T1",1,2,2,"H"
"6444",2015-09-28,2015,"Bursaspor","Eskisehirspor","2-0",2,0,"T1",1,2,2,"H"
"6445",2015-09-28,2015,"Kasimpasa","Rizespor","1-1",1,1,"T1",1,2,0,"D"
"6446",2015-09-28,2015,"Kayserispor","Buyuksehyr","0-1",0,1,"T1",1,1,-1,"A"
"6447",2015-10-02,2015,"Sivasspor","Mersin Idman Yurdu","2-2",2,2,"T1",1,4,0,"D"
"6448",2015-10-02,2015,"Trabzonspor","Konyaspor","1-2",1,2,"T1",1,3,-1,"A"
"6449",2015-10-03,2015,"Buyuksehyr","Galatasaray","0-2",0,2,"T1",1,2,-2,"A"
"6450",2015-10-03,2015,"Gaziantepspor","Osmanlispor","2-1",2,1,"T1",1,3,1,"H"
"6451",2015-10-03,2015,"Genclerbirligi","Kayserispor","2-0",2,0,"T1",1,2,2,"H"
"6452",2015-10-04,2015,"Antalyaspor","Kasimpasa","0-0",0,0,"T1",1,0,0,"D"
"6453",2015-10-04,2015,"Eskisehirspor","Besiktas","1-2",1,2,"T1",1,3,-1,"A"
"6454",2015-10-04,2015,"Fenerbahce","Akhisar Belediyespor","2-2",2,2,"T1",1,4,0,"D"
"6455",2015-10-04,2015,"Rizespor","Bursaspor","2-3",2,3,"T1",1,5,-1,"A"
"6456",2015-10-17,2015,"Bursaspor","Antalyaspor","0-2",0,2,"T1",1,2,-2,"A"
"6457",2015-10-17,2015,"Galatasaray","Genclerbirligi","4-1",4,1,"T1",1,5,3,"H"
"6458",2015-10-17,2015,"Konyaspor","Gaziantepspor","2-1",2,1,"T1",1,3,1,"H"
"6459",2015-10-18,2015,"Akhisar Belediyespor","Eskisehirspor","1-0",1,0,"T1",1,1,1,"H"
"6460",2015-10-18,2015,"Besiktas","Rizespor","1-0",1,0,"T1",1,1,1,"H"
"6461",2015-10-18,2015,"Kasimpasa","Sivasspor","2-1",2,1,"T1",1,3,1,"H"
"6462",2015-10-18,2015,"Kayserispor","Fenerbahce","0-1",0,1,"T1",1,1,-1,"A"
"6463",2015-10-19,2015,"Mersin Idman Yurdu","Trabzonspor","3-2",3,2,"T1",1,5,1,"H"
"6464",2015-10-19,2015,"Osmanlispor","Buyuksehyr","0-3",0,3,"T1",1,3,-3,"A"
"6465",2015-10-23,2015,"Eskisehirspor","Kayserispor","1-3",1,3,"T1",1,4,-2,"A"
"6466",2015-10-23,2015,"Rizespor","Akhisar Belediyespor","0-2",0,2,"T1",1,2,-2,"A"
"6467",2015-10-24,2015,"Gaziantepspor","Mersin Idman Yurdu","1-0",1,0,"T1",1,1,1,"H"
"6468",2015-10-24,2015,"Genclerbirligi","Osmanlispor","1-0",1,0,"T1",1,1,1,"H"
"6469",2015-10-24,2015,"Kasimpasa","Bursaspor","0-1",0,1,"T1",1,1,-1,"A"
"6470",2015-10-24,2015,"Sivasspor","Trabzonspor","0-2",0,2,"T1",1,2,-2,"A"
"6471",2015-10-25,2015,"Buyuksehyr","Konyaspor","4-0",4,0,"T1",1,4,4,"H"
"6472",2015-10-25,2015,"Fenerbahce","Galatasaray","1-1",1,1,"T1",1,2,0,"D"
"6473",2015-10-26,2015,"Antalyaspor","Besiktas","1-5",1,5,"T1",1,6,-4,"A"
"6474",2015-10-28,2015,"Bursaspor","Sivasspor","1-0",1,0,"T1",1,1,1,"H"
"6475",2015-10-28,2015,"Kayserispor","Rizespor","0-0",0,0,"T1",1,0,0,"D"
"6476",2015-10-28,2015,"Trabzonspor","Gaziantepspor","2-2",2,2,"T1",1,4,0,"D"
"6477",2015-10-29,2015,"Galatasaray","Eskisehirspor","4-0",4,0,"T1",1,4,4,"H"
"6478",2015-10-29,2015,"Mersin Idman Yurdu","Buyuksehyr","1-1",1,1,"T1",1,2,0,"D"
"6479",2015-10-29,2015,"Osmanlispor","Fenerbahce","0-1",0,1,"T1",1,1,-1,"A"
"6480",2015-10-30,2015,"Akhisar Belediyespor","Antalyaspor","2-1",2,1,"T1",1,3,1,"H"
"6481",2015-10-30,2015,"Besiktas","Kasimpasa","3-3",3,3,"T1",1,6,0,"D"
"6482",2015-10-30,2015,"Konyaspor","Genclerbirligi","0-0",0,0,"T1",1,0,0,"D"
"6483",2015-11-06,2015,"Eskisehirspor","Osmanlispor","0-2",0,2,"T1",1,2,-2,"A"
"6484",2015-11-06,2015,"Genclerbirligi","Mersin Idman Yurdu","1-1",1,1,"T1",1,2,0,"D"
"6485",2015-11-07,2015,"Antalyaspor","Kayserispor","1-1",1,1,"T1",1,2,0,"D"
"6486",2015-11-07,2015,"Buyuksehyr","Trabzonspor","1-0",1,0,"T1",1,1,1,"H"
"6487",2015-11-07,2015,"Kasimpasa","Akhisar Belediyespor","2-1",2,1,"T1",1,3,1,"H"
"6488",2015-11-07,2015,"Rizespor","Galatasaray","4-3",4,3,"T1",1,7,1,"H"
"6489",2015-11-08,2015,"Bursaspor","Besiktas","0-1",0,1,"T1",1,1,-1,"A"
"6490",2015-11-08,2015,"Fenerbahce","Konyaspor","1-0",1,0,"T1",1,1,1,"H"
"6491",2015-11-08,2015,"Sivasspor","Gaziantepspor","3-0",3,0,"T1",1,3,3,"H"
"6492",2015-11-21,2015,"Akhisar Belediyespor","Bursaspor","3-1",3,1,"T1",1,4,2,"H"
"6493",2015-11-21,2015,"Galatasaray","Antalyaspor","3-3",3,3,"T1",1,6,0,"D"
"6494",2015-11-21,2015,"Kayserispor","Kasimpasa","0-0",0,0,"T1",1,0,0,"D"
"6495",2015-11-21,2015,"Mersin Idman Yurdu","Fenerbahce","1-3",1,3,"T1",1,4,-2,"A"
"6496",2015-11-22,2015,"Besiktas","Sivasspor","2-0",2,0,"T1",1,2,2,"H"
"6497",2015-11-22,2015,"Konyaspor","Eskisehirspor","3-2",3,2,"T1",1,5,1,"H"
"6498",2015-11-22,2015,"Osmanlispor","Rizespor","0-1",0,1,"T1",1,1,-1,"A"
"6499",2015-11-22,2015,"Trabzonspor","Genclerbirligi","1-0",1,0,"T1",1,1,1,"H"
"6500",2015-11-23,2015,"Gaziantepspor","Buyuksehyr","0-1",0,1,"T1",1,1,-1,"A"
"6501",2015-11-27,2015,"Antalyaspor","Osmanlispor","1-1",1,1,"T1",1,2,0,"D"
"6502",2015-11-27,2015,"Bursaspor","Kayserispor","1-2",1,2,"T1",1,3,-1,"A"
"6503",2015-11-27,2015,"Rizespor","Konyaspor","0-0",0,0,"T1",1,0,0,"D"
"6504",2015-11-28,2015,"Eskisehirspor","Mersin Idman Yurdu","3-2",3,2,"T1",1,5,1,"H"
"6505",2015-11-28,2015,"Sivasspor","Buyuksehyr","2-2",2,2,"T1",1,4,0,"D"
"6506",2015-11-29,2015,"Besiktas","Akhisar Belediyespor","0-2",0,2,"T1",1,2,-2,"A"
"6507",2015-11-29,2015,"Genclerbirligi","Gaziantepspor","2-2",2,2,"T1",1,4,0,"D"
"6508",2015-11-29,2015,"Kasimpasa","Galatasaray","2-2",2,2,"T1",1,4,0,"D"
"6509",2015-11-30,2015,"Fenerbahce","Trabzonspor","2-0",2,0,"T1",1,2,2,"H"
"6510",2015-12-04,2015,"Galatasaray","Bursaspor","3-0",3,0,"T1",1,3,3,"H"
"6511",2015-12-05,2015,"Kayserispor","Besiktas","1-2",1,2,"T1",1,3,-1,"A"
"6512",2015-12-05,2015,"Konyaspor","Antalyaspor","3-2",3,2,"T1",1,5,1,"H"
"6513",2015-12-05,2015,"Osmanlispor","Kasimpasa","0-1",0,1,"T1",1,1,-1,"A"
"6514",2015-12-06,2015,"Buyuksehyr","Genclerbirligi","2-0",2,0,"T1",1,2,2,"H"
"6515",2015-12-06,2015,"Gaziantepspor","Fenerbahce","2-2",2,2,"T1",1,4,0,"D"
"6516",2015-12-06,2015,"Mersin Idman Yurdu","Rizespor","3-0",3,0,"T1",1,3,3,"H"
"6517",2015-12-07,2015,"Akhisar Belediyespor","Sivasspor","1-0",1,0,"T1",1,1,1,"H"
"6518",2015-12-07,2015,"Trabzonspor","Eskisehirspor","3-1",3,1,"T1",1,4,2,"H"
"6519",2015-12-11,2015,"Bursaspor","Osmanlispor","0-4",0,4,"T1",1,4,-4,"A"
"6520",2015-12-12,2015,"Antalyaspor","Mersin Idman Yurdu","3-2",3,2,"T1",1,5,1,"H"
"6521",2015-12-12,2015,"Eskisehirspor","Gaziantepspor","1-2",1,2,"T1",1,3,-1,"A"
"6522",2015-12-12,2015,"Kasimpasa","Konyaspor","2-1",2,1,"T1",1,3,1,"H"
"6523",2015-12-12,2015,"Rizespor","Trabzonspor","3-0",3,0,"T1",1,3,3,"H"
"6524",2015-12-13,2015,"Fenerbahce","Buyuksehyr","1-0",1,0,"T1",1,1,1,"H"
"6525",2015-12-13,2015,"Genclerbirligi","Sivasspor","0-1",0,1,"T1",1,1,-1,"A"
"6526",2015-12-13,2015,"Kayserispor","Akhisar Belediyespor","3-2",3,2,"T1",1,5,1,"H"
"6527",2015-12-14,2015,"Besiktas","Galatasaray","2-1",2,1,"T1",1,3,1,"H"
"6528",2015-12-19,2015,"Gaziantepspor","Rizespor","2-0",2,0,"T1",1,2,2,"H"
"6529",2015-12-19,2015,"Konyaspor","Bursaspor","1-0",1,0,"T1",1,1,1,"H"
"6530",2015-12-19,2015,"Mersin Idman Yurdu","Kasimpasa","1-2",1,2,"T1",1,3,-1,"A"
"6531",2015-12-19,2015,"Trabzonspor","Antalyaspor","3-0",3,0,"T1",1,3,3,"H"
"6532",2015-12-20,2015,"Buyuksehyr","Eskisehirspor","2-1",2,1,"T1",1,3,1,"H"
"6533",2015-12-20,2015,"Galatasaray","Akhisar Belediyespor","3-2",3,2,"T1",1,5,1,"H"
"6534",2015-12-20,2015,"Genclerbirligi","Fenerbahce","0-1",0,1,"T1",1,1,-1,"A"
"6535",2015-12-20,2015,"Sivasspor","Kayserispor","0-0",0,0,"T1",1,0,0,"D"
"6536",2015-12-21,2015,"Osmanlispor","Besiktas","2-3",2,3,"T1",1,5,-1,"A"
"6537",2015-12-26,2015,"Antalyaspor","Gaziantepspor","0-0",0,0,"T1",1,0,0,"D"
"6538",2015-12-26,2015,"Kasimpasa","Trabzonspor","1-1",1,1,"T1",1,2,0,"D"
"6539",2015-12-26,2015,"Rizespor","Buyuksehyr","2-1",2,1,"T1",1,3,1,"H"
"6540",2015-12-27,2015,"Akhisar Belediyespor","Osmanlispor","0-0",0,0,"T1",1,0,0,"D"
"6541",2015-12-27,2015,"Besiktas","Konyaspor","4-0",4,0,"T1",1,4,4,"H"
"6542",2015-12-27,2015,"Bursaspor","Mersin Idman Yurdu","2-1",2,1,"T1",1,3,1,"H"
"6543",2015-12-27,2015,"Kayserispor","Galatasaray","1-1",1,1,"T1",1,2,0,"D"
"6544",2015-12-28,2015,"Eskisehirspor","Genclerbirligi","2-0",2,0,"T1",1,2,2,"H"
"6545",2015-12-28,2015,"Fenerbahce","Sivasspor","2-1",2,1,"T1",1,3,1,"H"
"6546",2016-01-16,2015,"Akhisar Belediyespor","Konyaspor","0-2",0,2,"T1",1,2,-2,"A"
"6547",2016-01-16,2015,"Galatasaray","Sivasspor","3-1",3,1,"T1",1,4,2,"H"
"6548",2016-01-16,2015,"Kasimpasa","Gaziantepspor","1-2",1,2,"T1",1,3,-1,"A"
"6549",2016-01-16,2015,"Kayserispor","Osmanlispor","1-0",1,0,"T1",1,1,1,"H"
"6550",2016-01-17,2015,"Antalyaspor","Buyuksehyr","1-2",1,2,"T1",1,3,-1,"A"
"6551",2016-01-17,2015,"Bursaspor","Trabzonspor","4-2",4,2,"T1",1,6,2,"H"
"6552",2016-01-17,2015,"Rizespor","Genclerbirligi","2-3",2,3,"T1",1,5,-1,"A"
"6553",2016-01-18,2015,"Eskisehirspor","Fenerbahce","0-3",0,3,"T1",1,3,-3,"A"
"6554",2016-01-23,2015,"Konyaspor","Kayserispor","1-0",1,0,"T1",1,1,1,"H"
"6555",2016-01-23,2015,"Mersin Idman Yurdu","Akhisar Belediyespor","0-0",0,0,"T1",1,0,0,"D"
"6556",2016-01-23,2015,"Osmanlispor","Galatasaray","3-2",3,2,"T1",1,5,1,"H"
"6557",2016-01-24,2015,"Fenerbahce","Rizespor","2-1",2,1,"T1",1,3,1,"H"
"6558",2016-01-24,2015,"Gaziantepspor","Bursaspor","2-3",2,3,"T1",1,5,-1,"A"
"6559",2016-01-24,2015,"Genclerbirligi","Antalyaspor","1-0",1,0,"T1",1,1,1,"H"
"6560",2016-01-24,2015,"Sivasspor","Eskisehirspor","1-2",1,2,"T1",1,3,-1,"A"
"6561",2016-01-25,2015,"Buyuksehyr","Kasimpasa","1-1",1,1,"T1",1,2,0,"D"
"6562",2016-02-05,2015,"Antalyaspor","Fenerbahce","4-2",4,2,"T1",1,6,2,"H"
"6563",2016-02-05,2015,"Osmanlispor","Sivasspor","4-0",4,0,"T1",1,4,4,"H"
"6564",2016-02-06,2015,"Bursaspor","Buyuksehyr","3-3",3,3,"T1",1,6,0,"D"
"6565",2016-02-06,2015,"Galatasaray","Konyaspor","0-0",0,0,"T1",1,0,0,"D"
"6566",2016-02-06,2015,"Kayserispor","Mersin Idman Yurdu","0-1",0,1,"T1",1,1,-1,"A"
"6567",2016-02-07,2015,"Akhisar Belediyespor","Trabzonspor","2-1",2,1,"T1",1,3,1,"H"
"6568",2016-02-07,2015,"Besiktas","Gaziantepspor","4-0",4,0,"T1",1,4,4,"H"
"6569",2016-02-07,2015,"Rizespor","Eskisehirspor","1-1",1,1,"T1",1,2,0,"D"
"6570",2016-02-08,2015,"Kasimpasa","Genclerbirligi","0-1",0,1,"T1",1,1,-1,"A"
"6571",2016-02-12,2015,"Fenerbahce","Kasimpasa","3-1",3,1,"T1",1,4,2,"H"
"6572",2016-02-13,2015,"Genclerbirligi","Bursaspor","2-0",2,0,"T1",1,2,2,"H"
"6573",2016-02-13,2015,"Konyaspor","Osmanlispor","1-1",1,1,"T1",1,2,0,"D"
"6574",2016-02-13,2015,"Mersin Idman Yurdu","Galatasaray","2-1",2,1,"T1",1,3,1,"H"
"6575",2016-02-14,2015,"Buyuksehyr","Besiktas","2-2",2,2,"T1",1,4,0,"D"
"6576",2016-02-14,2015,"Eskisehirspor","Antalyaspor","3-2",3,2,"T1",1,5,1,"H"
"6577",2016-02-14,2015,"Gaziantepspor","Akhisar Belediyespor","0-1",0,1,"T1",1,1,-1,"A"
"6578",2016-02-14,2015,"Sivasspor","Rizespor","2-1",2,1,"T1",1,3,1,"H"
"6579",2016-02-15,2015,"Trabzonspor","Kayserispor","2-1",2,1,"T1",1,3,1,"H"
"6580",2016-02-17,2015,"Besiktas","Mersin Idman Yurdu","1-0",1,0,"T1",1,1,1,"H"
"6581",2016-02-19,2015,"Konyaspor","Sivasspor","2-1",2,1,"T1",1,3,1,"H"
"6582",2016-02-20,2015,"Antalyaspor","Rizespor","2-1",2,1,"T1",1,3,1,"H"
"6583",2016-02-20,2015,"Bursaspor","Fenerbahce","0-0",0,0,"T1",1,0,0,"D"
"6584",2016-02-20,2015,"Kasimpasa","Eskisehirspor","2-1",2,1,"T1",1,3,1,"H"
"6585",2016-02-21,2015,"Akhisar Belediyespor","Buyuksehyr","0-0",0,0,"T1",1,0,0,"D"
"6586",2016-02-21,2015,"Galatasaray","Trabzonspor","2-1",2,1,"T1",1,3,1,"H"
"6587",2016-02-21,2015,"Kayserispor","Gaziantepspor","2-2",2,2,"T1",1,4,0,"D"
"6588",2016-02-21,2015,"Osmanlispor","Mersin Idman Yurdu","3-1",3,1,"T1",1,4,2,"H"
"6589",2016-02-22,2015,"Besiktas","Genclerbirligi","1-0",1,0,"T1",1,1,1,"H"
"6590",2016-02-26,2015,"Buyuksehyr","Kayserispor","1-0",1,0,"T1",1,1,1,"H"
"6591",2016-02-27,2015,"Eskisehirspor","Bursaspor","0-1",0,1,"T1",1,1,-1,"A"
"6592",2016-02-27,2015,"Mersin Idman Yurdu","Konyaspor","0-2",0,2,"T1",1,2,-2,"A"
"6593",2016-02-27,2015,"Rizespor","Kasimpasa","2-0",2,0,"T1",1,2,2,"H"
"6594",2016-02-27,2015,"Trabzonspor","Osmanlispor","1-2",1,2,"T1",1,3,-1,"A"
"6595",2016-02-28,2015,"Gaziantepspor","Galatasaray","2-0",2,0,"T1",1,2,2,"H"
"6596",2016-02-28,2015,"Genclerbirligi","Akhisar Belediyespor","3-1",3,1,"T1",1,4,2,"H"
"6597",2016-02-28,2015,"Sivasspor","Antalyaspor","0-0",0,0,"T1",1,0,0,"D"
"6598",2016-02-29,2015,"Fenerbahce","Besiktas","2-0",2,0,"T1",1,2,2,"H"
"6599",2016-03-04,2015,"Mersin Idman Yurdu","Sivasspor","1-0",1,0,"T1",1,1,1,"H"
"6600",2016-03-05,2015,"Bursaspor","Rizespor","1-0",1,0,"T1",1,1,1,"H"
"6601",2016-03-05,2015,"Kayserispor","Genclerbirligi","0-2",0,2,"T1",1,2,-2,"A"
"6602",2016-03-05,2015,"Osmanlispor","Gaziantepspor","1-1",1,1,"T1",1,2,0,"D"
"6603",2016-03-06,2015,"Akhisar Belediyespor","Fenerbahce","0-3",0,3,"T1",1,3,-3,"A"
"6604",2016-03-06,2015,"Galatasaray","Buyuksehyr","3-3",3,3,"T1",1,6,0,"D"
"6605",2016-03-06,2015,"Kasimpasa","Antalyaspor","2-1",2,1,"T1",1,3,1,"H"
"6606",2016-03-06,2015,"Konyaspor","Trabzonspor","2-0",2,0,"T1",1,2,2,"H"
"6607",2016-03-07,2015,"Besiktas","Eskisehirspor","3-1",3,1,"T1",1,4,2,"H"
"6608",2016-03-11,2015,"Trabzonspor","Mersin Idman Yurdu","1-0",1,0,"T1",1,1,1,"H"
"6609",2016-03-12,2015,"Buyuksehyr","Osmanlispor","2-3",2,3,"T1",1,5,-1,"A"
"6610",2016-03-12,2015,"Gaziantepspor","Konyaspor","0-1",0,1,"T1",1,1,-1,"A"
"6611",2016-03-12,2015,"Rizespor","Besiktas","1-2",1,2,"T1",1,3,-1,"A"
"6612",2016-03-13,2015,"Eskisehirspor","Akhisar Belediyespor","3-3",3,3,"T1",1,6,0,"D"
"6613",2016-03-13,2015,"Fenerbahce","Kayserispor","1-0",1,0,"T1",1,1,1,"H"
"6614",2016-03-13,2015,"Genclerbirligi","Galatasaray","1-1",1,1,"T1",1,2,0,"D"
"6615",2016-03-14,2015,"Antalyaspor","Bursaspor","3-0",3,0,"T1",1,3,3,"H"
"6616",2016-03-14,2015,"Sivasspor","Kasimpasa","1-0",1,0,"T1",1,1,1,"H"
"6617",2016-03-15,2015,"Trabzonspor","Besiktas","0-2",0,2,"T1",1,2,-2,"A"
"6618",2016-03-18,2015,"Akhisar Belediyespor","Rizespor","1-1",1,1,"T1",1,2,0,"D"
"6619",2016-03-18,2015,"Kayserispor","Eskisehirspor","0-0",0,0,"T1",1,0,0,"D"
"6620",2016-03-19,2015,"Besiktas","Antalyaspor","1-0",1,0,"T1",1,1,1,"H"
"6621",2016-03-19,2015,"Osmanlispor","Genclerbirligi","3-1",3,1,"T1",1,4,2,"H"
"6622",2016-03-19,2015,"Trabzonspor","Sivasspor","1-0",1,0,"T1",1,1,1,"H"
"6623",2016-03-20,2015,"Bursaspor","Kasimpasa","4-1",4,1,"T1",1,5,3,"H"
"6624",2016-03-20,2015,"Konyaspor","Buyuksehyr","1-1",1,1,"T1",1,2,0,"D"
"6625",2016-03-20,2015,"Mersin Idman Yurdu","Gaziantepspor","0-0",0,0,"T1",1,0,0,"D"
"6626",2016-04-02,2015,"Eskisehirspor","Galatasaray","4-3",4,3,"T1",1,7,1,"H"
"6627",2016-04-02,2015,"Gaziantepspor","Trabzonspor","0-1",0,1,"T1",1,1,-1,"A"
"6628",2016-04-02,2015,"Genclerbirligi","Konyaspor","0-1",0,1,"T1",1,1,-1,"A"
"6629",2016-04-03,2015,"Antalyaspor","Akhisar Belediyespor","2-2",2,2,"T1",1,4,0,"D"
"6630",2016-04-03,2015,"Buyuksehyr","Mersin Idman Yurdu","3-0",3,0,"T1",1,3,3,"H"
"6631",2016-04-03,2015,"Fenerbahce","Osmanlispor","0-0",0,0,"T1",1,0,0,"D"
"6632",2016-04-03,2015,"Sivasspor","Bursaspor","1-2",1,2,"T1",1,3,-1,"A"
"6633",2016-04-04,2015,"Kasimpasa","Besiktas","2-1",2,1,"T1",1,3,1,"H"
"6634",2016-04-04,2015,"Rizespor","Kayserispor","0-0",0,0,"T1",1,0,0,"D"
"6635",2016-04-08,2015,"Gaziantepspor","Sivasspor","0-1",0,1,"T1",1,1,-1,"A"
"6636",2016-04-09,2015,"Galatasaray","Rizespor","1-1",1,1,"T1",1,2,0,"D"
"6637",2016-04-09,2015,"Kayserispor","Antalyaspor","0-0",0,0,"T1",1,0,0,"D"
"6638",2016-04-09,2015,"Osmanlispor","Eskisehirspor","0-0",0,0,"T1",1,0,0,"D"
"6639",2016-04-10,2015,"Konyaspor","Fenerbahce","2-1",2,1,"T1",1,3,1,"H"
"6640",2016-04-10,2015,"Mersin Idman Yurdu","Genclerbirligi","1-3",1,3,"T1",1,4,-2,"A"
"6641",2016-04-10,2015,"Trabzonspor","Buyuksehyr","1-1",1,1,"T1",1,2,0,"D"
"6642",2016-04-11,2015,"Akhisar Belediyespor","Kasimpasa","0-1",0,1,"T1",1,1,-1,"A"
"6643",2016-04-11,2015,"Besiktas","Bursaspor","3-2",3,2,"T1",1,5,1,"H"
"6644",2016-04-13,2015,"Galatasaray","Fenerbahce","0-0",0,0,"T1",1,0,0,"D"
"6645",2016-04-16,2015,"Antalyaspor","Galatasaray","4-2",4,2,"T1",1,6,2,"H"
"6646",2016-04-16,2015,"Eskisehirspor","Konyaspor","1-2",1,2,"T1",1,3,-1,"A"
"6647",2016-04-16,2015,"Rizespor","Osmanlispor","0-1",0,1,"T1",1,1,-1,"A"
"6648",2016-04-16,2015,"Sivasspor","Besiktas","1-2",1,2,"T1",1,3,-1,"A"
"6649",2016-04-17,2015,"Bursaspor","Akhisar Belediyespor","0-2",0,2,"T1",1,2,-2,"A"
"6650",2016-04-17,2015,"Buyuksehyr","Gaziantepspor","4-1",4,1,"T1",1,5,3,"H"
"6651",2016-04-17,2015,"Fenerbahce","Mersin Idman Yurdu","4-1",4,1,"T1",1,5,3,"H"
"6652",2016-04-17,2015,"Kasimpasa","Kayserispor","1-2",1,2,"T1",1,3,-1,"A"
"6653",2016-04-18,2015,"Genclerbirligi","Trabzonspor","3-1",3,1,"T1",1,4,2,"H"
"6654",2016-04-22,2015,"Kayserispor","Bursaspor","2-1",2,1,"T1",1,3,1,"H"
"6655",2016-04-23,2015,"Akhisar Belediyespor","Besiktas","3-3",3,3,"T1",1,6,0,"D"
"6656",2016-04-23,2015,"Buyuksehyr","Sivasspor","2-2",2,2,"T1",1,4,0,"D"
"6657",2016-04-23,2015,"Osmanlispor","Antalyaspor","3-0",3,0,"T1",1,3,3,"H"
"6658",2016-04-24,2015,"Galatasaray","Kasimpasa","4-1",4,1,"T1",1,5,3,"H"
"6659",2016-04-24,2015,"Konyaspor","Rizespor","3-1",3,1,"T1",1,4,2,"H"
"6660",2016-04-24,2015,"Mersin Idman Yurdu","Eskisehirspor","1-2",1,2,"T1",1,3,-1,"A"
"6661",2016-04-24,2015,"Trabzonspor","Fenerbahce","0-4",0,4,"T1",1,4,-4,"A"
"6662",2016-04-25,2015,"Gaziantepspor","Genclerbirligi","1-3",1,3,"T1",1,4,-2,"A"
"6663",2016-04-29,2015,"Bursaspor","Galatasaray","1-1",1,1,"T1",1,2,0,"D"
"6664",2016-04-29,2015,"Rizespor","Mersin Idman Yurdu","2-0",2,0,"T1",1,2,2,"H"
"6665",2016-04-30,2015,"Besiktas","Kayserispor","4-0",4,0,"T1",1,4,4,"H"
"6666",2016-04-30,2015,"Eskisehirspor","Trabzonspor","1-0",1,0,"T1",1,1,1,"H"
"6667",2016-04-30,2015,"Genclerbirligi","Buyuksehyr","0-0",0,0,"T1",1,0,0,"D"
"6668",2016-05-01,2015,"Antalyaspor","Konyaspor","1-0",1,0,"T1",1,1,1,"H"
"6669",2016-05-01,2015,"Fenerbahce","Gaziantepspor","3-0",3,0,"T1",1,3,3,"H"
"6670",2016-05-01,2015,"Sivasspor","Akhisar Belediyespor","1-1",1,1,"T1",1,2,0,"D"
"6671",2016-05-02,2015,"Kasimpasa","Osmanlispor","1-1",1,1,"T1",1,2,0,"D"
"6672",2016-05-07,2015,"Gaziantepspor","Eskisehirspor","1-1",1,1,"T1",1,2,0,"D"
"6673",2016-05-07,2015,"Osmanlispor","Bursaspor","3-3",3,3,"T1",1,6,0,"D"
"6674",2016-05-07,2015,"Sivasspor","Genclerbirligi","2-1",2,1,"T1",1,3,1,"H"
"6675",2016-05-08,2015,"Akhisar Belediyespor","Kayserispor","1-1",1,1,"T1",1,2,0,"D"
"6676",2016-05-08,2015,"Galatasaray","Besiktas","0-1",0,1,"T1",1,1,-1,"A"
"6677",2016-05-08,2015,"Mersin Idman Yurdu","Antalyaspor","0-1",0,1,"T1",1,1,-1,"A"
"6678",2016-05-08,2015,"Trabzonspor","Rizespor","6-0",6,0,"T1",1,6,6,"H"
"6679",2016-05-09,2015,"Buyuksehyr","Fenerbahce","2-1",2,1,"T1",1,3,1,"H"
"6680",2016-05-09,2015,"Konyaspor","Kasimpasa","2-0",2,0,"T1",1,2,2,"H"
"6681",2016-05-13,2015,"Antalyaspor","Trabzonspor","7-0",7,0,"T1",1,7,7,"H"
"6682",2016-05-14,2015,"Bursaspor","Konyaspor","1-1",1,1,"T1",1,2,0,"D"
"6683",2016-05-14,2015,"Eskisehirspor","Buyuksehyr","1-2",1,2,"T1",1,3,-1,"A"
"6684",2016-05-14,2015,"Kayserispor","Sivasspor","1-1",1,1,"T1",1,2,0,"D"
"6685",2016-05-14,2015,"Rizespor","Gaziantepspor","1-0",1,0,"T1",1,1,1,"H"
"6686",2016-05-15,2015,"Akhisar Belediyespor","Galatasaray","1-2",1,2,"T1",1,3,-1,"A"
"6687",2016-05-15,2015,"Besiktas","Osmanlispor","3-1",3,1,"T1",1,4,2,"H"
"6688",2016-05-15,2015,"Fenerbahce","Genclerbirligi","2-1",2,1,"T1",1,3,1,"H"
"6689",2016-05-15,2015,"Kasimpasa","Mersin Idman Yurdu","7-0",7,0,"T1",1,7,7,"H"
"6690",2016-05-18,2015,"Buyuksehyr","Rizespor","1-0",1,0,"T1",1,1,1,"H"
"6691",2016-05-18,2015,"Konyaspor","Besiktas","2-1",2,1,"T1",1,3,1,"H"
"6692",2016-05-18,2015,"Mersin Idman Yurdu","Bursaspor","2-5",2,5,"T1",1,7,-3,"A"
"6693",2016-05-19,2015,"Galatasaray","Kayserispor","6-0",6,0,"T1",1,6,6,"H"
"6694",2016-05-19,2015,"Gaziantepspor","Antalyaspor","2-0",2,0,"T1",1,2,2,"H"
"6695",2016-05-19,2015,"Genclerbirligi","Eskisehirspor","3-1",3,1,"T1",1,4,2,"H"
"6696",2016-05-19,2015,"Osmanlispor","Akhisar Belediyespor","1-0",1,0,"T1",1,1,1,"H"
"6697",2016-05-19,2015,"Sivasspor","Fenerbahce","2-2",2,2,"T1",1,4,0,"D"
"6698",2016-05-19,2015,"Trabzonspor","Kasimpasa","0-6",0,6,"T1",1,6,-6,"A"
"6699",2016-08-19,2016,"Adanaspor","Bursaspor","1-2",1,2,"T1",1,3,-1,"A"
"6700",2016-08-20,2016,"Besiktas","Alanyaspor","4-1",4,1,"T1",1,5,3,"H"
"6701",2016-08-20,2016,"Rizespor","Konyaspor","1-1",1,1,"T1",1,2,0,"D"
"6702",2016-08-20,2016,"Trabzonspor","Kasimpasa","2-0",2,0,"T1",1,2,2,"H"
"6703",2016-08-21,2016,"Antalyaspor","Osmanlispor","0-0",0,0,"T1",1,0,0,"D"
"6704",2016-08-21,2016,"Buyuksehyr","Fenerbahce","1-0",1,0,"T1",1,1,1,"H"
"6705",2016-08-21,2016,"Genclerbirligi","Gaziantepspor","2-0",2,0,"T1",1,2,2,"H"
"6706",2016-08-21,2016,"Kayserispor","Akhisar Belediyespor","0-2",0,2,"T1",1,2,-2,"A"
"6707",2016-08-22,2016,"Galatasaray","Karabukspor","1-0",1,0,"T1",1,1,1,"H"
"6708",2016-08-26,2016,"Alanyaspor","Antalyaspor","2-1",2,1,"T1",1,3,1,"H"
"6709",2016-08-26,2016,"Konyaspor","Besiktas","2-2",2,2,"T1",1,4,0,"D"
"6710",2016-08-27,2016,"Akhisar Belediyespor","Galatasaray","1-3",1,3,"T1",1,4,-2,"A"
"6711",2016-08-27,2016,"Gaziantepspor","Trabzonspor","1-0",1,0,"T1",1,1,1,"H"
"6712",2016-08-27,2016,"Kasimpasa","Adanaspor","1-1",1,1,"T1",1,2,0,"D"
"6713",2016-08-28,2016,"Bursaspor","Buyuksehyr","0-2",0,2,"T1",1,2,-2,"A"
"6714",2016-08-28,2016,"Fenerbahce","Kayserispor","3-3",3,3,"T1",1,6,0,"D"
"6715",2016-08-28,2016,"Karabukspor","Rizespor","3-0",3,0,"T1",1,3,3,"H"
"6716",2016-08-28,2016,"Osmanlispor","Genclerbirligi","2-2",2,2,"T1",1,4,0,"D"
"6717",2016-09-10,2016,"Adanaspor","Gaziantepspor","0-0",0,0,"T1",1,0,0,"D"
"6718",2016-09-10,2016,"Besiktas","Karabukspor","3-1",3,1,"T1",1,4,2,"H"
"6719",2016-09-10,2016,"Buyuksehyr","Kasimpasa","3-1",3,1,"T1",1,4,2,"H"
"6720",2016-09-10,2016,"Genclerbirligi","Alanyaspor","0-0",0,0,"T1",1,0,0,"D"
"6721",2016-09-10,2016,"Kayserispor","Galatasaray","1-1",1,1,"T1",1,2,0,"D"
"6722",2016-09-11,2016,"Antalyaspor","Konyaspor","1-3",1,3,"T1",1,4,-2,"A"
"6723",2016-09-11,2016,"Fenerbahce","Bursaspor","0-1",0,1,"T1",1,1,-1,"A"
"6724",2016-09-11,2016,"Rizespor","Akhisar Belediyespor","1-0",1,0,"T1",1,1,1,"H"
"6725",2016-09-11,2016,"Trabzonspor","Osmanlispor","0-2",0,2,"T1",1,2,-2,"A"
"6726",2016-09-16,2016,"Bursaspor","Kayserispor","3-1",3,1,"T1",1,4,2,"H"
"6727",2016-09-16,2016,"Karabukspor","Antalyaspor","3-2",3,2,"T1",1,5,1,"H"
"6728",2016-09-17,2016,"Alanyaspor","Trabzonspor","3-0",3,0,"T1",1,3,3,"H"
"6729",2016-09-17,2016,"Galatasaray","Rizespor","2-0",2,0,"T1",1,2,2,"H"
"6730",2016-09-18,2016,"Akhisar Belediyespor","Besiktas","0-2",0,2,"T1",1,2,-2,"A"
"6731",2016-09-18,2016,"Gaziantepspor","Buyuksehyr","0-1",0,1,"T1",1,1,-1,"A"
"6732",2016-09-18,2016,"Konyaspor","Genclerbirligi","1-1",1,1,"T1",1,2,0,"D"
"6733",2016-09-18,2016,"Osmanlispor","Adanaspor","1-0",1,0,"T1",1,1,1,"H"
"6734",2016-09-19,2016,"Kasimpasa","Fenerbahce","1-5",1,5,"T1",1,6,-4,"A"
"6735",2016-09-23,2016,"Antalyaspor","Akhisar Belediyespor","0-0",0,0,"T1",1,0,0,"D"
"6736",2016-09-24,2016,"Besiktas","Galatasaray","2-2",2,2,"T1",1,4,0,"D"
"6737",2016-09-24,2016,"Buyuksehyr","Osmanlispor","2-2",2,2,"T1",1,4,0,"D"
"6738",2016-09-24,2016,"Trabzonspor","Konyaspor","1-0",1,0,"T1",1,1,1,"H"
"6739",2016-09-25,2016,"Bursaspor","Kasimpasa","1-0",1,0,"T1",1,1,1,"H"
"6740",2016-09-25,2016,"Fenerbahce","Gaziantepspor","2-1",2,1,"T1",1,3,1,"H"
"6741",2016-09-25,2016,"Genclerbirligi","Karabukspor","2-0",2,0,"T1",1,2,2,"H"
"6742",2016-09-25,2016,"Kayserispor","Rizespor","2-1",2,1,"T1",1,3,1,"H"
"6743",2016-09-26,2016,"Adanaspor","Alanyaspor","3-2",3,2,"T1",1,5,1,"H"
"6744",2016-09-30,2016,"Akhisar Belediyespor","Genclerbirligi","0-0",0,0,"T1",1,0,0,"D"
"6745",2016-10-01,2016,"Gaziantepspor","Bursaspor","3-2",3,2,"T1",1,5,1,"H"
"6746",2016-10-01,2016,"Karabukspor","Trabzonspor","4-0",4,0,"T1",1,4,4,"H"
"6747",2016-10-01,2016,"Kasimpasa","Kayserispor","3-1",3,1,"T1",1,4,2,"H"
"6748",2016-10-01,2016,"Rizespor","Besiktas","0-1",0,1,"T1",1,1,-1,"A"
"6749",2016-10-02,2016,"Alanyaspor","Buyuksehyr","0-5",0,5,"T1",1,5,-5,"A"
"6750",2016-10-02,2016,"Galatasaray","Antalyaspor","3-1",3,1,"T1",1,4,2,"H"
"6751",2016-10-02,2016,"Konyaspor","Adanaspor","1-0",1,0,"T1",1,1,1,"H"
"6752",2016-10-02,2016,"Osmanlispor","Fenerbahce","1-1",1,1,"T1",1,2,0,"D"
"6753",2016-10-15,2016,"Adanaspor","Karabukspor","1-2",1,2,"T1",1,3,-1,"A"
"6754",2016-10-15,2016,"Genclerbirligi","Galatasaray","0-1",0,1,"T1",1,1,-1,"A"
"6755",2016-10-15,2016,"Kasimpasa","Gaziantepspor","0-0",0,0,"T1",1,0,0,"D"
"6756",2016-10-15,2016,"Kayserispor","Besiktas","0-1",0,1,"T1",1,1,-1,"A"
"6757",2016-10-16,2016,"Bursaspor","Osmanlispor","0-0",0,0,"T1",1,0,0,"D"
"6758",2016-10-16,2016,"Buyuksehyr","Konyaspor","1-1",1,1,"T1",1,2,0,"D"
"6759",2016-10-16,2016,"Fenerbahce","Alanyaspor","1-1",1,1,"T1",1,2,0,"D"
"6760",2016-10-16,2016,"Trabzonspor","Akhisar Belediyespor","0-0",0,0,"T1",1,0,0,"D"
"6761",2016-10-17,2016,"Antalyaspor","Rizespor","1-1",1,1,"T1",1,2,0,"D"
"6762",2016-10-21,2016,"Gaziantepspor","Kayserispor","1-2",1,2,"T1",1,3,-1,"A"
"6763",2016-10-21,2016,"Rizespor","Genclerbirligi","2-1",2,1,"T1",1,3,1,"H"
"6764",2016-10-22,2016,"Akhisar Belediyespor","Adanaspor","1-0",1,0,"T1",1,1,1,"H"
"6765",2016-10-22,2016,"Alanyaspor","Bursaspor","0-2",0,2,"T1",1,2,-2,"A"
"6766",2016-10-22,2016,"Galatasaray","Trabzonspor","0-1",0,1,"T1",1,1,-1,"A"
"6767",2016-10-23,2016,"Besiktas","Antalyaspor","3-0",3,0,"T1",1,3,3,"H"
"6768",2016-10-23,2016,"Karabukspor","Buyuksehyr","0-2",0,2,"T1",1,2,-2,"A"
"6769",2016-10-23,2016,"Osmanlispor","Kasimpasa","1-2",1,2,"T1",1,3,-1,"A"
"6770",2016-10-24,2016,"Konyaspor","Fenerbahce","0-1",0,1,"T1",1,1,-1,"A"
"6771",2016-10-28,2016,"Genclerbirligi","Besiktas","1-1",1,1,"T1",1,2,0,"D"
"6772",2016-10-29,2016,"Adanaspor","Galatasaray","0-1",0,1,"T1",1,1,-1,"A"
"6773",2016-10-29,2016,"Bursaspor","Konyaspor","2-0",2,0,"T1",1,2,2,"H"
"6774",2016-10-29,2016,"Gaziantepspor","Osmanlispor","3-1",3,1,"T1",1,4,2,"H"
"6775",2016-10-30,2016,"Buyuksehyr","Akhisar Belediyespor","5-1",5,1,"T1",1,6,4,"H"
"6776",2016-10-30,2016,"Fenerbahce","Karabukspor","5-0",5,0,"T1",1,5,5,"H"
"6777",2016-10-30,2016,"Trabzonspor","Rizespor","2-2",2,2,"T1",1,4,0,"D"
"6778",2016-10-31,2016,"Kasimpasa","Alanyaspor","2-1",2,1,"T1",1,3,1,"H"
"6779",2016-10-31,2016,"Kayserispor","Antalyaspor","0-1",0,1,"T1",1,1,-1,"A"
"6780",2016-11-04,2016,"Galatasaray","Buyuksehyr","1-2",1,2,"T1",1,3,-1,"A"
"6781",2016-11-05,2016,"Alanyaspor","Gaziantepspor","4-3",4,3,"T1",1,7,1,"H"
"6782",2016-11-05,2016,"Antalyaspor","Genclerbirligi","1-0",1,0,"T1",1,1,1,"H"
"6783",2016-11-05,2016,"Besiktas","Trabzonspor","2-1",2,1,"T1",1,3,1,"H"
"6784",2016-11-05,2016,"Karabukspor","Bursaspor","0-0",0,0,"T1",1,0,0,"D"
"6785",2016-11-06,2016,"Akhisar Belediyespor","Fenerbahce","1-3",1,3,"T1",1,4,-2,"A"
"6786",2016-11-06,2016,"Konyaspor","Kasimpasa","2-1",2,1,"T1",1,3,1,"H"
"6787",2016-11-06,2016,"Osmanlispor","Kayserispor","1-1",1,1,"T1",1,2,0,"D"
"6788",2016-11-06,2016,"Rizespor","Adanaspor","2-2",2,2,"T1",1,4,0,"D"
"6789",2016-11-19,2016,"Adanaspor","Besiktas","1-2",1,2,"T1",1,3,-1,"A"
"6790",2016-11-19,2016,"Bursaspor","Akhisar Belediyespor","0-0",0,0,"T1",1,0,0,"D"
"6791",2016-11-19,2016,"Gaziantepspor","Konyaspor","0-3",0,3,"T1",1,3,-3,"A"
"6792",2016-11-19,2016,"Osmanlispor","Alanyaspor","2-0",2,0,"T1",1,2,2,"H"
"6793",2016-11-20,2016,"Fenerbahce","Galatasaray","2-0",2,0,"T1",1,2,2,"H"
"6794",2016-11-20,2016,"Kasimpasa","Karabukspor","2-2",2,2,"T1",1,4,0,"D"
"6795",2016-11-20,2016,"Kayserispor","Genclerbirligi","0-2",0,2,"T1",1,2,-2,"A"
"6796",2016-11-21,2016,"Buyuksehyr","Rizespor","2-1",2,1,"T1",1,3,1,"H"
"6797",2016-11-21,2016,"Trabzonspor","Antalyaspor","0-1",0,1,"T1",1,1,-1,"A"
"6798",2016-11-25,2016,"Alanyaspor","Kayserispor","3-0",3,0,"T1",1,3,3,"H"
"6799",2016-11-25,2016,"Galatasaray","Bursaspor","3-1",3,1,"T1",1,4,2,"H"
"6800",2016-11-26,2016,"Akhisar Belediyespor","Kasimpasa","1-0",1,0,"T1",1,1,1,"H"
"6801",2016-11-26,2016,"Antalyaspor","Adanaspor","1-0",1,0,"T1",1,1,1,"H"
"6802",2016-11-26,2016,"Besiktas","Buyuksehyr","1-1",1,1,"T1",1,2,0,"D"
"6803",2016-11-26,2016,"Karabukspor","Gaziantepspor","2-0",2,0,"T1",1,2,2,"H"
"6804",2016-11-27,2016,"Genclerbirligi","Trabzonspor","0-0",0,0,"T1",1,0,0,"D"
"6805",2016-11-27,2016,"Rizespor","Fenerbahce","1-5",1,5,"T1",1,6,-4,"A"
"6806",2016-11-28,2016,"Konyaspor","Osmanlispor","1-1",1,1,"T1",1,2,0,"D"
"6807",2016-12-03,2016,"Buyuksehyr","Antalyaspor","2-2",2,2,"T1",1,4,0,"D"
"6808",2016-12-03,2016,"Fenerbahce","Besiktas","0-0",0,0,"T1",1,0,0,"D"
"6809",2016-12-04,2016,"Adanaspor","Genclerbirligi","0-2",0,2,"T1",1,2,-2,"A"
"6810",2016-12-04,2016,"Alanyaspor","Konyaspor","2-3",2,3,"T1",1,5,-1,"A"
"6811",2016-12-04,2016,"Gaziantepspor","Akhisar Belediyespor","1-2",1,2,"T1",1,3,-1,"A"
"6812",2016-12-04,2016,"Kasimpasa","Galatasaray","1-2",1,2,"T1",1,3,-1,"A"
"6813",2016-12-04,2016,"Osmanlispor","Karabukspor","2-1",2,1,"T1",1,3,1,"H"
"6814",2016-12-05,2016,"Bursaspor","Rizespor","2-1",2,1,"T1",1,3,1,"H"
"6815",2016-12-05,2016,"Kayserispor","Trabzonspor","0-1",0,1,"T1",1,1,-1,"A"
"6816",2016-12-09,2016,"Trabzonspor","Adanaspor","4-1",4,1,"T1",1,5,3,"H"
"6817",2016-12-10,2016,"Besiktas","Bursaspor","2-1",2,1,"T1",1,3,1,"H"
"6818",2016-12-10,2016,"Genclerbirligi","Buyuksehyr","0-0",0,0,"T1",1,0,0,"D"
"6819",2016-12-10,2016,"Rizespor","Kasimpasa","0-1",0,1,"T1",1,1,-1,"A"
"6820",2016-12-11,2016,"Akhisar Belediyespor","Osmanlispor","1-2",1,2,"T1",1,3,-1,"A"
"6821",2016-12-11,2016,"Galatasaray","Gaziantepspor","3-1",3,1,"T1",1,4,2,"H"
"6822",2016-12-11,2016,"Karabukspor","Alanyaspor","0-2",0,2,"T1",1,2,-2,"A"
"6823",2016-12-11,2016,"Konyaspor","Kayserispor","1-0",1,0,"T1",1,1,1,"H"
"6824",2016-12-12,2016,"Antalyaspor","Fenerbahce","1-0",1,0,"T1",1,1,1,"H"
"6825",2016-12-17,2016,"Buyuksehyr","Trabzonspor","1-0",1,0,"T1",1,1,1,"H"
"6826",2016-12-17,2016,"Kasimpasa","Besiktas","2-1",2,1,"T1",1,3,1,"H"
"6827",2016-12-18,2016,"Adanaspor","Kayserispor","2-1",2,1,"T1",1,3,1,"H"
"6828",2016-12-18,2016,"Alanyaspor","Akhisar Belediyespor","0-0",0,0,"T1",1,0,0,"D"
"6829",2016-12-18,2016,"Gaziantepspor","Rizespor","1-2",1,2,"T1",1,3,-1,"A"
"6830",2016-12-18,2016,"Karabukspor","Konyaspor","1-1",1,1,"T1",1,2,0,"D"
"6831",2016-12-18,2016,"Osmanlispor","Galatasaray","2-2",2,2,"T1",1,4,0,"D"
"6832",2016-12-19,2016,"Bursaspor","Antalyaspor","2-1",2,1,"T1",1,3,1,"H"
"6833",2016-12-19,2016,"Fenerbahce","Genclerbirligi","3-0",3,0,"T1",1,3,3,"H"
"6834",2016-12-24,2016,"Adanaspor","Buyuksehyr","1-1",1,1,"T1",1,2,0,"D"
"6835",2016-12-24,2016,"Besiktas","Gaziantepspor","1-0",1,0,"T1",1,1,1,"H"
"6836",2016-12-25,2016,"Akhisar Belediyespor","Konyaspor","1-0",1,0,"T1",1,1,1,"H"
"6837",2016-12-25,2016,"Antalyaspor","Kasimpasa","2-1",2,1,"T1",1,3,1,"H"
"6838",2016-12-25,2016,"Galatasaray","Alanyaspor","5-1",5,1,"T1",1,6,4,"H"
"6839",2016-12-25,2016,"Kayserispor","Karabukspor","2-0",2,0,"T1",1,2,2,"H"
"6840",2016-12-25,2016,"Rizespor","Osmanlispor","0-1",0,1,"T1",1,1,-1,"A"
"6841",2016-12-26,2016,"Genclerbirligi","Bursaspor","3-1",3,1,"T1",1,4,2,"H"
"6842",2016-12-26,2016,"Trabzonspor","Fenerbahce","0-3",0,3,"T1",1,3,-3,"A"
"6843",2017-01-13,2016,"Bursaspor","Trabzonspor","1-2",1,2,"T1",1,3,-1,"A"
"6844",2017-01-14,2016,"Alanyaspor","Rizespor","2-3",2,3,"T1",1,5,-1,"A"
"6845",2017-01-14,2016,"Buyuksehyr","Kayserispor","5-0",5,0,"T1",1,5,5,"H"
"6846",2017-01-14,2016,"Karabukspor","Akhisar Belediyespor","1-0",1,0,"T1",1,1,1,"H"
"6847",2017-01-14,2016,"Konyaspor","Galatasaray","0-1",0,1,"T1",1,1,-1,"A"
"6848",2017-01-15,2016,"Fenerbahce","Adanaspor","2-2",2,2,"T1",1,4,0,"D"
"6849",2017-01-15,2016,"Gaziantepspor","Antalyaspor","0-3",0,3,"T1",1,3,-3,"A"
"6850",2017-01-15,2016,"Kasimpasa","Genclerbirligi","3-0",3,0,"T1",1,3,3,"H"
"6851",2017-01-16,2016,"Osmanlispor","Besiktas","0-2",0,2,"T1",1,2,-2,"A"
"6852",2017-01-21,2016,"Akhisar Belediyespor","Kayserispor","0-0",0,0,"T1",1,0,0,"D"
"6853",2017-01-21,2016,"Bursaspor","Adanaspor","0-1",0,1,"T1",1,1,-1,"A"
"6854",2017-01-21,2016,"Karabukspor","Galatasaray","2-1",2,1,"T1",1,3,1,"H"
"6855",2017-01-21,2016,"Konyaspor","Rizespor","2-1",2,1,"T1",1,3,1,"H"
"6856",2017-01-22,2016,"Fenerbahce","Buyuksehyr","1-0",1,0,"T1",1,1,1,"H"
"6857",2017-01-22,2016,"Kasimpasa","Trabzonspor","0-1",0,1,"T1",1,1,-1,"A"
"6858",2017-01-22,2016,"Osmanlispor","Antalyaspor","1-2",1,2,"T1",1,3,-1,"A"
"6859",2017-01-23,2016,"Alanyaspor","Besiktas","1-4",1,4,"T1",1,5,-3,"A"
"6860",2017-01-28,2016,"Antalyaspor","Alanyaspor","2-1",2,1,"T1",1,3,1,"H"
"6861",2017-01-28,2016,"Galatasaray","Akhisar Belediyespor","6-0",6,0,"T1",1,6,6,"H"
"6862",2017-01-28,2016,"Rizespor","Karabukspor","1-0",1,0,"T1",1,1,1,"H"
"6863",2017-01-29,2016,"Buyuksehyr","Bursaspor","1-0",1,0,"T1",1,1,1,"H"
"6864",2017-01-29,2016,"Genclerbirligi","Osmanlispor","1-1",1,1,"T1",1,2,0,"D"
"6865",2017-01-29,2016,"Kayserispor","Fenerbahce","4-1",4,1,"T1",1,5,3,"H"
"6866",2017-01-29,2016,"Trabzonspor","Gaziantepspor","4-0",4,0,"T1",1,4,4,"H"
"6867",2017-01-30,2016,"Adanaspor","Kasimpasa","2-0",2,0,"T1",1,2,2,"H"
"6868",2017-01-30,2016,"Besiktas","Konyaspor","5-1",5,1,"T1",1,6,4,"H"
"6869",2017-02-10,2016,"Karabukspor","Besiktas","2-1",2,1,"T1",1,3,1,"H"
"6870",2017-02-11,2016,"Alanyaspor","Genclerbirligi","3-0",3,0,"T1",1,3,3,"H"
"6871",2017-02-11,2016,"Bursaspor","Fenerbahce","1-1",1,1,"T1",1,2,0,"D"
"6872",2017-02-11,2016,"Osmanlispor","Trabzonspor","0-1",0,1,"T1",1,1,-1,"A"
"6873",2017-02-12,2016,"Akhisar Belediyespor","Rizespor","1-0",1,0,"T1",1,1,1,"H"
"6874",2017-02-12,2016,"Galatasaray","Kayserispor","1-2",1,2,"T1",1,3,-1,"A"
"6875",2017-02-12,2016,"Kasimpasa","Buyuksehyr","4-0",4,0,"T1",1,4,4,"H"
"6876",2017-02-12,2016,"Konyaspor","Antalyaspor","1-1",1,1,"T1",1,2,0,"D"
"6877",2017-02-13,2016,"Gaziantepspor","Adanaspor","1-0",1,0,"T1",1,1,1,"H"
"6878",2017-02-17,2016,"Kayserispor","Bursaspor","2-0",2,0,"T1",1,2,2,"H"
"6879",2017-02-18,2016,"Antalyaspor","Karabukspor","1-0",1,0,"T1",1,1,1,"H"
"6880",2017-02-18,2016,"Buyuksehyr","Gaziantepspor","0-0",0,0,"T1",1,0,0,"D"
"6881",2017-02-18,2016,"Rizespor","Galatasaray","1-1",1,1,"T1",1,2,0,"D"
"6882",2017-02-19,2016,"Adanaspor","Osmanlispor","1-5",1,5,"T1",1,6,-4,"A"
"6883",2017-02-19,2016,"Besiktas","Akhisar Belediyespor","3-1",3,1,"T1",1,4,2,"H"
"6884",2017-02-19,2016,"Fenerbahce","Kasimpasa","0-0",0,0,"T1",1,0,0,"D"
"6885",2017-02-19,2016,"Genclerbirligi","Konyaspor","2-0",2,0,"T1",1,2,2,"H"
"6886",2017-02-20,2016,"Trabzonspor","Alanyaspor","0-0",0,0,"T1",1,0,0,"D"
"6887",2017-02-24,2016,"Kasimpasa","Bursaspor","4-0",4,0,"T1",1,4,4,"H"
"6888",2017-02-24,2016,"Rizespor","Kayserispor","2-4",2,4,"T1",1,6,-2,"A"
"6889",2017-02-25,2016,"Akhisar Belediyespor","Antalyaspor","3-0",3,0,"T1",1,3,3,"H"
"6890",2017-02-25,2016,"Alanyaspor","Adanaspor","4-1",4,1,"T1",1,5,3,"H"
"6891",2017-02-25,2016,"Konyaspor","Trabzonspor","1-1",1,1,"T1",1,2,0,"D"
"6892",2017-02-26,2016,"Gaziantepspor","Fenerbahce","1-1",1,1,"T1",1,2,0,"D"
"6893",2017-02-26,2016,"Karabukspor","Genclerbirligi","1-0",1,0,"T1",1,1,1,"H"
"6894",2017-02-26,2016,"Osmanlispor","Buyuksehyr","0-1",0,1,"T1",1,1,-1,"A"
"6895",2017-02-27,2016,"Galatasaray","Besiktas","0-1",0,1,"T1",1,1,-1,"A"
"6896",2017-03-03,2016,"Trabzonspor","Karabukspor","1-0",1,0,"T1",1,1,1,"H"
"6897",2017-03-04,2016,"Besiktas","Rizespor","1-0",1,0,"T1",1,1,1,"H"
"6898",2017-03-04,2016,"Bursaspor","Gaziantepspor","2-1",2,1,"T1",1,3,1,"H"
"6899",2017-03-05,2016,"Adanaspor","Konyaspor","0-1",0,1,"T1",1,1,-1,"A"
"6900",2017-03-05,2016,"Buyuksehyr","Alanyaspor","2-1",2,1,"T1",1,3,1,"H"
"6901",2017-03-05,2016,"Fenerbahce","Osmanlispor","1-0",1,0,"T1",1,1,1,"H"
"6902",2017-03-05,2016,"Kayserispor","Kasimpasa","2-2",2,2,"T1",1,4,0,"D"
"6903",2017-03-06,2016,"Antalyaspor","Galatasaray","2-3",2,3,"T1",1,5,-1,"A"
"6904",2017-03-06,2016,"Genclerbirligi","Akhisar Belediyespor","2-0",2,0,"T1",1,2,2,"H"
"6905",2017-03-10,2016,"Alanyaspor","Fenerbahce","2-3",2,3,"T1",1,5,-1,"A"
"6906",2017-03-11,2016,"Galatasaray","Genclerbirligi","3-2",3,2,"T1",1,5,1,"H"
"6907",2017-03-11,2016,"Gaziantepspor","Kasimpasa","0-2",0,2,"T1",1,2,-2,"A"
"6908",2017-03-11,2016,"Karabukspor","Adanaspor","2-0",2,0,"T1",1,2,2,"H"
"6909",2017-03-11,2016,"Osmanlispor","Bursaspor","1-1",1,1,"T1",1,2,0,"D"
"6910",2017-03-12,2016,"Besiktas","Kayserispor","2-2",2,2,"T1",1,4,0,"D"
"6911",2017-03-12,2016,"Konyaspor","Buyuksehyr","0-3",0,3,"T1",1,3,-3,"A"
"6912",2017-03-12,2016,"Rizespor","Antalyaspor","1-2",1,2,"T1",1,3,-1,"A"
"6913",2017-03-13,2016,"Akhisar Belediyespor","Trabzonspor","1-3",1,3,"T1",1,4,-2,"A"
"6914",2017-03-17,2016,"Fenerbahce","Konyaspor","2-3",2,3,"T1",1,5,-1,"A"
"6915",2017-03-18,2016,"Adanaspor","Akhisar Belediyespor","2-1",2,1,"T1",1,3,1,"H"
"6916",2017-03-18,2016,"Kasimpasa","Osmanlispor","3-2",3,2,"T1",1,5,1,"H"
"6917",2017-03-18,2016,"Kayserispor","Gaziantepspor","3-4",3,4,"T1",1,7,-1,"A"
"6918",2017-03-18,2016,"Trabzonspor","Galatasaray","2-0",2,0,"T1",1,2,2,"H"
"6919",2017-03-19,2016,"Antalyaspor","Besiktas","0-0",0,0,"T1",1,0,0,"D"
"6920",2017-03-19,2016,"Bursaspor","Alanyaspor","1-3",1,3,"T1",1,4,-2,"A"
"6921",2017-03-19,2016,"Buyuksehyr","Karabukspor","3-3",3,3,"T1",1,6,0,"D"
"6922",2017-03-19,2016,"Genclerbirligi","Rizespor","1-0",1,0,"T1",1,1,1,"H"
"6923",2017-04-01,2016,"Akhisar Belediyespor","Buyuksehyr","2-1",2,1,"T1",1,3,1,"H"
"6924",2017-04-01,2016,"Alanyaspor","Kasimpasa","3-1",3,1,"T1",1,4,2,"H"
"6925",2017-04-01,2016,"Antalyaspor","Kayserispor","2-1",2,1,"T1",1,3,1,"H"
"6926",2017-04-01,2016,"Karabukspor","Fenerbahce","0-1",0,1,"T1",1,1,-1,"A"
"6927",2017-04-02,2016,"Besiktas","Genclerbirligi","3-0",3,0,"T1",1,3,3,"H"
"6928",2017-04-02,2016,"Konyaspor","Bursaspor","2-0",2,0,"T1",1,2,2,"H"
"6929",2017-04-02,2016,"Osmanlispor","Gaziantepspor","0-2",0,2,"T1",1,2,-2,"A"
"6930",2017-04-02,2016,"Rizespor","Trabzonspor","0-1",0,1,"T1",1,1,-1,"A"
"6931",2017-04-03,2016,"Galatasaray","Adanaspor","4-0",4,0,"T1",1,4,4,"H"
"6932",2017-04-07,2016,"Bursaspor","Karabukspor","3-0",3,0,"T1",1,3,3,"H"
"6933",2017-04-08,2016,"Gaziantepspor","Alanyaspor","2-3",2,3,"T1",1,5,-1,"A"
"6934",2017-04-08,2016,"Genclerbirligi","Antalyaspor","1-1",1,1,"T1",1,2,0,"D"
"6935",2017-04-08,2016,"Trabzonspor","Besiktas","3-4",3,4,"T1",1,7,-1,"A"
"6936",2017-04-09,2016,"Adanaspor","Rizespor","1-3",1,3,"T1",1,4,-2,"A"
"6937",2017-04-09,2016,"Fenerbahce","Akhisar Belediyespor","3-1",3,1,"T1",1,4,2,"H"
"6938",2017-04-09,2016,"Kayserispor","Osmanlispor","1-4",1,4,"T1",1,5,-3,"A"
"6939",2017-04-10,2016,"Buyuksehyr","Galatasaray","4-0",4,0,"T1",1,4,4,"H"
"6940",2017-04-10,2016,"Kasimpasa","Konyaspor","1-1",1,1,"T1",1,2,0,"D"
"6941",2017-04-12,2016,"Gaziantepspor","Genclerbirligi","0-1",0,1,"T1",1,1,-1,"A"
"6942",2017-04-21,2016,"Karabukspor","Kasimpasa","0-0",0,0,"T1",1,0,0,"D"
"6943",2017-04-21,2016,"Konyaspor","Gaziantepspor","1-2",1,2,"T1",1,3,-1,"A"
"6944",2017-04-22,2016,"Alanyaspor","Osmanlispor","0-1",0,1,"T1",1,1,-1,"A"
"6945",2017-04-22,2016,"Antalyaspor","Trabzonspor","0-3",0,3,"T1",1,3,-3,"A"
"6946",2017-04-22,2016,"Genclerbirligi","Kayserispor","2-1",2,1,"T1",1,3,1,"H"
"6947",2017-04-22,2016,"Rizespor","Buyuksehyr","3-3",3,3,"T1",1,6,0,"D"
"6948",2017-04-23,2016,"Akhisar Belediyespor","Bursaspor","5-1",5,1,"T1",1,6,4,"H"
"6949",2017-04-23,2016,"Galatasaray","Fenerbahce","0-1",0,1,"T1",1,1,-1,"A"
"6950",2017-04-24,2016,"Besiktas","Adanaspor","3-2",3,2,"T1",1,5,1,"H"
"6951",2017-04-28,2016,"Gaziantepspor","Karabukspor","0-0",0,0,"T1",1,0,0,"D"
"6952",2017-04-29,2016,"Kayserispor","Alanyaspor","3-0",3,0,"T1",1,3,3,"H"
"6953",2017-04-29,2016,"Trabzonspor","Genclerbirligi","0-0",0,0,"T1",1,0,0,"D"
"6954",2017-04-30,2016,"Adanaspor","Antalyaspor","2-5",2,5,"T1",1,7,-3,"A"
"6955",2017-04-30,2016,"Buyuksehyr","Besiktas","3-1",3,1,"T1",1,4,2,"H"
"6956",2017-04-30,2016,"Fenerbahce","Rizespor","2-1",2,1,"T1",1,3,1,"H"
"6957",2017-04-30,2016,"Kasimpasa","Akhisar Belediyespor","0-2",0,2,"T1",1,2,-2,"A"
"6958",2017-05-01,2016,"Bursaspor","Galatasaray","0-5",0,5,"T1",1,5,-5,"A"
"6959",2017-05-01,2016,"Osmanlispor","Konyaspor","0-0",0,0,"T1",1,0,0,"D"
"6960",2017-05-05,2016,"Antalyaspor","Buyuksehyr","0-1",0,1,"T1",1,1,-1,"A"
"6961",2017-05-06,2016,"Galatasaray","Kasimpasa","1-3",1,3,"T1",1,4,-2,"A"
"6962",2017-05-06,2016,"Genclerbirligi","Adanaspor","0-1",0,1,"T1",1,1,-1,"A"
"6963",2017-05-06,2016,"Konyaspor","Alanyaspor","2-3",2,3,"T1",1,5,-1,"A"
"6964",2017-05-06,2016,"Trabzonspor","Kayserispor","2-3",2,3,"T1",1,5,-1,"A"
"6965",2017-05-07,2016,"Besiktas","Fenerbahce","1-1",1,1,"T1",1,2,0,"D"
"6966",2017-05-07,2016,"Rizespor","Bursaspor","6-0",6,0,"T1",1,6,6,"H"
"6967",2017-05-08,2016,"Akhisar Belediyespor","Gaziantepspor","6-0",6,0,"T1",1,6,6,"H"
"6968",2017-05-08,2016,"Karabukspor","Osmanlispor","1-0",1,0,"T1",1,1,1,"H"
"6969",2017-05-12,2016,"Kasimpasa","Rizespor","4-2",4,2,"T1",1,6,2,"H"
"6970",2017-05-12,2016,"Kayserispor","Konyaspor","2-1",2,1,"T1",1,3,1,"H"
"6971",2017-05-13,2016,"Adanaspor","Trabzonspor","1-1",1,1,"T1",1,2,0,"D"
"6972",2017-05-13,2016,"Buyuksehyr","Genclerbirligi","2-1",2,1,"T1",1,3,1,"H"
"6973",2017-05-13,2016,"Fenerbahce","Antalyaspor","0-1",0,1,"T1",1,1,-1,"A"
"6974",2017-05-14,2016,"Alanyaspor","Karabukspor","4-2",4,2,"T1",1,6,2,"H"
"6975",2017-05-14,2016,"Gaziantepspor","Galatasaray","1-2",1,2,"T1",1,3,-1,"A"
"6976",2017-05-14,2016,"Osmanlispor","Akhisar Belediyespor","0-4",0,4,"T1",1,4,-4,"A"
"6977",2017-05-15,2016,"Bursaspor","Besiktas","0-2",0,2,"T1",1,2,-2,"A"
"6978",2017-05-19,2016,"Galatasaray","Osmanlispor","2-0",2,0,"T1",1,2,2,"H"
"6979",2017-05-20,2016,"Antalyaspor","Bursaspor","2-1",2,1,"T1",1,3,1,"H"
"6980",2017-05-20,2016,"Besiktas","Kasimpasa","4-1",4,1,"T1",1,5,3,"H"
"6981",2017-05-20,2016,"Kayserispor","Adanaspor","1-1",1,1,"T1",1,2,0,"D"
"6982",2017-05-20,2016,"Rizespor","Gaziantepspor","2-0",2,0,"T1",1,2,2,"H"
"6983",2017-05-21,2016,"Konyaspor","Karabukspor","3-0",3,0,"T1",1,3,3,"H"
"6984",2017-05-21,2016,"Trabzonspor","Buyuksehyr","0-0",0,0,"T1",1,0,0,"D"
"6985",2017-05-22,2016,"Akhisar Belediyespor","Alanyaspor","3-0",3,0,"T1",1,3,3,"H"
"6986",2017-05-22,2016,"Genclerbirligi","Fenerbahce","1-2",1,2,"T1",1,3,-1,"A"
"6987",2017-05-27,2016,"Buyuksehyr","Adanaspor","2-1",2,1,"T1",1,3,1,"H"
"6988",2017-05-27,2016,"Fenerbahce","Trabzonspor","1-1",1,1,"T1",1,2,0,"D"
"6989",2017-05-27,2016,"Kasimpasa","Antalyaspor","0-3",0,3,"T1",1,3,-3,"A"
"6990",2017-05-27,2016,"Konyaspor","Akhisar Belediyespor","0-3",0,3,"T1",1,3,-3,"A"
"6991",2017-05-28,2016,"Bursaspor","Genclerbirligi","1-2",1,2,"T1",1,3,-1,"A"
"6992",2017-05-28,2016,"Gaziantepspor","Besiktas","0-4",0,4,"T1",1,4,-4,"A"
"6993",2017-05-28,2016,"Karabukspor","Kayserispor","2-2",2,2,"T1",1,4,0,"D"
"6994",2017-05-28,2016,"Osmanlispor","Rizespor","1-2",1,2,"T1",1,3,-1,"A"
"6995",2017-05-29,2016,"Alanyaspor","Galatasaray","2-3",2,3,"T1",1,5,-1,"A"
"6996",2017-06-02,2016,"Akhisar Belediyespor","Karabukspor","2-3",2,3,"T1",1,5,-1,"A"
"6997",2017-06-02,2016,"Antalyaspor","Gaziantepspor","4-1",4,1,"T1",1,5,3,"H"
"6998",2017-06-02,2016,"Genclerbirligi","Kasimpasa","1-0",1,0,"T1",1,1,1,"H"
"6999",2017-06-03,2016,"Adanaspor","Fenerbahce","1-3",1,3,"T1",1,4,-2,"A"
"7000",2017-06-03,2016,"Besiktas","Osmanlispor","4-0",4,0,"T1",1,4,4,"H"
"7001",2017-06-03,2016,"Galatasaray","Konyaspor","2-1",2,1,"T1",1,3,1,"H"
"7002",2017-06-03,2016,"Kayserispor","Buyuksehyr","0-1",0,1,"T1",1,1,-1,"A"
"7003",2017-06-03,2016,"Rizespor","Alanyaspor","1-0",1,0,"T1",1,1,1,"H"
"7004",2017-06-03,2016,"Trabzonspor","Bursaspor","1-2",1,2,"T1",1,3,-1,"A"
